Domestic turkey	binomial	Wild Turkey
HeLa	binomial	HeLa#Helacyton gartleri
Ugli fruit	binomial	Mandarin orange
Basil	binomial	Ocimum basilicum
Paraponera	binomial	Paraponera
Pinus palustris	binomial	Palustris
Kombu	binomial	Saccharina japonica
Razorback	binomial	Wild boar
Bergamot orange	binomial	Wikispecies:Citrus bergamia
Penicillium candidum	binomial	Johann Heinrich Friedrich Link
Hydrophyllum virginianum	binomial	Carl Linnaeus
Hemidesmus indicus	binomial	Carl Linnaeus
Choristotanyderus	binomial	Extinction
Scissor-tail rasbora	binomial	Maurice Kottelat
Carrot	binomial	Daucus carota
Methanospirillaceae	binomial	Methanomicrobiales
Trichuris suis	binomial	Trichuris suis
Papilio bianor	binomial	Pieter Cramer
Coffea liberica	binomial	William Bull
Betula platyphylla	binomial	Vladimir Sukachev
Kirtland's Snake	binomial	Robert Kennicott
Plasmodium falciparum biology	binomial	Plasmodium falciparum
Datura leichhardtii	binomial	Ferdinand von Mueller
Datura ceratocaula	binomial	Nikolaus Joseph von Jacquin
Lapland Ringlet	binomial	Lapland Ringlet
Arctic Ringlet	binomial	Arctic Ringlet
Piedmont Ringlet	binomial	Piedmont Ringlet
Ranunculus longirostris	binomial	Dominique Alexandre Godron
Japanese water spider	binomial	Diving bell spider
Australian spider beetle	binomial	Ptinus tectus
Showa (Nishikigoi)	binomial	Common carp
Macheirocera grandis	binomial	Camillo Róndani
Macheirocera grandis	binomial	1869
Dalpiazella	binomial	Dalpiazella brevicauda
Elaeodendron australe	binomial	Otto Kuntze
Megapiranha	binomial	Type (biology)
Western Tailed-Blue	binomial	Western Tailed-Blue
Blechnum nudum	binomial	Jacques Labillardière
Blechnum ambiguum	binomial	Carl Borivoj Presl
Doodia aspera	binomial	Robert Brown (botanist)
Pellaea falcata	binomial	Robert Brown (botanist)
Lindera aggregata	binomial	John Sims (taxonomist)
Pellaea atropurpurea	binomial	Carl Linnaeus
Pellaea glabella	binomial	Georg Heinrich Mettenius
Maytenus silvestris	binomial	Lawrence Alexander Sidney Johnson
Syncarpia hillii	binomial	Frederick Manson Bailey
Raukaua laetevirens	binomial	Claude Gay
University of Maryland Arboretum & Botanical Garden	binomial	Acer griseum
Pellaea nana	binomial	William Jackson Hooker
Steganotaenia araliacea	binomial	Steganotaenia araliacea
Mescalerolemur	binomial	Extinction
Pellaea paradoxa	binomial	Robert Brown (botanist)
Magnolia montana	binomial	Carl Ludwig Blume
Pimpinella major	binomial	Carl Linnaeus
