WABC-TV	CALLLETTERS	WABC-TV
WAPA-TV	CALLLETTERS	WAPA-TV
WPXN-TV	CALLLETTERS	WPXN-TV
WPIX	CALLLETTERS	WPIX
WTTW	CALLLETTERS	WTTW
WGN-TV	CALLLETTERS	WGN-TV
FUJI TELEVISION	CALLLETTERS	JOCX-DTV
WKAQ-TV	CALLLETTERS	WKAQ-TV
WSTE-DT	CALLLETTERS	WSTE-DT
WLII-DT	CALLLETTERS	WLII-DT
WOWOW	CALLLETTERS	WOWOW
GEORGIA PUBLIC BROADCASTING	CALLLETTERS	GEORGIA PUBLIC BROADCASTING
WNET	CALLLETTERS	WNET
WEFG-LD	CALLLETTERS	WEFG-LD
KCET	CALLLETTERS	KCET
IOWA PUBLIC TELEVISION	CALLLETTERS	IOWA PUBLIC TELEVISION
CKVR-DT	CALLLETTERS	CKVR-DT
CFPL-DT	CALLLETTERS	CFPL-DT
WEWS-TV	CALLLETTERS	WEWS-TV
KARE	CALLLETTERS	KARE
KAAL	CALLLETTERS	KAAL
WHEC-TV	CALLLETTERS	WHEC-TV
WDIO-DT	CALLLETTERS	WDIO-DT / WIRT-DT
KSTC-TV	CALLLETTERS	KSTC-TV
WNYT	CALLLETTERS	WNYT
CKWS-DT	CALLLETTERS	CKWS-DT
WCFE-TV	CALLLETTERS	WCFE-TV
CJOH-DT	CALLLETTERS	CJOH-DT
WMTW	CALLLETTERS	WMTW
WWNY-TV	CALLLETTERS	WWNY-TV
TVONTARIO	CALLLETTERS	TVONTARIO
CJON-DT	CALLLETTERS	CJON-DT
CKCO-DT	CALLLETTERS	CKCO-DT
DXAG-TV	CALLLETTERS	DXAG-TV
WRAL-TV	CALLLETTERS	WRAL-TV
WTVD	CALLLETTERS	WTVD
WUVC-DT	CALLLETTERS	WUVC-DT
WRAZ	CALLLETTERS	WRAZ
CKXT-DT	CALLLETTERS	CKXT-DT
CITY-DT	CALLLETTERS	CITY-DT
WHYY-TV	CALLLETTERS	WHYY-TV / WDPB
WGBH-TV	CALLLETTERS	WGBH-TV
TV TOKYO	CALLLETTERS	JOTX-TV
TéLé-QUéBEC	CALLLETTERS	CIVM-DT
KMSP-TV	CALLLETTERS	KMSP-TV
WCCO-TV	CALLLETTERS	WCCO-TV
CHFD-DT	CALLLETTERS	CHFD-DT
CKPR-DT	CALLLETTERS	CKPR-DT
TDT	CALLLETTERS	TDT
CHCH-DT	CALLLETTERS	CHCH-DT
ATV	CALLLETTERS	ATV
GTV	CALLLETTERS	GTV
TEN	CALLLETTERS	TEN
CKND-DT	CALLLETTERS	CKND-DT
WITN-TV	CALLLETTERS	WITN-TV
CKNX-TV	CALLLETTERS	CKNX-TV
CHWI-DT	CALLLETTERS	CHWI-DT
WBTV	CALLLETTERS	WBTV
CHRO-TV	CALLLETTERS	CHRO-TV
CIVI-DT	CALLLETTERS	CIVI-DT
WCNC-TV	CALLLETTERS	WCNC-TV
WCCB	CALLLETTERS	WCCB
TVT	CALLLETTERS	TVT
CHMI-DT	CALLLETTERS	CHMI-DT
TNT	CALLLETTERS	TNT
OREGON PUBLIC BROADCASTING	CALLLETTERS	OREGON PUBLIC BROADCASTING
CITV-DT	CALLLETTERS	CITV-DT
BCV	CALLLETTERS	GLV / BCV
WTVT	CALLLETTERS	WTVT
ART TV	CALLLETTERS	ART TV
TV OSAKA	CALLLETTERS	JOBH-DTV
WTTE	CALLLETTERS	WTTE
WNEP-TV	CALLLETTERS	WNEP-TV
CKVU-DT	CALLLETTERS	CKVU-DT
WBRE-TV	CALLLETTERS	WBRE-TV
CJMT-DT	CALLLETTERS	CJMT-DT
CFMT-DT	CALLLETTERS	CFMT-DT
CBWT-DT	CALLLETTERS	CBWT-DT
WBZ-TV	CALLLETTERS	WBZ-TV
CHNU-DT	CALLLETTERS	CHNU-DT
CIIT-DT	CALLLETTERS	CIIT-DT
CBOT-DT	CALLLETTERS	CBOT-DT
WCMH-TV	CALLLETTERS	WCMH-TV
WWHO	CALLLETTERS	WWHO
COBB EDUCATION TELEVISION	CALLLETTERS	COBB EDUCATION TELEVISION
CFTU-DT	CALLLETTERS	CFTU-DT
CHNM-DT	CALLLETTERS	CHNM-DT
WSTR-TV	CALLLETTERS	WSTR-TV
WKEF	CALLLETTERS	WKEF
WRGT-TV	CALLLETTERS	WRGT-TV
WFGX	CALLLETTERS	WFGX
WTTA	CALLLETTERS	WTTA
WEAR-TV	CALLLETTERS	WEAR-TV
WICS	CALLLETTERS	WICS
WICD	CALLLETTERS	WICD
KGAN	CALLLETTERS	KGAN
KBSI	CALLLETTERS	KBSI
KDSM-TV	CALLLETTERS	KDSM-TV
KDNL-TV	CALLLETTERS	KDNL-TV
WNUV	CALLLETTERS	WNUV
WSYT	CALLLETTERS	WSYT
WBFF	CALLLETTERS	WBFF
WUHF	CALLLETTERS	WUHF
WUTV	CALLLETTERS	WUTV
WNYO-TV	CALLLETTERS	WNYO-TV
WGME-TV	CALLLETTERS	WGME-TV
WNYS-TV	CALLLETTERS	WNYS-TV
WGGB-TV	CALLLETTERS	WGGB-TV
WDKA	CALLLETTERS	WDKA
KVCW	CALLLETTERS	KVCW
WGWG	CALLLETTERS	WGWG
WSMH	CALLLETTERS	WSMH
WPNT	CALLLETTERS	WPNT
KHSV	CALLLETTERS	KHSV
WZTV	CALLLETTERS	WZTV
WMYA-TV	CALLLETTERS	WMYA-TV
WUXP-TV	CALLLETTERS	WUXP-TV
WNAB	CALLLETTERS	WNAB
WMSN-TV	CALLLETTERS	WMSN-TV
CITS-DT	CALLLETTERS	CITS-DT
CFYK-DT	CALLLETTERS	CFYK-DT
CBXT-DT	CALLLETTERS	CBXT-DT
CBKST	CALLLETTERS	CBKST
CBUT-DT	CALLLETTERS	CBUT-DT
CBRT-DT	CALLLETTERS	CBRT-DT
CBKT-DT	CALLLETTERS	CBKT-DT
CBLT-DT	CALLLETTERS	CBLT-DT
CBET-DT	CALLLETTERS	CBET-DT
CBMT-DT	CALLLETTERS	CBMT-DT
CBAT-DT	CALLLETTERS	CBAT-DT
CBCT-DT	CALLLETTERS	CBCT-DT
WBNS-TV	CALLLETTERS	WBNS-TV
WGCT-CD	CALLLETTERS	WGCT-CD
NBN TELEVISION	CALLLETTERS	NBN
TWIN CITIES PBS	CALLLETTERS	KTCA-TV / KTCI-TV
WSJV	CALLLETTERS	WSJV
WVVA	CALLLETTERS	WVVA
WQOW	CALLLETTERS	WQOW
WXOW	CALLLETTERS	WXOW
WAOW	CALLLETTERS	WAOW
KTTC	CALLLETTERS	KTTC
CITO-TV	CALLLETTERS	CITO-TV
CHBX-TV	CALLLETTERS	CHBX-TV
CKNY-TV	CALLLETTERS	CKNY-TV
CICI-TV	CALLLETTERS	CICI-TV
CFEG-TV	CALLLETTERS	CFEG-TV
CKEM-DT	CALLLETTERS	CKEM-DT
CKAL-DT	CALLLETTERS	CKAL-DT
WTSP	CALLLETTERS	WTSP
KIRO-TV	CALLLETTERS	KIRO-TV
KING-TV	CALLLETTERS	KING-TV
KOMO-TV	CALLLETTERS	KOMO-TV
TND	CALLLETTERS	TND
KSL-TV	CALLLETTERS	KSL-TV
CKCK-DT	CALLLETTERS	CKCK-DT
CFQC-DT	CALLLETTERS	CFQC-DT
WPMI-TV	CALLLETTERS	WPMI-TV
WKRG-TV	CALLLETTERS	WKRG-TV
WJAX-TV	CALLLETTERS	WJAX-TV
WJXX	CALLLETTERS	WJXX
WTLV	CALLLETTERS	WTLV
KCTS-TV	CALLLETTERS	KCTS-TV
KCTS-TV	CALLLETTERS	KYVE
KZJO	CALLLETTERS	KZJO
KCPQ	CALLLETTERS	KCPQ
KONG	CALLLETTERS	KONG
KSTW	CALLLETTERS	KSTW
KWPX-TV	CALLLETTERS	KWPX-TV
WSB-TV	CALLLETTERS	WSB-TV
KQED	CALLLETTERS	KQED/KQET
WGCL-TV	CALLLETTERS	WGCL-TV
WXIA-TV	CALLLETTERS	WXIA-TV
WATL	CALLLETTERS	WATL
WUPA	CALLLETTERS	WUPA
KTTV	CALLLETTERS	KTTV
KSCI	CALLLETTERS	KSCI
WGBA-TV	CALLLETTERS	WGBA-TV
WACY-TV	CALLLETTERS	WACY-TV
WHDH	CALLLETTERS	WHDH
ALABAMA PUBLIC TELEVISION	CALLLETTERS	ALABAMA PUBLIC TELEVISION
KAKM	CALLLETTERS	KAKM / KTOO-TV
KSAZ-TV	CALLLETTERS	KSAZ-TV
KTVK	CALLLETTERS	KTVK
KHET	CALLLETTERS	KHET / KMEB
KGMB	CALLLETTERS	KGMB
KITV	CALLLETTERS	KITV
KHNL	CALLLETTERS	KHNL
KHON-TV	CALLLETTERS	KHON-TV
KPXO-TV	CALLLETTERS	KPXO-TV
KFVE	CALLLETTERS	KFVE
KIKU	CALLLETTERS	KIKU
KTVI	CALLLETTERS	KTVI
KMOV	CALLLETTERS	KMOV
KLTV	CALLLETTERS	KLTV
KSDK	CALLLETTERS	KSDK
KETC	CALLLETTERS	KETC
KPLR-TV	CALLLETTERS	KPLR-TV
KNLC	CALLLETTERS	KNLC
WRBU	CALLLETTERS	WRBU
WLS-TV	CALLLETTERS	WLS-TV
KCAL-TV	CALLLETTERS	KCAL-TV
WDRB	CALLLETTERS	WDRB
CIII-DT	CALLLETTERS	CIII-DT
KATU	CALLLETTERS	KATU
WFXT	CALLLETTERS	WFXT
KPBS	CALLLETTERS	KPBS
TVW	CALLLETTERS	TVW
STW	CALLLETTERS	STW
WDTN	CALLLETTERS	WDTN
WGTV	CALLLETTERS	WGTV
CHAN-DT	CALLLETTERS	CHAN-DT
KUTP	CALLLETTERS	KUTP
WPBA	CALLLETTERS	WPBA
KOAA-TV	CALLLETTERS	KOAA-TV
KKTV	CALLLETTERS	KKTV
KWGN-TV	CALLLETTERS	KWGN-TV
KXRM-TV	CALLLETTERS	KXRM-TV
KRDO-TV	CALLLETTERS	KRDO-TV
KCNC-TV	CALLLETTERS	KCNC-TV
ROCKY MOUNTAIN PBS	CALLLETTERS	ROCKY MOUNTAIN PBS
KMGH-TV	CALLLETTERS	KMGH-TV
KTVD	CALLLETTERS	KTVD
KRMT	CALLLETTERS	KRMT
KUSA	CALLLETTERS	KUSA
KCEC	CALLLETTERS	KCEC
KPXC-TV	CALLLETTERS	KPXC-TV
KDVR	CALLLETTERS	KDVR
KDVR	CALLLETTERS	KFCT
KREX-TV	CALLLETTERS	KREX-TV
WUCW	CALLLETTERS	WUCW
CFCF-DT	CALLLETTERS	CFCF-DT
WSOC-TV	CALLLETTERS	WSOC-TV
WLBT	CALLLETTERS	WLBT
KRCR-TV	CALLLETTERS	KRCR-TV/KAEF-TV
WTHC-LD	CALLLETTERS	WTHC-LD
KTVQ	CALLLETTERS	KTVQ
CBHT-DT	CALLLETTERS	CBHT-DT
CHEK-DT	CALLLETTERS	CHEK-DT
KPPC	CALLLETTERS	KPPC-FM
WCSH	CALLLETTERS	WCSH
KZTV	CALLLETTERS	KZTV
KVIE	CALLLETTERS	KVIE
KCRA-TV	CALLLETTERS	KCRA-TV
KXTV	CALLLETTERS	KXTV
KOVR	CALLLETTERS	KOVR
CHEX-DT	CALLLETTERS	CHEX-DT
CBEFT	CALLLETTERS	CBEFT
WBQC-LD	CALLLETTERS	WBQC-LD
WSKC-CD	CALLLETTERS	WSKC-CD
WHSG-TV	CALLLETTERS	WHSG-TV
WUVM-LP	CALLLETTERS	WUVM-LP
WXID-LP	CALLLETTERS	WXID-LP
WATC-DT	CALLLETTERS	WATC-DT
WDTA-LD	CALLLETTERS	WDTA-LD
WPXA-TV	CALLLETTERS	WPXA-TV
WUVG-DT	CALLLETTERS	WUVG-DT
WIRE-CD	CALLLETTERS	WIRE-CD
W45DX-D	CALLLETTERS	W45DX-D
WTBS-LD	CALLLETTERS	WTBS-LP / WTBS-LD
WANN-CD	CALLLETTERS	WANN-CD
WKTB-CD	CALLLETTERS	WKTB-CD
BKN	CALLLETTERS	GTS/BKN
CHCA-TV	CALLLETTERS	CHCA-TV
CJFB-TV	CALLLETTERS	CJFB-TV
WNWO-TV	CALLLETTERS	WNWO-TV
WNYW	CALLLETTERS	WNYW
KATC	CALLLETTERS	KATC
CIVT-DT	CALLLETTERS	CIVT-DT
CHBC-DT	CALLLETTERS	CHBC-DT
WABM	CALLLETTERS	WABM
WBMA-LD	CALLLETTERS	WBMA-LD
WBRC	CALLLETTERS	WBRC
WUFT	CALLLETTERS	WUFT
WIAT	CALLLETTERS	WIAT
WVTM-TV	CALLLETTERS	WVTM-TV
WTTO	CALLLETTERS	WTTO / WDBB
WPXH-TV	CALLLETTERS	WPXH-TV
KMTR	CALLLETTERS	KMTR
WRC-TV	CALLLETTERS	WRC-TV
CKCW-DT	CALLLETTERS	CKCW-DT
CKLT-DT	CALLLETTERS	CKLT-DT
CJCB-TV	CALLLETTERS	CJCB-TV
WVII-TV	CALLLETTERS	WVII-TV
WPBS-DT	CALLLETTERS	WPBS-DT / WNPI-DT
WNBC	CALLLETTERS	WNBC
WUSA	CALLLETTERS	WUSA
NRN	CALLLETTERS	NRN
TCN	CALLLETTERS	TCN
ATN	CALLLETTERS	ATN
KMTV-TV	CALLLETTERS	KMTV-TV
WOWT	CALLLETTERS	WOWT
KETV	CALLLETTERS	KETV
WTAE-TV	CALLLETTERS	WTAE-TV
WPCW	CALLLETTERS	WPCW
KDKA-TV	CALLLETTERS	KDKA-TV
WQED	CALLLETTERS	WQED
WPXI	CALLLETTERS	WPXI
WPGH-TV	CALLLETTERS	WPGH-TV
TAEGU BROADCASTING CORPORATION	CALLLETTERS	HLDE-DTV
KNBC	CALLLETTERS	KNBC
WLWT	CALLLETTERS	WLWT
WLBZ	CALLLETTERS	WLBZ
WSAZ-TV	CALLLETTERS	WSAZ-TV
CHOT-DT	CALLLETTERS	CHOT-DT
CBLFT-DT	CALLLETTERS	CBLFT-DT
CBOFT-DT	CALLLETTERS	CBOFT-DT
CHNB-TV	CALLLETTERS	CHNB-TV
CKNC-TV	CALLLETTERS	CKNC-TV
CBWFT-DT	CALLLETTERS	CBWFT-DT
CBFT-DT	CALLLETTERS	CBFT-DT
CBVT-DT	CALLLETTERS	CBVT
CFTM-DT	CALLLETTERS	CFTM-DT
CFJP-DT	CALLLETTERS	CFJP-DT
CKMI-DT	CALLLETTERS	CKMI-DT
CJNT-DT	CALLLETTERS	CJNT-DT
WEST VIRGINIA PUBLIC BROADCASTING	CALLLETTERS	WEST VIRGINIA PUBLIC BROADCASTING
WLOS	CALLLETTERS	WLOS
WSPA-TV	CALLLETTERS	WSPA-TV
CFGS-DT	CALLLETTERS	CFGS-DT
NWS	CALLLETTERS	NWS
WRGB	CALLLETTERS	WRGB
WMHT	CALLLETTERS	WMHT
WTEN	CALLLETTERS	WTEN
WTEN	CALLLETTERS	WCDC-TV
ASAHI BROADCASTING CORPORATION	CALLLETTERS	JONR-DTV
KTVB	CALLLETTERS	KTVB
KANSAI TELECASTING CORPORATION	CALLLETTERS	JODX-DTV
TOHOKU BROADCASTING COMPANY	CALLLETTERS	JOIR-DTV
RCC BROADCASTING	CALLLETTERS	JOER-TV, JOER-DTV
YOMIURI TELECASTING CORPORATION	CALLLETTERS	JOIX-DTV
SANYO BROADCASTING	CALLLETTERS	JOYR-TV, JOYR-DTV
WFLA-TV	CALLLETTERS	WFLA-TV
KXMC-TV	CALLLETTERS	KXMC-TV
KXMD-TV	CALLLETTERS	KXMD-TV
KXMB-TV	CALLLETTERS	KXMB-TV
KXMA-TV	CALLLETTERS	KXMA-TV
KXLN-DT	CALLLETTERS	KXLN-DT
KFYR-TV	CALLLETTERS	KFYR-TV
KUMV-TV	CALLLETTERS	KUMV-TV
KQCD-TV	CALLLETTERS	KQCD-TV
KVLY-TV	CALLLETTERS	KVLY-TV
KMOT	CALLLETTERS	KMOT
KRDK-TV	CALLLETTERS	KRDK-TV
WWOR-TV	CALLLETTERS	WWOR-TV
WPHL-TV	CALLLETTERS	WPHL-TV
WNIT	CALLLETTERS	WNIT
WFTY-DT	CALLLETTERS	WFTY-DT
KTRK-TV	CALLLETTERS	KTRK-TV
KETK-LP	CALLLETTERS	KETK-LP
KETK-TV	CALLLETTERS	KETK-TV
KYTX	CALLLETTERS	KYTX
KFXK-TV	CALLLETTERS	KFXK-TV
KCEB	CALLLETTERS	KCEB
WZZM	CALLLETTERS	WZZM
WOOD-TV	CALLLETTERS	WOOD-TV
NTD	CALLLETTERS	NTD
KCBS-TV	CALLLETTERS	KCBS-TV
WSVN	CALLLETTERS	WSVN
CISA-DT	CALLLETTERS	CISA-DT
WXXA-TV	CALLLETTERS	WXXA-TV
KLRU	CALLLETTERS	KLRU
WCBS-TV	CALLLETTERS	WCBS-TV
MARYLAND PUBLIC TELEVISION	CALLLETTERS	MARYLAND PUBLIC TELEVISION
NEW JERSEY NETWORK	CALLLETTERS	NEW JERSEY NETWORK
WGBX-TV	CALLLETTERS	WGBX-TV
WBBM-TV	CALLLETTERS	WBBM-TV
CIHF-DT	CALLLETTERS	CIHF-DT
CICT-DT	CALLLETTERS	CICT-DT
CITL-DT	CALLLETTERS	CITL-DT
CFCN-DT	CALLLETTERS	CFCN-DT
CFRN-DT	CALLLETTERS	CFRN-DT
CIPA-TV	CALLLETTERS	CIPA-TV
CBXFT-DT	CALLLETTERS	CBXFT-DT
CBYT	CALLLETTERS	CBYT
CBAFT-DT	CALLLETTERS	CBAFT
CBUFT-DT	CALLLETTERS	CBUFT-DT
CBNT-DT	CALLLETTERS	CBNT-DT
CBKFT-DT	CALLLETTERS	CBKFT-DT
STQ	CALLLETTERS	STQ
WFTC	CALLLETTERS	WFTC / KFTC
KPXM-TV	CALLLETTERS	KPXM-TV
KSTP-TV	CALLLETTERS	KSTP-TV
KPLC	CALLLETTERS	KPLC
WFLD	CALLLETTERS	WFLD
PIONEER PUBLIC TV	CALLLETTERS	KWCM-TV / KSMN-TV
WLNY-TV	CALLLETTERS	WLNY-TV
CICC-TV	CALLLETTERS	CICC-TV
WIFR	CALLLETTERS	WIFR
TELEVISION AICHI BROADCASTING	CALLLETTERS	JOCI-DTV
CHūKYō TELEVISION BROADCASTING	CALLLETTERS	JOCH-DTV
QTQ	CALLLETTERS	QTQ
KLCS	CALLLETTERS	KLCS
WCWN	CALLLETTERS	WCWN
WNYA	CALLLETTERS	WNYA
KMEX-DT	CALLLETTERS	KMEX-DT
WJXT	CALLLETTERS	WJXT
SUN TELEVISION	CALLLETTERS	JOUH-DTV
W47EI-D	CALLLETTERS	W47EI-D
WJZY	CALLLETTERS	WJZY
WAXN-TV	CALLLETTERS	WAXN-TV
KBMY	CALLLETTERS	KBMY / KMCY
WXII-TV	CALLLETTERS	WXII-TV
WNCN	CALLLETTERS	WNCN
WCIU-TV	CALLLETTERS	WCIU-TV
WFMY-TV	CALLLETTERS	WFMY-TV
WWAY	CALLLETTERS	WWAY
WECT	CALLLETTERS	WECT
WILM-LD	CALLLETTERS	WILM-LD
WNCT-TV	CALLLETTERS	WNCT-TV
WXLV-TV	CALLLETTERS	WXLV-TV
WCTI-TV	CALLLETTERS	WCTI-TV
WBAY-TV	CALLLETTERS	WBAY-TV
KVRR	CALLLETTERS	KVRR
TōKAI TELEVISION BROADCASTING	CALLLETTERS	JOFX-TV
WNSC-TV	CALLLETTERS	WNSC-TV
WTVI	CALLLETTERS	WTVI
WCWG	CALLLETTERS	WCWG
WMAQ-TV	CALLLETTERS	WMAQ-TV
WLVT-TV	CALLLETTERS	WLVT-TV
WFMZ-TV	CALLLETTERS	WFMZ-TV
WVUA-CD	CALLLETTERS	WVUA-CD / WVUA
WBTW	CALLLETTERS	WBTW
WCSC-TV	CALLLETTERS	WCSC-TV
WPLG	CALLLETTERS	WPLG
KPRC-TV	CALLLETTERS	KPRC-TV
WKMG-TV	CALLLETTERS	WKMG-TV
WDIV-TV	CALLLETTERS	WDIV-TV
WVCY-TV	CALLLETTERS	WVCY-TV
WTMJ-TV	CALLLETTERS	WTMJ-TV
ALASKAONE	CALLLETTERS	ALASKAONE
WCAX-TV	CALLLETTERS	WCAX-TV
WPTZ	CALLLETTERS	WPTZ
WSRE	CALLLETTERS	WSRE
KSBY	CALLLETTERS	KSBY
WMYO	CALLLETTERS	WMYO
WITI	CALLLETTERS	WITI
WDJT-TV	CALLLETTERS	WDJT-TV
WISN-TV	CALLLETTERS	WISN-TV
WCGV-TV	CALLLETTERS	WCGV-TV
WVTV	CALLLETTERS	WVTV
WBBJ-TV	CALLLETTERS	WBBJ-TV
WMVT	CALLLETTERS	WMVT
WMVS	CALLLETTERS	WMVS
KGW	CALLLETTERS	KGW
WPVI-TV	CALLLETTERS	WPVI-TV
WTXF-TV	CALLLETTERS	WTXF-TV
WPSG	CALLLETTERS	WPSG
KYW-TV	CALLLETTERS	KYW-TV
WCAU	CALLLETTERS	WCAU
WRDC	CALLLETTERS	WRDC
CHUBU-NIPPON BROADCASTING	CALLLETTERS	JOGX-DTV
WJCT	CALLLETTERS	WJCT
WCVB-TV	CALLLETTERS	WCVB-TV
WWJ-TV	CALLLETTERS	WWJ-TV
WJBK	CALLLETTERS	WJBK
WXYZ-TV	CALLLETTERS	WXYZ-TV
WOIO	CALLLETTERS	WOIO
KMOS-TV	CALLLETTERS	KMOS-TV
WUAB	CALLLETTERS	WUAB
CKBI-TV	CALLLETTERS	CKBI-TV
CKOS-TV	CALLLETTERS	CKOS-TV
CKSA-DT	CALLLETTERS	CKSA-DT
WGRZ	CALLLETTERS	WGRZ
WVIA-TV	CALLLETTERS	WVIA-TV
WBNX-TV	CALLLETTERS	WBNX-TV
WPBT	CALLLETTERS	WPBT
WCBD-TV	CALLLETTERS	WCBD-TV
WCIV	CALLLETTERS	WCIV
WCVE-TV	CALLLETTERS	WCVE-TV / WCVW / WHTJ
KGO-TV	CALLLETTERS	KGO-TV
WDAZ-TV	CALLLETTERS	WDAZ-TV
WWBT	CALLLETTERS	WWBT
WHTV	CALLLETTERS	WHTV
STAR RAY TV	CALLLETTERS	VX9AMK
STAR RAY TV	CALLLETTERS	\
KLAS-TV	CALLLETTERS	KLAS-TV
SHINHIROSHIMA TELECASTING	CALLLETTERS	JORM-TV
KIXE-TV	CALLLETTERS	KIXE-TV
WALA-TV	CALLLETTERS	WALA-TV
WJTC	CALLLETTERS	WJTC
WPWR-TV	CALLLETTERS	WPWR-TV
WSES	CALLLETTERS	WSES
WGWW	CALLLETTERS	WGWW
KDOC-TV	CALLLETTERS	KDOC-TV
KNSD	CALLLETTERS	KNSD
KGTV	CALLLETTERS	KGTV
KFMB-TV	CALLLETTERS	KFMB-TV
WFNA	CALLLETTERS	WFNA
WQRF-TV	CALLLETTERS	WQRF-TV
WREX	CALLLETTERS	WREX
XETV-TDT	CALLLETTERS	XETV-TDT
WIVB-TV	CALLLETTERS	WIVB-TV
WFAA	CALLLETTERS	WFAA
WKBW-TV	CALLLETTERS	WKBW-TV
NAGOYA BROADCASTING NETWORK	CALLLETTERS	JOLX-DTV
KPNX	CALLLETTERS	KPNX
KSEE	CALLLETTERS	KSEE
NEW	CALLLETTERS	NEW
WCWJ	CALLLETTERS	WCWJ
KLVX	CALLLETTERS	KLVX
KXAS-TV	CALLLETTERS	KXAS-TV
KSAT-TV	CALLLETTERS	KSAT-TV
KRIV	CALLLETTERS	KRIV
KNXT	CALLLETTERS	KNXT
KIAH	CALLLETTERS	KIAH
WFOX-TV	CALLLETTERS	WFOX-TV
KUHT	CALLLETTERS	KUHT
WKTV	CALLLETTERS	WKTV
KDFW	CALLLETTERS	KDFW
WEYI-TV	CALLLETTERS	WEYI-TV
KVOS-TV	CALLLETTERS	KVOS-TV
UNC-TV	CALLLETTERS	UNIVERSITY OF NORTH CAROLINA TELEVISION
WNDU-TV	CALLLETTERS	WNDU-TV
WSBT-TV	CALLLETTERS	WSBT-TV
WETA-TV	CALLLETTERS	WETA-TV
KEYE-TV	CALLLETTERS	KEYE-TV
KENS	CALLLETTERS	KENS
KYAZ	CALLLETTERS	KYAZ
WUDT-LD	CALLLETTERS	WUDT-LD
WKBD-TV	CALLLETTERS	WKBD-TV
WEDU	CALLLETTERS	WEDU
WCPO-TV	CALLLETTERS	WCPO-TV
KVVU-TV	CALLLETTERS	KVVU-TV
WAVE	CALLLETTERS	WAVE
WLKY	CALLLETTERS	WLKY
WHAS-TV	CALLLETTERS	WHAS-TV
WBKI-TV	CALLLETTERS	WBKI-TV
KUNS-TV	CALLLETTERS	KUNS-TV
UNIVERSITY OF WISCONSIN–STEVENS POINT	CALLLETTERS	SPTV
WTVO	CALLLETTERS	WTVO
WOFL	CALLLETTERS	WOFL
WTVS	CALLLETTERS	WTVS
WSBK-TV	CALLLETTERS	WSBK-TV
WLVI	CALLLETTERS	WLVI
WGEM-TV	CALLLETTERS	WGEM-TV
KXLT-TV	CALLLETTERS	KXLT-TV
WKOW	CALLLETTERS	WKOW
KXNW	CALLLETTERS	KXNW
WJAR	CALLLETTERS	WJAR
WPCB-TV	CALLLETTERS	WPCB-TV
WLNE-TV	CALLLETTERS	WLNE-TV
WUMN-LP	CALLLETTERS	WUMN-LP
WMYD	CALLLETTERS	WMYD
KTVT	CALLLETTERS	KTVT
WWLP	CALLLETTERS	WWLP
WOAI-TV	CALLLETTERS	WOAI-TV
KBCW	CALLLETTERS	KBCW
KEZI	CALLLETTERS	KEZI
WJLA-TV	CALLLETTERS	WJLA-TV
WLIW	CALLLETTERS	WLIW
WWSI	CALLLETTERS	WWSI
WFDC-DT	CALLLETTERS	WFDC-DT
TELEFE	CALLLETTERS	LS84 TV
WDCA	CALLLETTERS	WDCA
MDV	CALLLETTERS	MDV
KDAF	CALLLETTERS	KDAF
KABB	CALLLETTERS	KABB
KMYS	CALLLETTERS	KMYS
KTXA	CALLLETTERS	KTXA
KDFI	CALLLETTERS	KDFI
KTBU	CALLLETTERS	KTBU
KFWD	CALLLETTERS	KFWD
WXTV-DT	CALLLETTERS	WXTV-DT
KMAX-TV	CALLLETTERS	KMAX-TV
WXMI	CALLLETTERS	WXMI
WKRC-TV	CALLLETTERS	WKRC-TV
WXIX-TV	CALLLETTERS	WXIX-TV
KTBS-TV	CALLLETTERS	KTBS-TV
KPHO-TV	CALLLETTERS	KPHO-TV
KNXV-TV	CALLLETTERS	KNXV-TV
KHOU	CALLLETTERS	KHOU
WXSP-CD	CALLLETTERS	WXSP-CD
BUCKEYE TV	CALLLETTERS	BUCKEYE TV
CFJC-TV	CALLLETTERS	CFJC-TV
KTWU	CALLLETTERS	KTWU
KTXH	CALLLETTERS	KTXH
KCWX	CALLLETTERS	KCWX
WUVP-DT	CALLLETTERS	WUVP-DT
WJZ-TV	CALLLETTERS	WJZ-TV
WVIZ	CALLLETTERS	WVIZ
WYBE	CALLLETTERS	WYBE
WWSB	CALLLETTERS	WWSB
WFTS-TV	CALLLETTERS	WFTS
KNTV	CALLLETTERS	KNTV
WKYC	CALLLETTERS	WKYC
WNYE-TV	CALLLETTERS	WNYE-TV
WNJU	CALLLETTERS	WNJU
WFUT-DT	CALLLETTERS	WFUT-DT
WPPX-TV	CALLLETTERS	WPPX-TV
WMBC-TV	CALLLETTERS	WMBC-TV
WTVE	CALLLETTERS	WTVE
WFPA-CD	CALLLETTERS	WFPA-CD
WRNN-TV	CALLLETTERS	WRNN-TV
KPIX-TV	CALLLETTERS	KPIX-TV
WHUT-TV	CALLLETTERS	WHUT-TV
WDCW	CALLLETTERS	WDCW
WTTG	CALLLETTERS	WTTG
WTNH	CALLLETTERS	WTNH
KABC-TV	CALLLETTERS	KABC-TV
KVEA	CALLLETTERS	KVEA
XHDTV-TDT	CALLLETTERS	XHDTV-TDT
WYOU	CALLLETTERS	WYOU
CJBN-TV	CALLLETTERS	CJBN-TV
WBPH-TV	CALLLETTERS	WBPH-TV
SOUTH CAROLINA EDUCATIONAL TELEVISION	CALLLETTERS	SOUTH CAROLINA EDUCATIONAL TELEVISION
KTXL	CALLLETTERS	KTXL
WICU-TV	CALLLETTERS	WICU-TV
XHAS-TDT	CALLLETTERS	XHAS-TDT
KLST	CALLLETTERS	KLST
KTVU	CALLLETTERS	KTVU
WMDO-CD	CALLLETTERS	WMDO-CD
KRCA	CALLLETTERS	KRCA
CFAP-DT	CALLLETTERS	CFAP-TV
CFKM-DT	CALLLETTERS	CFKM-DT
CFRS-DT	CALLLETTERS	CFRS-DT
CFKS-DT	CALLLETTERS	CFKS-DT
CFTF-DT	CALLLETTERS	CFTF-DT
CFVS-DT	CALLLETTERS	CFVS-DT
WHIO-TV	CALLLETTERS	WHIO-TV
CJPM-DT	CALLLETTERS	CJPM-DT
CHAU-DT	CALLLETTERS	CHAU-DT
CFCM-DT	CALLLETTERS	CFCM-DT
CHLT-DT	CALLLETTERS	CHLT-DT
CFER-DT	CALLLETTERS	CFER-DT
CFEM-DT	CALLLETTERS	CFEM-DT
CHEM-DT	CALLLETTERS	CHEM-DT
CIMT-DT	CALLLETTERS	CIMT-DT
WHKY-TV	CALLLETTERS	WHKY-TV
KRON-TV	CALLLETTERS	KRON-TV
WBAL-TV	CALLLETTERS	WBAL-TV
WTRF-TV	CALLLETTERS	WTRF-TV
WYPX-TV	CALLLETTERS	WYPX-TV
WYCC	CALLLETTERS	WYCC
WTOV-TV	CALLLETTERS	WTOV-TV
WROC-TV	CALLLETTERS	WROC-TV
KMID	CALLLETTERS	KMID
KVCR-DT	CALLLETTERS	KVCR-DT
KAZA-TV	CALLLETTERS	KAZA-TV
KICU-TV	CALLLETTERS	KICU-TV
KRXI-TV	CALLLETTERS	KRXI-TV
KVUE	CALLLETTERS	KVUE
KOCE-TV	CALLLETTERS	KOCE-TV
KTMD	CALLLETTERS	KTMD
KERA-TV	CALLLETTERS	KERA-TV
KUVN-DT	CALLLETTERS	KUVN-DT
KXTX-TV	CALLLETTERS	KXTX-TV
KDFX-CD	CALLLETTERS	KDFX-CD
WIS	CALLLETTERS	WIS
KWEX-DT	CALLLETTERS	KWEX-DT
KVDA	CALLLETTERS	KVDA
WWL-TV	CALLLETTERS	WWL-TV
WGWB	CALLLETTERS	WGWB
WWAY-DT2	CALLLETTERS	WWAY-DT2
KASW	CALLLETTERS	KASW
WFSU-TV	CALLLETTERS	WFSU-TV / WFSG
EL TRECE	CALLLETTERS	LS85
WMUR-TV	CALLLETTERS	WMUR-TV
WMAR-TV	CALLLETTERS	WMAR-TV
WNEM-TV	CALLLETTERS	WNEM-TV
KNLA-CD	CALLLETTERS	KNLA-CD
KTLA	CALLLETTERS	KTLA
KXLA	CALLLETTERS	KXLA
KAZT-TV	CALLLETTERS	KAZT-TV
KPAZ-TV	CALLLETTERS	KPAZ-TV
KOIN	CALLLETTERS	KOIN
KPTV	CALLLETTERS	KPTV
WFTV	CALLLETTERS	WFTV
KTAV-LD	CALLLETTERS	KTAV-LD
KPDX	CALLLETTERS	KPDX
WESH	CALLLETTERS	WESH
KWHY-TV	CALLLETTERS	KWHY-TV
KTVW-DT	CALLLETTERS	KTVW-DT
WTHR	CALLLETTERS	WTHR
KFOR-TV	CALLLETTERS	KFOR-TV
KPPX-TV	CALLLETTERS	KPPX-TV
WFRV-TV	CALLLETTERS	WFRV-TV
WWMT	CALLLETTERS	WWMT
XHAB-TDT	CALLLETTERS	XHAB-TDT
XHTIT-TDT	CALLLETTERS	XHTIT-TDT
XHJK-TDT	CALLLETTERS	XHJK-TDT
XEWT-TDT	CALLLETTERS	XEWT-TDT
XHBJ-TDT	CALLLETTERS	XHBJ-TDT
XHUAA-TDT	CALLLETTERS	XHUAA-TDT
WOTV	CALLLETTERS	WOTV
WMKG-CD	CALLLETTERS	WMKG-CD
WTLJ	CALLLETTERS	WTLJ
WGVU-TV	CALLLETTERS	WGVU-TV / WGVK
KJZZ-TV	CALLLETTERS	KJZZ-TV
KUED	CALLLETTERS	KUED
KBYU-TV	CALLLETTERS	KBYU-TV
KUEN	CALLLETTERS	KUEN
KSTU	CALLLETTERS	KSTU
XHTJB-TDT	CALLLETTERS	XHTJB-TDT
WMC-TV	CALLLETTERS	WMC-TV
KUSI-TV	CALLLETTERS	KUSI-TV
KSWB-TV	CALLLETTERS	KSWB-TV
WHBQ-TV	CALLLETTERS	WHBQ-TV
WREG-TV	CALLLETTERS	WREG-TV
MHZ NETWORKS	CALLLETTERS	WNVT / WNVC
WZDC-CD	CALLLETTERS	WZDC-CD
WPXW-TV	CALLLETTERS	WPXW-TV
KADN-TV	CALLLETTERS	KADN-TV
KUCW	CALLLETTERS	KUCW
KPNZ	CALLLETTERS	KPNZ
WUTB	CALLLETTERS	WUTB
KGNS-TV	CALLLETTERS	KGNS-TV
KVTV	CALLLETTERS	KVTV
CFSK-DT	CALLLETTERS	CFSK-DT
CFRE-DT	CALLLETTERS	CFRE-DT
KAET	CALLLETTERS	KAET
WTIC-TV	CALLLETTERS	WTIC-TV
KXLY-TV	CALLLETTERS	KXLY-TV
KAIT	CALLLETTERS	KAIT
KREM	CALLLETTERS	KREM
KHQ-TV	CALLLETTERS	KHQ-TV
KSPS-TV	CALLLETTERS	KSPS-TV
KGPX-TV	CALLLETTERS	KGPX-TV
KSKN	CALLLETTERS	KSKN
KAYU-TV	CALLLETTERS	KAYU-TV
KQUP	CALLLETTERS	KQUP
WCET	CALLLETTERS	WCET
WAGM-TV	CALLLETTERS	WAGM-TV
KDPH-LP	CALLLETTERS	KDPH-LP
WATN-TV	CALLLETTERS	WATN-TV
KTAZ	CALLLETTERS	KTAZ
WLMT	CALLLETTERS	WLMT
WRCB	CALLLETTERS	WRCB
WTVC	CALLLETTERS	WTVC
WTCI	CALLLETTERS	WTCI
WDEF-TV	CALLLETTERS	WDEF-TV
WFLI-TV	CALLLETTERS	WFLI-TV
WDSI-TV	CALLLETTERS	WDSI-TV
WOOT-LP	CALLLETTERS	WOOT-LP
WYHB-LP	CALLLETTERS	WYHB-LP
WFOR-TV	CALLLETTERS	WFOR-TV
WISC-TV	CALLLETTERS	WISC-TV
TVW	CALLLETTERS	TVW/WISC-DT2
KVEW	CALLLETTERS	KVEW
KAPP	CALLLETTERS	KAPP
KTRE	CALLLETTERS	KTRE
KSLA	CALLLETTERS	KSLA
KIMA-TV	CALLLETTERS	KIMA-TV
KEPR-TV	CALLLETTERS	KEPR-TV
KLEW-TV	CALLLETTERS	KLEW-TV
WABI-TV	CALLLETTERS	WABI-TV
WFVX-LD	CALLLETTERS	WFVX-LD
WZPX-TV	CALLLETTERS	WZPX-TV
KSNB-TV	CALLLETTERS	KSNB-TV
WJRT-TV	CALLLETTERS	WJRT-TV
WRTV	CALLLETTERS	WRTV
WTIU	CALLLETTERS	WTIU
WOWK-TV	CALLLETTERS	WOWK-TV
KTTZ-TV	CALLLETTERS	KTTZ-TV
KMPH-TV	CALLLETTERS	KMPH-TV
WTTV	CALLLETTERS	WTTV
WTTV	CALLLETTERS	WTTK
XHK-TV	CALLLETTERS	XHK-TV
KUAM-TV	CALLLETTERS	KUAM-TV
WPFO	CALLLETTERS	WPFO
DWAO-TV	CALLLETTERS	DWAO-TV
WTVR-TV	CALLLETTERS	WTVR-TV
WSFJ-TV	CALLLETTERS	WSFJ-TV
KQEG-CA	CALLLETTERS	KQEG-CA
WCIA	CALLLETTERS	WCIA
WCIX	CALLLETTERS	WCIX
KJLA	CALLLETTERS	KJLA
KUPX-TV	CALLLETTERS	KUPX-TV
WTJR	CALLLETTERS	WTJR
KQEH	CALLLETTERS	KQEH
WBDT	CALLLETTERS	WBDT
KELO-TV	CALLLETTERS	KELO-TV
KCSG	CALLLETTERS	KCSG
KHTV-CD	CALLLETTERS	KHTV-CD
KPXN-TV	CALLLETTERS	KPXN-TV
KPSP-CD	CALLLETTERS	KPSP-CD
KXAN-TV	CALLLETTERS	KXAN-TV
ISUTV	CALLLETTERS	ISUTV
KMLM-DT	CALLLETTERS	KMLM-DT / KPCB-DT
WPEC	CALLLETTERS	WPEC
WTOC-TV	CALLLETTERS	WTOC-TV
WSAV-TV	CALLLETTERS	WSAV-TV
KTNV-TV	CALLLETTERS	KTNV-TV
WCCT-TV	CALLLETTERS	WCCT-TV
WVUE-DT	CALLLETTERS	WVUE-DT
WISH-TV	CALLLETTERS	WISH-TV
WBGU-TV	CALLLETTERS	WBGU-TV
CJCH-DT	CALLLETTERS	CJCH-DT
KEEF-TV	CALLLETTERS	KEEF-TV
KEEF-TV	CALLLETTERS	KVST-TV
WTOG	CALLLETTERS	WTOG
WDTI	CALLLETTERS	WDTI
WXIN	CALLLETTERS	WXIN
WJCL	CALLLETTERS	WJCL
WGSA	CALLLETTERS	WGSA
WTGS	CALLLETTERS	WTGS
WDSU	CALLLETTERS	WDSU
WGNO	CALLLETTERS	WGNO
WNOL-TV	CALLLETTERS	WNOL-TV
WUPL	CALLLETTERS	WUPL
WSMV-TV	CALLLETTERS	WSMV-TV
WSFL-TV	CALLLETTERS	WSFL-TV
WBFS-TV	CALLLETTERS	WBFS-TV
WAMI-DT	CALLLETTERS	WAMI-DT
KTWO-TV	CALLLETTERS	KTWO-TV
KLWY	CALLLETTERS	KLWY
KCWY-DT	CALLLETTERS	KCWY-DT
KWYF-LD	CALLLETTERS	KWYF-LD
KGWN-TV	CALLLETTERS	KGWN-TV/KSTF
WUHQ-LD	CALLLETTERS	WUHQ-LD
WLUK-TV	CALLLETTERS	WLUK-TV
WCWF	CALLLETTERS	WCWF
WISCONSIN PUBLIC TELEVISION	CALLLETTERS	WISCONSIN PUBLIC TELEVISION
WKRN-TV	CALLLETTERS	WKRN-TV
WNPT	CALLLETTERS	WNPT
WTVF	CALLLETTERS	WTVF
WCTE	CALLLETTERS	WCTE
WKNO	CALLLETTERS	WKNO
WPXX-TV	CALLLETTERS	WPXX-TV
KCCI	CALLLETTERS	KCCI
WLLA	CALLLETTERS	WLLA
WPXS	CALLLETTERS	WPXS
KFVS-TV	CALLLETTERS	KFVS-TV
WATE-TV	CALLLETTERS	WATE-TV
WBIR-TV	CALLLETTERS	WBIR-TV
WBPX-TV	CALLLETTERS	WBPX-TV
WUNI	CALLLETTERS	WUNI
WXFT-DT	CALLLETTERS	WXFT-DT
WGBO-DT	CALLLETTERS	WGBO-DT
WFMJ-TV	CALLLETTERS	WFMJ-TV
WPTD	CALLLETTERS	WPTD
WPTD	CALLLETTERS	WPTO
KOFY-TV	CALLLETTERS	KOFY-TV
WRDQ	CALLLETTERS	WRDQ
WOPX-TV	CALLLETTERS	WOPX-TV
WPBN-TV	CALLLETTERS	WPBN-TV/WTOM-TV
WPRU-LP	CALLLETTERS	WPRU-LP
WVIT	CALLLETTERS	WVIT
WFYI	CALLLETTERS	WFYI
WIPB	CALLLETTERS	WIPB
WSJP-LD	CALLLETTERS	WSJP-LD
WNDY-TV	CALLLETTERS	WNDY-TV
WEAU	CALLLETTERS	WEAU
KOB	CALLLETTERS	KOB
KSTR-DT	CALLLETTERS	KSTR-DT
WORA-TV	CALLLETTERS	WORA-TV
KOAT-TV	CALLLETTERS	KOAT-TV
KRQE	CALLLETTERS	KRQE
KASA-TV	CALLLETTERS	KASA-TV
KFTH-DT	CALLLETTERS	KFTH-DT
KUBE-TV	CALLLETTERS	KUBE-TV
WVPX-TV	CALLLETTERS	WVPX-TV
KXGN-TV	CALLLETTERS	KXGN-TV
WINP-TV	CALLLETTERS	WINP-TV
WQHS-DT	CALLLETTERS	WQHS-DT
WMOR-TV	CALLLETTERS	WMOR-TV
KDTX-TV	CALLLETTERS	KDTX-TV
WKBF-TV	CALLLETTERS	WKBF-TV
KPXD-TV	CALLLETTERS	KPXD-TV
WCTX	CALLLETTERS	WCTX
KWTV-DT	CALLLETTERS	KWTV-DT
KBVO-CD	CALLLETTERS	KBVO-CD
KNVA	CALLLETTERS	KNVA
WIIH-CD	CALLLETTERS	WIIH-CD
WYES-TV	CALLLETTERS	WYES-TV
WHFT-TV	CALLLETTERS	WHFT-TV
WJW	CALLLETTERS	WJW
WALB	CALLLETTERS	WALB
WUVN	CALLLETTERS	WUVN
TELEVISION HOKKAIDO	CALLLETTERS	JOHI-TV
MAINE PUBLIC BROADCASTING NETWORK	CALLLETTERS	MAINE PUBLIC BROADCASTING NETWORK
WAND	CALLLETTERS	WAND
WBUI	CALLLETTERS	WBUI
WEIU-TV	CALLLETTERS	WEIU-TV
WEHT	CALLLETTERS	WEHT
WRSP-TV	CALLLETTERS	WRSP-TV/WCCU
KCRG-TV	CALLLETTERS	KCRG-TV
WCHS-TV	CALLLETTERS	WCHS-TV
KWWL	CALLLETTERS	KWWL
WEVV-TV	CALLLETTERS	WEVV-TV
WFIE	CALLLETTERS	WFIE
WSIU-TV	CALLLETTERS	WSIU-TV / WUSI-TV
WTHI-TV	CALLLETTERS	WTHI-TV
WSIL-TV	CALLLETTERS	WSIL-TV/KPOB-TV
WTWO	CALLLETTERS	WTWO
WVUT	CALLLETTERS	WVUT
KAKW-DT	CALLLETTERS	KAKW-DT
KDTN	CALLLETTERS	KDTN
WMGM-TV	CALLLETTERS	WMGM-TV
WAWV-TV	CALLLETTERS	WAWV-TV
WKBT-DT	CALLLETTERS	WKBT-DT
KFXA	CALLLETTERS	KFXA
WJFW-TV	CALLLETTERS	WJFW-TV
KFXB-TV	CALLLETTERS	KFXB-TV
WSAW-TV	CALLLETTERS	WSAW-TV
WLAX	CALLLETTERS	WLAX / WEUX
KRCW-TV	CALLLETTERS	KRCW-TV
WPXL-TV	CALLLETTERS	WPXL-TV
WHNO	CALLLETTERS	WHNO
WMTV	CALLLETTERS	WMTV
WBUW	CALLLETTERS	WBUW
WKBN-TV	CALLLETTERS	WKBN-TV
WYTV	CALLLETTERS	WYTV
WYFX-LD	CALLLETTERS	WYFX-LD
WNJX-TV	CALLLETTERS	WNJX-TV
WOLE-DT	CALLLETTERS	WOLE-DT
WMBD-TV	CALLLETTERS	WMBD-TV
KWBQ	CALLLETTERS	KWBQ / KRWB-TV
KASY-TV	CALLLETTERS	KASY-TV
WPSD-TV	CALLLETTERS	WPSD-TV
KSNW	CALLLETTERS	KSNW
KWCH-DT	CALLLETTERS	KWCH-DT
KAKE	CALLLETTERS	KAKE
KSAS-TV	CALLLETTERS	KSAS-TV
KMTW	CALLLETTERS	KMTW
KPTS	CALLLETTERS	KPTS
KSCW-DT	CALLLETTERS	KSCW-DT
NEW HAMPSHIRE PUBLIC TELEVISION	CALLLETTERS	NEW HAMPSHIRE PUBLIC TELEVISION
KBOI-TV	CALLLETTERS	KBOI-TV
IDAHO PUBLIC TELEVISION	CALLLETTERS	IDAHO PUBLIC TELEVISION
KIVI-TV	CALLLETTERS	KIVI-TV
KNIN-TV	CALLLETTERS	KNIN-TV
KTRV-TV	CALLLETTERS	KTRV-TV
KWSU-TV	CALLLETTERS	KWSU-TV / KTNW
KFFX-TV	CALLLETTERS	KFFX-TV
KNDO	CALLLETTERS	KNDO
KNDU	CALLLETTERS	KNDU
KDBC-TV	CALLLETTERS	KDBC-TV
KVIA-TV	CALLLETTERS	KVIA-TV
KTSM-TV	CALLLETTERS	KTSM-TV
KCOS	CALLLETTERS	KCOS
KFOX-TV	CALLLETTERS	KFOX-TV
KINT-TV	CALLLETTERS	KINT-TV
KTFN	CALLLETTERS	KTFN
KTDO	CALLLETTERS	KTDO
KSCE	CALLLETTERS	KSCE
XHIJ-TDT	CALLLETTERS	XHIJ-TDT
K26KJ-D	CALLLETTERS	K26KJ-D
WBME-CD	CALLLETTERS	WBME-CD
KOPB-TV	CALLLETTERS	KOPB-TV
KOCO-TV	CALLLETTERS	KOCO-TV
KLJB	CALLLETTERS	KLJB
KHME	CALLLETTERS	KHME / KQME
SOUTH DAKOTA PUBLIC BROADCASTING	CALLLETTERS	SOUTH DAKOTA PUBLIC BROADCASTING
KOTA-TV	CALLLETTERS	KOTA-TV / KHSD-TV
KNBN	CALLLETTERS	KNBN
KWBH-LP	CALLLETTERS	KWBH-LP
KCPO-LP	CALLLETTERS	KCPO-LP
KESQ-TV	CALLLETTERS	KESQ-TV
WKAR-TV	CALLLETTERS	WKAR-TV
WPSU-TV	CALLLETTERS	WPSU-TV
ARKANSAS EDUCATIONAL TELEVISION NETWORK	CALLLETTERS	ARKANSAS EDUCATIONAL TELEVISION NETWORK
KARK-TV	CALLLETTERS	KARK-TV
KATV	CALLLETTERS	KATV
KTHV	CALLLETTERS	KTHV
KLRT-TV	CALLLETTERS	KLRT-TV
KASN	CALLLETTERS	KASN
KVTN-DT	CALLLETTERS	VICTORY TELEVISION NETWORK
KMYA-DT	CALLLETTERS	KMYA-DT
KXVO	CALLLETTERS	KXVO
KCSM-TV	CALLLETTERS	KCSM-TV
WVNY	CALLLETTERS	WVNY
WFFF-TV	CALLLETTERS	WFFF-TV
WGMU-LP	CALLLETTERS	WGMU-LP
WHIZ-TV	CALLLETTERS	WHIZ-TV
CJIC-TV	CALLLETTERS	CJIC-TV
CFCL-TV	CALLLETTERS	CFCL-TV
WALV-CD	CALLLETTERS	WALV-CD
WTVE	CALLLETTERS	WTVE
WRAP-LP	CALLLETTERS	WRAP-LP
WFSB	CALLLETTERS	WFSB
WPRI-TV	CALLLETTERS	WPRI-TV
WUPW	CALLLETTERS	WUPW
WDCQ-TV	CALLLETTERS	WDCQ-TV
WCMU-TV	CALLLETTERS	WCMU-TV
WCMU-TV	CALLLETTERS	CMU PUBLIC TELEVISION
WBSF	CALLLETTERS	WBSF
WVGN-LD	CALLLETTERS	WVGN-LD
XHBC-TDT	CALLLETTERS	XHBC-TDT
WWTV	CALLLETTERS	WWTV / WWUP-TV
WGTU	CALLLETTERS	WGTU/WGTQ
WFQX-TV	CALLLETTERS	WFQX-TV/WFUP
KMTP-TV	CALLLETTERS	KMTP-TV
WKOI-TV	CALLLETTERS	WKOI-TV
KPXG-TV	CALLLETTERS	KPXG-TV
WIPX-TV	CALLLETTERS	WIPX-TV
WHMB-TV	CALLLETTERS	WHMB-TV
WPXT	CALLLETTERS	WPXT
ADS	CALLLETTERS	ADS
WINK-TV	CALLLETTERS	WINK-TV
KDTV-DT	CALLLETTERS	KDTV-DT
WFTX-TV	CALLLETTERS	WFTX-TV
WZVN-TV	CALLLETTERS	WZVN-TV
WBBH-TV	CALLLETTERS	WBBH-TV
WHO-DT	CALLLETTERS	WHO-DT
WOI-DT	CALLLETTERS	WOI-DT
KCWI-TV	CALLLETTERS	KCWI-TV
WOAY-TV	CALLLETTERS	WOAY-TV
CJDC-TV	CALLLETTERS	CJDC-TV
KKPX-TV	CALLLETTERS	KKPX-TV
WHPX-TV	CALLLETTERS	WHPX-TV
WOSU-TV	CALLLETTERS	WOSU-TV / WPBO
KCTV	CALLLETTERS	KCTV
KMBC-TV	CALLLETTERS	KMBC-TV
KSHB-TV	CALLLETTERS	KSHB-TV
KSMO-TV	CALLLETTERS	KSMO-TV
KCWE	CALLLETTERS	KCWE
KPXE-TV	CALLLETTERS	KPXE-TV
KMCI-TV	CALLLETTERS	KMCI-TV
KFTR-DT	CALLLETTERS	KFTR-DT
WDAF-TV	CALLLETTERS	WDAF-TV
WHTN	CALLLETTERS	WHTN
KUOK	CALLLETTERS	KUOK
KOPX-TV	CALLLETTERS	KOPX-TV
KXOC-LP	CALLLETTERS	KXOC-LP
KSBI	CALLLETTERS	KSBI
KAUT-TV	CALLLETTERS	KAUT-TV
KTUZ-TV	CALLLETTERS	KTUZ-TV
WLAE-TV	CALLLETTERS	WLAE-TV
KTVA	CALLLETTERS	KTVA
WNYB	CALLLETTERS	WNYB
WBBZ-TV	CALLLETTERS	WBBZ-TV
WNLO	CALLLETTERS	WNLO
JTV	CALLLETTERS	JTV
WSFX-TV	CALLLETTERS	WSFX-TV
WYFF	CALLLETTERS	WYFF
WGGS-TV	CALLLETTERS	WGGS-TV
WHNS	CALLLETTERS	WHNS
WYCW	CALLLETTERS	WYCW
WLFL	CALLLETTERS	WLFL
WTVX	CALLLETTERS	WTVX
WCTV	CALLLETTERS	WCTV
WTLH	CALLLETTERS	WTLH
WHME-TV	CALLLETTERS	WHME-TV
WTAT-TV	CALLLETTERS	WTAT-TV
WNEO	CALLLETTERS	WNEO / WEAO
WFXI	CALLLETTERS	WFXI
WFXI	CALLLETTERS	WYDO
WPXD-TV	CALLLETTERS	WPXD-TV
KVAL-TV	CALLLETTERS	KVAL-TV
KFSF-DT	CALLLETTERS	KFSF-DT
LOUISIANA PUBLIC BROADCASTING	CALLLETTERS	LOUISIANA PUBLIC BROADCASTING
KTTU	CALLLETTERS	KTTU
KMSB	CALLLETTERS	KMSB
KJRH-TV	CALLLETTERS	KJRH-TV
KWBA-TV	CALLLETTERS	KWBA-TV
KVOA	CALLLETTERS	KVOA
KHRR	CALLLETTERS	KHRR
KOKI-TV	CALLLETTERS	KOKI-TV
WGPX-TV	CALLLETTERS	WGPX-TV
WAVY-TV	CALLLETTERS	WAVY-TV
WVEC	CALLLETTERS	WVEC
WTKR	CALLLETTERS	WTKR
WHRO-TV	CALLLETTERS	WHRO-TV
WVBT	CALLLETTERS	WVBT
WTVZ-TV	CALLLETTERS	WTVZ-TV
WSKY-TV	CALLLETTERS	WSKY-TV
WGNT	CALLLETTERS	WGNT
WLXI	CALLLETTERS	WLXI
KTBN-TV	CALLLETTERS	KTBN-TV
KTUL	CALLLETTERS	KTUL
KOTV-DT	CALLLETTERS	KOTV-DT
WYTU-LD	CALLLETTERS	WYTU-LD
KTFK-DT	CALLLETTERS	KTFK-DT
WRLH-TV	CALLLETTERS	WRLH-TV
WVRN	CALLLETTERS	WVRN
WUPV	CALLLETTERS	WUPV
WRIC-TV	CALLLETTERS	WRIC-TV
SAS	CALLLETTERS	SAS
TVQ	CALLLETTERS	TVQ
BTQ	CALLLETTERS	BTQ
WRBW	CALLLETTERS	WRBW
WOTF-DT	CALLLETTERS	WOTF-DT
WKCF	CALLLETTERS	WKCF
WBVC	CALLLETTERS	\
WVEN-TV	CALLLETTERS	WVEN-TV
WSJU-TV	CALLLETTERS	WSJU-TV
KWVT-LD	CALLLETTERS	KWVT-LD
WGAL	CALLLETTERS	WGAL
WGCB-TV	CALLLETTERS	WGCB-TV
WGBY-TV	CALLLETTERS	WGBY-TV
CANAL 9	CALLLETTERS	LS83
WBNA	CALLLETTERS	WBNA
WKYI-CD	CALLLETTERS	WKYI-CD
KBTX-TV	CALLLETTERS	KBTX-TV
WMFP	CALLLETTERS	WMFP
WWDP	CALLLETTERS	WWDP
WNEU	CALLLETTERS	WNEU
WUTF-DT	CALLLETTERS	WUTF-DT
WBTS-LD	CALLLETTERS	WBTS-LD
WLMB	CALLLETTERS	WLMB
WYDN	CALLLETTERS	WYDN
WBIN-TV	CALLLETTERS	WBIN-TV
WXPO-TV	CALLLETTERS	WXPO-TV
WTCN-CA	CALLLETTERS	WTCN-CA
WLWC	CALLLETTERS	WLWC
WTVM	CALLLETTERS	WTVM
WHAM-TV	CALLLETTERS	WHAM-TV
WVAH-TV	CALLLETTERS	WVAH-TV
KRWG-TV	CALLLETTERS	KRWG-TV
WQCW	CALLLETTERS	WQCW
DZEC-TV	CALLLETTERS	DZEC-TV
WNHT	CALLLETTERS	WNHT
WPXC-TV	CALLLETTERS	WPXC-TV
WNAC-TV	CALLLETTERS	WNAC-TV
KTUD-CD	CALLLETTERS	KTUD-CD
KWKB	CALLLETTERS	KWKB
KCPT	CALLLETTERS	KCPT
WMTJ	CALLLETTERS	WMTJ
KCBD	CALLLETTERS	KCBD
WGEM-DT2	CALLLETTERS	WGEM-DT2
WGEM-DT3	CALLLETTERS	WGEM-DT3
WILL	CALLLETTERS	WILL-TV
WBRZ-TV	CALLLETTERS	WBRZ-TV
WPXJ-TV	CALLLETTERS	WPXJ-TV
KCNS	CALLLETTERS	KCNS
KBLR	CALLLETTERS	KBLR
CKSH-DT	CALLLETTERS	CKSH-DT
CKTM-DT	CALLLETTERS	CKTM-DT
CKTV-DT	CALLLETTERS	CKTV-DT
CKRN-DT	CALLLETTERS	CKRN-DT
XEW-TDT	CALLLETTERS	XEW-TDT
XHDF-TDT	CALLLETTERS	XHDF-TDT
KOMU-TV	CALLLETTERS	KOMU-TV
XHGC-TDT	CALLLETTERS	XHGC-TDT
XEQ-TDT	CALLLETTERS	XEQ-TDT
XHTV-TDT	CALLLETTERS	XHTV
XET-TDT	CALLLETTERS	XET-TDT
WAFB	CALLLETTERS	WAFB-TV
CKRT-DT	CALLLETTERS	CKRT-DT
KTAL-TV	CALLLETTERS	KTAL-TV
KMAH-LP	CALLLETTERS	KMAH-LP
WCNY-TV	CALLLETTERS	WCNY-TV
WCNY-TV	CALLLETTERS	W22DO-D
KIIT-CA	CALLLETTERS	KIIT-CA
OKLAHOMA EDUCATIONAL TELEVISION AUTHORITY	CALLLETTERS	OKLAHOMA EDUCATIONAL TELEVISION AUTHORITY
KOKH-TV	CALLLETTERS	KOKH-TV
KOCB	CALLLETTERS	KOCB
WSHM-LD	CALLLETTERS	WSHM-LD
WUPX-TV	CALLLETTERS	WUPX-TV
WTLW	CALLLETTERS	WTLW
KTFQ-DT	CALLLETTERS	KTFQ-DT
KLUZ-TV	CALLLETTERS	KLUZ-TV
WJPX	CALLLETTERS	WJPX
WJPX	CALLLETTERS	WIRS
WBXX-TV	CALLLETTERS	WBXX-TV
WZME	CALLLETTERS	WZME
KXXV	CALLLETTERS	KXXV
WKTC	CALLLETTERS	WKTC
WLFI-TV	CALLLETTERS	WLFI-TV
KAZO-LP	CALLLETTERS	KAZO-LP
WBGR-LP	CALLLETTERS	WBGR-LP
WCKD-LP	CALLLETTERS	WCKD-LP
KFSN-TV	CALLLETTERS	KFSN-TV
WPME	CALLLETTERS	WPME
KGPE	CALLLETTERS	KGPE
KAIL	CALLLETTERS	KAIL
WHOI	CALLLETTERS	WHOI
WAPT	CALLLETTERS	WAPT
WXMS-LP	CALLLETTERS	WXMS-LP
WLOO	CALLLETTERS	WLOO
WDBD	CALLLETTERS	WDBD
KYUR	CALLLETTERS	KYUR
KTBY	CALLLETTERS	KTBY
KTUU-TV	CALLLETTERS	KTUU-TV
KYES-TV	CALLLETTERS	KYES-TV
KDMD	CALLLETTERS	KDMD
WJTV	CALLLETTERS	WJTV
WBXK-CA	CALLLETTERS	WBXK-CA
WTVG	CALLLETTERS	WTVG
WVLA-TV	CALLLETTERS	WVLA-TV
KFOL-CD	CALLLETTERS	KFOL-CD / KJUN-CD
KPDF-CA	CALLLETTERS	KPDF-CA
KFPH-DT	CALLLETTERS	KFPH-DT
KTGM	CALLLETTERS	KTGM
KGTF	CALLLETTERS	KGTF
KUAM-LP	CALLLETTERS	KUAM-LP
KTKB-LD	CALLLETTERS	KTKB-LD
WMJF-CD	CALLLETTERS	WMJF-LP
KGEB	CALLLETTERS	KGEB
KLFY-TV	CALLLETTERS	KLFY-TV
KUDF-LP	CALLLETTERS	KUDF-LP
KTNC-TV	CALLLETTERS	KTNC-TV
KOLD-TV	CALLLETTERS	KOLD-TV
KBCA	CALLLETTERS	KBCA
WSBE-TV	CALLLETTERS	WSBE-TV
WJBF	CALLLETTERS	WJBF
WRDW-TV	CALLLETTERS	WRDW-TV
WAGT	CALLLETTERS	WAGT
WETV-LP	CALLLETTERS	WETV-LP
KEMO-TV	CALLLETTERS	KEMO-TV
WOUB-TV	CALLLETTERS	WOUB-TV / WOUC-TV
WCPX-TV	CALLLETTERS	WCPX-TV
W33BY-D	CALLLETTERS	W33BY-D
KRNV-DT	CALLLETTERS	KRNV-DT
WJMN-TV	CALLLETTERS	WJMN-TV
CFWH-TV	CALLLETTERS	CFWH-TV
CFFB-TV	CALLLETTERS	CFFB-TV
WYZZ-TV	CALLLETTERS	WYZZ-TV
WVXF	CALLLETTERS	WVXF
KSBW	CALLLETTERS	KSBW
KKFX-CD	CALLLETTERS	KKFX-CD
KWUB	CALLLETTERS	KWUB
WCLF	CALLLETTERS	WCLF
KPMR	CALLLETTERS	KPMR
WEEK-TV	CALLLETTERS	WEEK-TV
WJJN-LD	CALLLETTERS	WJJN-LD
WUDL-LD	CALLLETTERS	WUDL-LD
WDWO-CD	CALLLETTERS	WDWO-CD
WLNS-TV	CALLLETTERS	WLNS-TV
ABW	CALLLETTERS	ABW
WMNT-CD	CALLLETTERS	WMNT-CD
WPXQ-TV	CALLLETTERS	WPXQ-TV
WILX-TV	CALLLETTERS	WILX-TV
WTOL	CALLLETTERS	WTOL
HSV	CALLLETTERS	HSV
WGTE-TV	CALLLETTERS	WGTE-TV
KVER-CA	CALLLETTERS	KVER-CA
KUNA-LP	CALLLETTERS	KUNA-LP
KCWQ-LP	CALLLETTERS	KCWQ-LP/LD
KVYE	CALLLETTERS	KVYE
KSWT	CALLLETTERS	KSWT
KECY-TV	CALLLETTERS	KECY-TV
KYMA-DT	CALLLETTERS	KYMA-DT
WSET-TV	CALLLETTERS	WSET-TV
WSLS-TV	CALLLETTERS	WSLS-TV
BLUE RIDGE PBS	CALLLETTERS	BLUE RIDGE PBS
WDBJ	CALLLETTERS	WDBJ
KAJB	CALLLETTERS	KAJB
KNAZ-TV	CALLLETTERS	KNAZ-TV
KSNV	CALLLETTERS	KSNV
WLAJ	CALLLETTERS	WLAJ
WSYM-TV	CALLLETTERS	WSYM-TV
XHIMT-TDT	CALLLETTERS	XHIMT-TDT
KTVN	CALLLETTERS	KTVN
WJYL-CD	CALLLETTERS	WJYL-CD
KLAF-LD	CALLLETTERS	KLAF-LD
KLWB	CALLLETTERS	KLWB
WBOC-TV	CALLLETTERS	WBOC-TV
CJSS-TV	CALLLETTERS	CJSS-TV
KSTS	CALLLETTERS	KSTS
KESE-LP	CALLLETTERS	KESE-LP
KYUM-LP	CALLLETTERS	KYUM-LD
KRCB	CALLLETTERS	KRCB
KTSF	CALLLETTERS	KTSF
KTLN-TV	CALLLETTERS	KTLN-TV
NETWORK KNOWLEDGE	CALLLETTERS	WMEC / WQEC / WSEC
WXAX-CD	CALLLETTERS	WXAX-CD
WSPF-CD	CALLLETTERS	WSPF-CD
WCMZ-TV	CALLLETTERS	WCMZ-TV
KLTJ	CALLLETTERS	KLTJ
KETH-TV	CALLLETTERS	KETH-TV
WNYN-LD	CALLLETTERS	WNYN-LD
WDVB-CD	CALLLETTERS	WDVB-CD
KDLH	CALLLETTERS	KDLH
KBJR-TV	CALLLETTERS	KBJR-TV / KRII
WIPR-TV	CALLLETTERS	WIPR-TV
K18JL-D	CALLLETTERS	K18JL-D
KNOP-TV	CALLLETTERS	KNOP-TV
KSNK	CALLLETTERS	KSNK
KEYC-TV	CALLLETTERS	KEYC-TV
KTVO	CALLLETTERS	KTVO
WLUC-TV	CALLLETTERS	WLUC-TV
WPTA	CALLLETTERS	WPTA
KIMT	CALLLETTERS	KIMT
WDSC-TV	CALLLETTERS	WDSC-TV
XEPM-TDT	CALLLETTERS	XEPM-TDT
XEJ-TDT	CALLLETTERS	XEJ-TDT
XHJCI-TDT	CALLLETTERS	XHJCI-TDT
XHCJH-TDT	CALLLETTERS	XHCJH
XHCJE-TDT	CALLLETTERS	XHCJE-TDT
KBEH	CALLLETTERS	KBEH
KILM	CALLLETTERS	KILM
XHJUB-TDT	CALLLETTERS	XHJUB-TDT
WVEA-TV	CALLLETTERS	WVEA-TV
WFTT-DT	CALLLETTERS	WFTT-DT
WRMD-CD	CALLLETTERS	WRMD-CD
WAZE-TV	CALLLETTERS	WAZE-LP
WYYW-CD	CALLLETTERS	WYYW-CD
WRIW-CD	CALLLETTERS	WRIW-CD
WNIN	CALLLETTERS	WNIN
WTVW	CALLLETTERS	WTVW
KSPR	CALLLETTERS	KSPR
KOLR	CALLLETTERS	KOLR-TV
KYTV	CALLLETTERS	KYTV
WMGT-TV	CALLLETTERS	WMGT-TV
WGXA	CALLLETTERS	WGXA
WPGA-TV	CALLLETTERS	WPGA-TV
WMAZ-TV	CALLLETTERS	WMAZ-TV
WLEX-TV	CALLLETTERS	WLEX-TV
KGBY	CALLLETTERS	KGBY
KKCO	CALLLETTERS	KKCO
WCAV	CALLLETTERS	WCAV
WVAW-LD	CALLLETTERS	WVAW-LD
WVIR-TV	CALLLETTERS	WVIR-TV
KFTU-DT	CALLLETTERS	KFTU-DT
KUVS-DT	CALLLETTERS	KUVS-DT
KQCA	CALLLETTERS	KQCA
WCYB-TV	CALLLETTERS	WCYB-TV
WWHB-CA	CALLLETTERS	WWHB-CA
CFTO-DT	CALLLETTERS	CFTO-DT
AMéRICA TV	CALLLETTERS	LS86 TV
KCPM	CALLLETTERS	KCPM
WPHY-CD	CALLLETTERS	WPHY-CD
CJPC-DT	CALLLETTERS	CJPC-DT
WTVJ	CALLLETTERS	WTVJ
WPCH-TV	CALLLETTERS	WPCH-TV
KNME-TV	CALLLETTERS	KNME-TV
WSYX	CALLLETTERS	WSYX
KBVO	CALLLETTERS	KBVO
KBNT-CD	CALLLETTERS	KBNT-CD
WNED-TV	CALLLETTERS	WNED-TV
WGTA	CALLLETTERS	WGTA
WJHG-TV	CALLLETTERS	WJHG-TV
KTNL-TV	CALLLETTERS	KTNL-TV
KUBD	CALLLETTERS	KUBD
KDMD-LP	CALLLETTERS	KDMD-LP
KUBD-LP	CALLLETTERS	KUBD-LP
WSTQ-LP	CALLLETTERS	WSTQ-LP
WSTM-TV	CALLLETTERS	WSTM-TV
WENY-TV	CALLLETTERS	WENY-TV
WETM-TV	CALLLETTERS	WETM-TV
NEBRASKA EDUCATIONAL TELECOMMUNICATIONS	CALLLETTERS	NEBRASKA EDUCATIONAL TELECOMMUNICATIONS
KBCB	CALLLETTERS	KBCB
CFTV-DT	CALLLETTERS	CFTV-DT
WNNE	CALLLETTERS	WNNE
WBKP	CALLLETTERS	WBKP
WNMU	CALLLETTERS	WNMU
WZMQ	CALLLETTERS	WZMQ
WTVQ-DT	CALLLETTERS	WTVQ-DT
WKYT-TV	CALLLETTERS	WKYT-TV
WYMT-TV	CALLLETTERS	WYMT-TV
KQDS-TV	CALLLETTERS	KQDS-TV
WDSE	CALLLETTERS	WDSE / WRPT
WBUP	CALLLETTERS	WBUP
KFPX-TV	CALLLETTERS	KFPX-TV
WITF-TV	CALLLETTERS	WITF-TV
XERV-TDT	CALLLETTERS	XERV-TDT
WPDE-TV	CALLLETTERS	WPDE-TV
KTXS-TV	CALLLETTERS	KTXS-TV
KIFI-TV	CALLLETTERS	KIFI-TV
TBN REPEATERS IN THE TAMPA BAY DMA	CALLLETTERS	TBN REPEATERS
TBN REPEATERS IN THE TAMPA BAY DMA	CALLLETTERS	IN THE TAMPA BAY MARKET
KGET-TV	CALLLETTERS	KGET-TV
KVUI	CALLLETTERS	KVUI
KPVI-DT	CALLLETTERS	KPVI-DT
KIDK	CALLLETTERS	KIDK
WISE-TV	CALLLETTERS	WISE-TV
WTWV	CALLLETTERS	WTWV
XHTAM-TDT	CALLLETTERS	XHTAM-TDT
XHLAR-TDT	CALLLETTERS	XHLAR-TDT
WVLT-TV	CALLLETTERS	WVLT-TV
WWBI-LP	CALLLETTERS	WWBI-LP
WAQP	CALLLETTERS	WAQP
WLGA	CALLLETTERS	WLGA
WOCH-CD	CALLLETTERS	WOCH-CD
KLSR-TV	CALLLETTERS	KLSR-TV
KEVU-CD	CALLLETTERS	KEVU-CD
WZRA-CA	CALLLETTERS	WZRA-CA
WPDS-LD	CALLLETTERS	WPDS-LD
WXPX-TV	CALLLETTERS	WXPX-TV
WBKB-TV	CALLLETTERS	WBKB-TV
WJHL-TV	CALLLETTERS	WJHL-TV
KTVE	CALLLETTERS	KTVE
KNOE-TV	CALLLETTERS	KNOE-TV
KMLU	CALLLETTERS	KMLU
KEJB	CALLLETTERS	KEJB
WFFP-TV	CALLLETTERS	WFFP-TV
KFSM-TV	CALLLETTERS	KFSM-TV
WHTM-TV	CALLLETTERS	WHTM-TV
KNWA-TV	CALLLETTERS	KNWA-TV
KARD	CALLLETTERS	KARD
WBYD-CD	CALLLETTERS	WBYD-CD
WTXL-TV	CALLLETTERS	WTXL-TV
WDFM-LP	CALLLETTERS	WDFM-LP
WKPT-TV	CALLLETTERS	WKPT-TV
VSB-TV	CALLLETTERS	VSB-TV
TEXAS STUDENT TELEVISION	CALLLETTERS	K29HW-D
KUTH-DT	CALLLETTERS	KUTH-DT
KDLT-TV	CALLLETTERS	KDLT-TV / KDLV-TV
WLTX	CALLLETTERS	WLTX
KTTW	CALLLETTERS	KTTW / KTTM
KSFY-TV	CALLLETTERS	KSFY-TV
WMDT	CALLLETTERS	WMDT
WDAY-TV	CALLLETTERS	WDAY-TV
KJUD	CALLLETTERS	KJUD
KATN	CALLLETTERS	KATN-TV
NTTV	CALLLETTERS	NTTV
KULR-TV	CALLLETTERS	KULR-TV / KYUS-TV
WNTZ-TV	CALLLETTERS	WNTZ-TV
KDEN-TV	CALLLETTERS	KDEN-TV
KSVI	CALLLETTERS	KSVI
KHMT	CALLLETTERS	KHMT
KWBM	CALLLETTERS	KWBM
COMMUNITY SEVEN	CALLLETTERS	COMMUNITY SEVEN
KLEI-TV	CALLLETTERS	KLEI-TV
KCAU-TV	CALLLETTERS	KCAU-TV
KACV-TV	CALLLETTERS	KACV-TV
KVII-TV	CALLLETTERS	KVII-TV / KVIH-TV
WORO-DT	CALLLETTERS	WORO-DT
KWDK	CALLLETTERS	KWDK
WPMT	CALLLETTERS	WPMT
DWDB-TV	CALLLETTERS	DWDB-TV
WTVP	CALLLETTERS	WTVP
WLPC-CD	CALLLETTERS	WLPC-CD
CFSO-TV	CALLLETTERS	CFSO-TV
KPXB-TV	CALLLETTERS	KPXB-TV
KAMR-TV	CALLLETTERS	KAMR-TV
WRBJ-TV	CALLLETTERS	WRBJ-TV
KIDA	CALLLETTERS	KIDA
KHBS	CALLLETTERS	KHBS / KHOG-TV
WBQP-CD	CALLLETTERS	WBQP-CD
KCIT	CALLLETTERS	KCIT
WTAJ-TV	CALLLETTERS	WTAJ-TV
KMYT-TV	CALLLETTERS	KMYT-TV
KQCW-DT	CALLLETTERS	KQCW-DT
WTSF	CALLLETTERS	WTSF
KXII	CALLLETTERS	KXII
WYGA-CD	CALLLETTERS	WYGA-CD
KFDA-TV	CALLLETTERS	KFDA-TV
KDTP-LP	CALLLETTERS	KDTP-LP
WVNS-TV	CALLLETTERS	WVNS-TV
KCBA	CALLLETTERS	KCBA
KION-TV	CALLLETTERS	KION-TV
KFRE-TV	CALLLETTERS	KFRE-TV
KBAK-TV	CALLLETTERS	KBAK-TV
KERO-TV	CALLLETTERS	KERO-TV
KBFX-CD	CALLLETTERS	KBFX-CD
KUVI-DT	CALLLETTERS	KUVI-DT
WTWC-TV	CALLLETTERS	WTWC-TV
WDTV	CALLLETTERS	WDTV
WBOY-TV	CALLLETTERS	WBOY-TV
WVFX	CALLLETTERS	WVFX
WFWC-CD	CALLLETTERS	WFWC-CD
WAUG-LD	CALLLETTERS	WAUG-LD
WANE-TV	CALLLETTERS	WANE-TV
WFFT-TV	CALLLETTERS	WFFT-TV
WFWA	CALLLETTERS	WFWA
WINM	CALLLETTERS	WINM
WPXE-TV	CALLLETTERS	WPXE-TV
WTAP-TV	CALLLETTERS	WTAP-TV
WNYZ-LP	CALLLETTERS	WNYZ-LP
WSVI	CALLLETTERS	WSVI
WEMT	CALLLETTERS	WEMT
WXGA-TV	CALLLETTERS	WXGA-TV
WTVA	CALLLETTERS	WTVA
WWMB	CALLLETTERS	WWMB
WFXB	CALLLETTERS	WFXB
WOLO-TV	CALLLETTERS	WOLO-TV
WZRB	CALLLETTERS	WZRB
WACH	CALLLETTERS	WACH
WAOE	CALLLETTERS	WAOE
WPTV-TV	CALLLETTERS	WPTV-TV
WVAN-TV	CALLLETTERS	WVAN-TV
KPXJ	CALLLETTERS	KPXJ
KMSS-TV	CALLLETTERS	KMSS-TV
KSHV-TV	CALLLETTERS	KSHV-TV
KNMT	CALLLETTERS	KNMT
TECHTV	CALLLETTERS	TECHTV
KWWF	CALLLETTERS	KWWF
MONTANA PBS	CALLLETTERS	MONTANA PBS
KOLN	CALLLETTERS	KOLN / KGIN
WAST-LP	CALLLETTERS	WAST-LP
WJAN-CD	CALLLETTERS	WJAN-CD
WHP-TV	CALLLETTERS	WHP-TV
WAHU-CD	CALLLETTERS	WAHU-CD
KOLO-TV	CALLLETTERS	KOLO-TV
WTVH	CALLLETTERS	WTVH
WZDX	CALLLETTERS	WZDX
WCFC-CA	CALLLETTERS	WCFC-CA
KAWE	CALLLETTERS	KAWE / KAWB
WXON-LP	CALLLETTERS	WXON-LP
ZBM-TV	CALLLETTERS	ZBM-TV
ZNS-TV	CALLLETTERS	ZNS-TV
ZFB-TV	CALLLETTERS	ZFB
KMEG	CALLLETTERS	KMEG
KCSI-TV	CALLLETTERS	KCSI-TV
WWTI	CALLLETTERS	WWTI
WYKE-CD	CALLLETTERS	WYKE-CD
KPTH	CALLLETTERS	KPTH
KNAT-TV	CALLLETTERS	KNAT-TV
KCHF	CALLLETTERS	KCHF
KFDX-TV	CALLLETTERS	KFDX-TV
KSWO-TV	CALLLETTERS	KSWO-TV
KTEN	CALLLETTERS	KTEN
KAUZ-TV	CALLLETTERS	KAUZ-TV
KWSD	CALLLETTERS	KWSD
WADL	CALLLETTERS	WADL
WIVM-LD	CALLLETTERS	WIVM-LD / WIVN-LD / WIVD-LD / WIVX-LD
KMYU	CALLLETTERS	KMYU
KWES-TV	CALLLETTERS	KWES-TV / KWAB-TV
KJTL	CALLLETTERS	KJTL
KJBO-LP	CALLLETTERS	KJBO-LP
WMLW-TV	CALLLETTERS	WMLW-TV
WVTX-CD	CALLLETTERS	WVTX-CD
KREN-TV	CALLLETTERS	KREN-TV
WEPA-CD	CALLLETTERS	WEPA-CD
WHDF	CALLLETTERS	WHDF
KKYK-CD	CALLLETTERS	KKYK-CD
WAAY-TV	CALLLETTERS	WAAY-TV
KUNP	CALLLETTERS	KUNP
WJSP-TV	CALLLETTERS	WJSP-TV
WHNT-TV	CALLLETTERS	WHNT-TV
WCES-TV	CALLLETTERS	WCES-TV
WAOH-CD	CALLLETTERS	WAOH-CD / W16DO-D
WRDM-CD	CALLLETTERS	WRDM-CD
KZAK-LD	CALLLETTERS	KZAK-LD
WFXG	CALLLETTERS	WFXG
CKPG-TV	CALLLETTERS	CKPG-TV
WAFF	CALLLETTERS	WAFF
WWME-CD	CALLLETTERS	WWME-CD
KSNT	CALLLETTERS	KSNT
WSYR-TV	CALLLETTERS	WSYR-TV
WUTH-CD	CALLLETTERS	WUTH-CD
WHCT-LD	CALLLETTERS	WHCT-LD
W44CK-D	CALLLETTERS	W44CK-D
WELU	CALLLETTERS	WELU
WSKG-TV	CALLLETTERS	WSKG-TV / WSKA
WWLP-DT2	CALLLETTERS	WWLP-DT2
WDHN	CALLLETTERS	WDHN
WNCF	CALLLETTERS	WNCF
KTKA-TV	CALLLETTERS	KTKA-TV
WTAC-TV	CALLLETTERS	WTAC
WABI-DT2	CALLLETTERS	WABI-DT2
WKTV-DT2	CALLLETTERS	WKTV-DT2
WWTI-DT2	CALLLETTERS	WWTI-DT2
WHAM-DT2	CALLLETTERS	WHAM-DT2
WENY-DT3	CALLLETTERS	WENY-DT3
WBNG-DT2	CALLLETTERS	WBNG-DT2
WBPQ	CALLLETTERS	\
WSEE-DT2	CALLLETTERS	WSEE-DT2
KMIZ	CALLLETTERS	KMIZ
WABW-TV	CALLLETTERS	WABW-TV
WNGH-TV	CALLLETTERS	WNGH-TV
WBRL-CD	CALLLETTERS	WBRL-CD
WCVI-TV	CALLLETTERS	WCVI-TV
WGNM	CALLLETTERS	WGNM
WPBF	CALLLETTERS	WPBF
WIVT	CALLLETTERS	WIVT
KSNF	CALLLETTERS	KSNF
WBND-LD	CALLLETTERS	WBND-LD
KGMC	CALLLETTERS	KGMC
WLJT-DT	CALLLETTERS	WLJT-DT
KLNM-LD	CALLLETTERS	KLNM-LD
CHAT-TV	CALLLETTERS	CHAT-TV
WEVU-LP	CALLLETTERS	WEVU-LP
WXCW	CALLLETTERS	WXCW
WEAC-CD	CALLLETTERS	WEAC-CD
WTZT-CD	CALLLETTERS	WTZT-CD
XHRIO-TDT	CALLLETTERS	XHRIO-TDT
WNFM-TV	CALLLETTERS	\
WAPK-CD	CALLLETTERS	WAPK-CD
WSWB	CALLLETTERS	WSWB
WOLF-TV	CALLLETTERS	WOLF-TV
WKNX-TV	CALLLETTERS	WKNX-TV
WFLX	CALLLETTERS	WFLX
KTVF	CALLLETTERS	KTVF
KFXF	CALLLETTERS	KFXF
KAME-TV	CALLLETTERS	KAME-TV
WFXU	CALLLETTERS	WFXU
WTLF	CALLLETTERS	WTLF
WACS-TV	CALLLETTERS	WACS-TV
WMFD-TV	CALLLETTERS	WMFD-TV
WNYF-CD	CALLLETTERS	WNYF-CD / WWNY-CD
WCWW-LD	CALLLETTERS	WCWW-LD
KUAC-TV	CALLLETTERS	KUAC-TV
WFXL	CALLLETTERS	WFXL
WSEE-TV	CALLLETTERS	WSEE-TV
WBNB-TV	CALLLETTERS	WBNB-TV
KWHB	CALLLETTERS	KWHB
WSST-TV	CALLLETTERS	WSST-TV
K13XD-D	CALLLETTERS	K13XD-D
WIBW-TV	CALLLETTERS	WIBW-TV
WMUM-TV	CALLLETTERS	WMUM-TV
WLPX-TV	CALLLETTERS	WLPX-TV
WYIN	CALLLETTERS	WYIN
WCJB-TV	CALLLETTERS	WCJB-TV
KQFX-LD	CALLLETTERS	KQFX-LD
WTNZ	CALLLETTERS	WTNZ
WVBG-LP	CALLLETTERS	WVBG-LP
WDKY-TV	CALLLETTERS	WDKY-TV
WSCV	CALLLETTERS	WSCV
KRCG	CALLLETTERS	KRCG
KWHE	CALLLETTERS	KWHE-TV
KAAH-TV	CALLLETTERS	KAAH-TV
KBFD-DT	CALLLETTERS	KBFD-DT
KALO	CALLLETTERS	KALO-TV
KWBN	CALLLETTERS	KWBN
KKAI	CALLLETTERS	KKAI-TV
KUPU	CALLLETTERS	KUPU-TV
KHLU-LP	CALLLETTERS	KHLU-LP
KJEO-LD	CALLLETTERS	KJEO-LD
KGOF-LP	CALLLETTERS	KGOF-LP / KSDI-LD
KNSO	CALLLETTERS	KNSO
WGSR-LD	CALLLETTERS	WGSR-LD
GWTV	CALLLETTERS	GW-TV
WHBF-TV	CALLLETTERS	WHBF-TV
WQAD-TV	CALLLETTERS	WQAD-TV
KWQC-TV	CALLLETTERS	KWQC-TV
WDNN-CD	CALLLETTERS	WDNN-CD
KFTV-DT	CALLLETTERS	KFTV-DT
KMSG-LD	CALLLETTERS	KMSG-LD
KHSC-LP	CALLLETTERS	KHSC-LP
KVPT	CALLLETTERS	KVPT
KVHF-LD	CALLLETTERS	KVHF-LD
KZMM-CD	CALLLETTERS	KZMM-CD
KVBC-LP	CALLLETTERS	KVBC-LP
TOKYO METROPOLITAN TELEVISION	CALLLETTERS	TOKYO METROPOLITAN TELEVISION
WBTL-LP	CALLLETTERS	WBTL-LP
WMYS-LD	CALLLETTERS	WMYS-LD
WTJX-TV	CALLLETTERS	WTJX-TV
WEID-LP	CALLLETTERS	WEID-LP
WVIF	CALLLETTERS	WVIF
W21BF	CALLLETTERS	W21BF
W29CB	CALLLETTERS	W29CB - W36DX-D
WMNS-LP	CALLLETTERS	WMNS-LP
WBIV-LP	CALLLETTERS	WBIV-LP
WEYA-LP	CALLLETTERS	WEYA-LP/LD
WEON-LP	CALLLETTERS	WEON-LP
WJWM-LP	CALLLETTERS	WJWM-LP
CARIBBEAN BROADCAST NETWORK	CALLLETTERS	CARIBBEAN BROADCAST NETWORK
K28HS	CALLLETTERS	K28HS
K32GB	CALLLETTERS	K32GB
K36GJ	CALLLETTERS	K36GJ
KEQI-LP	CALLLETTERS	KEQI-LP
K30HB	CALLLETTERS	K30HB
KKHJ-LP	CALLLETTERS	KKHJ-LP
WTBY-TV	CALLLETTERS	WTBY-TV
WNGN-LP	CALLLETTERS	WNGN-LP / WNGX-LD
WOGX	CALLLETTERS	WOGX
WLOX	CALLLETTERS	WLOX
WDAM-TV	CALLLETTERS	WDAM-TV
WHLT	CALLLETTERS	WHLT
WRAY-TV	CALLLETTERS	WRAY-TV
WRLM	CALLLETTERS	WRLM
KVZK-2	CALLLETTERS	KVZK-2
WHAG-TV	CALLLETTERS	WHAG-TV
KHQA-TV	CALLLETTERS	KHQA-TV
WSJX-LP	CALLLETTERS	WSJX-LP
WGGN-TV	CALLLETTERS	WGGN-TV
WLAJ-DT2	CALLLETTERS	WLAJ-DT2
WFXR	CALLLETTERS	WFXR
WBKO	CALLLETTERS	WBKO
W09CK	CALLLETTERS	W09CK
WHNE-LD	CALLLETTERS	WHNE-LD
WLFM-LP	CALLLETTERS	WLFM-LP
WTCV	CALLLETTERS	WTCV
KLBK-TV	CALLLETTERS	KLBK-TV
KNTS-LP	CALLLETTERS	KNTS-LP
KAMC	CALLLETTERS	KAMC
KOZL-TV	CALLLETTERS	KOZL-TV
KODE-TV	CALLLETTERS	KODE-TV
KOZK	CALLLETTERS	KOZK / KOZJ
WBXH-CD	CALLLETTERS	WBXH-CD
MISSISSIPPI PUBLIC BROADCASTING	CALLLETTERS	MISSISSIPPI PUBLIC BROADCASTING
KODF-LD	CALLLETTERS	KODF-LD
WRUA	CALLLETTERS	WRUA
WMEI	CALLLETTERS	WMEI
WMEI	CALLLETTERS	WOST
WLRN-TV	CALLLETTERS	WLRN-TV
WDFX-TV	CALLLETTERS	WDFX-TV
WLTV-DT	CALLLETTERS	WLTV-DT
WTVY	CALLLETTERS	WTVY
KOSA-TV	CALLLETTERS	KOSA-TV
KLVD-LD	CALLLETTERS	KLVD-LD
KWNL-CD	CALLLETTERS	KWNL-CD
WOLV	CALLLETTERS	WOLV
KPMC-LP	CALLLETTERS	KPMC-LP
KBFK-LP	CALLLETTERS	KBFK-LP
KJOU-LP	CALLLETTERS	KJOU-LP
KCPN-LP	CALLLETTERS	KCPN-LP
KBBV-CD	CALLLETTERS	KBBV-CD
W07DP-D	CALLLETTERS	W07DP-D
KABE-CD	CALLLETTERS	KABE-CD
KKEY-LP	CALLLETTERS	KKEY-LP
WXBU	CALLLETTERS	WXBU
WJET-TV	CALLLETTERS	WJET-TV
WGMB-TV	CALLLETTERS	WGMB-TV
KBSV	CALLLETTERS	KBSV
KSPX-TV	CALLLETTERS	KSPX-TV
KSTV-LP	CALLLETTERS	KSTV-LP
KSAO-LD	CALLLETTERS	KSAO-LD
KTFF-DT	CALLLETTERS	KTFF-DT
KBSH-DT	CALLLETTERS	KBSH-DT
KBSD-DT	CALLLETTERS	KBSD-DT
KBSL-DT	CALLLETTERS	KBSL-DT
WLFT-CD	CALLLETTERS	WLFT-CD
KPBN-LD	CALLLETTERS	KPBN-LP
KZUP-CD	CALLLETTERS	KZUP-CD
W10BM	CALLLETTERS	W10BM
KMOH-TV	CALLLETTERS	KMOH-TV
KVIQ	CALLLETTERS	KVIQ
KSNC	CALLLETTERS	KSNC
KSNG	CALLLETTERS	KSNG
WYLN-LP	CALLLETTERS	WYLN-LP
WBMS-CA	CALLLETTERS	WBMS-CA
KHSL-TV	CALLLETTERS	KHSL-TV
KCVU	CALLLETTERS	KCVU
KKJB	CALLLETTERS	KKJB
KWTX-TV	CALLLETTERS	KWTX-TV
KIEM-TV	CALLLETTERS	KIEM-TV
KTIV	CALLLETTERS	KTIV
WQTV-LP	CALLLETTERS	WQTV-LP/WQWQ-LP
TELECARIBE	CALLLETTERS	TELECARIBE
CBN	CALLLETTERS	CBN
WBNG-TV	CALLLETTERS	WBNG-TV
CFTK-TV	CALLLETTERS	CFTK-TV
AMV	CALLLETTERS	AMV
MTN	CALLLETTERS	MTN
WCBI-TV	CALLLETTERS	WCBI-TV
WJAC-TV	CALLLETTERS	WJAC-TV
KDCG-CD	CALLLETTERS	KDCG-CD
KJLR-LP	CALLLETTERS	KJLR-LP
WQPX-TV	CALLLETTERS	WQPX-TV
WHSV-TV	CALLLETTERS	WHSV-TV
KMUM-CA	CALLLETTERS	KMUM-CD / KMMW-LD
KAZV-LP	CALLLETTERS	KAZV-LP
WLIO	CALLLETTERS	WLIO
WRBL	CALLLETTERS	WRBL
KCEN-TV	CALLLETTERS	KCEN-TV
KWKT-TV	CALLLETTERS	KWKT-TV
KJTV-TV	CALLLETTERS	KJTV-TV
WLTZ	CALLLETTERS	WLTZ
KCOP-TV	CALLLETTERS	KCOP-TV
WXXI-TV	CALLLETTERS	WXXI-TV
MUTV	CALLLETTERS	MUTV
WEBR-CD	CALLLETTERS	WEBR-CD
SHAW TV KENORA	CALLLETTERS	SHAW TV
KQCK	CALLLETTERS	KQCK
KEGS	CALLLETTERS	KEGS
WFXP	CALLLETTERS	WFXP
WWCP-TV	CALLLETTERS	WWCP-TV
KSAN-TV	CALLLETTERS	KSAN-TV
K25MM-D	CALLLETTERS	K25MM-D
KPTM	CALLLETTERS	KPTM
WXEL-TV	CALLLETTERS	WXEL-TV
WGFL	CALLLETTERS	WGFL
WSWG	CALLLETTERS	WSWG
WBGH-CD	CALLLETTERS	WBGH-CD
KTVG-TV	CALLLETTERS	KTVG-TV
KTVQ-DT2	CALLLETTERS	KTVQ-DT2
WIAV-CD	CALLLETTERS	WIAV-CD
WUTR	CALLLETTERS	WUTR
WMBB	CALLLETTERS	WMBB
WFXV	CALLLETTERS	WFXV
WPNY-LP	CALLLETTERS	WPNY-LP
WSPX-TV	CALLLETTERS	WSPX-TV
KALB-TV	CALLLETTERS	KALB-TV
YSWA	CALLLETTERS	YSWA
TELEDOS	CALLLETTERS	YSWR
YSU4	CALLLETTERS	YSU4
DUKE UNION COMMUNITY TELEVISION	CALLLETTERS	DUKE UNION COMMUNITY TELEVISION
WQMY	CALLLETTERS	WQMY
KRBC-TV	CALLLETTERS	KRBC-TV
WAKA	CALLLETTERS	WAKA
WSFA	CALLLETTERS	WSFA
WCOV-TV	CALLLETTERS	WCOV-TV
WABG-TV	CALLLETTERS	WABG-TV
WXVT	CALLLETTERS	WXVT
WATM-TV	CALLLETTERS	WATM-TV
KPEJ-TV	CALLLETTERS	KPEJ-TV
WAZS-LD	CALLLETTERS	WAZS-LP
WJNI-LD	CALLLETTERS	WJNI-LD
WJAL	CALLLETTERS	WJAL
WNPX-TV	CALLLETTERS	WNPX-TV
WPGD-TV	CALLLETTERS	WPGD-TV
WJFB	CALLLETTERS	WJFB
WTOK-TV	CALLLETTERS	WTOK-TV
WDNI-CD	CALLLETTERS	WDNI-CD
KCWK	CALLLETTERS	KCWK
KOBI	CALLLETTERS	KOBI
KOTI	CALLLETTERS	KOTI
WFRZ-LD	CALLLETTERS	WFRZ-LD
KMVU-DT	CALLLETTERS	KMVU-DT
KTVL	CALLLETTERS	KTVL
KDRV	CALLLETTERS	KDRV / KDKF
KGEC-LD	CALLLETTERS	KGEC-LD
KBLN-TV	CALLLETTERS	KBLN-TV
WBLU-LP	CALLLETTERS	WBLU-LP
WNKY	CALLLETTERS	WNKY
WNYJ-TV	CALLLETTERS	WNYJ-TV
KTVC	CALLLETTERS	KTVC
WMDN	CALLLETTERS	WMDN
KYCW-LD	CALLLETTERS	KYCW-LD
KWWT	CALLLETTERS	KWWT
WGBC	CALLLETTERS	WGBC
KXTU-LD	CALLLETTERS	KXTU-LD
KMVT	CALLLETTERS	KMVT
KLAX-TV	CALLLETTERS	KLAX-TV
WPXM-TV	CALLLETTERS	WPXM-TV
KTOV-LP	CALLLETTERS	KTOV-LP
WWPX-TV	CALLLETTERS	WWPX-TV
IUSTV	CALLLETTERS	IUSTV
SOUTHERN OREGON PUBLIC TELEVISION	CALLLETTERS	KSYS / KFTS
WHLV-TV	CALLLETTERS	WHLV-TV
WTMO-CD	CALLLETTERS	WTMO-CD
KGCW	CALLLETTERS	KGCW
KKOG-TV	CALLLETTERS	KKOG-TV
WEFS	CALLLETTERS	WEFS
WTGL	CALLLETTERS	WTGL
WACX	CALLLETTERS	WACX
WPXK-TV	CALLLETTERS	WPXK-TV
WLFG	CALLLETTERS	WLFG
WLOV-TV	CALLLETTERS	WLOV-TV
WKDH	CALLLETTERS	WKDH
KVHP	CALLLETTERS	KVHP
KHPK-LD	CALLLETTERS	KHPK-LD
WGCU	CALLLETTERS	WGCU
WARP-CD	CALLLETTERS	WARP-CD
WBPN-LP	CALLLETTERS	WBPN-LP
WICZ-TV	CALLLETTERS	WICZ-TV
KUIL-LD	CALLLETTERS	KUIL-LD
WRDE-LD	CALLLETTERS	WRDE-TV
WPTA-DT2	CALLLETTERS	WPTA-DT2
KVEO-TV	CALLLETTERS	KVEO-TV
KGBT-TV	CALLLETTERS	KGBT-TV
KRGV-TV	CALLLETTERS	KRGV-TV
KLKN	CALLLETTERS	KLKN
WHDT	CALLLETTERS	WHDT
KOAM-TV	CALLLETTERS	KOAM-TV
WYGN-LD	CALLLETTERS	WYGN-LD
WXSX-CA	CALLLETTERS	WXSX-CA
KHGI-TV	CALLLETTERS	KHGI-TV / KWNB-TV
WBXI-CD	CALLLETTERS	WBXI-CD
WMKE-CD	CALLLETTERS	WMKE-CD
KVMD	CALLLETTERS	KVMD
KNAV-LP	CALLLETTERS	KNAV-LP
KATA-CD	CALLLETTERS	KATA-CD
KDTP	CALLLETTERS	KDTP
KFBI-LD	CALLLETTERS	KFBI-LD
CJBR-DT	CALLLETTERS	CJBR-DT
WNCE-CD	CALLLETTERS	WNCE-CD
WNYI	CALLLETTERS	WNYI
W06BD	CALLLETTERS	W06BD
KBTR-CD	CALLLETTERS	KBTR-CD
WMBQ-CD	CALLLETTERS	WMBQ-CD
WVVA-DT2	CALLLETTERS	WVVA-DT2
WLCN-CD	CALLLETTERS	WLCN-CD
KADF-LP	CALLLETTERS	KADF-LD
WOBZ-LD	CALLLETTERS	WOBZ-LD
KMPX	CALLLETTERS	KMPX
KCTU-LD	CALLLETTERS	KCTU-LD
KFJX	CALLLETTERS	KFJX
WBGT-CD	CALLLETTERS	WBGT-CD
WQLN	CALLLETTERS	WQLN
KPXL-TV	CALLLETTERS	KPXL-TV
KTPX-TV	CALLLETTERS	KTPX-TV
KPXR-TV	CALLLETTERS	KPXR-TV
WEPX-TV	CALLLETTERS	WEPX-TV
KAUN-LP	CALLLETTERS	KAUN-LP
WPXU-TV	CALLLETTERS	WPXU-TV
WFPX-TV	CALLLETTERS	WFPX-TV
WRPX-TV	CALLLETTERS	WRPX-TV
WPXP-TV	CALLLETTERS	WPXP-TV
WPXR-TV	CALLLETTERS	WPXR-TV
WPXV-TV	CALLLETTERS	WPXV-TV
WYCI	CALLLETTERS	WYCI
RYUKYU ASAHI BROADCASTING	CALLLETTERS	JORY-TV
RYUKYU ASAHI BROADCASTING	CALLLETTERS	JORY-DTV
WRID-LD	CALLLETTERS	WRID-LD
WLQP-LP	CALLLETTERS	WLQP-LP
WLMO-LP	CALLLETTERS	WLMO-LP
WOHL-CD	CALLLETTERS	WOHL-CD
WFND-LD	CALLLETTERS	WFND-LD
W09CG	CALLLETTERS	W09CG
W16BT	CALLLETTERS	W16BT
WMNO-CD	CALLLETTERS	WMNO-CD
KCSO-LD	CALLLETTERS	KCSO-LD
WPGX	CALLLETTERS	WPGX
WWBK-LP	CALLLETTERS	WWBK-LP
KOREA NEW NETWORK	CALLLETTERS	HLDG-DTV
WIYC	CALLLETTERS	WIYC
WKBS-TV	CALLLETTERS	WKBS-TV
KAZQ	CALLLETTERS	KAZQ
WXXV-TV	CALLLETTERS	WXXV-TV
KJWP	CALLLETTERS	KJWP
KREG-TV	CALLLETTERS	KREG-TV
WJLP	CALLLETTERS	WJLP
WTCT	CALLLETTERS	WTCT
WIWU-CD	CALLLETTERS	WIWU-CD
KJEF-CA	CALLLETTERS	KJEF-LP
KKEI-CD	CALLLETTERS	KKEI-CD
RKB MAINICHI BROADCASTING	CALLLETTERS	JOFR-DTV
KUGB-CD	CALLLETTERS	KUGB-CD
WVTT-CD	CALLLETTERS	WVTT-CD
KMCC	CALLLETTERS	KMCC
KYNM-CD	CALLLETTERS	KYNM-CD
WOCW-LP	CALLLETTERS	WOCW-LP
WSWY-LP	CALLLETTERS	WSWY-LP
W38BK	CALLLETTERS	W38BK
WOTM-LP	CALLLETTERS	WOTM-LP
WTJP-TV	CALLLETTERS	WTJP-TV
KJNP-TV	CALLLETTERS	KJNP-TV
W47CK	CALLLETTERS	W47CK
WZXZ-CD	CALLLETTERS	WZXZ-CD
W23BV-D	CALLLETTERS	W23BV-D
WCLJ-TV	CALLLETTERS	WCLJ-TV
WMUN-LP	CALLLETTERS	WMUN-LP
WHFE-LP	CALLLETTERS	WHFE-LP / WVGO-LP
WVVH-CD	CALLLETTERS	WVVH-CD
KKAX-LP	CALLLETTERS	KKAX-LP
WBXC-CD	CALLLETTERS	WBXC-CD
WAAA-LP	CALLLETTERS	WAAA-LP
KMMA-CD	CALLLETTERS	KMMA-CD
KMMD-CD	CALLLETTERS	KMMD-CD
KVMM-CD	CALLLETTERS	KVMM-CD
KVPS-LP	CALLLETTERS	KVPS-LP
KQMM-CD	CALLLETTERS	KQMM-CD
KNLJ	CALLLETTERS	KNLJ
KQTV	CALLLETTERS	KQTV
KEUV-LP	CALLLETTERS	KEUV-LP
WLCU-CA	CALLLETTERS	WLCU-CA
W30CV-D	CALLLETTERS	W30CV-D
WQAD-DT3	CALLLETTERS	WQAD-DT3
WSJN-CD	CALLLETTERS	SBN SENDA BROADCASTING NETWORK
KMCA-LD	CALLLETTERS	KMCA-LD
WJTS-CD	CALLLETTERS	WJTS-CD
WOTH-CD	CALLLETTERS	WOTH-CD
WVUP-CD	CALLLETTERS	WVUP-CD
WJYS	CALLLETTERS	WJYS
KBSC-LP	CALLLETTERS	KBSC-LP
KUKC-LP	CALLLETTERS	KUKC-LD
KINC	CALLLETTERS	KINC
KELV-LD	CALLLETTERS	KELV-LD
WIMN-CA	CALLLETTERS	WIMN-CD
KTVP-LD	CALLLETTERS	KTVP-LD
KUOK-CA	CALLLETTERS	KUOK-CA
WODN-LP	CALLLETTERS	WODN-LP
KUVE-DT	CALLLETTERS	KUVE-DT
KCOS-LP	CALLLETTERS	KCOS-LP
IUP-TV	CALLLETTERS	IUP-TV
WKYU-TV	CALLLETTERS	WKYU
KUPT	CALLLETTERS	KUPT
KUNU-LD	CALLLETTERS	KUNU-LD
KBTV-TV	CALLLETTERS	KBTV-TV
KFDM	CALLLETTERS	KFDM
KBMT	CALLLETTERS	KBMT
KTAB-TV	CALLLETTERS	KTAB-TV
WELL-LD	CALLLETTERS	WELL-LD
WDMA-CD	CALLLETTERS	WDMA-CD
KPSE-LD	CALLLETTERS	KPSE-LD
W24DL-D	CALLLETTERS	W24DL-D
KFXL-TV	CALLLETTERS	KFXL-TV
WDLI-TV	CALLLETTERS	WDLI-TV
WDHS	CALLLETTERS	WDHS
WETM-DT2	CALLLETTERS	WETM-DT2
WHDT-LD	CALLLETTERS	WHDT-LD
WOCK-CD	CALLLETTERS	WOCK-CD
WEDE-CD	CALLLETTERS	WEDE-CD
WWTO-TV	CALLLETTERS	WWTO-TV
WRLW-CD	CALLLETTERS	WRLW-CD
WREP-LD	CALLLETTERS	WREP-LD
WKOG-LP	CALLLETTERS	WKOG-LP
K22JA-D	CALLLETTERS	K22JA-D
K47DF-D	CALLLETTERS	K47DF-D
KRIS-TV	CALLLETTERS	KRIS-TV
KIII	CALLLETTERS	KIII
KNHL	CALLLETTERS	KNHL
WTPM-LD	CALLLETTERS	WTPM-LD
WQPT-TV	CALLLETTERS	WQPT-TV
KJCW	CALLLETTERS	KJCW
KGWC-TV	CALLLETTERS	KGWC-TV
WUSF-TV	CALLLETTERS	WUSF-TV
WAWD	CALLLETTERS	WAWD
WXOB-LP	CALLLETTERS	WXOB-LP
KAVU-TV	CALLLETTERS	KAVU-TV
W47CO	CALLLETTERS	W47CO-D
KIDY	CALLLETTERS	KIDY
WSOT-LD	CALLLETTERS	WSOT-LD
KXVA	CALLLETTERS	KXVA
KVCT	CALLLETTERS	KVCT
WECN	CALLLETTERS	WECN
KBBA-LP	CALLLETTERS	KBBA-LP
KLRN	CALLLETTERS	KLRN
WBUY-TV	CALLLETTERS	WBUY-TV
KJST-LP	CALLLETTERS	KJST-LP
KTFV-CD	CALLLETTERS	KTFV-CD
KETF-CD	CALLLETTERS	KETF-CD
KFXV-LD	CALLLETTERS	KFXV-LD
KFTA-TV	CALLLETTERS	KFTA-TV
KPBI-CA	CALLLETTERS	KPBI-CA
KXTF	CALLLETTERS	KXTF
KBTV-CD	CALLLETTERS	KBTV-CD
CHCO-TV	CALLLETTERS	CHCO-TV
KFQX	CALLLETTERS	KFQX
KVPA-LD	CALLLETTERS	KVPA-LD
KTMO-LP	CALLLETTERS	KTMO-LP
KCVH-LD	CALLLETTERS	KCVH-LD
KJJM-LD	CALLLETTERS	KJJM-LD
KYLE-TV	CALLLETTERS	KYLE-TV
KISA-LD	CALLLETTERS	KISA-LD
KVAT-LD	CALLLETTERS	KVAT-LD
WMOW	CALLLETTERS	WMOW
WIWN	CALLLETTERS	WIWN
W48CL	CALLLETTERS	W48CL
WDEM-CD	CALLLETTERS	WDEM-CD
WCLL-CD	CALLLETTERS	WCLL-CD
WWRS-TV	CALLLETTERS	WWRS-TV
WBIF	CALLLETTERS	WBIF
KDMI	CALLLETTERS	KDMI
WEYS-LP	CALLLETTERS	WEYS-LP
WCCV-TV	CALLLETTERS	WCCV-TV
WJKT	CALLLETTERS	WJKT
WUJA	CALLLETTERS	WUJA
KBDI-TV	CALLLETTERS	KBDI
KDAO-CD	CALLLETTERS	KDAO-CD
WDWL	CALLLETTERS	WDWL
WIDP	CALLLETTERS	WIDP
WVQS-LD	CALLLETTERS	WVQS-LD
WRFB	CALLLETTERS	WRFB
WQHA	CALLLETTERS	WQHA
WQHA	CALLLETTERS	W06DA-D
WQHA	CALLLETTERS	W44DW-D
KORS-CD	CALLLETTERS	KORS-CD
TV SETOUCHI	CALLLETTERS	JOPH-TV
WYLE	CALLLETTERS	WYLE
WAJN-LP	CALLLETTERS	WAJN-LP
WLJC-TV	CALLLETTERS	WLJC-TV
WGEN-TV	CALLLETTERS	WGEN-TV
WSBS-TV	CALLLETTERS	WSBS-TV
WDDN-LD	CALLLETTERS	WDDN-LD
WRTN-LP	CALLLETTERS	WRTN-LP / WRTN-LD
WVLR	CALLLETTERS	WVLR
WYDC	CALLLETTERS	WYDC
WTPC-TV	CALLLETTERS	WTPC-TV
WVPT	CALLLETTERS	WVPT / WVPY
WELF-TV	CALLLETTERS	WELF-TV
WXTX	CALLLETTERS	WXTX
WMCN-TV	CALLLETTERS	WMCN-TV
WIIC-LD	CALLLETTERS	WIIC-LD
KTMJ-CD	CALLLETTERS	KTMJ-CD
KCFG	CALLLETTERS	KCFG
WBIH	CALLLETTERS	WBIH
WMCF-TV	CALLLETTERS	WMCF-TV
WMPV-TV	CALLLETTERS	WMPV-TV
WRXY-TV	CALLLETTERS	WRXY-TV
WFGC	CALLLETTERS	WFGC
WHBR	CALLLETTERS	WHBR
WJEB-TV	CALLLETTERS	WJEB-TV
WTCE-TV	CALLLETTERS	WTCE-TV
WBEC-TV	CALLLETTERS	WBEC-TV
WPCT	CALLLETTERS	WPCT
WBMM	CALLLETTERS	WBMM
WOCB-CD	CALLLETTERS	WOCB-CD / WXCB-CD
W15BU-D	CALLLETTERS	W15BU-D
W29CI-D	CALLLETTERS	W29CI-D
KSMQ-TV	CALLLETTERS	KSMQ PUBLIC TELEVISION
WSSS-LP	CALLLETTERS	WSSS-LP
WWTD-LD	CALLLETTERS	WWTD-LD
KNJO-LP	CALLLETTERS	KNJO-LP
KCAB-LP	CALLLETTERS	KCAB-LP
KLCW-TV	CALLLETTERS	KLCW-TV
W41DO-D	CALLLETTERS	W41DO-D
KTAJ-TV	CALLLETTERS	KTAJ-TV
K38IZ-D	CALLLETTERS	K38IZ-D
KPHE-LD	CALLLETTERS	KPHE-LD
KFXO-LD	CALLLETTERS	KFXO-LD
W30DG-D	CALLLETTERS	W30DG-D
KQBN-LP	CALLLETTERS	KQBN-LP
KPCE-LP	CALLLETTERS	KPCE-LP
WBXJ-CD	CALLLETTERS	WBXJ-CD
WDTJ-LD	CALLLETTERS	WDTJ-LD
WAGT-DT2	CALLLETTERS	WAGT-DT2
WAGT-CD	CALLLETTERS	WAGT-CD
KJPX-LP	CALLLETTERS	KJPX-LP
WPEN-LP	CALLLETTERS	WPEN-LP
K18DD-D	CALLLETTERS	K18DD-D / K23FZ
KUAT-TV	CALLLETTERS	KUAT-TV / KUAS-TV
K19FD	CALLLETTERS	K19FD
XHEW-TV	CALLLETTERS	XHEW
XHREY-TDT	CALLLETTERS	XHREY-TDT
XHBR-TDT	CALLLETTERS	XHBR-TDT
XHLNA-TDT	CALLLETTERS	XHLNA-TDT
XHLAT-TDT	CALLLETTERS	XHLAT-TDT
XEFE-TDT	CALLLETTERS	XEFE-TDT
K21GE	CALLLETTERS	K21GE
KCYU-LD	CALLLETTERS	KCYU-LD
XHUNAM-TDT	CALLLETTERS	XHUNAM-TDT
XHUS-TV	CALLLETTERS	XHUS-TV
XHMNU-TDT	CALLLETTERS	XHMNU-TDT
XHX-TDT	CALLLETTERS	XHX-TDT
XHWX-TDT	CALLLETTERS	XHWX-TV
XHFN-TDT	CALLLETTERS	XHFN-TDT
XHCNL-TDT	CALLLETTERS	XHCNL-TDT
XHCH-TDT	CALLLETTERS	XHCH-TV
XHECH-TDT	CALLLETTERS	XHECH-TDT
XHIT-TDT	CALLLETTERS	XHIT-TDT
XHFI-TDT	CALLLETTERS	XHFI-TDT
XHAUC-TDT	CALLLETTERS	XHAUC-TDT
XHCHZ-TDT	CALLLETTERS	XHCHZ-TDT
K33CG	CALLLETTERS	K33CG
KBRO-LD	CALLLETTERS	KBRO-LD
K25AL	CALLLETTERS	K25AL
KYOU-TV	CALLLETTERS	KYOU-TV
W17AY	CALLLETTERS	W17AY
WRCX-LP	CALLLETTERS	WRCX-LP
WWRD-LP	CALLLETTERS	WWRD-LP
W32AR	CALLLETTERS	W32AR
W26AL	CALLLETTERS	W26AL
W23BZ-D	CALLLETTERS	W23BZ-D
W08EM-D	CALLLETTERS	W08EM-D
KSMS-TV	CALLLETTERS	KSMS-TV
KMUV-LP	CALLLETTERS	KMUV-LP
WCDN-LD	CALLLETTERS	WCDN-LP
WBXV-LP	CALLLETTERS	WBXV-LP
XHAW-TDT	CALLLETTERS	XHAW-TDT
XHSAW-TDT	CALLLETTERS	XHSAW-TDT
KLHU-CD	CALLLETTERS	KLHU-CD
KPIF	CALLLETTERS	KPIF
KEFB	CALLLETTERS	KEFB
K27EC-D	CALLLETTERS	K25HD-D
K27EC-D	CALLLETTERS	K27EC-D
WTAM-LD	CALLLETTERS	WTAM-LD
KFFV	CALLLETTERS	KFFV
KTVH-DT	CALLLETTERS	KTVH-DT
GREAT BELIZE TELEVISION	CALLLETTERS	CHANNEL 5
TROPICAL VISION LIMITED	CALLLETTERS	CHANNEL 7
WAZT-CD	CALLLETTERS	WAZT-CD
KZSD-LP	CALLLETTERS	KZSD-LP
K21CX-D	CALLLETTERS	K21CX-D
KVSW-LP	CALLLETTERS	KVSW-LP
KTBW-TV	CALLLETTERS	KTBW-TV
WLLS-LP	CALLLETTERS	WLLS-LP
KEET	CALLLETTERS	KEET
KMCT-TV	CALLLETTERS	KMCT-TV
KTFL	CALLLETTERS	KTFL
WKAG-CA	CALLLETTERS	WKAG-CA
WQFL-CA	CALLLETTERS	WQFL-CA
WLPD-CD	CALLLETTERS	WLPD-CD/LP
W23BW-D	CALLLETTERS	W23BW-D
KBGH	CALLLETTERS	KBGH
KZJL	CALLLETTERS	KZJL
KTVZ	CALLLETTERS	KTVZ
KENW	CALLLETTERS	KENW
KKAP	CALLLETTERS	KKAP
WXWZ-LP	CALLLETTERS	WXWZ-LD
KCBU	CALLLETTERS	KCBU
KUTF	CALLLETTERS	KUTF
KTMW	CALLLETTERS	KTMW
KBTZ	CALLLETTERS	KBTZ
KXLF-TV	CALLLETTERS	KXLF-TV / KBZK
KETD	CALLLETTERS	KETD
KDOR-TV	CALLLETTERS	KDOR-TV
KAZD	CALLLETTERS	KAZD
KTEL-CD	CALLLETTERS	KTEL-CD / KTEL-TV
ONTARIO PARLIAMENT NETWORK	CALLLETTERS	ONTARIO PARLIAMENT NETWORK
ONTARIO PARLIAMENT NETWORK	CALLLETTERS	CJOL-TV
WLNN-CD	CALLLETTERS	WLNN-CD
WTBL-CD	CALLLETTERS	WTBL-CD
KEYU	CALLLETTERS	KEYU
WUHO-LP	CALLLETTERS	WUHO-LP
KNPB	CALLLETTERS	KNPB
KPAX-TV	CALLLETTERS	KPAX-TV
GIBRALTAR BROADCASTING CORPORATION	CALLLETTERS	GBC-TV
KREM TELEVISION	CALLLETTERS	KREM TV
KRTV	CALLLETTERS	KRTV
KEDT	CALLLETTERS	KEDT
DZBB-TV	CALLLETTERS	DZBB-TV
DWWX-TV	CALLLETTERS	DWWX-TV
DWET-TV	CALLLETTERS	DWET-TV
TRI-VALLEY COMMUNITY TELEVISION	CALLLETTERS	TV30
DZKB-TV	CALLLETTERS	DZKB-TV
DZOE-TV	CALLLETTERS	DZOE-TV
DWGT-TV	CALLLETTERS	DWGT-TV
KOCM	CALLLETTERS	KOCM
TVMAX	CALLLETTERS	TV MAX
KMIZ-DT2	CALLLETTERS	KMIZ-DT2
XHILA-TDT	CALLLETTERS	XHILA-TDT
KFBB-TV	CALLLETTERS	KFBB-TV
KRSU-TV	CALLLETTERS	KRSU-TV
KDYW	CALLLETTERS	KDYW
KCTF-LP	CALLLETTERS	KCTF-LP
CHEX-TV-2	CALLLETTERS	CHEX-TV-2
K26GS-D	CALLLETTERS	K26GS-D / K07XL-D
KTBO-TV	CALLLETTERS	KTBO-TV
KTMF	CALLLETTERS	KTMF
KHCE-TV	CALLLETTERS	KHCE-TV
KLDO-TV	CALLLETTERS	KLDO-TV
KITU-TV	CALLLETTERS	KITU-TV
KLUJ-TV	CALLLETTERS	KLUJ-TV
KPBT-TV	CALLLETTERS	KPBT-TV
KBEO	CALLLETTERS	KBEO
KWYB	CALLLETTERS	KWYB
KVAW	CALLLETTERS	KVAW
KNVO	CALLLETTERS	KNVO
KUPB	CALLLETTERS	KUPB
KTLM	CALLLETTERS	KTLM
KTGF	CALLLETTERS	KTGF
KUHM-TV	CALLLETTERS	KUHM-TV
KFTL-CD	CALLLETTERS	KFTL-CD
KMMF	CALLLETTERS	KMMF
KNCT	CALLLETTERS	KNCT
KPTF-DT	CALLLETTERS	KPTF-DT
KLMN	CALLLETTERS	KLMN
KYVV-TV	CALLLETTERS	KYVV-TV
KTXD-TV	CALLLETTERS	KTXD-TV
KORO	CALLLETTERS	KORO
KTAS	CALLLETTERS	KTAS
DWBP-TV	CALLLETTERS	DWBP-TV
KATH-LD	CALLLETTERS	KATH-LD / KSCT-LP
KVFW-LD	CALLLETTERS	KVFW-LD
DWKC-TV	CALLLETTERS	DWKC-TV
WWDT-CD	CALLLETTERS	WWDT-CD
WZGS-CD	CALLLETTERS	WZGS-CD
KRFT-LD	CALLLETTERS	KRFT-LD
WTNC-LD	CALLLETTERS	WTNC-LD
WHFL-CD	CALLLETTERS	WHFL-CD
WJJY-TV	CALLLETTERS	WJJY-TV
DWCP-TV	CALLLETTERS	DWCP-TV
KFDF-CD	CALLLETTERS	KFDF-CD
WJMF-LP	CALLLETTERS	WJMF-LP
WVAD-LD	CALLLETTERS	WVAD-LD
K25FW-D	CALLLETTERS	K25FW-D
WMYG-LP	CALLLETTERS	WMYG-LP
K36DU	CALLLETTERS	K36DU
DWXI-TV	CALLLETTERS	DWXI-TV
WPBM-CD	CALLLETTERS	WPBM-CD
KLHO-LD	CALLLETTERS	KLHO-LD
KUOT-CD	CALLLETTERS	KUOT-CD
KWEM-LP	CALLLETTERS	KWEM-LP
KXOK-LD	CALLLETTERS	KXOK-LD
KTEW-LD	CALLLETTERS	KTEW-LD
KTOU-LD	CALLLETTERS	KTOU-LD
KTKO-LP	CALLLETTERS	KTKO-LP
CBC TV 8	CALLLETTERS	8
KOHD	CALLLETTERS	KOHD
K43FO-D	CALLLETTERS	K43FO-D
KHDF-CD	CALLLETTERS	KHDF-CD
KUJH-LP	CALLLETTERS	KUJH-LP
KEEN-CD	CALLLETTERS	KEEN-CD
KRNS-CD	CALLLETTERS	KRNS-CD
KCVB-CD	CALLLETTERS	KCVB-CD
KQDF-LP	CALLLETTERS	KQDF-LP
KLEG-CD	CALLLETTERS	KLEG-CD
BIP	CALLLETTERS	BIP
K47DR	CALLLETTERS	K47DR
KUTV	CALLLETTERS	KUTV
KTVX	CALLLETTERS	KTVX
DYXX-TV	CALLLETTERS	DYXX-TV
KRDN-LP	CALLLETTERS	KRDN-LP
KSVN-CD	CALLLETTERS	KSVN-CD
KIWB-LP	CALLLETTERS	KIWB-LP
KPTN-LD	CALLLETTERS	KPTN-LD
DYAF-TV	CALLLETTERS	DYAF-TV
DYJB-TV	CALLLETTERS	DYJB-TV
DYRI-TV	CALLLETTERS	DYRI-TV
DYAQ-TV	CALLLETTERS	DYAQ-TV
DYNY-TV	CALLLETTERS	DYNY-TV
DYRJ-TV	CALLLETTERS	DYRJ-TV
KOTR-LP	CALLLETTERS	KOTR-LP
WJKP-LD	CALLLETTERS	WJKP-LD
ITHACA COLLEGE TELEVISION	CALLLETTERS	ICTV
XEIMT-TDT	CALLLETTERS	XEIMT-TDT
KVPX-LD	CALLLETTERS	KVPX-LD
KPVT-LP	CALLLETTERS	KPVT-LP
KVTE-LP	CALLLETTERS	KVTE-LP
KLSV-LD	CALLLETTERS	KLSV-LD
KHMP-LD	CALLLETTERS	KHMP-LD
K41IO-D	CALLLETTERS	K41IO-D
KPVM-LP	CALLLETTERS	KPVM-LP/-LD
WSUN-TV	CALLLETTERS	WSUN-TV
KXMN-LD	CALLLETTERS	KXMN-LD
WMYT-TV	CALLLETTERS	WMYT-TV
K17JI-D	CALLLETTERS	K17JI-D
KULX-CD	CALLLETTERS	KULX-CD
WAMY-TV	CALLLETTERS	\
KUTA-LD	CALLLETTERS	KUTA-LD
K07UF	CALLLETTERS	K07UF
KTXC-LP	CALLLETTERS	KTXC-LP
K08MM-D	CALLLETTERS	K08MM-D
KKRR-LP	CALLLETTERS	KKRR-LP
WJPW-CD	CALLLETTERS	WJPW-CD
WWVW-LD	CALLLETTERS	WWVW-LD
KBID-LP	CALLLETTERS	KBID-LP
XHTVM-TDT	CALLLETTERS	XHTVM-TDT
K25NK-D	CALLLETTERS	K25NK-D
CHIBA TELEVISION BROADCASTING	CALLLETTERS	JOCL-DTV
KWKD-LP	CALLLETTERS	KWKD-LP
KGPT-CD	CALLLETTERS	KGPT-CD / KGPT-LD
KSMI-LP	CALLLETTERS	KSMI-LP
WGBS-LD	CALLLETTERS	WGBS-LD
K31GL-D	CALLLETTERS	K31GL-D
W07BN-D	CALLLETTERS	W07BN-D
WFYW-LP	CALLLETTERS	WFYW-LP
WLLB-LD	CALLLETTERS	WLLB-LD
KCND-TV	CALLLETTERS	KCND-TV
WUVF-LP	CALLLETTERS	WUVF-LD
WWJX	CALLLETTERS	WWJX
WLOT-LP	CALLLETTERS	WLOT-LP
KVQT-LD	CALLLETTERS	KVQT-LD
WLLZ-LP	CALLLETTERS	WLLZ-LP
DWVN-TV	CALLLETTERS	DWVN-TV
WTLE-LP	CALLLETTERS	WTLE-LP
WWXY-LD	CALLLETTERS	WWXY-LD
KYAV-LD	CALLLETTERS	KYAV-LD
KVFA-LP	CALLLETTERS	KVFA-LP
KHLM-LD	CALLLETTERS	KHLM-LD
KUVM-CD	CALLLETTERS	KUVM-CD
KXLK-CD	CALLLETTERS	KXLK-CD
K34HO-D	CALLLETTERS	K34HO-D
KNWS-LP	CALLLETTERS	KNWS-LP
WMBF-TV	CALLLETTERS	WMBF-TV
KBTF-CD	CALLLETTERS	KBTF-CD / KTFB-CA
KTSB-CA	CALLLETTERS	KTSB-CA
KDTF-LD	CALLLETTERS	KDTF-LD
K55KD	CALLLETTERS	KWJU-CD
PEISH TV	CALLLETTERS	PEISH TV
W51AG	CALLLETTERS	W51AG
W36CK	CALLLETTERS	W36CK
KSBT-LD	CALLLETTERS	KSBT-LD
WHVL-LP	CALLLETTERS	WHVL-LP/-LD
WYSJ-CA	CALLLETTERS	WYSJ-CA
WTOP-TV	CALLLETTERS	WTOP
K24GP	CALLLETTERS	K24GP
K45HW	CALLLETTERS	K45HW
K51JF	CALLLETTERS	K51JF
K20JT-D	CALLLETTERS	K20JT-D
K69IT	CALLLETTERS	K69IT
K64GK	CALLLETTERS	K64GK
KGBS-CD	CALLLETTERS	KGBS-CD
W30BX	CALLLETTERS	W30BX
WTSJ-LP	CALLLETTERS	WTSJ-LP
WEST CENTRAL OHIO CW	CALLLETTERS	WEST CENTRAL OHIO CW
KSDY-LD	CALLLETTERS	KSDY-LD
KNIC-CD	CALLLETTERS	KNIC-CD
KEUS-LD	CALLLETTERS	KEUS-LD
DWNQ-TV	CALLLETTERS	DWNQ-TV
DZGB-TV	CALLLETTERS	DZGB-TV
K35DG-D	CALLLETTERS	K35DG-D
W25CP	CALLLETTERS	W25CP
W26BS	CALLLETTERS	W26BS
KVDF-CD	CALLLETTERS	KVDF-CD
KQVE-LP	CALLLETTERS	KQVE-LP
K45IO-D	CALLLETTERS	K45IO-D
K44FK	CALLLETTERS	K44FK
K58CM	CALLLETTERS	K58CM
K56HW	CALLLETTERS	K56HW
KQCT-LP	CALLLETTERS	KQCT-LP
K17ET	CALLLETTERS	K17ET
K42HI	CALLLETTERS	K42HI
KGLR-LP	CALLLETTERS	KGLR-LP
KXPI-LD	CALLLETTERS	KXPI-LD
TELEVISION KANAGAWA	CALLLETTERS	TV KANAGAWA
TELEVISION KANAGAWA	CALLLETTERS	JOKM-TV
EHIME ASAHI TELEVISION	CALLLETTERS	EHIME ASAHI TELEVISION
EHIME ASAHI TELEVISION	CALLLETTERS	JOEY-TV
WSVT-LD	CALLLETTERS	WSVT-LD
K33HZ	CALLLETTERS	K33HZ
KAJN-CD	CALLLETTERS	KAJN-CD
KADT-LD	CALLLETTERS	KADT-LD
K33LN-D	CALLLETTERS	K33LN-D
WYCX-CD	CALLLETTERS	WYCX-CD
KCDN-LD	CALLLETTERS	KCDN-LD
KANG-LP	CALLLETTERS	KANG-LP
WAKN-LP	CALLLETTERS	WAKN-LP
KBNS-CD	CALLLETTERS	KBNS-CD
KSEX-CD	CALLLETTERS	KSEX-CD
KCHD-CA	CALLLETTERS	KCHD-CA
K17FA-D	CALLLETTERS	K17FA-D
KMOL-LD	CALLLETTERS	KMOL-LD
KXTS-LD	CALLLETTERS	KXTS-LD
KVTX-LP	CALLLETTERS	KVTX-LP
K43DV	CALLLETTERS	K43DV
KCLG-LD	CALLLETTERS	KCLG-LD
KCLJ-LP	CALLLETTERS	KCLJ-LP
KCLP-CA	CALLLETTERS	KCLP-CA\N  \N  \N  STATION_BRANDING         =
K27LF-D	CALLLETTERS	K27LF-D
K24HH-D	CALLLETTERS	K24HH-D
K20KF-D	CALLLETTERS	K20KF-D
K17ED-D	CALLLETTERS	K17ED-D
K21DO-D	CALLLETTERS	K21DO-D
K21JQ-D	CALLLETTERS	K21JQ-D
K31FD-D	CALLLETTERS	K31FD-D
K33EJ-D	CALLLETTERS	K33EJ-D
KWOG	CALLLETTERS	KWOG
K20JX-D	CALLLETTERS	K20JX-D
K54GK	CALLLETTERS	K54GK
K48BL	CALLLETTERS	K48BL
K49FC	CALLLETTERS	K49FC
YAMANASHI BROADCASTING SYSTEM	CALLLETTERS	YAMANASHI BROADCASTING SYSTEM
YAMANASHI BROADCASTING SYSTEM	CALLLETTERS	JOJF-DTV
KAXT-CD	CALLLETTERS	KAXT-CD
DWNB-TV	CALLLETTERS	DWNB-TV
KSBO-CD	CALLLETTERS	KSBO-CD
W40CN-D	CALLLETTERS	W40CN-D
KPOM-LP	CALLLETTERS	KPOM-LP
KCRP-CD	CALLLETTERS	KCRP-CD
NANKAI BROADCASTING	CALLLETTERS	JOAF-DTV
WFXZ-CD	CALLLETTERS	WFXZ-CD
K45IE-D	CALLLETTERS	K45IE-D
KQDK-CD	CALLLETTERS	KQDK-CD
KRET-CD	CALLLETTERS	KRET-CD
KEXT-CD	CALLLETTERS	KEXT-CD
KEZT-CD	CALLLETTERS	KEZT-CD
KHMM-CD	CALLLETTERS	KHMM-CD
KSKJ-CD	CALLLETTERS	KSKJ-CD
WCHU-LD	CALLLETTERS	WCHU-LD
KPAL-LP	CALLLETTERS	KVME
WAGA-TV	CALLLETTERS	WAGA-TV
KUTU-CD	CALLLETTERS	KUTU-CD
KLAU-LP	CALLLETTERS	KLAU-LP
KTLE-LP	CALLLETTERS	KTLE-LP
KJCN-LP	CALLLETTERS	KJCN-LP
KDJT-CD	CALLLETTERS	KDJT-CD
KSKT-CD	CALLLETTERS	KSKT-CD
KFRE-CA	CALLLETTERS	KFRE-CA
KUCL-LD	CALLLETTERS	KUCL-LD
KRBK	CALLLETTERS	KRBK
KGHB-CD	CALLLETTERS	KGHB-CD
CIMC-TV	CALLLETTERS	CIMC-TV
CHMG-TV	CALLLETTERS	CHMG-TV
CHVC-TV	CALLLETTERS	CHVC-TV-1
CHET-TV	CALLLETTERS	CHET-TV
NAC TV	CALLLETTERS	CH5248
MICHIGAN CHANNEL	CALLLETTERS	MICHIGAN CHANNEL
KLPS-LP	CALLLETTERS	KLPS-LP
MARQUETTE UNIVERSITY TELEVISION	CALLLETTERS	MUTV
KIDZ-LD	CALLLETTERS	KIDZ-LD
TV3 WINCHESTER	CALLLETTERS	TV3 WINCHESTER
KTVS-LD	CALLLETTERS	KTVS-LD
HIROSHIMA HOME TELEVISION	CALLLETTERS	JOGM-DTV
HIROSHIMA TELECASTING	CALLLETTERS	JONX-TV
ABN	CALLLETTERS	ABN
ABC	CALLLETTERS	ABC
ABD	CALLLETTERS	ABD
ABT	CALLLETTERS	ABT
ABS	CALLLETTERS	ABS
ABQ	CALLLETTERS	ABQ
ABV	CALLLETTERS	ABV
MCTV 26	CALLLETTERS	MCTV 26
K36DB-CD	CALLLETTERS	K36DB-CD
DXMJ-TV	CALLLETTERS	DXMJ-TV
WGUD-LD	CALLLETTERS	WGUD-LD
W47CG	CALLLETTERS	W47CG
WKNI-LP	CALLLETTERS	WKNI-LP
KJCP-LP	CALLLETTERS	KJCP-LP
K34HI	CALLLETTERS	K34HI
K11UU-D	CALLLETTERS	K11UU-D
W23BC	CALLLETTERS	W23BC
KNIC-DT	CALLLETTERS	KNIC-DT
KVVV-TV	CALLLETTERS	KVVV-TV
DXNP-TV	CALLLETTERS	DXNP-TV
KUSE-LD	CALLLETTERS	KUSE-LD
CFLA-TV	CALLLETTERS	CFLA-TV
K25DS	CALLLETTERS	K25DS
K31BW	CALLLETTERS	K31BW
K39FW	CALLLETTERS	K39FW
K43HN	CALLLETTERS	K43HN
K50JG	CALLLETTERS	K50JG
K15CN	CALLLETTERS	K15CN
WRUF-LD	CALLLETTERS	WRUF-LD
WNCR-LD	CALLLETTERS	WNCR-LD
KNIK-LP	CALLLETTERS	KNIK-LP/-LD
KLMV-LD	CALLLETTERS	KLMV-LD
KXOF-CD	CALLLETTERS	KXOF-CD
XHNAT-TDT	CALLLETTERS	XHNAT
KYLX-LD	CALLLETTERS	KYLX-LD
KJWY-LP	CALLLETTERS	KJWY-LP/KJWY-LD
KDFQ-LP	CALLLETTERS	KDFQ-LP
WTMS-CA	CALLLETTERS	WTMS-CA
WLHG-CD	CALLLETTERS	WLHG-CD
KKSU-LP	CALLLETTERS	KKSU-LD
K41OI	CALLLETTERS	K41OI
K56AU	CALLLETTERS	K56AU
W16AL	CALLLETTERS	W16AL
KORK-CD	CALLLETTERS	KORK-CD
KOXO-LD	CALLLETTERS	KOXO-LD
KUMY-LD	CALLLETTERS	KUMY-LD
KOXI-CD	CALLLETTERS	KOXI-CD
KXOR-LP	CALLLETTERS	KXOR-LP
KORY-CD	CALLLETTERS	KORY-CD
KHWB-LD	CALLLETTERS	KHWB-LD
KCWT	CALLLETTERS	KCWT-TV
K49FV	CALLLETTERS	K49FV
K33AO	CALLLETTERS	K33AO
K39EF-D	CALLLETTERS	K39EF-D
K41IX	CALLLETTERS	K41IX
W38DH	CALLLETTERS	W38DH
KDTL-LD	CALLLETTERS	KDTL-LD
K33AG	CALLLETTERS	K33AG
KMBA-LP	CALLLETTERS	KMBA-LP
KRHP-LD	CALLLETTERS	KRHP-LD
KNEE-LD	CALLLETTERS	KNEE-LD
K34EM	CALLLETTERS	K34EM
KWCC-LD	CALLLETTERS	KWCC-LD
K43GZ-D	CALLLETTERS	K43GZ-D
KHBA-LD	CALLLETTERS	KHBA-LD
KDYS-LD	CALLLETTERS	KDYS-LD
KTYJ-LP	CALLLETTERS	KTYJ-LP
KIDQ-LP	CALLLETTERS	KIDQ-LP
KOHC-CD	CALLLETTERS	KOHC-CD
K25FP-D	CALLLETTERS	K25FP-D
K39DM	CALLLETTERS	K39DM
KRLB-LD	CALLLETTERS	KRLB-LD
CFVO-TV	CALLLETTERS	CFVO-TV
CAROLINA WEEK	CALLLETTERS	CAROLINA WEEK
ASHUR TV	CALLLETTERS	ASHUR TV
CTV TWO ALBERTA	CALLLETTERS	CJAL-TV / CIAN-TV
KTFD-DT	CALLLETTERS	KTFD-DT
KWCE-LP	CALLLETTERS	KWCE-LP
KTPN-LD	CALLLETTERS	KTPN-LD / KLPN-LD
WCGTV	CALLLETTERS	WCGTV
DYSS-TV	CALLLETTERS	DYSS-TV
KSPJ-LP	CALLLETTERS	KSPJ-LP
KMCE-LP	CALLLETTERS	KMCE-LP
WKFK-LD	CALLLETTERS	WKFK-LD
KZCO-LD	CALLLETTERS	KZCO-LD
DZOZ-TV	CALLLETTERS	DZOZ-TV
KZSW-LD	CALLLETTERS	KZSW-LD
DXLM-TV	CALLLETTERS	DXLM-TV
DXLL-TV	CALLLETTERS	DXLL-TV
STAGSTV	CALLLETTERS	STAGSTV
BPS-TV	CALLLETTERS	BPS-TV
KSCZ-LD	CALLLETTERS	KSCZ-LP
WAXO	CALLLETTERS	W29DM-D/WAXO-TV
WRLP-TV	CALLLETTERS	WRLP-TV
WJZB-TV	CALLLETTERS	WJZB-TV
VTV	CALLLETTERS	VTV
WSCP-LP	CALLLETTERS	WSCP-LP
WNYX-LP	CALLLETTERS	WNYX-LD
WNXY-LD	CALLLETTERS	WNXY-LD
KXFX-CD	CALLLETTERS	KXFX-CD
WCSN-LD	CALLLETTERS	WCSN-LD
DXET-TV	CALLLETTERS	DXET-TV
KADY-LP	CALLLETTERS	KADY-LP
KRRI-LP	CALLLETTERS	KRRI-LP
QQQ	CALLLETTERS	ITQ / QQQ
WRBD-LP	CALLLETTERS	WRBD-LP
WGTB-CD	CALLLETTERS	WGTB-CD
KSDX-LD	CALLLETTERS	KSDX-LD
KQRE-LP	CALLLETTERS	KQRE-LP
WCOT	CALLLETTERS	WCOT-TV
CHAB-TV	CALLLETTERS	CHAB-TV
CBNLT	CALLLETTERS	CBNLT
WQAW-LP	CALLLETTERS	WQAW-LP
W43CE-D	CALLLETTERS	W43CE-D
KKIC-LP	CALLLETTERS	KKIC-LP
KGLA-DT	CALLLETTERS	KGLA-DT
KNVV-LP	CALLLETTERS	KNVV-LP
UHF TELEVISION YAMANASHI	CALLLETTERS	TV YAMANASHI
UHF TELEVISION YAMANASHI	CALLLETTERS	JOGI-TV
WPVS-LP	CALLLETTERS	WPVS-LP
KCXP-LP	CALLLETTERS	KCXP-LP TV ASPEN
WPAN	CALLLETTERS	WPAN
KOBR	CALLLETTERS	KOBR
WGHP	CALLLETTERS	WGHP
REPRETEL 4	CALLLETTERS	REPRETEL 4
REPRETEL 4	CALLLETTERS	(TI-IVS)
REPRETEL 6	CALLLETTERS	REPRETEL 6
REPRETEL 6	CALLLETTERS	(TI-TV6)
REPRETEL: CANAL 11	CALLLETTERS	REPRETEL 11
REPRETEL: CANAL 11	CALLLETTERS	(TI-BYK)
CONEXIóN TV CANAL 2	CALLLETTERS	TITNS-TV
TELETICA CANAL 7	CALLLETTERS	TELETICA 7
TELETICA CANAL 7	CALLLETTERS	(TI-TSR)
WVTV	CALLLETTERS	VTV
WJCN-LD	CALLLETTERS	WJCN-LD
TVES	CALLLETTERS	TVES
XHTRES-TDT	CALLLETTERS	XHTRES-TDT
MILWAUKEE PUBLIC TELEVISION	CALLLETTERS	WMVS
MILWAUKEE PUBLIC TELEVISION	CALLLETTERS	WMVT
WTNO-LP	CALLLETTERS	WTNO-LP
W21AU	CALLLETTERS	W21AU-D
DXWW-TV	CALLLETTERS	DXWW-TV
WJXF-LP	CALLLETTERS	WJXF-LP
KXPX-LP	CALLLETTERS	KXPX-LP
WMDF-LD	CALLLETTERS	WMDF-LD
DXXX-TV	CALLLETTERS	DXXX-TV
K49FF	CALLLETTERS	K49FF
K17HG	CALLLETTERS	K17HG
K35KD	CALLLETTERS	K35KD
XHMNL-TDT	CALLLETTERS	XHMNL-TDT
DWAI-TV	CALLLETTERS	DWAI-TV
TNQ	CALLLETTERS	TNQ
K28EP	CALLLETTERS	K28EP
K21GQ	CALLLETTERS	K21GQ
K40DE	CALLLETTERS	K40DE
K46DY	CALLLETTERS	K46DY
XHJAL-TDT	CALLLETTERS	XHJAL-TDT
CJCO-DT	CALLLETTERS	CJCO-DT
CKCS-DT	CALLLETTERS	CKCS-DT
CKES-DT	CALLLETTERS	CKES-DT
CJEO-DT	CALLLETTERS	CJEO-DT
KRHT-LP	CALLLETTERS	KRHT-LP
WHSV-DT4	CALLLETTERS	WHSV-DT4
WSVF-CD	CALLLETTERS	WSVF-CD
WMDT-DT2	CALLLETTERS	WMDT-DT2
W67DP	CALLLETTERS	W67DP
KSPK-LP	CALLLETTERS	KSPK-DT
KXPD-LP	CALLLETTERS	KXPD-LP
HOKKAIDO TELEVISION BROADCASTING	CALLLETTERS	JOHH-DTV
KMHB	CALLLETTERS	KMHB
K49EK	CALLLETTERS	K49EK
SUN DEVIL TELEVISION	CALLLETTERS	SPTV
KWBJ-CD	CALLLETTERS	KWBJ-CD
WPXO-LD	CALLLETTERS	WPXO-LD
KIMG-LD	CALLLETTERS	KIMG-LD
RTQ	CALLLETTERS	RTQ
KTGB-LP	CALLLETTERS	KTGB-LP
KWSM-LP	CALLLETTERS	KWSM-LD
KKDJ-LP	CALLLETTERS	KKDJ-LP
KHHB-LP	CALLLETTERS	DKHHB-LP
KZKC-LP	CALLLETTERS	KZKC-LP
KESU-LP	CALLLETTERS	KESU-LP
W18BT	CALLLETTERS	W18BT
KSXC-LP	CALLLETTERS	KSXC-LP
KJKZ-LP	CALLLETTERS	KJKZ-LP
RTS	CALLLETTERS	SES / RTS
KCSB-TV	CALLLETTERS	KCSB
KCSB-TV	CALLLETTERS	PUBLIC-ACCESS TELEVISION CABLE TV CHANNEL
LRS	CALLLETTERS	MGS / LRS
NEN	CALLLETTERS	NEN
WOW	CALLLETTERS	WOW
CTC	CALLLETTERS	CTC
W20BA	CALLLETTERS	W20BA
RIALTO NETWORK	CALLLETTERS	RIALTO NETWORK
RIALTO NETWORK	CALLLETTERS	PUBLIC ACCESS CHANNEL
KNOV-CD	CALLLETTERS	KNOV-CD
KYMB-LD	CALLLETTERS	KYMB-LD
WPAG-TV	CALLLETTERS	WPAG-TV
WJMY	CALLLETTERS	WJMY
CFKL-TV	CALLLETTERS	CFKL-TV
PTV	CALLLETTERS	PTV
STV	CALLLETTERS	STV
WIN	CALLLETTERS	WIN
KSSY-LP	CALLLETTERS	KSSY-LP
KCCE-LP	CALLLETTERS	KCCE-LP
KEDD-LD	CALLLETTERS	KEDD-LD
WCPX-LP	CALLLETTERS	WCPX-LP
KHIZ-LD	CALLLETTERS	KHIZ-LD
KZNO-LP	CALLLETTERS	KZNO-LP
KFLA-LD	CALLLETTERS	KFLA-LD
COGECOTV	CALLLETTERS	COGECOTV
COGECOTV	CALLLETTERS	COGECOTV
KOIW-LP	CALLLETTERS	KOIW-LP
KJIB-LP	CALLLETTERS	KJIB-LP
KWJD-LP	CALLLETTERS	KWJD-LP
KBLM-LP	CALLLETTERS	KBLM-LP
KLFB-LD	CALLLETTERS	KLFB-LD
WSQY-LP	CALLLETTERS	WSQY-LP
WKNA-TV	CALLLETTERS	WKNA-TV
WZTD-LD	CALLLETTERS	WZTD-LD
KHRT-TV	CALLLETTERS	KHRT
WAGM-DT2	CALLLETTERS	WAGM-DT2
WUJX-LD	CALLLETTERS	WUJX-LD
ALASKA RURAL COMMUNICATIONS SERVICE	CALLLETTERS	ALASKA RURAL COMMUNICATIONS SERVICE
K31IA	CALLLETTERS	K31IA
K45AR	CALLLETTERS	K45AR
WICA-TV	CALLLETTERS	WICA-TV
WWDD-LD	CALLLETTERS	WWDD-LD
WBQM-LD	CALLLETTERS	WBQM-LD
KFON	CALLLETTERS	KFON
KFON	CALLLETTERS	PUBLIC ACCESS CHANNEL
KTSS-LP	CALLLETTERS	KTSS-LP
K42FE-D	CALLLETTERS	K42FE-D
KRTN-LD	CALLLETTERS	KRTN-LD
K10OI	CALLLETTERS	K10OI
WYAM-LD	CALLLETTERS	WYAM-LD
WFFF-DT2	CALLLETTERS	WFFF-DT2
K20HZ	CALLLETTERS	K20HZ
KMST	CALLLETTERS	KMST
FUKUI TELEVISION BROADCASTING	CALLLETTERS	JOFI-TV
HOM-TV 21	CALLLETTERS	HOMTV 21
KLOA-LP	CALLLETTERS	KLOA-LP
WVUE	CALLLETTERS	WVUE
WBOC-DT2	CALLLETTERS	WBOC-DT2
KVSN-DT	CALLLETTERS	KVSN-DT
CHAK-TV	CALLLETTERS	CHAK-TV
CIHC-TV	CALLLETTERS	CIHC-TV
CFTS-TV	CALLLETTERS	CFTS-TV
CIRE-TV	CALLLETTERS	CIRE-TV
WFMA-LP	CALLLETTERS	WFMA-LP
SEMINOLE GOVERNMENT TELEVISION	CALLLETTERS	SEMINOLE GOVERNMENT TELEVISION
WQXT-CD	CALLLETTERS	WQXT-CD
WFTV	CALLLETTERS	WFTV
KDUL-LP	CALLLETTERS	KDUL-LP
KUQI	CALLLETTERS	KUQI
CHICAGO ACCESS NETWORK TELEVISION	CALLLETTERS	CHICAGO ACCESS NETWORK TELEVISION
WCCA-TV	CALLLETTERS	WCCA-TV
WYCN-CD	CALLLETTERS	WYCN-CD
KZFW-LP	CALLLETTERS	KZFW-LP
KCWV	CALLLETTERS	KCWV
KXLJ-LD	CALLLETTERS	KXLJ-LD
METRO 3	CALLLETTERS	METRO NASHVILLE NETWORK
HARTFORD PUBLIC ACCESS TELEVISION	CALLLETTERS	HARTFORD PUBLIC ACCESS TELEVISION
THE OHIO CHANNEL	CALLLETTERS	THE OHIO CHANNEL
KTUW	CALLLETTERS	KTUW
KNMD-TV	CALLLETTERS	KNMD-TV
KNNN-LP	CALLLETTERS	KNNN-LP
KPOL	CALLLETTERS	KPOL
KLEP	CALLLETTERS	KLEP
KIVA	CALLLETTERS	KIVA
WMEU-CD	CALLLETTERS	WMEU-CD/LP
WXXV-DT3	CALLLETTERS	WXXV-DT3
KXUN-LD	CALLLETTERS	KXUN-LD
LEWIS UNIVERSITY TELEVISION NETWORK	CALLLETTERS	LEWIS UNIVERSITY
LEWIS UNIVERSITY TELEVISION NETWORK	CALLLETTERS	TELEVISION NETWORK
MVTV 3	CALLLETTERS	MVTV
MVTV 3	CALLLETTERS	PUBLIC-ACCESS TELEVISION CHANNEL
K36JH	CALLLETTERS	K36JH
DXEC-TV	CALLLETTERS	DXEC-TV
TV ITAPOAN	CALLLETTERS	TV ITAPOAN
KDCU-DT	CALLLETTERS	KDCU-DT
WUVI-LD	CALLLETTERS	WUVI-LD
TV RECORD RIO DE JANEIRO	CALLLETTERS	TV RECORD RIO DE JANEIRO
KPMT-LP	CALLLETTERS	KPMT-LP
CHNE-TV	CALLLETTERS	CHNE-TV
WKLO-TV	CALLLETTERS	WKLO-TV
KBZO-LD	CALLLETTERS	KBZO-LD
XHY-TDT	CALLLETTERS	XHY-TDT
XHND-TDT	CALLLETTERS	XHND-TDT
RPC-TV	CALLLETTERS	RPC TV CANAL 4
TVN	CALLLETTERS	TVN
FETV	CALLLETTERS	FETV CANAL 5
15 ATV	CALLLETTERS	PJA-TV
SHAW TV SAULT STE. MARIE	CALLLETTERS	SHAW TV
WYAT-LP	CALLLETTERS	WYAT-LP
WWCG-LP	CALLLETTERS	WWCG-LP
DWTE-TV	CALLLETTERS	DWTE-TV
KAMM-LP	CALLLETTERS	KAMM-LP
KAMT-LP	CALLLETTERS	KAMT-LP
WCJB-DT2	CALLLETTERS	WCJB-DT2
KTXD-LP	CALLLETTERS	KTXD-LP
WLCF-LD	CALLLETTERS	WLCF-LD
OC CHANNEL	CALLLETTERS	OC CHANNEL
KCBB-LP	CALLLETTERS	KCBB-LP
KBSE-LP	CALLLETTERS	KBSE-LD
KBTI-LD	CALLLETTERS	KBTI-LD
KUWF-LP	CALLLETTERS	KUWF-LP
KYUU-LD	CALLLETTERS	KYUU-LD
KSCM-LP	CALLLETTERS	KSCM-LP
KBAX-LD	CALLLETTERS	KBAX-LD
KVFD-TV	CALLLETTERS	KVFD
K11UJ	CALLLETTERS	K11UJ
KFIZ-TV	CALLLETTERS	KFIZ-TV
BINGHAMTON TELEVISION	CALLLETTERS	BTV
WBPI-CD	CALLLETTERS	WBPI-CD
K45EB	CALLLETTERS	K45EB
WTRF-DT2	CALLLETTERS	WTRF-DT2
KJCQ-LD	CALLLETTERS	KJCQ-LD
WGBI-LP	CALLLETTERS	WGBI-LP
WZCK-LP	CALLLETTERS	WZCK-LP
KRET-TV	CALLLETTERS	KRET-TV
KFMP-LP	CALLLETTERS	KFMP-LP
K44HH	CALLLETTERS	K44HH
K38HP	CALLLETTERS	K38HP
KLBB-LP	CALLLETTERS	KLBB-LD
KJTV-CD	CALLLETTERS	KJTV-CD
KTFA-LP	CALLLETTERS	KTFA-LP
WTPH-LP	CALLLETTERS	WTPH-LP
XHGO-TDT	CALLLETTERS	XHGO
XHD-TDT	CALLLETTERS	XHD
XHFW-TDT	CALLLETTERS	XHFW-TDT
XHVTU-TDT	CALLLETTERS	XHVTU
XHTPZ-TDT	CALLLETTERS	XHTPZ-TDT
XHTAO-TDT	CALLLETTERS	XHTAO-TDT
KDEV-LP	CALLLETTERS	KDEV-LP
WXXW-LP	CALLLETTERS	WXXW-LP
CHANNEL 5 – ROSARIO	CALLLETTERS	LT84
CHANNEL 7 – MENDOZA	CALLLETTERS	LV89
KDUO-LP	CALLLETTERS	KDUO-LP
OSWEGO COUNTY PUBLIC ACCESS 96	CALLLETTERS	OSWEGO COUNTY PUBLIC ACCESS
KTES-LP	CALLLETTERS	KTES-LP
WCYB-DT2	CALLLETTERS	WCYB-DT2
KAMU-TV	CALLLETTERS	KAMU-TV
WTRF-DT3	CALLLETTERS	WTRF-DT3
WARZ-CD	CALLLETTERS	WARZ-CD
CHANNEL 10 – RíO NEGRO	CALLLETTERS	LU92
CHANNEL 9 – LA RIOJA	CALLLETTERS	LV 91 TV
W45BM	CALLLETTERS	W45BM
KIBN-LD	CALLLETTERS	KIBN-LD
KLUF-LP	CALLLETTERS	KLUF-LP
KLGV-LD	CALLLETTERS	KLGV-LD
KHTM-LP	CALLLETTERS	KHTM-LP
KIVY-LD	CALLLETTERS	KIVY-LD
WVNS-DT2	CALLLETTERS	WVNS-DT2
WYTV-DT2	CALLLETTERS	WYTV-DT2
DYCC-TV	CALLLETTERS	DYCC-TV
WYBU-CD	CALLLETTERS	WYBU-CD
KSNL-LD	CALLLETTERS	KSNL-LD
CHANNEL 10 – CóRDOBA	CALLLETTERS	LV80
WBOY-DT2	CALLLETTERS	WBOY-DT2
WNBW-DT	CALLLETTERS	WNBW-DT
KCDO-TV	CALLLETTERS	KCDO-TV
KVHC-LP	CALLLETTERS	KVHC-LP
CHANNEL 9 – BAHíA BLANCA	CALLLETTERS	LU80
W26CD	CALLLETTERS	W26CD
CHANNEL 6 – BARILOCHE	CALLLETTERS	LU93
WWPS-LP	CALLLETTERS	WWPS-LP
KUBX-LP	CALLLETTERS	KUBX-LP
KXTQ-CD	CALLLETTERS	KXTQ-CD
WOVA-LD	CALLLETTERS	WOVA-LD
WDPM-DT	CALLLETTERS	WDPM-DT
CHANNEL 3 – ROSARIO	CALLLETTERS	LT83
WGBD-LD	CALLLETTERS	WGBD-LD
W30BU	CALLLETTERS	W30BU
XHENB-TDT	CALLLETTERS	XHENB-TV
XEDK-TDT	CALLLETTERS	XEDK-TDT
WJOS-LD	CALLLETTERS	WJOS-LD
MEDINA CABLE ACCESS	CALLLETTERS	MEDINA CABLE ACCESS
EMISSORAS PIONEIRAS DE TELEVISãO	CALLLETTERS	EPTV
REDE INTERNACIONAL DE TELEVISãO	CALLLETTERS	RIT
K26EW	CALLLETTERS	K26EW
K42EO	CALLLETTERS	K42EO
XHPNW-TDT	CALLLETTERS	XHPNW-TDT
XHDEH-TDT	CALLLETTERS	XHDEH-TDT
XHCDE-TDT	CALLLETTERS	XHCDE-TDT
XHGJG-TDT	CALLLETTERS	XHGJG-TV
XHMAP-TV	CALLLETTERS	XHMAP-TV
XHRCG-TDT	CALLLETTERS	XHRCG-TDT
XHRCG-TDT	CALLLETTERS	XHCAW-TDT
XHCGA-TDT	CALLLETTERS	AGUASCALIENTES TV
XHCGA-TDT	CALLLETTERS	(XHCGA-TDT)
XHLEG-TDT	CALLLETTERS	TV CUATRO
XHLEG-TDT	CALLLETTERS	(XHLEG-TV)
WBXZ-LP	CALLLETTERS	WBXZ-LP
XHTLX-TDT	CALLLETTERS	XHTLX-TDT
XHGV-TDT	CALLLETTERS	TVMÁS
XHGV-TDT	CALLLETTERS	(XHGV-TDT)
XHUNES-TDT	CALLLETTERS	XHUNES-TDT
XHPUE-TDT	CALLLETTERS	PUEBLA TV
XHPUE-TDT	CALLLETTERS	(XHPUE-TDT)
WGSF	CALLLETTERS	WGSF
WDUM-LP	CALLLETTERS	WDUM-LP
WPHA-CD	CALLLETTERS	WPHA-CD
WIYE-LD2	CALLLETTERS	WIYE-LD2
WBKO-DT2	CALLLETTERS	WBKO-DT2
WTOK-DT2	CALLLETTERS	WTOK-DT2
KNMQ-LD	CALLLETTERS	KNMQ-LD
KAF RADIO	CALLLETTERS	KAF RADIO
WTKJ-LP	CALLLETTERS	WTKJ-LP
 KHOG-DT2	CALLLETTERS	KHBS-DT2 / KHOG-DT2
WPTA-DT3	CALLLETTERS	WPTA-DT3
KTCJ-LD	CALLLETTERS	KTCJ-LD
KHVM-LD	CALLLETTERS	KHVM-LD
W07BP-D	CALLLETTERS	W07BP-D
W39BT	CALLLETTERS	W39BT
WSFG-LD	CALLLETTERS	WSFG-LD
WSFG-LD	CALLLETTERS	WSSF-LP
WASA-LD	CALLLETTERS	WASA-LD
KCEB	CALLLETTERS	KCEB-TV
KOMI-CD	CALLLETTERS	KOMI-CD
DZAD-TV	CALLLETTERS	DZAD-TV
KADO-CD	CALLLETTERS	KADO-CD
WWJS-CD	CALLLETTERS	WWJS-CD
WHDH-TV	CALLLETTERS	WHDH-TV
WNCT-DT2	CALLLETTERS	WNCT-DT2
K17HC	CALLLETTERS	K17HC
WVIR-DT3	CALLLETTERS	WVIR-DT3
KBTU-LD	CALLLETTERS	KBTU-LD
KLSE	CALLLETTERS	KLSE
KNVN	CALLLETTERS	KNVN
KWHS-LD	CALLLETTERS	KWHS-LD
KRUM-LD	CALLLETTERS	KRUM-LD
KEVE-LD	CALLLETTERS	KEVE-LD
KUNW-CD	CALLLETTERS	KUNW-CD
WLLP-CA	CALLLETTERS	WLLP-CA
WFPG-TV	CALLLETTERS	WFPG-TV
W17CF	CALLLETTERS	W17CF
W44CT-D	CALLLETTERS	W44CT-D
DXTE-TV	CALLLETTERS	DXTE-TV
DYET-TV	CALLLETTERS	DYET-TV
DYTE-TV	CALLLETTERS	DYTE-TV
DXER-TV	CALLLETTERS	DXER-TV
DZET-TV	CALLLETTERS	DZET-TV
KCDH-LP	CALLLETTERS	KCDH-LP
DXTV-TV	CALLLETTERS	DXTV-TV
DYTV-TV	CALLLETTERS	DYTV-TV
K38HE-D	CALLLETTERS	K38HE-D
DXVC-TV	CALLLETTERS	DXVC-TV
DXBN-TV	CALLLETTERS	DXBN-TV
WOIL-CD	CALLLETTERS	WOIL-CD
WCBZ-LP	CALLLETTERS	WCBZ-LP
KNLD-LD	CALLLETTERS	KNLD-LD
W48DW-D	CALLLETTERS	W48DW-D
WLPN-LP	CALLLETTERS	WLPN-LP
IWATE MENKOI TELEVISION	CALLLETTERS	JOYH-TV
KTVQ	CALLLETTERS	KTVQ
RADIO KOLOR	CALLLETTERS	RADIO KOLOR 103 FM
NIIGATA SOGO TELEVISION	CALLLETTERS	JONH-TV
KAGOSHIMA YOMIURI TELEVISION	CALLLETTERS	JOUI-TV
BROADCASTING SYSTEM OF NIIGATA	CALLLETTERS	JODR-TV
NIIGATA TELEVISION NETWORK 21	CALLLETTERS	JOUX-TV
TELEVISION NIIGATA NETWORK	CALLLETTERS	JOPI-TV
DWRW-TV	CALLLETTERS	DWRW-TV
FUKUI BROADCASTING	CALLLETTERS	JOPR-TV
TOYAMA TELEVISION	CALLLETTERS	JOTH-TV
DXCC-TV	CALLLETTERS	DXCC-TV
TULIP TELEVISION	CALLLETTERS	JOJH-TV
WLMF-LD	CALLLETTERS	WLMF-LD
DYPT-TV	CALLLETTERS	DYPT-TV
DXKO-TV	CALLLETTERS	DXKO-TV
WPMF-CD	CALLLETTERS	WPMF-CD
WBWP-LD	CALLLETTERS	WBWP-LD
WIMP-CD	CALLLETTERS	WIMP-CD
WCAY-CD	CALLLETTERS	WCAY-CD
WFUN-LD	CALLLETTERS	WFUN-LD
WWCI-CD	CALLLETTERS	WWCI-CD
KFPB-LD	CALLLETTERS	KFPB-LD
KOHA-LD	CALLLETTERS	KOHA-LD
WBII-CD	CALLLETTERS	WBII-CD
KZTN-LD	CALLLETTERS	KZTN-LD
WDCN-LP	CALLLETTERS	WDCN-LP
DXZB-TV	CALLLETTERS	DXZB-TV
DWRD-TV	CALLLETTERS	DWRD-TV
WHRT-LP	CALLLETTERS	WHRT-LP
WRLH-DT2	CALLLETTERS	WRLH-DT2
WDTB-LP	CALLLETTERS	WDTB-LP
DXSA-TV	CALLLETTERS	DXSA-TV
CINCINNATI REDS RADIO NETWORK	CALLLETTERS	CINCINNATI REDS RADIO NETWORK
KRIS-DT2	CALLLETTERS	KRIS-DT2
SWX RIGHT NOW	CALLLETTERS	SWX RIGHT NOW
K17HI-D	CALLLETTERS	K17HI-D
W43CO-D	CALLLETTERS	W43CO-D/W54BO
DYKB-TV	CALLLETTERS	DYKB-TV
DZBS-TV	CALLLETTERS	DZBS-TV
DXWP-TV	CALLLETTERS	DXWP-TV
DXNL-TV	CALLLETTERS	DXNL-TV
DWKI-TV	CALLLETTERS	DWKI-TV
K50DB-D	CALLLETTERS	K50DB-D
DZRR-TV	CALLLETTERS	DZRR-TV
CHARTER TV3	CALLLETTERS	WCTR CHARTER TV3
WLTZ-DT2	CALLLETTERS	WLTZ-DT2
KPFW-LD	CALLLETTERS	KPFW-LD
KBPX-LD	CALLLETTERS	KBPX-LD
KFVT-LP	CALLLETTERS	KFVT-LP
CHANNEL 13 – SANTA FE	CALLLETTERS	LT82
WFBT	CALLLETTERS	WFBT
WTPX-TV	CALLLETTERS	WTPX-TV
KPJR-TV	CALLLETTERS	KPJR-TV
DWAF-TV	CALLLETTERS	DWAF-TV
WOPI-CD	CALLLETTERS	WOPI-CD
KCFT-CD	CALLLETTERS	KCFT-CD
KDMD-DT3	CALLLETTERS	KDMD-DT3
KENV-DT	CALLLETTERS	KENV-DT
K16HY-D	CALLLETTERS	K16HY
WHDO-CD	CALLLETTERS	WHDO-CD
TV2	CALLLETTERS	TV2
KLTV	CALLLETTERS	KLTV PUBLIC, EDUCATION, GOVERNMENT
CHOY-TV	CALLLETTERS	CHOY-TV
DYME-TV	CALLLETTERS	DYME-TV
DXMM-TV	CALLLETTERS	DXMM-TV
WWLF-LP	CALLLETTERS	WWLF-LP
KYUSHU ASAHI BROADCASTING	CALLLETTERS	JOIF-TV, JOIF-DTV
WCBD-DT2	CALLLETTERS	WCBD-DT2
WFBD	CALLLETTERS	WFBD
TELEVISION NISHINIPPON CORPORATION	CALLLETTERS	JOJY-DTV
FUKUOKA BROADCASTING CORPORATION	CALLLETTERS	JOFH-TV
TVQ KYUSHU BROADCASTING	CALLLETTERS	JOTY-TV
KCTY	CALLLETTERS	KCTY
K04QR-D	CALLLETTERS	K04QR-D
WLUC-DT2	CALLLETTERS	WLUC-DT2
W36DH	CALLLETTERS	W36DH
WDWW-LP	CALLLETTERS	WDWW-LP
K09YL-D	CALLLETTERS	K09YL-D
KBNZ-LD	CALLLETTERS	KBNZ-LD
DWNJ-TV	CALLLETTERS	DWNJ-TV
DWRA-TV	CALLLETTERS	DWRA-TV
NEW UNIVERSITY TELEVISION	CALLLETTERS	NUTV
W63AU	CALLLETTERS	W63AU
WPGA-LP	CALLLETTERS	WPGA-LP
WMDV-LD	CALLLETTERS	WMDV-LD
PASADENA COMMUNITY NETWORK	CALLLETTERS	THE ARROYO CHANNEL, KPAS, KLRN, PCC-TV
K54GL	CALLLETTERS	K54GL
WNAC-DT2	CALLLETTERS	WNAC-DT2
TBS TELEVISION	CALLLETTERS	JORX-TV
MARECO BROADCASTING NETWORK	CALLLETTERS	DWBM-TV
WROV-TV	CALLLETTERS	WROV-TV
WCKN TELEVISION	CALLLETTERS	WCKN
KJNK-LD	CALLLETTERS	KJNK-LD
W18BL-D	CALLLETTERS	W18BL-D
W34DV-D	CALLLETTERS	W34DV-D
W15CG	CALLLETTERS	W15CG
W39CA-D	CALLLETTERS	W39CA-D
W06AW	CALLLETTERS	W06AW
P4A 13	CALLLETTERS	P4A 13
WHDC-LD	CALLLETTERS	WHDC-LD
PJC-TV	CALLLETTERS	PJC-TV
KSLM-LD	CALLLETTERS	KSLM-LD
WMGT-DT2	CALLLETTERS	WMGT-DT2
WITN-DT2	CALLLETTERS	WITN-DT2
KBMT-DT2	CALLLETTERS	KBMT-DT2
WSVL-LP	CALLLETTERS	WSVL-LP
DTD	CALLLETTERS	DTD
WENY-DT2	CALLLETTERS	WENY-DT2
PEGASYS-TV	CALLLETTERS	PEGASYS
KEYC-DT2	CALLLETTERS	KEYC-DT2
DXSS-TV	CALLLETTERS	DXSS-TV
KALB-DT2	CALLLETTERS	KALB-DT2
WNKY-DT2	CALLLETTERS	WNKY-DT2
KSVT-LD	CALLLETTERS	KSVT-LD
WERI-LP	CALLLETTERS	WERI-LP
KLPD-LD	CALLLETTERS	KLPD-LD
KDEO-LD	CALLLETTERS	KDEO-LD
WKWT-LP	CALLLETTERS	WKWT-LP
WIBW-DT2	CALLLETTERS	WIBW-DT2
KDHW-CD	CALLLETTERS	KDHW-CD
K17DL-D	CALLLETTERS	K17DL-D
DYFX-TV	CALLLETTERS	DYFX-TV
WLIO-DT2	CALLLETTERS	WLIO-DT2
DXBM-TV	CALLLETTERS	DXGO-TV
KMBY-LD	CALLLETTERS	KMBY-LD
WNYX-LD	CALLLETTERS	WNYX-LD
KCBT-LD	CALLLETTERS	KCBT-LD
KXKW-LP	CALLLETTERS	KXKW-LP
KOMU-DT3	CALLLETTERS	KOMU-DT3
COMCAST C2 CHARLESTON	CALLLETTERS	COMCAST C2
WKBS-TV	CALLLETTERS	WKBS-TV
DZBA-TV	CALLLETTERS	DZBA-TV
DWIN-TV	CALLLETTERS	DWIN-TV
DWZT-TV	CALLLETTERS	DWZT-TV
DWTC-TV	CALLLETTERS	DWTC-TV
DZVC-TV	CALLLETTERS	DZVC-TV
DWEW-TV	CALLLETTERS	DWEW-TV
DWLY-TV	CALLLETTERS	DWLY-TV
DWMP-TV	CALLLETTERS	DWMP-TV
DZTC-TV	CALLLETTERS	DZTC-TV
DZSC-TV	CALLLETTERS	DZSC-TV
DWZA-TV	CALLLETTERS	DWZA-TV
DWTY-TV	CALLLETTERS	DWTY-TV
DYKA-TV	CALLLETTERS	DYKA-TV
DYPR-TV	CALLLETTERS	DYPR-TV
NISHINIPPON BROADCASTING	CALLLETTERS	JOKF-TV
TV CIDADE FORTALEZA	CALLLETTERS	TV CIDADE
TV VERDES MARES	CALLLETTERS	TV VERDES MARES
TV JANGADEIRO	CALLLETTERS	TV JANGADEIRO
KVDO-LP	CALLLETTERS	KVDO-LP
SETONAIKAI BROADCASTING	CALLLETTERS	JOVH-TV
KXDP-LP	CALLLETTERS	KXDP-LP
KUVM-LD	CALLLETTERS	KUVM-LD
WTXX-LP	CALLLETTERS	WTXX-LP
KNRC-LD	CALLLETTERS	KNRC-LD
EAST TENNESSEE PBS	CALLLETTERS	WETP-TV / WKOP-TV
WPVN-CD	CALLLETTERS	WPVN-CD
XHI-TDT	CALLLETTERS	XHI-TDT
DWEC-TV	CALLLETTERS	DWEC-TV
CIER-TV	CALLLETTERS	CIER-TV
CHOB-TV	CALLLETTERS	CHOB-TV
K47JO-D	CALLLETTERS	K47JO
KELM-LP	CALLLETTERS	KELM-LP
WMUB-LD	CALLLETTERS	WMUB-LD
KZHO-LD	CALLLETTERS	KZHO-LD
WNBD-LD	CALLLETTERS	WNBD-LD
KMBD-LD	CALLLETTERS	KMBD-LD
KQSL	CALLLETTERS	KQSL
WDCI-LD	CALLLETTERS	WDCI-LD
WESV-LD	CALLLETTERS	WESV-LD
DYER-TV	CALLLETTERS	DYER-TV
KVMD-DT6	CALLLETTERS	KSDY-50.3 DTV
KZTC-LP	CALLLETTERS	KZTC-LP
KBKF-LP	CALLLETTERS	KBKF-LP
KDHU-LD	CALLLETTERS	KDHU-LD
KEHO-LD	CALLLETTERS	KEHO-LD
CKY-DT	CALLLETTERS	CKY-DT
WCEA-LD	CALLLETTERS	WCEA-LD
CITRUSTV	CALLLETTERS	CITRUSTV
WFMJ-DT2	CALLLETTERS	WFMJ-DT2
WSNS-TV	CALLLETTERS	WSNS-TV
KEVC-CD	CALLLETTERS	KEVC-CD
WFXS-DT	CALLLETTERS	WFXS-DT
SMOKY HILLS PUBLIC TELEVISION	CALLLETTERS	SMOKY HILLS PUBLIC TELEVISION
KEYT-TV	CALLLETTERS	KEYT-TV
KARZ-TV	CALLLETTERS	KARZ-TV
KCOY-TV	CALLLETTERS	KCOY-TV
CJIL-DT	CALLLETTERS	CJIL-DT
KNDB	CALLLETTERS	KNDB / KNDM
WMYV	CALLLETTERS	WMYV
KMIR-TV	CALLLETTERS	KMIR-TV
WGTW-TV	CALLLETTERS	WGTW-TV
DYXX-TV	CALLLETTERS	DYXX-TV
WMNN-LD	CALLLETTERS	WMNN-LD
WLEP-LD	CALLLETTERS	WLEP-LD
WYME-CD	CALLLETTERS	WYME-CD
KSBW-DT2	CALLLETTERS	KSBW-DT2
K42DJ	CALLLETTERS	K42DJ
KGWN-DT2	CALLLETTERS	KGWN-DT2
KSAW-LD	CALLLETTERS	KSAW-LD
DWIM-TV	CALLLETTERS	DWIM-TV 44
GNN NAGA	CALLLETTERS	GNN TV 48
DZNC-TV	CALLLETTERS	DZNC-TV
WUCF-TV	CALLLETTERS	WUCF-TV
HAIKOU TELEVISION	CALLLETTERS	HKTV
HAINAN TELEVISION	CALLLETTERS	HNWTV
TELEVISIóN TABASQUEñA	CALLLETTERS	XHSTA-TV
XHBZC-TDT	CALLLETTERS	XHBZC-TDT
TELEVISIóN Y RADIO DE CAMPECHE	CALLLETTERS	XHCCA-TDT
CANAL 10 CHIAPAS	CALLLETTERS	XHTTG-TDT
XHAMO-TDT	CALLLETTERS	XHAMO-TDT
XHCMO-TDT	CALLLETTERS	XHCMO-TDT
XHSLS-TDT	CALLLETTERS	CANAL NUEVE
XHSLS-TDT	CALLLETTERS	(XHSLS-TDT)
XHTPG-TDT	CALLLETTERS	XHTPG-TDT
XHST-TDT	CALLLETTERS	TRECEVISIóN
XHST-TDT	CALLLETTERS	(XHST)
KTJA-LP	CALLLETTERS	KTJA-LP
KJNE-LP	CALLLETTERS	KJNE-LD
NJTV	CALLLETTERS	NJTV
WLLC-LP	CALLLETTERS	WLLC-LP
XHSDD-TDT	CALLLETTERS	XHSDD-TDT
XHALC-TV	CALLLETTERS	XHALC-TV
XHMH-TDT	CALLLETTERS	XHMH-TV
XHABC-TDT	CALLLETTERS	XHABC-TDT
XHRIG-TV	CALLLETTERS	XHRIG
MEDFORD CABLE NEWS	CALLLETTERS	MCN-TV
XHRRZ-TV	CALLLETTERS	XHRRZ
XHCEP-TDT	CALLLETTERS	XHCEP-TV
XHARJ-TV	CALLLETTERS	XHARJ-TV
K15FW	CALLLETTERS	K15FW
K39CP	CALLLETTERS	K39CP
KHMA	CALLLETTERS	KHMA-TV
KWMS-LP	CALLLETTERS	KWMS-LP
KTAG-TV	CALLLETTERS	KTAG-TV
KTFO-CD	CALLLETTERS	KTFO-CD
WTHI-DT2	CALLLETTERS	WTHI-DT2
WEVV-DT2	CALLLETTERS	WEVV-DT2 / WEEV-LD
DWRC-TV	CALLLETTERS	DWRC-TV
DZAE-TV	CALLLETTERS	DZAE-TV
DWAT-TV	CALLLETTERS	DWAT-TV
DZAC-TV	CALLLETTERS	DZAC-TV
DWCI-TV	CALLLETTERS	DWCI-TV
DYBH-TV	CALLLETTERS	DYBH-TV
DYAN-TV	CALLLETTERS	DYAN-TV
TV SHIZUOKA	CALLLETTERS	JOQH-DTV
W41AP	CALLLETTERS	W41AP
DWDE-TV	CALLLETTERS	DWDE-TV
DYSB-TV	CALLLETTERS	DYSB-TV
DYRC-TV	CALLLETTERS	DYRC-TV
DWBY-TV	CALLLETTERS	DWBY-TV
DXCE-TV	CALLLETTERS	DXCE-TV
DXXB-TV	CALLLETTERS	DXXB-TV
ABS-CBN OCCIDENTAL MINDORO	CALLLETTERS	DWEF-TV
DYAB-TV	CALLLETTERS	DYAB-TV
DYMA-TV	CALLLETTERS	DYMA-TV
DXAI-TV	CALLLETTERS	DXAI-TV
ABS-CBN GENERAL SANTOS	CALLLETTERS	DXZT-TV
KFAZ	CALLLETTERS	KFAZ
WHPM-LD	CALLLETTERS	WHPM-LD
TV ASAHI	CALLLETTERS	JOEX-TV
TV ASAHI	CALLLETTERS	JOEX-DTV
NIPPON TV	CALLLETTERS	JOAX-DTV
KSQA	CALLLETTERS	KSQA
DYAM-TV	CALLLETTERS	DYAM-TV
KKTF-LD	CALLLETTERS	KKTF-LD
DWAS-TV	CALLLETTERS	DWAS-TV
DXED-TV	CALLLETTERS	DXED-TV
KLDO-DT2	CALLLETTERS	KLDO-DT2
WPSJ-CD	CALLLETTERS	WPSJ-CD
KDOV-LP	CALLLETTERS	KDOV-LP
TELEVISION JAMAICA	CALLLETTERS	TELEVISION JAMAICA LIMITED
KAGS-LD	CALLLETTERS	KAGS-LD
DWCW-TV	CALLLETTERS	DWCW-TV
WBBJ-DT3	CALLLETTERS	WBBJ-DT3
WWCW	CALLLETTERS	WWCW
KIMT-DT3	CALLLETTERS	KIMT-DT3
NANJING EDUCATION AND TECHNOLOGY CHANNEL	CALLLETTERS	NANJING EDUCATION AND TECHNOLOGY CHANNEL
DXKC-TV	CALLLETTERS	DXKC-TV
DXHB-TV	CALLLETTERS	DXHB-TV
DYAR-TV	CALLLETTERS	DYAR-TV
DXVM-TV	CALLLETTERS	DXVM-TV
DYGM-TV	CALLLETTERS	DYGM-TV
KOCY-LP	CALLLETTERS	KOCY-LP
WGBC	CALLLETTERS	WGBC-DT2
KCWT-CD	CALLLETTERS	KCWT-CD
WYOW	CALLLETTERS	WYOW
KNPN-LD	CALLLETTERS	KNPN-LD
TELEMETRO	CALLLETTERS	TELEMETRO PANAMA
RCM TELEVISION	CALLLETTERS	RCM TELEVISION
WLOX-DT2	CALLLETTERS	WLOX-DT2
SERTV	CALLLETTERS	SERTV
WRMX-LP	CALLLETTERS	WRMX-LP
KBJO-LD	CALLLETTERS	KBJO-LD
KXAP-LD	CALLLETTERS	KXAP-LD
DALMAR TV	CALLLETTERS	WCSN
WDMI-LD	CALLLETTERS	WDMI-LD
WXXV-DT2	CALLLETTERS	WXXV-DT2
WDAM-DT2	CALLLETTERS	WDAM-DT2
K19BG	CALLLETTERS	K19BG-D
WSVF-CD2	CALLLETTERS	WSVF-CD2
DYPU-TV	CALLLETTERS	DYPU-TV
DXBG-TV	CALLLETTERS	DXBG-TV
KPDR-LD	CALLLETTERS	KPDR-LD
KRVU-LD	CALLLETTERS	KRVU-LD/KZVU-LD/KECA-LD
KYTX-DT2	CALLLETTERS	KYTX-DT2
W26DK-D	CALLLETTERS	W26DK-D
WACP	CALLLETTERS	WACP
WMWC-TV	CALLLETTERS	WMWC-TV
WZPA-LD	CALLLETTERS	WZPA-LD
KAOB-LD	CALLLETTERS	KAOB-LD
WTVA-DT2	CALLLETTERS	WTVA-DT2
K39JV	CALLLETTERS	K39JV
KNOE-DT2	CALLLETTERS	KNOE-DT2
WKYT-DT2	CALLLETTERS	WKYT-DT2
WTVQ-DT2	CALLLETTERS	WTVQ-DT2
WVLT-DT2	CALLLETTERS	WVLT-DT2
WIYE-LD	CALLLETTERS	WIYE-LD
WJHG-DT2	CALLLETTERS	WJHG-DT2
KXGN-DT2	CALLLETTERS	KXGN-DT2
WBKO-DT3	CALLLETTERS	WBKO-DT3
WECP-LD	CALLLETTERS	WECP-LD
JEJU FREE INTERNATIONAL CITY BROADCASTING SYSTEM	CALLLETTERS	HLKJ-DTV
GANGWON NO.1 BROADCASTING	CALLLETTERS	HLCG-DTV
TAEJON BROADCASTING CORPORATION	CALLLETTERS	HLDF-DTV
KWANGJU BROADCASTING CORPORATION	CALLLETTERS	HLDH-DTV
JEONJU TELEVISION	CALLLETTERS	HLDQ-DTV
ULSAN BROADCASTING CORPORATION	CALLLETTERS	HLDP-DTV
CHEONGJU BROADCASTING	CALLLETTERS	HLDR-DTV
CFHD-DT	CALLLETTERS	CFHD-DT
DXRZ-TV	CALLLETTERS	DXRZ-TV
DXDG-TV	CALLLETTERS	DXDG-TV
EXXV-TV	CALLLETTERS	\
WMUN-CD	CALLLETTERS	WMUN – CD
DZDT-TV	CALLLETTERS	DZDT-TV
DXAP-TV	CALLLETTERS	DXAP-TV
ABS-CBN SPORTS AND ACTION KORONADAL	CALLLETTERS	DXAR-TV
WIIW-LP	CALLLETTERS	WIIW-LP
WTSD-CA	CALLLETTERS	WTSD-CA
NEXTV	CALLLETTERS	NEXTV
WBQD-LP	CALLLETTERS	WBQD-LP
WTSN-CD	CALLLETTERS	WTSN-CD
WDNM-LD	CALLLETTERS	WDNM-LD
K40FJ	CALLLETTERS	K40FJ
W17DJ-D	CALLLETTERS	W17DJ-D
DYYB-TV	CALLLETTERS	DYYB-TV
DYLS-TV	CALLLETTERS	DYLS-TV
DYMY-TV	CALLLETTERS	DYMY-TV
DXNU-TV	CALLLETTERS	DXNU-TV
DXNY-TV	CALLLETTERS	DXNY-TV
KECA-LD	CALLLETTERS	KECA-LD
CITYTV BOGOTá	CALLLETTERS	CITYTV BOGOTá
KZDN-LD	CALLLETTERS	KZDN-LD
KSBS-CD	CALLLETTERS	KSBS-CD
KNPL-LD	CALLLETTERS	KNPL-LD
KUHD-LD	CALLLETTERS	KUHD-LD
WEPT-CD	CALLLETTERS	WEPT-CD
DXRA-TV	CALLLETTERS	DXRA-TV
WFHW-LP	CALLLETTERS	WFHW-LP
DWNC-TV	CALLLETTERS	DWNC-TV
DWTL-TV	CALLLETTERS	DWTL-TV
DXVD-TV	CALLLETTERS	DXVD-TV
CHNB-DT	CALLLETTERS	CHNB-DT
DYLY-TV	CALLLETTERS	DYLY-TV
DYXS-TV	CALLLETTERS	DYXS-TV
DXJT-TV	CALLLETTERS	DXJT-TV
DWAD-TV	CALLLETTERS	DWAD-TV
WRGX-LD	CALLLETTERS	WRGX-LD
WATV-LD	CALLLETTERS	WATV-LD
KDGL-LD	CALLLETTERS	KDGL-LD
KQHW-LD	CALLLETTERS	KQHW-LD
WANA-LD	CALLLETTERS	WANA-LD
WEYW-LP	CALLLETTERS	WEYW-LP
KINV-LD	CALLLETTERS	KINV-LD
WMAZ-DT2	CALLLETTERS	WMAZ-DT2
WVOA-LP	CALLLETTERS	WVOA-LP
KNPG-LD	CALLLETTERS	KNPG-LD
WCKV-LD	CALLLETTERS	WCKV-LD
XHOPMA-TDT	CALLLETTERS	XHOPMA-TDT
RNN, REGIONAL NEWS NETWORK	CALLLETTERS	RNN
DYRQ-TV	CALLLETTERS	DYRO-TV
W26CE	CALLLETTERS	W26CE
WAGC-LD	CALLLETTERS	WAGC-LD
KVHD-LD	CALLLETTERS	KVHD-LD
KYLU-LP	CALLLETTERS	KYLU-LP
IPCTV	CALLLETTERS	IPC TV
CHANNEL 8 SAN JUAN	CALLLETTERS	LV82
XHHCU-TDT	CALLLETTERS	XHHCU-TDT
DWSB-TV	CALLLETTERS	DWSB-TV
WCZU-LD	CALLLETTERS	WCZU-LD
XHCDM-TDT	CALLLETTERS	XHCDM-TDT
DXRV-TV	CALLLETTERS	DXRV-TV
DXGM-TV	CALLLETTERS	DXGM-TV
DXXA-TV	CALLLETTERS	DXXA-TV
DXEJ-TV	CALLLETTERS	DXEJ-TV
DXXT-TV	CALLLETTERS	DXXT-TV
XHUDG-TDT	CALLLETTERS	XHUDG-TDT
XHUJED-TDT	CALLLETTERS	XHUJED-TDT
RIVERS STATE TELEVISION	CALLLETTERS	RSTV
RADIO Y TELEVISIóN QUERéTARO	CALLLETTERS	XHSECE-TDT
XHUAD-TDT	CALLLETTERS	XHUAD-TDT
XHMZE-TDT	CALLLETTERS	XHMZE-TV
XHVSL-TDT	CALLLETTERS	XHVSL-TDT
XELD-TV	CALLLETTERS	XELD-TV
XHTM-TDT	CALLLETTERS	XHTM-TDT
WNAC-TV	CALLLETTERS	WNAC-TV
XHCCU-TDT	CALLLETTERS	XHCCU-TDT
WUWB-LD	CALLLETTERS	WUWB-LD
WTVF-DT2	CALLLETTERS	WTVF-DT2
KMCW-LD	CALLLETTERS	KMCW-LD
K15CU-D	CALLLETTERS	K15CU-D
WYJJ-LD	CALLLETTERS	WYJJ-LD
EPB6	CALLLETTERS	EPB 6
KLKW-LD	CALLLETTERS	KLKW-LD
LAGOS TELEVISION	CALLLETTERS	LTV, LWT
WNBJ-LD	CALLLETTERS	WNBJ-LD
WNTU-LP	CALLLETTERS	WNTU-LP/LD
WNTU-LP	CALLLETTERS	WNPX-LP
WKUW-LD	CALLLETTERS	WKUW-LD
W50CI-D	CALLLETTERS	W50CI-D
WUWT-CD	CALLLETTERS	WUWT-CD
KNKC-LD	CALLLETTERS	KNKC-LD
KPJO-LP	CALLLETTERS	KPJO-LP
WADA-LD	CALLLETTERS	WADA-LD
WPGF-LD	CALLLETTERS	WPGF-LD
WVTN-LP	CALLLETTERS	WVTN-LP
KAJL-LD	CALLLETTERS	KAJL-LD
WRCF-CD	CALLLETTERS	WRCF-CD
WNCB-LD	CALLLETTERS	WNCB-LD
WCEE-LP	CALLLETTERS	WCEE-LP
KGHD-LP	CALLLETTERS	KGHD-LP
DYDY-TV	CALLLETTERS	DYDY-TV
WTMH-LD	CALLLETTERS	WTMH-LD
KJCT-LP	CALLLETTERS	KJCT-LP
WVVC-LD	CALLLETTERS	WVVC-LD
WTZP-LD	CALLLETTERS	WTZP-LD
KUPT-LD	CALLLETTERS	KUPT-LD
W06AY-D	CALLLETTERS	W06AY-D
7	CALLLETTERS	EPB 24/7
WKRN-DT2	CALLLETTERS	WKRN-DT2
THE VOLUNTEER CHANNEL	CALLLETTERS	THE VOLUNTEER CHANNEL
SCTV-6	CALLLETTERS	SCTV-6
VTV	CALLLETTERS	VANDERBILT TV
EPLUSTV6	CALLLETTERS	EPLUSTV 6
KDKZ-LD	CALLLETTERS	KDKZ-LD
FPB-TV	CALLLETTERS	FPB-TV
APSU-TV	CALLLETTERS	APSU-TV
WGPS-LP	CALLLETTERS	WGPS-LP
DYTO-TV	CALLLETTERS	DYTO-TV
WDTT-LD	CALLLETTERS	WDTT-LD
KGCS-LD	CALLLETTERS	KGCS-LD
WKUT-LD	CALLLETTERS	WKUT-LD
KQPS-LD	CALLLETTERS	KQPS-LD
OCTV-71	CALLLETTERS	OCTV-71
DWMR-TV	CALLLETTERS	DWMR-TV
WROB-LD	CALLLETTERS	WROB-LD
BGTV4	CALLLETTERS	BGTV-4
GTV3	CALLLETTERS	GTV3
KNOX-TV	CALLLETTERS	KNOX-TV
WZMC-LP	CALLLETTERS	WZMC-LP
GILA RIVER BROADCASTING CORPORATION	CALLLETTERS	GILA RIVER BROADCASTING CORPORATION
WWTW	CALLLETTERS	WWTW
WHJC-LD	CALLLETTERS	WHJC-LP
DYKD-TV	CALLLETTERS	DYKD-TV
WBCF-LD	CALLLETTERS	WBCF-LD
KUOC-LD	CALLLETTERS	KUOC-LD
XHJMA-TV	CALLLETTERS	XHJMA-TV
CTV	CALLLETTERS	COMMUNITY TELEVISION OF KNOXVILLE
WFIE-DT2	CALLLETTERS	WFIE-DT2
UKTV	CALLLETTERS	WILDCAT STUDENT TV
UKTV	CALLLETTERS	UKTV
KRCC-TV	CALLLETTERS	KRCC-TV
WK&T SPORTS	CALLLETTERS	WK&T SPORTS CHANNEL
KMJC-LD	CALLLETTERS	KMJC-LD
KCKS-LD	CALLLETTERS	KCKS-LD
WWAT-CD	CALLLETTERS	WWAT-CD
WBOA-CD	CALLLETTERS	WBOA-CD
WQVC-CD	CALLLETTERS	WQVC-CD
WPTG-CD	CALLLETTERS	WPTG-CD
WJKF-CA	CALLLETTERS	WJKF-CA
WTOO-CD	CALLLETTERS	WTOO-CD
WWBP-LP	CALLLETTERS	WWBP-LP
CABLE 8 PRODUCTIONS	CALLLETTERS	CABLE 8 PRODUCTIONS
KPDC-LP	CALLLETTERS	KPDC
KJNB-LD	CALLLETTERS	KJNB-LD
WBXA-CD	CALLLETTERS	WBXA-CD
KBGU-LP	CALLLETTERS	KBGU-LP
LIBERTY FLAMES SPORTS NETWORK	CALLLETTERS	LIBERTY FLAMES SPORTS NETWORK
KFKK-LD	CALLLETTERS	KFKK-LD
KFLL-LD	CALLLETTERS	KFLL-LD
ERT3	CALLLETTERS	ERT3
WDYR-CD	CALLLETTERS	WDYR-CD
WJDP-LD	CALLLETTERS	WJDP-LD
WZAW-LD	CALLLETTERS	WZAW-LD
W45EC-D	CALLLETTERS	W45EC-D
WMDE	CALLLETTERS	WMDE
DTC-3	CALLLETTERS	DTC-3
UDC-TV	CALLLETTERS	UDC-TV
METROTV	CALLLETTERS	METROTV
COMMUNITY CHANNEL 10	CALLLETTERS	COMMUNITY CHANNEL 10
WJNK-LD	CALLLETTERS	WJNK-LD
WKNX-LP	CALLLETTERS	WKNX-LP
WGGD-LD	CALLLETTERS	WGGD-LD
XHZHZ-TDT	CALLLETTERS	XHZHZ-TDT
WMCT-TV	CALLLETTERS	WMCT-TV
WDSF-LD	CALLLETTERS	WDSF-LD
KDKJ-LD	CALLLETTERS	KDKJ-LD
XHUJAT-TDT	CALLLETTERS	XHUJAT-TDT
WKDC-LD	CALLLETTERS	WKDC-LD
WALE-LD	CALLLETTERS	WALE-LD
WAAO-LD	CALLLETTERS	WAAO-LD
W43DL-D	CALLLETTERS	W43DL-D
KTWC-LD	CALLLETTERS	KTWC-LD
WYBN-LD	CALLLETTERS	WYBN-LD
WCQT-LP	CALLLETTERS	WCQT-LP
KIJR-LP	CALLLETTERS	KIJR-LP
KDKW-LD	CALLLETTERS	KDKW-LD
ASU-TV	CALLLETTERS	ASU-TV
K30MF-D	CALLLETTERS	K30MF-D
WLKT-TV	CALLLETTERS	WLKT-TV
DWGM-TV	CALLLETTERS	DWGM-TV
W45DF-D	CALLLETTERS	W45DF-D
WHWD-LD	CALLLETTERS	WHWD-LD
WKTV-DT3	CALLLETTERS	WKTV-DT3
DZEA-TV	CALLLETTERS	DZEA-TV
DWLA-TV	CALLLETTERS	DWLA-TV
DZZC-TV	CALLLETTERS	DZZC-TV
WK&T LOCAL CHANNEL 1	CALLLETTERS	WK&T LOCAL CHANNEL 1
KTBC	CALLLETTERS	KTBC
DWZM-TV	CALLLETTERS	DWZM-TV
XHBG-TDT	CALLLETTERS	XHBG-TDT
XHNSS-TDT	CALLLETTERS	XHNSS-TDT
XHCOZ-TDT	CALLLETTERS	XHCOZ-TDT
W14DG-D	CALLLETTERS	W14DG-D
990WBOB	CALLLETTERS	990
WQDI-LD	CALLLETTERS	WQDI-LD
DXGB-TV	CALLLETTERS	DXGB-TV
WJHL-DT2	CALLLETTERS	WJHL-DT2
WJGN-CD	CALLLETTERS	WJGN-CD
WLEX-DT2	CALLLETTERS	WLEX-DT2
WSMV-DT2	CALLLETTERS	WSMV-DT2
WEIN-LD	CALLLETTERS	WEIN-LD
KZCZ-LD	CALLLETTERS	KZCZ-LD
WHJK-LD	CALLLETTERS	WHJK-LD
DXSB-TV	CALLLETTERS	DXSB-TV
WDMC-LD	CALLLETTERS	WDMC-LD
WZNA-LD	CALLLETTERS	WZNA-LD
KEVN-LD	CALLLETTERS	KEVN-LD
WKBJ-LD	CALLLETTERS	WKBJ-LD
MBS TV	CALLLETTERS	JOOR-DTV
KXVU-LD	CALLLETTERS	KXVU-LD
KUCO-LD	CALLLETTERS	KUCO-LD
WBUN-CA	CALLLETTERS	WBUN-LD
WXOD-LD	CALLLETTERS	WXOD-LD
WEKA-LD	CALLLETTERS	WEKA-LD
WNKJ-TV	CALLLETTERS	WNKJ-TV
KABI-LD	CALLLETTERS	KABI-LD
KMYL-LD	CALLLETTERS	KMYL-LD
DYRX-TV	CALLLETTERS	DYRX-TV
KPMF-LD	CALLLETTERS	KPMF-LD
KVTU-LP	CALLLETTERS	KVTU-LP
KFLU-LD	CALLLETTERS	KFLU-LD
KBZC-LD	CALLLETTERS	KBZC-LD
WUDZ-LD	CALLLETTERS	WUDZ-LD
RCTV-19	CALLLETTERS	RCTV-19
KAXW-LP	CALLLETTERS	KAXW-LP
WKUG-LP	CALLLETTERS	WKUG-LD
WIRP-LD	CALLLETTERS	WIRP-LD
KAIT-DT2	CALLLETTERS	KAIT-DT2
KPKN-LD	CALLLETTERS	KPKN-LD
WLEK-LD	CALLLETTERS	WLEK-LD
WQEK-LD	CALLLETTERS	WQEK-LD
WBXP-LP	CALLLETTERS	WBXP-LP
WROZ-TV	CALLLETTERS	WROZ
RYUKYU BROADCASTING CORPORATION	CALLLETTERS	JORR-DTV
KPTB-DT	CALLLETTERS	KPTB-DT & KPCB-DT
WUOA-LD	CALLLETTERS	WUOA-LD
WSTY-LD	CALLLETTERS	WSTY-LP
KAJF-LD	CALLLETTERS	KAJF-LD
KAUO-LD	CALLLETTERS	KAUO-LD
K51JN-D	CALLLETTERS	K51JN-D
WHFV	CALLLETTERS	WHFV
CATHOLIC TELEVISION OF NIGERIA	CALLLETTERS	CATHOLIC TELEVISION OF NIGERIA
NOS PAIS TELEVISION	CALLLETTERS	NOS PAIS
XHCTMX-TDT	CALLLETTERS	XHCTMX-TDT
WEEK-DT2	CALLLETTERS	WEEK-DT2
KXJB-LD	CALLLETTERS	KXJB-LD
KAHC-LD	CALLLETTERS	KAHC-LD
AKITA TELEVISION	CALLLETTERS	JOBI-TV
