BRUCE PERENS	CALLSIGN	K6BP
STEVE WOZNIAK	CALLSIGN	EX-WA6BND
WARD CUNNINGHAM	CALLSIGN	K9OX
KEVIN MITNICK	CALLSIGN	N6NHG
ART BELL	CALLSIGN	W6OBB / 4F1AB
HIRAM PERCY MAXIM	CALLSIGN	W1AW
ATRIOS	CALLSIGN	ATRIOS
ADAM CURRY	CALLSIGN	K5ACC
DICK RUTAN	CALLSIGN	“KILLER” \NKB6LQS
HENRY BOURNE JOY	CALLSIGN	W1AHM
SCOT RUBIN	CALLSIGN	AGN
DOUGLAS H. WHEELOCK	CALLSIGN	KF5BOC
OKOT ODHIAMBO	CALLSIGN	TWO VICTOR
REGINALD VAUGHN FINLEY, SR.	CALLSIGN	DR. ION OR THE INFIDEL GUY
JEFF PULVER	CALLSIGN	WA2BOT
JAKE STEVENS	CALLSIGN	WHISTLE
MICHAEL MEEKS	CALLSIGN	MMEEKS
JOHN AMODEO	CALLSIGN	NN6JA
ORIO PALMER	CALLSIGN	BATTALION 7
THEEPAN	CALLSIGN	TANGO PAPA
GREG CATON	CALLSIGN	N5OY
CYRUS FERNANDEZ	CALLSIGN	CASTOR
CYRUS FERNANDEZ	CALLSIGN	CYRUS THE VIRUS
CYRUS FERNANDEZ	CALLSIGN	CHASE
BOB HEIL	CALLSIGN	K9EID
JURE ŠTERK	CALLSIGN	S52YS
PAT VILLANI	CALLSIGN	WB2GBF
HE PEIRONG	CALLSIGN	PEARL
VICTOR POOR	CALLSIGN	W6JSO/W5SMM
MARISOL MACíAS	CALLSIGN	NENADLAREDO, OR LA NENA DE LAREDO
FLORIAN EFFENBERGER	CALLSIGN	FLOEFF
AREND LANGENBERG	CALLSIGN	THE VOICE
ROGER MELEN	CALLSIGN	WB6JXU
HARRY GARLAND	CALLSIGN	WA8FJW
HARRY GARLAND	CALLSIGN	WA6VYT
TIM HUGHES	CALLSIGN	\
HARRY G. GARLAND	CALLSIGN	WA8GFP
NIXMAN ORYANGA	CALLSIGN	\
DHARMASIRI GAMAGE	CALLSIGN	BEST TRAVEL WRITER - 2002
DENIS PERIšA	CALLSIGN	DARKMAN
BJöRN MICHAELSEN	CALLSIGN	SWEETSHARK
RYSZARD PIOTROWSKI	CALLSIGN	PIORUN, IN ENGLISH - LIGHTNING
MARTIN F. JUE	CALLSIGN	K5FLU
MATIJA ČUPIć	CALLSIGN	YT1REX
TOSHIFUMI TAKESHIMA	CALLSIGN	JOBI-DTV
