Aalborg Municipality	capitalPosition	Aalborg Municipality  capitalPosition  1
Azores	capitalPosition	Azores  capitalPosition  1
Madeira	capitalPosition	Madeira  capitalPosition  1
Albany County, New York	capitalPosition	Albany County, New York  capitalPosition  1
Rensselaer County, New York	capitalPosition	Rensselaer County, New York  capitalPosition  1
Boone County, Missouri	capitalPosition	Boone County, Missouri  capitalPosition  1
Algarve	capitalPosition	Algarve  capitalPosition  1
Herat Province	capitalPosition	Herat Province  capitalPosition  1
Zabul Province	capitalPosition	Zabul Province  capitalPosition  1
San Cristóbal Province	capitalPosition	San Cristóbal Province  capitalPosition  1
Balkh Province	capitalPosition	Balkh Province  capitalPosition  1
Faryab Province	capitalPosition	Faryab Province  capitalPosition  1
Farah Province	capitalPosition	Farah Province  capitalPosition  1
Ghōr Province	capitalPosition	Ghōr Province  capitalPosition  1
Ghazni Province	capitalPosition	Ghazni Province  capitalPosition  1
Helmand Province	capitalPosition	Helmand Province  capitalPosition  1
Jowzjan Province	capitalPosition	Jowzjan Province  capitalPosition  1
Kandahar Province	capitalPosition	Kandahar Province  capitalPosition  1
Kapisa Province	capitalPosition	Kapisa Province  capitalPosition  1
Kabul Province	capitalPosition	Kabul Province  capitalPosition  1
Khost Province	capitalPosition	Khost Province  capitalPosition  1
Logar Province	capitalPosition	Logar Province  capitalPosition  1
Nangarhar Province	capitalPosition	Nangarhar Province  capitalPosition  1
Nimruz Province	capitalPosition	Nimruz Province  capitalPosition  1
Orūzgān Province	capitalPosition	Orūzgān Province  capitalPosition  1
Paktia Province	capitalPosition	Paktia Province  capitalPosition  1
Nuristan Province	capitalPosition	Nuristan Province  capitalPosition  1
Parwan Province	capitalPosition	Parwan Province  capitalPosition  1
Sar-e Pol Province	capitalPosition	Sar-e Pol Province  capitalPosition  1
Takhar Province	capitalPosition	Takhar Province  capitalPosition  1
Wardak Province	capitalPosition	Wardak Province  capitalPosition  1
Paktika Province	capitalPosition	Paktika Province  capitalPosition  1
Daykundi Province	capitalPosition	Daykundi Province  capitalPosition  1
Chiriquí Province	capitalPosition	Chiriquí Province  capitalPosition  1
Panjshir Province	capitalPosition	Panjshir Province  capitalPosition  1
Prešov Region	capitalPosition	Prešov Region  capitalPosition  1
Liberec Region	capitalPosition	Liberec Region  capitalPosition  1
Plzeň Region	capitalPosition	Plzeň Region  capitalPosition  1
Azua Province	capitalPosition	Azua Province  capitalPosition  1
Baoruco Province	capitalPosition	Baoruco Province  capitalPosition  1
Barahona Province	capitalPosition	Barahona Province  capitalPosition  1
Duarte Province	capitalPosition	Duarte Province  capitalPosition  1
Dajabón Province	capitalPosition	Dajabón Province  capitalPosition  1
Elías Piña Province	capitalPosition	Elías Piña Province  capitalPosition  1
El Seibo	capitalPosition	El Seibo  capitalPosition  1
Espaillat Province	capitalPosition	Espaillat Province  capitalPosition  1
Hato Mayor Province	capitalPosition	Hato Mayor Province  capitalPosition  1
Independencia Province	capitalPosition	Independencia Province  capitalPosition  1
La Altagracia Province	capitalPosition	La Altagracia Province  capitalPosition  1
La Romana Province	capitalPosition	La Romana Province  capitalPosition  1
La Vega Province	capitalPosition	La Vega Province  capitalPosition  1
María Trinidad Sánchez Province	capitalPosition	María Trinidad Sánchez Province  capitalPosition  1
Monseñor Nouel Province	capitalPosition	Monseñor Nouel Province  capitalPosition  1
Monte Cristi Province	capitalPosition	Monte Cristi Province  capitalPosition  1
Monte Plata Province	capitalPosition	Monte Plata Province  capitalPosition  1
Pedernales Province	capitalPosition	Pedernales Province  capitalPosition  1
Peravia Province	capitalPosition	Peravia Province  capitalPosition  1
Hermanas Mirabal Province	capitalPosition	Hermanas Mirabal Province  capitalPosition  1
Samaná Province	capitalPosition	Samaná Province  capitalPosition  1
Puerto Plata Province	capitalPosition	Puerto Plata Province  capitalPosition  1
Sánchez Ramírez Province	capitalPosition	Sánchez Ramírez Province  capitalPosition  1
San Pedro de Macorís Province	capitalPosition	San Pedro de Macorís Province  capitalPosition  1
San José de Ocoa Province	capitalPosition	San José de Ocoa Province  capitalPosition  1
Santiago Rodríguez Province	capitalPosition	Santiago Rodríguez Province  capitalPosition  1
Santiago Province (Dominican Republic)	capitalPosition	Santiago Province (Dominican Republic)  capitalPosition  1
Valverde Province	capitalPosition	Valverde Province  capitalPosition  1
Santo Domingo Province	capitalPosition	Santo Domingo Province  capitalPosition  1
Distrito Nacional	capitalPosition	Distrito Nacional  capitalPosition  1
Trenčín Region	capitalPosition	Trenčín Region  capitalPosition  1
Trnava Region	capitalPosition	Trnava Region  capitalPosition  1
Nitra Region	capitalPosition	Nitra Region  capitalPosition  1
Odense Municipality	capitalPosition	Odense Municipality  capitalPosition  1
Bragança District	capitalPosition	Bragança District  capitalPosition  1
Fredericia Municipality	capitalPosition	Fredericia Municipality  capitalPosition  1
Kunar Province	capitalPosition	Kunar Province  capitalPosition  1
Žilina Region	capitalPosition	Žilina Region  capitalPosition  1
Banská Bystrica Region	capitalPosition	Banská Bystrica Region  capitalPosition  1
Košice Region	capitalPosition	Košice Region  capitalPosition  1
Centro Region, Portugal	capitalPosition	Centro Region, Portugal  capitalPosition  1
Norte Region, Portugal	capitalPosition	Norte Region, Portugal  capitalPosition  1
Saint George Parish, Dominica	capitalPosition	Saint George Parish, Dominica  pitalPosition  1
Saint Andrew Parish, Dominica	capitalPosition	Saint Andrew Parish, Dominica  pitalPosition  1
Saint David Parish, Dominica	capitalPosition	Saint David Parish, Dominica  pitalPosition  1
Saint John Parish, Dominica	capitalPosition	Saint John Parish, Dominica  pitalPosition  1
Saint Joseph Parish, Dominica	capitalPosition	Saint Joseph Parish, Dominica  pitalPosition  1
Saint Mark Parish, Dominica	capitalPosition	Saint Mark Parish, Dominica  pitalPosition  1
Saint Peter Parish, Dominica	capitalPosition	Saint Peter Parish, Dominica  pitalPosition  1
Saint Patrick Parish, Dominica	capitalPosition	Saint Patrick Parish, Dominica  pitalPosition  1
Saint Luke Parish, Dominica	capitalPosition	Saint Luke Parish, Dominica  pitalPosition  1
Frederikshavn Municipality	capitalPosition	Frederikshavn Municipality  capitalPosition  1
Lisboa Region	capitalPosition	Lisboa Region  capitalPosition  1
Talamanca Canton	capitalPosition	Talamanca Canton  capitalPosition  1
Colón Island	capitalPosition	Colón Island  capitalPosition  1
Nawa-I-Barakzayi District	capitalPosition	Nawa-I-Barakzayi District  capitalPosition  1
Copenhagen Municipality	capitalPosition	Copenhagen Municipality  capitalPosition  1
San Juan Province (Dominican Republic)	capitalPosition	San Juan Province (Dominican Republic)  capitalPosition  1
Bocas del Toro Archipelago	capitalPosition	Bocas del Toro Archipelago  capitalPosition  1
