DEMOCRATIC PROGRESSIVE PARTY	CHAIRPERSON	TSAI ING-WEN
THE GREENS	CHAIRPERSON	SIMONE PETER AND
THE GREENS	CHAIRPERSON	CEM ÖZDEMIR
KUOMINTANG	CHAIRPERSON	HUNG HSIU-CHU
GREEN PARTY OF THE UNITED STATES	CHAIRPERSON	7
LIBERTARIAN PARTY	CHAIRPERSON	NICHOLAS SARWARK
REPUBLICAN PARTY	CHAIRPERSON	REINCE PRIEBUS
KALAKSHETRA	CHAIRPERSON	N. GOPALASWAMI
COALITION OF PROGRESSIVE ELECTORS	CHAIRPERSON	TIM LOUIS, CONNIE HUBBS
REFORM PARTY OF THE UNITED STATES OF AMERICA	CHAIRPERSON	DAVID COLLISON
ALASKAN INDEPENDENCE PARTY	CHAIRPERSON	LYNETTE CLARK
BANGLADESH NATIONALIST PARTY	CHAIRPERSON	BEGUM KHALEDA ZIA
AUSTRALIAN REPUBLICAN MOVEMENT	CHAIRPERSON	PETER FITZSIMONS
UNITED MALAYS NATIONAL ORGANISATION	CHAIRPERSON	BADRUDDIN AMIRULDIN
DEMOCRATIC PARTY	CHAIRPERSON	EMILY LAU
CO-OPERATIVE PARTY	CHAIRPERSON	GARETH THOMAS
COMMUNIST PARTY OF NEPAL	CHAIRPERSON	PUSHPA KAMAL DAHAL
PEOPLE'S FRONT FOR DEMOCRACY AND JUSTICE	CHAIRPERSON	ISAIAS AFEWERKI
WORKER-COMMUNIST PARTY OF IRAN	CHAIRPERSON	HAMID TAQVAEE
WORKER-COMMUNIST PARTY OF IRAQ	CHAIRPERSON	REBWAR AHMED
SIERRA LEONE PEOPLE'S PARTY	CHAIRPERSON	SUMANOH KAPENHTTP://WADR.ORG/EN/SITE/NEWS_EN/5425/SIERRA-LEONE-CHIEF-KAPEN-IS-NEW-SLPP-CHAIRMAN.HTM
WORKERS' SOCIALIST LEAGUE	CHAIRPERSON	ALAN THORNETT
FREEDOM FRONT PLUS	CHAIRPERSON	PIETER GROENEWALD
MALDIVIAN DEMOCRATIC PARTY	CHAIRPERSON	ALI WAHEED
PEOPLE'S NATIONAL MOVEMENT	CHAIRPERSON	FRANKLIN KHAN
ALL PEOPLE'S CONGRESS	CHAIRPERSON	ERNEST BAI KOROMA
WORKER-COMMUNIST PARTY OF IRAN – HEKMATIST	CHAIRPERSON	RAHMAN HOSSEINZADEH
LEFT WORKER-COMMUNIST PARTY OF IRAQ	CHAIRPERSON	ISSAM SHUKRI
AZANIAN PEOPLE'S ORGANISATION	CHAIRPERSON	ZITHULELE NYANGANA ABSALOM CINDI
CIVIC CONSERVATIVE PARTY	CHAIRPERSON	ONDREJ DOSTáL
GAHAL	CHAIRPERSON	MENACHEM BEGIN
COMMUNIST PARTY OF THE PHILIPPINES	CHAIRPERSON	JOHN BENEDICT PADRINAO
PARTI PESAKA BUMIPUTERA BERSATU	CHAIRPERSON	MOHD ASFIA AWANG NASSAR
NATIONAL DEMOCRATIC CONGRESS	CHAIRPERSON	KOFI PORTUPHY
UNITY PARTY	CHAIRPERSON	VARNEY SHERMAN
PEOPLE'S REDEMPTION PARTY	CHAIRPERSON	ALHAJI BALARABE MUSA
NEW DEMOCRATIC PARTY	CHAIRPERSON	LINTON LEWIS
PROGRESSIVE PARTY	CHAIRPERSON	NAZIR AHMAD MALLAL
CIVIL WILL–GREEN PARTY	CHAIRPERSON	SANJAASüRENGIIN OYUN
SRI LANKA FREEDOM PARTY	CHAIRPERSON	MAITHRIPALA SIRISENA
YOUNG FABIANS	CHAIRPERSON	MARTIN EDOBOR
ACTION CHRISTIAN NATIONAL	CHAIRPERSON	JAN DE WET
SOCIAL DEMOCRATIC PARTY	CHAIRPERSON	RAHMATULLO ZOIROV
NIGERIEN PARTY FOR DEMOCRACY AND SOCIALISM	CHAIRPERSON	FOUMAKOYE GADO
UNION FOR DEMOCRACY AND SOCIAL PROGRESS	CHAIRPERSON	ETIENNE TSHISEKEDI
NEW JERSEY DEMOCRATIC STATE COMMITTEE	CHAIRPERSON	JOHN CURRIE
BRITISH PEOPLE'S PARTY	CHAIRPERSON	HASTINGS RUSSELL, 12TH DUKE OF BEDFORD
AL ADL WA AL IHSSANE	CHAIRPERSON	MOHAMMED ABBADI
BEER LOVERS PARTY	CHAIRPERSON	THEMIS TSINOV
DEMOCRATIC PARTY	CHAIRPERSON	DONNA BRAZILE
IRISH METROPOLITAN CONSERVATIVE SOCIETY	CHAIRPERSON	CPT. WILLIAM SHIRLEY BALL
DHIRUBHAI AMBANI INTERNATIONAL SCHOOL	CHAIRPERSON	NITA AMBANI
AFRICA MUSLIM PARTY	CHAIRPERSON	GULAM SABDIA
OKLAHOMA REPUBLICAN PARTY	CHAIRPERSON	PAM POLLARD
THE WAY OF GEORGIA	CHAIRPERSON	TEIMURAZ MURVANIDZE
ILLINOIS REPUBLICAN PARTY	CHAIRPERSON	TIM SCHNEIDER
CHESTER UPLAND SCHOOL DISTRICT	CHAIRPERSON	FRANCIS BARNES, STATE APPOINTED RECEIVER
CHESTER UPLAND SCHOOL DISTRICT	CHAIRPERSON	JOSEPH P. WATKINS, STATE APPOINTED RECEIVER 2012-2015
PACIFIC GREEN PARTY	CHAIRPERSON	7
ARIZONA DEMOCRATIC PARTY	CHAIRPERSON	ALEXIS TAMERON
CSU	CHAIRPERSON	VOLKER KAUDER
TENNESSEE REPUBLICAN PARTY	CHAIRPERSON	RYAN A. HAYNES
REPUBLICAN PARTY OF LOUISIANA	CHAIRPERSON	ROGER F. VILLERE, JR.
REPUBLICAN PARTY OF NEW MEXICO	CHAIRPERSON	DEBBIE MAESTAS
OVAMBOLAND PEOPLE'S ORGANIZATION	CHAIRPERSON	LUCAS HALEINGE NEPELA
NATIONAL DEMOCRATS PARTY	CHAIRPERSON	ANTON FOLJAMBE
DISTRICT OF COLUMBIA DEMOCRATIC STATE COMMITTEE	CHAIRPERSON	ANITA BONDS
SOCIALIST PARTY OF ONTARIO	CHAIRPERSON	MICHAEL LAXER
ENGLISH COLLEGE IN PRAGUE	CHAIRPERSON	PATRICIA RAWLINGS, BARONESS RAWLINGS
THE SHRI RAM SCHOOL	CHAIRPERSON	LATE MANJU BHARAT RAM
FREEDOM AND SOLIDARITY	CHAIRPERSON	RICHARD SULíK MEP
LACOVIA HIGH SCHOOL	CHAIRPERSON	LACOVIA-HIGH
GOVT. HIGH SCHOOL, MATHILI	CHAIRPERSON	BDO,MATHILI
GOLDCREST HIGH INTERNATIONAL SCHOOL	CHAIRPERSON	AMIT DESHMUKH
WORKER-COMMUNISM UNITY PARTY OF IRAN	CHAIRPERSON	ALI JAVADI
WORKER-COMMUNIST PARTY OF KURDISTAN	CHAIRPERSON	OSMAN HAJY MAROUF
UNITY	CHAIRPERSON	JāNIS ROZENBERGS
KOWLOON WEST NEW DYNAMIC	CHAIRPERSON	PRISCILLA LEUNG
UNITED DEMOCRATIC FORCES OF RWANDA	CHAIRPERSON	VICTOIRE INGABIRE UMUHOZA
REVOLUTIONARY LEFT FRONT	CHAIRPERSON	ÓSCAR ZAMORA MEDINACELI
NEW PEOPLE'S PARTY	CHAIRPERSON	REGINA IP
KABALIKAT NG MALAYANG PILIPINO	CHAIRPERSON	TINGTING COJUANGCO
DELHI PUBLIC SCHOOL, ROURKELA	CHAIRPERSON	ASHOK CHANDRA, DELHI PUBLIC SCHOOL SOCIETY
PEOPLE POWER	CHAIRPERSON	RAYMOND CHAN CHI-CHUEN
PHALANG CHON PARTY	CHAIRPERSON	CHAO MANEEWONG
LIBERAL PARTY	CHAIRPERSON	STANISLAUS PAYSAMA
SOCIAL UNION	CHAIRPERSON	KATALIN SZILI
FREE PATRIOTIC UNION	CHAIRPERSON	SLIM RIAHI
GHAD EL-THAWRA PARTY	CHAIRPERSON	AYMAN NOUR
TAYO	CHAIRPERSON	MARYAM QAASIM
NATIONAL DEMOCRATIC PARTY	CHAIRPERSON	DR. JOSIAH ARYEH
MARKAZUL ULOOM SENIOR SECONDARY ENGLISH SCHOOL	CHAIRPERSON	T. ARIF ALI
LIBERAL SOCIALIST PARTY	CHAIRPERSON	NAZIR AHMAD MALLEK
HORSEED	CHAIRPERSON	ABDIRAHMAN MOHAMUD FAROLE
INDEPENDENT LIBERAL PARTY	CHAIRPERSON	REKHA RAMJIT
PIRATE PARTY OF BERLIN	CHAIRPERSON	BRUNO KRAMM
NORTHERN ELEMENTS PROGRESSIVE UNION	CHAIRPERSON	MALAM AMINU KANO
COMMUNITY FOR SOCIAL JUSTICE PEOPLE'S PARTY	CHAIRPERSON	KATALIN SZILI
BALVANTRAY MEHTA VIDYA BHAWAN ASMA	CHAIRPERSON	RADHAKRISHNA HARIRAM TAHILIANI
KANO PEOPLE'S PARTY	CHAIRPERSON	ALHAJI ABUBAKAR UBA
RIVERS STATE PEOPLE'S DEMOCRATIC PARTY	CHAIRPERSON	FELIX A. OBUAH
UNITED INDEPENDENT PARTY	CHAIRPERSON	EVAN FALCHUK
NEDA PARTY	CHAIRPERSON	SADEGH KHARAZI
MINKUOTANG	CHAIRPERSON	HSU HSIN-YING
ISPAT HIGH SCHOOL	CHAIRPERSON	ADMINISTRATION OF THE STEEL AUTHORITY OF INDIA LIMITED
ISPAT HIGH SCHOOL, ROURKELA	CHAIRPERSON	ADMINISTRATION OF THE STEEL AUTHORITY OF INDIA LIMITED
OFORI PANIN SENIOR HIGH SCHOOL	CHAIRPERSON	PRINCE KOFI AMOABENG, CHAIRPERSON OF BOARD OF GOVERNORS
BAKHRABAD GAS ADARSHA BIDHALAYA	CHAIRPERSON	BAKHRABAD
SCOTTISH SOCIALIST PARTY	CHAIRPERSON	PATRICK DOLLAN
MUSSOORIE INTERNATIONAL SCHOOL	CHAIRPERSON	DR. SHAYAMA CHONA
DALJIR PARTY	CHAIRPERSON	HASSAN MOALIM
THE MOTORISTS' PARTY OF ROC	CHAIRPERSON	BRYAN DONG
JOINT OPPOSITION	CHAIRPERSON	DINESH GUNAWARDENA
CARPATHIAN GERMAN PARTY	CHAIRPERSON	ROLAND STEINACKER
CARPATHIAN GERMAN PARTY	CHAIRPERSON	DESIDER ALEXY
CARPATHIAN GERMAN PARTY	CHAIRPERSON	FRANZ KARMASIN
NAYA SHAKTI	CHAIRPERSON	BABURAM BHATTARAI
PROGRESSIVE DEMOCRATIC FRONT	CHAIRPERSON	MANTRI PRASAD NAITHANI
KAMNOETVIDYA SCIENCE ACADEMY	CHAIRPERSON	DR. PAILIN CHUCHOTTAWORN
