BARB WIRE	CHARACTERNAME	BARB WIRE
PROFESSOR X	CHARACTERNAME	PROFESSOR X
GALACTUS	CHARACTERNAME	GALACTUS
ICEMAN	CHARACTERNAME	ICEMAN
JUDGE DREDD	CHARACTERNAME	JUDGE DREDD
JEAN GREY	CHARACTERNAME	JEAN GREY
SHANG-CHI	CHARACTERNAME	SHANG-CHI: MASTER OF KUNG FU
OBELIX	CHARACTERNAME	OBELIX
RACHEL SUMMERS	CHARACTERNAME	RACHEL SUMMERS
SAM & MAX	CHARACTERNAME	SAM & MAX, FREELANCE POLICE
SPAWN	CHARACTERNAME	SPAWN
THE YELLOW KID	CHARACTERNAME	THE YELLOW KID
BEYONDER	CHARACTERNAME	THE BEYONDER
CHAMPION OF THE UNIVERSE	CHARACTERNAME	CHAMPION OF THE UNIVERSE
HULK	CHARACTERNAME	HULK
ZIPPY THE PINHEAD	CHARACTERNAME	ZIPPY THE PINHEAD
FLASH GORDON	CHARACTERNAME	FLASH GORDON
DOCTOR DOOM	CHARACTERNAME	DOCTOR DOOM
PHOENIX FORCE	CHARACTERNAME	PHOENIX FORCE
GOOFY	CHARACTERNAME	SUPER GOOF
POISON IVY	CHARACTERNAME	POISON IVY
THING	CHARACTERNAME	THE THING
CYCLOPS	CHARACTERNAME	CYCLOPS
DESTINY	CHARACTERNAME	DESTINY
DESTRUCTION	CHARACTERNAME	DESTRUCTION
DEATH	CHARACTERNAME	DEATH
DREAM	CHARACTERNAME	DREAM
DESIRE	CHARACTERNAME	DESIRE
DESPAIR	CHARACTERNAME	DESPAIR
DELIRIUM	CHARACTERNAME	DELIRIUM
CORINTHIAN	CHARACTERNAME	THE CORINTHIAN
LUCIFER	CHARACTERNAME	LUCIFER
MARVELMAN	CHARACTERNAME	MIRACLEMAN
JOKER	CHARACTERNAME	THE JOKER
RED SKULL	CHARACTERNAME	RED SKULL
SHAZAM	CHARACTERNAME	SHAZAM
STREAKY THE SUPERCAT	CHARACTERNAME	STREAKY THE SUPERCAT
WONDER WOMAN	CHARACTERNAME	WONDER WOMAN
LONE RANGER	CHARACTERNAME	LONE RANGER
THE SHADOW	CHARACTERNAME	THE SHADOW
J. JONAH JAMESON	CHARACTERNAME	J. JONAH JAMESON
AUNT MAY	CHARACTERNAME	AUNT MAY
GWEN STACY	CHARACTERNAME	GWEN STACY
UNCLE BEN	CHARACTERNAME	UNCLE BEN
MISTER FANTASTIC	CHARACTERNAME	MISTER FANTASTIC
ROGER MELLIE	CHARACTERNAME	ROGER MELLIE
FOXGLOVE	CHARACTERNAME	FOXGLOVE
DAN DARE	CHARACTERNAME	DAN DARE
HOBGOBLIN	CHARACTERNAME	HOBGOBLIN 2211
JOHN CONSTANTINE	CHARACTERNAME	JOHN CONSTANTINE
LANA LANG	CHARACTERNAME	LANA LANG
TICK	CHARACTERNAME	THE .!.
JUDGE ANDERSON	CHARACTERNAME	JUDGE ANDERSON
SID THE SEXIST	CHARACTERNAME	SID THE SEXIST
LUCIFER	CHARACTERNAME	LUCIFER
COLOSSUS	CHARACTERNAME	COLOSSUS
STORM	CHARACTERNAME	STORM
SAGE	CHARACTERNAME	SAGE
BISHOP	CHARACTERNAME	LUCAS BISHOP
GAMBIT	CHARACTERNAME	GAMBIT
HUMAN TORCH	CHARACTERNAME	HUMAN TORCH
INVISIBLE WOMAN	CHARACTERNAME	INVISIBLE WOMAN
LIFEGUARD	CHARACTERNAME	LIFEGUARD
MYSTIQUE	CHARACTERNAME	MYSTIQUE
GREYSHIRT	CHARACTERNAME	GREYSHIRT
TOM STRONG	CHARACTERNAME	TOM STRONG
LAR GAND	CHARACTERNAME	LAR GAND
KING SNAKE	CHARACTERNAME	KING SNAKE
BIZARRO	CHARACTERNAME	BIZARRO
ELECTRO	CHARACTERNAME	ELECTRO
BLACK ORCHID	CHARACTERNAME	BLACK ORCHID
WHIZZER	CHARACTERNAME	WHIZZER
NAMOR	CHARACTERNAME	NAMOR THE SUB-MARINER
HUMAN TORCH	CHARACTERNAME	HUMAN TORCH
IZNOGOUD	CHARACTERNAME	IZNOGOUD
PLASTIC MAN	CHARACTERNAME	PLASTIC MAN
MARY JANE WATSON	CHARACTERNAME	MARY JANE WATSON
CHANG CHONG-CHEN	CHARACTERNAME	CHANG CHONG-CHEN
LONGSHOT	CHARACTERNAME	LONGSHOT
PROFESSOR POTTER	CHARACTERNAME	PROFESSOR POTTER
SOLAR	CHARACTERNAME	SOLAR
RICHIE RICH	CHARACTERNAME	RICHIE RICH
WOLVERINE	CHARACTERNAME	WOLVERINE
JAMIE MADROX	CHARACTERNAME	JAMIE MADROX
STRONG GUY	CHARACTERNAME	STRONG GUY
PYRO	CHARACTERNAME	PYRO
WARREN WORTHINGTON III	CHARACTERNAME	WARREN WORTHINGTON III
MOIRA MACTAGGERT	CHARACTERNAME	MOIRA MACTAGGERT
BANSHEE	CHARACTERNAME	BANSHEE
RICO DREDD	CHARACTERNAME	RICO DREDD
SLáINE	CHARACTERNAME	SLáINE MACROTH
SABRETOOTH	CHARACTERNAME	SABRETOOTH
PUNISHER	CHARACTERNAME	PUNISHER
PENGUIN	CHARACTERNAME	THE PENGUIN
HARLEY QUINN	CHARACTERNAME	HARLEY QUINN
SCARECROW	CHARACTERNAME	THE SCARECROW
RIDDLER	CHARACTERNAME	THE RIDDLER
SILVER FOX	CHARACTERNAME	SILVER FOX
CHAMELEON	CHARACTERNAME	CHAMELEON
VULTURE	CHARACTERNAME	VULTURE
KRAVEN THE HUNTER	CHARACTERNAME	KRAVEN THE HUNTER
CARNAGE	CHARACTERNAME	CARNAGE
RHINO	CHARACTERNAME	RHINO
DOCTOR OCTOPUS	CHARACTERNAME	DOCTOR OCTOPUS
MYSTERIO	CHARACTERNAME	MYSTERIO
MYSTERIO	CHARACTERNAME	DANIEL BERKHART
MYSTERIO	CHARACTERNAME	FRANCIS KLUM
BIANCA CASTAFIORE	CHARACTERNAME	BIANCA CASTAFIORE
XORN	CHARACTERNAME	XORN
THE BALLAD OF HALO JONES	CHARACTERNAME	HALO JONES
NIGHTCRAWLER	CHARACTERNAME	NIGHTCRAWLER
GARGANTA	CHARACTERNAME	GARGANTA
LIZARD	CHARACTERNAME	THE LIZARD
HYDRO-MAN	CHARACTERNAME	HYDRO-MAN
JUDGE DEATH	CHARACTERNAME	JUDGE DEATH
SHOCKER	CHARACTERNAME	SHOCKER
JAGUAR	CHARACTERNAME	THE JAGUAR
GROO THE WANDERER	CHARACTERNAME	GROO THE WANDERER
JUDGE KRAKEN	CHARACTERNAME	JUDGE KRAKEN
ERNIE PIKE	CHARACTERNAME	ERNIE PIKE
MERV PUMPKINHEAD	CHARACTERNAME	MERV PUMPKINHEAD
MARSUPILAMI	CHARACTERNAME	MARSUPILAMI
EDDIE BROCK	CHARACTERNAME	EDDIE BROCK
QUICKSILVER	CHARACTERNAME	QUICKSILVER
MAGNETO	CHARACTERNAME	MAGNETO
APOCALYPSE	CHARACTERNAME	APOCALYPSE
ELEKTRA	CHARACTERNAME	ELEKTRA
MADELYNE PRYOR	CHARACTERNAME	MADELYNE PRYOR
QUESTION	CHARACTERNAME	THE QUESTION
RORSCHACH	CHARACTERNAME	RORSCHACH
CRYSTAL	CHARACTERNAME	CRYSTAL
KINGPIN	CHARACTERNAME	THE KINGPIN
SPYKE	CHARACTERNAME	SPYKE
AVALANCHE	CHARACTERNAME	AVALANCHE
MEDUSA	CHARACTERNAME	MEDUSA
BEAST	CHARACTERNAME	BEAST
KANG THE CONQUEROR	CHARACTERNAME	KANG THE CONQUEROR
THUNDERBIRD	CHARACTERNAME	THUNDERBIRD
HAVOK	CHARACTERNAME	HAVOK
POLARIS	CHARACTERNAME	POLARIS
MIMIC	CHARACTERNAME	MIMIC
KEVIN SYDNEY	CHARACTERNAME	MORPH
KEVIN SYDNEY	CHARACTERNAME	CHANGELING
KITTY PRYDE	CHARACTERNAME	KITTY PRYDE
INSPECTOR SHIMURA	CHARACTERNAME	INSPECTOR SHIMURA
LADY DEATHSTRIKE	CHARACTERNAME	LADY DEATHSTRIKE
OMEGA RED	CHARACTERNAME	OMEGA RED
SHINOBI SHAW	CHARACTERNAME	SHINOBI SHAW
BLOODSCREAM	CHARACTERNAME	BLOODSCREAM
ROUGHOUSE	CHARACTERNAME	ROUGHOUSE
SILVER SAMURAI	CHARACTERNAME	SILVER SAMURAI
SHINGEN YASHIDA	CHARACTERNAME	LORD SHINGEN YASHIDA
SHINGEN YASHIDA	CHARACTERNAME	矢志田信玄
SEBASTIAN SHAW	CHARACTERNAME	SEBASTIAN SHAW
GENESIS	CHARACTERNAME	GENESIS
HYPERION	CHARACTERNAME	HYPERION
AGENT X	CHARACTERNAME	AGENT X
OBERON	CHARACTERNAME	OBERON
TITANIA	CHARACTERNAME	TITANIA
SANDMAN	CHARACTERNAME	SANDMAN
SANDMAN	CHARACTERNAME	SANDMAN
SANDMAN	CHARACTERNAME	SANDMAN
PETE WISDOM	CHARACTERNAME	PETE WISDOM
DOCTOR FATE	CHARACTERNAME	DOCTOR FATE
CAPTAIN BRITAIN	CHARACTERNAME	CAPTAIN BRITAIN
STARMAN	CHARACTERNAME	STARMAN
STARMAN	CHARACTERNAME	STARMAN
MEGGAN	CHARACTERNAME	MEGGAN
MARTIAN MANHUNTER	CHARACTERNAME	MARTIAN MANHUNTER
KAREN PAGE	CHARACTERNAME	KAREN PAGE
HARRY OSBORN	CHARACTERNAME	HARRY OSBORN
DAZZLER	CHARACTERNAME	DAZZLER
KREON	CHARACTERNAME	KREON
HANK PYM	CHARACTERNAME	HANK PYM
CAIN AND ABEL	CHARACTERNAME	CAIN AND ABEL
KRYPTO	CHARACTERNAME	KRYPTO
BLOB	CHARACTERNAME	BLOB
TOAD	CHARACTERNAME	TOAD
ETERNITY	CHARACTERNAME	ETERNITY
FIRELORD	CHARACTERNAME	FIRELORD
TABITHA SMITH	CHARACTERNAME	TABITHA SMITH
WASP	CHARACTERNAME	THE WASP
BEN URICH	CHARACTERNAME	BEN URICH
LUKE CAGE	CHARACTERNAME	LUKE CAGE
IMMORTUS	CHARACTERNAME	IMMORTUS
HOWARD THE DUCK	CHARACTERNAME	HOWARD THE DUCK
ATOM	CHARACTERNAME	ATOM
GUY GARDNER	CHARACTERNAME	GUY GARDNER
IMPOSSIBLE MAN	CHARACTERNAME	IMPOSSIBLE MAN
BUCKY O'HARE	CHARACTERNAME	BUCKY O'HARE
RED TORNADO	CHARACTERNAME	RED TORNADO
TWO-FACE	CHARACTERNAME	TWO-FACE
MANDRAKE THE MAGICIAN	CHARACTERNAME	MANDRAKE THE MAGICIAN
PHANTAZIA	CHARACTERNAME	PHANTAZIA
THOM KALLOR	CHARACTERNAME	STARMAN
RA'S AL GHUL	CHARACTERNAME	RA'S AL GHUL
GLEEK	CHARACTERNAME	GLEEK
LORI LEMARIS	CHARACTERNAME	LORI LEMARIS
TARA FREMONT	CHARACTERNAME	TARA FREMONT
BLADE	CHARACTERNAME	BLADE
MISS VICTORY	CHARACTERNAME	MISS VICTORY
HELLBOY	CHARACTERNAME	HELLBOY
MISTER MXYZPTLK	CHARACTERNAME	MISTER MXYZPTLK
JOR-EL	CHARACTERNAME	JOR-EL
DEADMAN	CHARACTERNAME	DEADMAN
ETRIGAN THE DEMON	CHARACTERNAME	ETRIGAN
SMAX	CHARACTERNAME	SMAX
BRAINIAC	CHARACTERNAME	BRAINIAC
NICK FURY	CHARACTERNAME	NICK FURY
MISTER SINISTER	CHARACTERNAME	MISTER SINISTER
STRYFE	CHARACTERNAME	STRYFE
VANDAL SAVAGE	CHARACTERNAME	VANDAL SAVAGE
DEATHLOK	CHARACTERNAME	DEATHLOK
DOOMSDAY	CHARACTERNAME	DOOMSDAY
DONATELLO	CHARACTERNAME	DONATELLO
WONDER TWINS	CHARACTERNAME	WONDER TWINS
MICHELANGELO	CHARACTERNAME	MICHELANGELO
RAPHAEL	CHARACTERNAME	RAPHAEL
LEONARDO	CHARACTERNAME	LEONARDO
JOLYON WAGG	CHARACTERNAME	JOLYON WAGG
GRAYDON CREED	CHARACTERNAME	GRAYDON CREED
NIGHTVEIL	CHARACTERNAME	NIGHTVEIL
LEGION	CHARACTERNAME	LEGION
HUMAN TARGET	CHARACTERNAME	THE HUMAN TARGET
HOURMAN	CHARACTERNAME	HOURMAN
MADMAN	CHARACTERNAME	MADMAN
HANNIBAL KING	CHARACTERNAME	HANNIBAL KING
ZATANNA	CHARACTERNAME	ZATANNA
ARION	CHARACTERNAME	ARION
ABSORBING MAN	CHARACTERNAME	ABSORBING MAN
DOCTOR THIRTEEN	CHARACTERNAME	DOCTOR THIRTEEN
ELONGATED MAN	CHARACTERNAME	ELONGATED MAN
KATO	CHARACTERNAME	KATO
DALE ARDEN	CHARACTERNAME	DALE ARDEN
IRON FIST	CHARACTERNAME	IRON FIST
STARDUST	CHARACTERNAME	STARDUST
FRANKLIN RICHARDS	CHARACTERNAME	FRANKLIN RICHARDS
ONSLAUGHT	CHARACTERNAME	ONSLAUGHT
SHADOWMAN	CHARACTERNAME	SHADOWMAN
STRONTIUM DOG	CHARACTERNAME	JOHNNY ALPHA
SPIRIT	CHARACTERNAME	SPIRIT
CABLE	CHARACTERNAME	CABLE
NIGHTHAWK	CHARACTERNAME	NIGHTHAWK
SUNSPOT	CHARACTERNAME	SUNSPOT
CAPTAIN UNIVERSE	CHARACTERNAME	CAPTAIN UNIVERSE
MISTER X	CHARACTERNAME	MISTER X
LOBO	CHARACTERNAME	LOBO
JUDGE MCGRUDER	CHARACTERNAME	JUDGE MCGRUDER
JUDGE HERSHEY	CHARACTERNAME	JUDGE HERSHEY
MISTER MIRACLE	CHARACTERNAME	MISTER MIRACLE
ZATOICHI	CHARACTERNAME	ZATōICHI
PSYLOCKE	CHARACTERNAME	PSYLOCKE
SHREDDER	CHARACTERNAME	OROKU SAKI / THE SHREDDER
BETTY BRANT	CHARACTERNAME	BETTY BRANT
BLACK CAT	CHARACTERNAME	BLACK CAT
NED LEEDS	CHARACTERNAME	NED LEEDS
FLASH THOMPSON	CHARACTERNAME	FLASH THOMPSON
OWL	CHARACTERNAME	THE OWL
ROCKETEER	CHARACTERNAME	THE ROCKETEER
SHE CAT	CHARACTERNAME	SHE CAT
COUNT NEFARIA	CHARACTERNAME	COUNT NEFARIA
JAMES GORDON	CHARACTERNAME	COMMISSIONER JAMES GORDON
PETE ROSS	CHARACTERNAME	PETE ROSS
BANE	CHARACTERNAME	BANE
MONITOR	CHARACTERNAME	THE MONITOR
CYBORG	CHARACTERNAME	CYBORG
BLACK ADAM	CHARACTERNAME	BLACK ADAM
ERIK THE RED	CHARACTERNAME	ERIK THE RED
MARROW	CHARACTERNAME	MARROW
SLEEPWALKER	CHARACTERNAME	SLEEPWALKER
PEACEMAKER	CHARACTERNAME	PEACEMAKER
CORSAIR	CHARACTERNAME	CORSAIR
EMMA FROST	CHARACTERNAME	EMMA FROST
ZATARA	CHARACTERNAME	ZATARA
HITMAN	CHARACTERNAME	HITMAN
GHOST RIDER	CHARACTERNAME	GHOST RIDER
RAVEN	CHARACTERNAME	RAVEN
GAMORA	CHARACTERNAME	GAMORA
THANOS	CHARACTERNAME	THANOS
LIVING TRIBUNAL	CHARACTERNAME	LIVING TRIBUNAL
DRAX THE DESTROYER	CHARACTERNAME	DRAX THE DESTROYER
PIP THE TROLL	CHARACTERNAME	PIP THE TROLL
MOONDRAGON	CHARACTERNAME	MOONDRAGON
BUSTER BROWN	CHARACTERNAME	BUSTER BROWN
DEATH	CHARACTERNAME	DEATH
HIGH EVOLUTIONARY	CHARACTERNAME	HIGH EVOLUTIONARY
GRANDMASTER	CHARACTERNAME	GRANDMASTER
FURY	CHARACTERNAME	FURY
PETER CANNON, THUNDERBOLT	CHARACTERNAME	THUNDERBOLT
ABYSS	CHARACTERNAME	ABYSS
ATOMIC MOUSE	CHARACTERNAME	ATOMIC MOUSE
UATU	CHARACTERNAME	UATU
NIGHTSHADE	CHARACTERNAME	NIGHTSHADE
WOLFSBANE	CHARACTERNAME	WOLFSBANE
YELLOWJACKET	CHARACTERNAME	YELLOWJACKET
ULTRON	CHARACTERNAME	ULTRON
BLACK WIDOW	CHARACTERNAME	BLACK WIDOW
ROY HARPER	CHARACTERNAME	ROY HARPER
ROYAL ROY	CHARACTERNAME	ROYAL ROY
CANNONBALL	CHARACTERNAME	CANNONBALL
LIGHTNING LORD	CHARACTERNAME	LIGHTNING LORD
BRAINIAC 5	CHARACTERNAME	BRAINIAC 5
AYLA RANZZ	CHARACTERNAME	AYLA RANZZ
DORMAMMU	CHARACTERNAME	DORMAMMU
MARY MARVEL	CHARACTERNAME	MARY MARVEL
NEMESIS KID	CHARACTERNAME	NEMESIS KID
PRINCESS PROJECTRA	CHARACTERNAME	PRINCESS PROJECTRA
KARATE KID	CHARACTERNAME	KARATE KID
NIGHTHAWK	CHARACTERNAME	NIGHTHAWK
NEMESIS	CHARACTERNAME	NEMESIS
DOCTOR LIGHT	CHARACTERNAME	DOCTOR LIGHT
CLAYFACE	CHARACTERNAME	CLAYFACE
STARFIRE	CHARACTERNAME	STARFIRE
LILITH CLAY	CHARACTERNAME	LILITH CLAY
KATANA	CHARACTERNAME	KATANA
METAMORPHO	CHARACTERNAME	METAMORPHO
AQUALAD	CHARACTERNAME	AQUALAD
JADE	CHARACTERNAME	JADE
GRACE CHOI	CHARACTERNAME	GRACE CHOI
SEBASTIAN FAUST	CHARACTERNAME	SEBASTIAN FAUST
HALO	CHARACTERNAME	HALO
TERRA	CHARACTERNAME	TERRA
MEPHISTO	CHARACTERNAME	MEPHISTO
SUPER-SONS	CHARACTERNAME	SUPER SONS
DANIELLE MOONSTAR	CHARACTERNAME	DANIELLE MOONSTAR
KARMA	CHARACTERNAME	KARMA
MAGIK	CHARACTERNAME	MAGIK
NITE OWL	CHARACTERNAME	NITE OWL
OZYMANDIAS	CHARACTERNAME	OZYMANDIAS
ICON	CHARACTERNAME	ICON
BLACKHEART	CHARACTERNAME	BLACKHEART
BLACKHEART	CHARACTERNAME	KID BLACKHEART
MIRAGE	CHARACTERNAME	MIRAGE
MAGMA	CHARACTERNAME	MAGMA
CYPHER	CHARACTERNAME	CYPHER
STEVEN LANG	CHARACTERNAME	STEVEN LANG
AMANDA SEFTON	CHARACTERNAME	DAYTRIPPER
SUNFIRE	CHARACTERNAME	SUNFIRE
WARPATH	CHARACTERNAME	WARPATH
SHATTERSTAR	CHARACTERNAME	SHATTERSTAR
BLOODWYND	CHARACTERNAME	BLOODWYND
BLINK	CHARACTERNAME	BLINK
FIN FANG FOOM	CHARACTERNAME	FIN FANG FOOM
MAX MERCURY	CHARACTERNAME	MAX MERCURY
IN-BETWEENER	CHARACTERNAME	IN-BETWEENER
CERISE	CHARACTERNAME	CERISE
CAPTAIN ULTRA	CHARACTERNAME	CAPTAIN ULTRA
NATE GREY	CHARACTERNAME	NATE GREY
LOCKHEED	CHARACTERNAME	LOCKHEED
KILLRAVEN	CHARACTERNAME	KILLRAVEN
AURORA	CHARACTERNAME	AURORA
KA-ZAR	CHARACTERNAME	KA-ZAR
ZZZAX	CHARACTERNAME	ZZZAX
KLAW	CHARACTERNAME	KLAW
RUSTY COLLINS	CHARACTERNAME	RUSTY COLLINS
SKIDS	CHARACTERNAME	SKIDS
ROBBIE BALDWIN	CHARACTERNAME	ROBBIE BALDWIN
NIGHT THRASHER	CHARACTERNAME	NIGHT THRASHER
TIGRA	CHARACTERNAME	TIGRA
DAIMON HELLSTROM	CHARACTERNAME	DAIMON HELLSTROM
ARIEL	CHARACTERNAME	ARIEL
SUPERIA	CHARACTERNAME	SUPERIA
LUORNU DURGO	CHARACTERNAME	LUORNU DURGO
THUNDRA	CHARACTERNAME	THUNDRA
SHARON VENTURA	CHARACTERNAME	SHARON VENTURA
TUROK	CHARACTERNAME	TUROK
SENSOR	CHARACTERNAME	SENSOR
DIANA PRINCE	CHARACTERNAME	DIANA PRINCE
CHAMBER	CHARACTERNAME	CHAMBER
CHEETAH	CHARACTERNAME	CHEETAH
ABE SAPIEN	CHARACTERNAME	ABRAHAM \
BLACK VULCAN	CHARACTERNAME	BLACK VULCAN
SILVER SWAN	CHARACTERNAME	SILVER SWAN
JENNY SPARKS	CHARACTERNAME	JENNY SPARKS
PATSY WALKER	CHARACTERNAME	PATSY WALKER
HANS ZARKOV	CHARACTERNAME	HANS ZARKOV
MING THE MERCILESS	CHARACTERNAME	MING THE MERCILESS
HAMMERHEAD	CHARACTERNAME	HAMMERHEAD
SPIDER-SLAYER	CHARACTERNAME	SPIDER-SLAYER
WILDCAT	CHARACTERNAME	WILDCAT
FLYGIRL	CHARACTERNAME	FLYGIRL
FLY	CHARACTERNAME	THE FLY
DRAGONFLY	CHARACTERNAME	DRAGONFLY
MAN-KILLER	CHARACTERNAME	MAN-KILLER
RAD	CHARACTERNAME	RAD
JOHNNY QUICK	CHARACTERNAME	JOHNNY QUICK
RED GUARDIAN	CHARACTERNAME	RED GUARDIAN
PHANTOM RIDER	CHARACTERNAME	PHANTOM RIDER
GOLDIE	CHARACTERNAME	GOLDIE
HUSK	CHARACTERNAME	HUSK
MASTERMIND	CHARACTERNAME	MASTERMIND
FORGE	CHARACTERNAME	FORGE
BULLSEYE	CHARACTERNAME	BULLSEYE
MASTER MOLD	CHARACTERNAME	MASTER MOLD
GLENN TALBOT	CHARACTERNAME	GLENN TALBOT
WAR MACHINE	CHARACTERNAME	WAR MACHINE
SHADOW KING	CHARACTERNAME	SHADOW KING
TAKION	CHARACTERNAME	TAKION
DESAAD	CHARACTERNAME	DESAAD
ORION	CHARACTERNAME	ORION
KALIBAK	CHARACTERNAME	KALIBAK
GRANNY GOODNESS	CHARACTERNAME	GRANNY GOODNESS
MANGA KHAN	CHARACTERNAME	MANGA KHAN
L-RON	CHARACTERNAME	L-RON
CRIMSON AVENGER	CHARACTERNAME	CRIMSON AVENGER
MANTRA	CHARACTERNAME	MANTRA
MANTRA	CHARACTERNAME	MANTRA II
DOLL MAN	CHARACTERNAME	DOLL MAN
ZAURIEL	CHARACTERNAME	ZAURIEL
DEN	CHARACTERNAME	DEN
RED BEE	CHARACTERNAME	RED BEE
DOCTOR MID-NITE	CHARACTERNAME	DOCTOR MID-NITE
WING	CHARACTERNAME	WING
RICK JONES	CHARACTERNAME	RICK JONES
BLOODAXE	CHARACTERNAME	BLOODAXE
THE MEKON	CHARACTERNAME	THE MEKON
NIMROD	CHARACTERNAME	NIMROD
PAT DUGAN	CHARACTERNAME	S.T.R.I.P.E.
DEATH-STALKER	CHARACTERNAME	DEATH-STALKER
SANDY HAWKINS	CHARACTERNAME	SANDY HAWKINS
ABOMINATION	CHARACTERNAME	THE ABOMINATION
BALDER	CHARACTERNAME	BALDER THE BRAVE
ARCADE	CHARACTERNAME	ARCADE
AZTEK	CHARACTERNAME	AZTEK
RICHARD DRAGON	CHARACTERNAME	RICHARD DRAGON
THUNDER	CHARACTERNAME	THUNDER
BLACK LIGHTNING	CHARACTERNAME	BLACK LIGHTNING
BRAINIAC 8	CHARACTERNAME	BRAINIAC 8
SARGON THE SORCERER	CHARACTERNAME	SARGON THE SORCERER
COCKNEY WANKER	CHARACTERNAME	COCKNEY WANKER
ARKON	CHARACTERNAME	ARKON
CASSANDRA CAIN	CHARACTERNAME	CASSANDRA CAIN
PROFESSOR CALCULUS	CHARACTERNAME	PROFESSOR CALCULUS
SCOURGE OF THE UNDERWORLD	CHARACTERNAME	SCOURGE OF THE UNDERWORLD
LEECH	CHARACTERNAME	LEECH
DEADSHOT	CHARACTERNAME	DEADSHOT
CAPTAIN BOOMERANG	CHARACTERNAME	CAPTAIN BOOMERANG
GENERAL ZOD	CHARACTERNAME	GENERAL ZOD
HUGO STRANGE	CHARACTERNAME	HUGO STRANGE
MAD HATTER	CHARACTERNAME	MAD HATTER
MAGGOTT	CHARACTERNAME	MAGGOTT
BARON STRUCKER	CHARACTERNAME	BARON STRUCKER
KILLER CROC	CHARACTERNAME	KILLER CROC
BASILISK	CHARACTERNAME	BASILISK
DUMA	CHARACTERNAME	DUMA
DAGWOOD BUMSTEAD	CHARACTERNAME	DAGWOOD BUMSTEAD
BLACKOUT	CHARACTERNAME	BLACKOUT
DEATHBIRD	CHARACTERNAME	DEATHBIRD
TASKMASTER	CHARACTERNAME	TASKMASTER
GRIFTER	CHARACTERNAME	GRIFTER
SATURN GIRL	CHARACTERNAME	SATURN GIRL
SHEENA, QUEEN OF THE JUNGLE	CHARACTERNAME	SHEENA, QUEEN OF THE JUNGLE
NOVA	CHARACTERNAME	NOVA
FRANK DRAKE	CHARACTERNAME	FRANK DRAKE
STACY X	CHARACTERNAME	STACY X
BRONZE TIGER	CHARACTERNAME	BRONZE TIGER
SIRYN	CHARACTERNAME	SIRYN
JAKEEM THUNDER	CHARACTERNAME	JAKEEM THUNDER
JOHNNY THUNDER	CHARACTERNAME	JOHNNY THUNDER
GUARDIAN	CHARACTERNAME	GUARDIAN
MAN-THING	CHARACTERNAME	MAN-THING
IMPERIEX	CHARACTERNAME	IMPERIEX
BLACK RACER	CHARACTERNAME	BLACK\N RACER
KID ETERNITY	CHARACTERNAME	KID ETERNITY
CAT CLAW	CHARACTERNAME	CAT CLAW
TONTO	CHARACTERNAME	TONTO
CLUEMASTER	CHARACTERNAME	CLUEMASTER
WILDCAT	CHARACTERNAME	WILDCAT
SHE-HULK	CHARACTERNAME	SHE-HULK
SINESTRO	CHARACTERNAME	SINESTRO
MAJOR FORCE	CHARACTERNAME	MAJOR FORCE
MADMAN	CHARACTERNAME	MADMAN
KRONA	CHARACTERNAME	KRONA
PRUNEFACE	CHARACTERNAME	PRUNEFACE
TINTIN	CHARACTERNAME	TINTIN
LIZ SHERMAN	CHARACTERNAME	LIZ SHERMAN
KRANG	CHARACTERNAME	KRANG
MAGGIE SAWYER	CHARACTERNAME	MAGGIE SAWYER
ERADICATOR	CHARACTERNAME	THE ERADICATOR
ENEMY ACE	CHARACTERNAME	HANS VON HAMMER
DOMINO	CHARACTERNAME	DOMINO
ODIN	CHARACTERNAME	ODIN
ZEUS	CHARACTERNAME	ZEUS
THOMSON AND THOMPSON	CHARACTERNAME	THOMSON AND THOMPSON
MIKHAIL RASPUTIN	CHARACTERNAME	MIKHAIL RASPUTIN
PRINCE VULTAN	CHARACTERNAME	PRINCE VULTAN
MOON MAID	CHARACTERNAME	MOON MAID
SGT. ROCK	CHARACTERNAME	SGT. ROCK
X-23	CHARACTERNAME	X-23
SAURON	CHARACTERNAME	SAURON
HAL JORDAN	CHARACTERNAME	HAL JORDAN
JERICHO	CHARACTERNAME	JERICHO
BADGER	CHARACTERNAME	THE BADGER
DUST	CHARACTERNAME	DUST
CYBER	CHARACTERNAME	CYBER
GORILLA GRODD	CHARACTERNAME	GORILLA GRODD
STEVE TREVOR	CHARACTERNAME	STEVE TREVOR
UNKNOWN SOLDIER	CHARACTERNAME	UNKNOWN SOLDIER
QUASAR	CHARACTERNAME	QUASAR
SPIRAL	CHARACTERNAME	SPIRAL
ULTRA-HUMANITE	CHARACTERNAME	ULTRA-HUMANITE
SHUMA-GORATH	CHARACTERNAME	SHUMA-GORATH
VRIL DOX	CHARACTERNAME	VRIL DOX
ARMADILLO	CHARACTERNAME	ARMADILLO
SOLOMON GRUNDY	CHARACTERNAME	SOLOMON GRUNDY
DOCTOR SPECTRUM	CHARACTERNAME	DOCTOR SPECTRUM
TOMORROW WOMAN	CHARACTERNAME	TOMORROW WOMAN
MORGAINE LE FEY	CHARACTERNAME	MORGAINE LE FEY
SASQUATCH	CHARACTERNAME	SASQUATCH
PUCK	CHARACTERNAME	PUCK
BLACK PANTHER	CHARACTERNAME	BLACK PANTHER
BLAZE AND SATANUS	CHARACTERNAME	BLAZE AND SATANUS
DAN TURPIN	CHARACTERNAME	DAN TURPIN
MORGAN EDGE	CHARACTERNAME	MORGAN EDGE
LIZ ALLAN	CHARACTERNAME	LIZ ALLAN
FOGGY NELSON	CHARACTERNAME	FOGGY NELSON
FAITH	CHARACTERNAME	FAITH
MANCHESTER BLACK	CHARACTERNAME	MANCHESTER BLACK
WISKE	CHARACTERNAME	WISKE
SUSKE	CHARACTERNAME	SUSKE
THUNDERSTRIKE	CHARACTERNAME	THUNDERSTRIKE
STATIC	CHARACTERNAME	STATIC
ALICIA MASTERS	CHARACTERNAME	ALICIA MASTERS
M.A.C.H. 1	CHARACTERNAME	M.A.C.H.1
MILLIE TANT	CHARACTERNAME	MILLIE TANT
ANTI-MONITOR	CHARACTERNAME	ANTI-MONITOR
PARIAH	CHARACTERNAME	PARIAH
LADY QUARK	CHARACTERNAME	LADY QUARK
CREEPER	CHARACTERNAME	THE CREEPER
ARCLIGHT	CHARACTERNAME	ARCLIGHT
BETA RAY BILL	CHARACTERNAME	BETA RAY BILL
DARKHAWK	CHARACTERNAME	DARKHAWK
SHADE	CHARACTERNAME	SHADE
JACK OF HEARTS	CHARACTERNAME	JACK OF HEARTS
TALIA AL GHUL	CHARACTERNAME	TALIA AL GHUL
DELROY GARRETT	CHARACTERNAME	DELROY GARRETT
SILVERCLAW	CHARACTERNAME	SILVERCLAW
VANCE ASTROVIK	CHARACTERNAME	VANCE ASTROVIK
WARLOCK	CHARACTERNAME	WARLOCK
ANYA CORAZON	CHARACTERNAME	ANYA CORAZON
DONALD PIERCE	CHARACTERNAME	DONALD PIERCE
CEREBRA	CHARACTERNAME	CEREBRA
OBSIDIAN	CHARACTERNAME	OBSIDIAN
SHANNA THE SHE-DEVIL	CHARACTERNAME	SHANNA THE SHE-DEVIL
ULTRAMAN	CHARACTERNAME	ULTRAMAN
ZALADANE	CHARACTERNAME	ZALADANE
BLACK TOM CASSIDY	CHARACTERNAME	BLACK TOM CASSIDY
BOILERPLATE	CHARACTERNAME	BOILERPLATE
G'NORT	CHARACTERNAME	G'NORT
ELIXIR	CHARACTERNAME	ELIXIR
PROMETHEUS	CHARACTERNAME	PROMETHEUS
SUE DIBNY	CHARACTERNAME	SUE DIBNY
DOCTOR DRUID	CHARACTERNAME	DOCTOR DRUID
FIXER	CHARACTERNAME	FIXER
CRIMSON FOX	CHARACTERNAME	CRIMSON FOX
TITANIUM MAN	CHARACTERNAME	TITANIUM MAN
ANACONDA	CHARACTERNAME	ANACONDA
ADVERSARY	CHARACTERNAME	THE ADVERSARY
MARVEL BOY	CHARACTERNAME	MARVEL BOY
MS. TREE	CHARACTERNAME	MS. TREE
AMAZING-MAN	CHARACTERNAME	AMAZING-MAN
DEATH'S HEAD	CHARACTERNAME	DEATH'S HEAD
DOGMATIX	CHARACTERNAME	DOGMATIX
FREEDOM BEAST	CHARACTERNAME	FREEDOM BEAST
MASTER ORDER	CHARACTERNAME	MASTER ORDER
LORD CHAOS	CHARACTERNAME	LORD CHAOS
THE DARKNESS	CHARACTERNAME	THE DARKNESS
PERRY WHITE	CHARACTERNAME	PERRY WHITE
WALLFLOWER	CHARACTERNAME	WALLFLOWER
METALLO	CHARACTERNAME	METALLO
SURGE	CHARACTERNAME	SURGE
WIND DANCER	CHARACTERNAME	WIND DANCER
GHOST	CHARACTERNAME	GHOST
MONGUL	CHARACTERNAME	MONGUL
FLASH	CHARACTERNAME	THE FLASH
FLASH	CHARACTERNAME	FLASH
WALLY WEST	CHARACTERNAME	WALLY WEST
KYLE RAYNER	CHARACTERNAME	KYLE RAYNER
TIM DRAKE	CHARACTERNAME	TIM DRAKE
JASON TODD	CHARACTERNAME	JASON TODD
WILMA DEERING	CHARACTERNAME	WILMA DEERING
FABIAN CORTEZ	CHARACTERNAME	FABIAN CORTEZ
REFLECTO	CHARACTERNAME	REFLECTO
ROY RACE	CHARACTERNAME	ROY RACE
SUPERWOMAN	CHARACTERNAME	SUPERWOMAN
DEMOGOBLIN	CHARACTERNAME	DEMOGOBLIN
EZRA	CHARACTERNAME	EZRA
CAPTAIN CARROT	CHARACTERNAME	CAPTAIN CARROT
THRUD THE BARBARIAN	CHARACTERNAME	THRUD THE BARBARIAN
AZRAEL	CHARACTERNAME	AZRAEL
SARA PEZZINI	CHARACTERNAME	SARA PEZZINI
SHADOWHAWK	CHARACTERNAME	SHADOWHAWK
SHADOWHAWK	CHARACTERNAME	SILVER AGE SHADOWHAWK
PARASITE	CHARACTERNAME	THE PARASITE
POWER PRINCESS	CHARACTERNAME	POWER PRINCESS
INFERNO	CHARACTERNAME	INFERNO
JACKAL	CHARACTERNAME	JACKAL
GEORGE STACY	CHARACTERNAME	GEORGE STACY
TARANTULA	CHARACTERNAME	TARANTULA
OZYMANDIAS	CHARACTERNAME	OZYMANDIAS
VICKI VALE	CHARACTERNAME	VICKI VALE
COBWEB	CHARACTERNAME	COBWEB
BREACH	CHARACTERNAME	BREACH
MAGNUS, ROBOT FIGHTER	CHARACTERNAME	MAGNUS, ROBOT FIGHTER
SPIDER JERUSALEM	CHARACTERNAME	SPIDER JERUSALEM
MAJOR DISASTER	CHARACTERNAME	MAJOR DISASTER
AMPHIBIAN	CHARACTERNAME	AMPHIBIAN
EGGHEAD	CHARACTERNAME	EGGHEAD
BELLA DONNA	CHARACTERNAME	BELLADONNA
BELLA DONNA	CHARACTERNAME	BELLA DONNA
VOLCANA	CHARACTERNAME	VOLCANA
JOHNNY DC	CHARACTERNAME	JOHNNY DC
TEMPO	CHARACTERNAME	TEMPO
WENDY THE GOOD LITTLE WITCH	CHARACTERNAME	WENDY THE GOOD LITTLE WITCH
DAVID NORTH	CHARACTERNAME	DAVID NORTH
SNOWBIRD	CHARACTERNAME	SNOWBIRD
FURY	CHARACTERNAME	THE FURY
GEOMANCERS	CHARACTERNAME	GEOMANCER
VALERIE COOPER	CHARACTERNAME	VALERIE COOPER
COTTONMOUTH	CHARACTERNAME	COTTONMOUTH
ASP	CHARACTERNAME	ASP
BLACK MAMBA	CHARACTERNAME	BLACK MAMBA
SIDEWINDER	CHARACTERNAME	SIDEWINDER
CLOAK AND DAGGER	CHARACTERNAME	CLOAK AND DAGGER
DIAMONDBACK	CHARACTERNAME	DIAMONDBACK
COBRA	CHARACTERNAME	COBRA
RATTLER	CHARACTERNAME	RATTLER
MISS AMERICA	CHARACTERNAME	MISS AMERICA
MISS AMERICA	CHARACTERNAME	MISS AMERICA
ABNER JENKINS	CHARACTERNAME	ABNER JENKINS
SAVAGE DRAGON	CHARACTERNAME	SAVAGE DRAGON
KYLUN	CHARACTERNAME	KYLUN
DARK BEAST	CHARACTERNAME	DARK BEAST
SELENE	CHARACTERNAME	SELENE
FALCON	CHARACTERNAME	FALCON
HERBIE POPNECKER	CHARACTERNAME	HERBIE
SECRET	CHARACTERNAME	SECRET
ARROWETTE	CHARACTERNAME	ARROWETTE
EMPRESS	CHARACTERNAME	EMPRESS
MAD JIM JASPERS	CHARACTERNAME	MAD JIM JASPERS
RAT-MAN	CHARACTERNAME	RAT-MAN
BATMAN	CHARACTERNAME	TERRY MCGINNIS
CALLISTO	CHARACTERNAME	CALLISTO
BUSHMAN	CHARACTERNAME	BUSHMAN
PRESENCE	CHARACTERNAME	THE PRESENCE
LOBSTER RANDOM	CHARACTERNAME	LOBSTER RANDOM
SUPER-SKRULL	CHARACTERNAME	SUPER-SKRULL
OWLMAN	CHARACTERNAME	OWLMAN
SPLINTER	CHARACTERNAME	SPLINTER
JACK POINT	CHARACTERNAME	JUDGE POINT
VERTIGO	CHARACTERNAME	VERTIGO
SALU DIGBY	CHARACTERNAME	SHRINKING VIOLET
PHANTOM GIRL	CHARACTERNAME	PHANTOM GIRL
BOUNCING BOY	CHARACTERNAME	BOUNCING BOY
MATTER-EATER LAD	CHARACTERNAME	MATTER-EATER LAD
NIGHT GIRL	CHARACTERNAME	NIGHT GIRL
NURA NAL	CHARACTERNAME	NURA NAL
SHADOW LASS	CHARACTERNAME	SHADOW LASS
FERRO LAD	CHARACTERNAME	FERRO LAD
REEP DAGGLE	CHARACTERNAME	CHAMELEON BOY
WHITE WITCH	CHARACTERNAME	WHITE WITCH
ULTRA BOY	CHARACTERNAME	ULTRA BOY
ELEMENT LAD	CHARACTERNAME	ELEMENT LAD
CHEMICAL KING	CHARACTERNAME	CHEMICAL KING
DAWNSTAR	CHARACTERNAME	DAWNSTAR
TIMBER WOLF	CHARACTERNAME	TIMBER WOLF
INVINCIBLE	CHARACTERNAME	INVINCIBLE
KAINE PARKER	CHARACTERNAME	KAINE PARKER
VIXEN	CHARACTERNAME	VIXEN
CAPTAIN CANUCK	CHARACTERNAME	CAPTAIN CANUCK
ROCKET	CHARACTERNAME	ROCKET
KISMET	CHARACTERNAME	KISMET
HENRY PETER GYRICH	CHARACTERNAME	HENRY GYRICH
HAWKWOMAN	CHARACTERNAME	HAWKWOMAN
YUGA KHAN	CHARACTERNAME	YUGA KHAN
LIGHTRAY	CHARACTERNAME	LIGHTRAY
QUEEN BEE	CHARACTERNAME	QUEEN BEE
TRIUMPH	CHARACTERNAME	TRIUMPH
MAJOR VICTORY	CHARACTERNAME	MAJOR VICTORY
STRANGE VISITOR	CHARACTERNAME	STRANGE VISITOR
KINETIX	CHARACTERNAME	KINETIX
SUN BOY	CHARACTERNAME	SUN BOY
MAGNO	CHARACTERNAME	MAGNO
LAUREL GAND	CHARACTERNAME	LAUREL GAND
GRAVITON	CHARACTERNAME	GRAVITON
CHRONOS	CHARACTERNAME	CHRONOS
APRIL O'NEIL	CHARACTERNAME	APRIL O'NEIL
CRIMESMITH	CHARACTERNAME	THE CRIMESMITH I
CRIMESMITH	CHARACTERNAME	THE CRIMESMITH II
EGO THE LIVING PLANET	CHARACTERNAME	EGO THE LIVING PLANET
GATES	CHARACTERNAME	GATES
LIVING MONOLITH	CHARACTERNAME	THE LIVING MONOLITH
ECLIPSO	CHARACTERNAME	ECLIPSO
WAVERIDER	CHARACTERNAME	WAVERIDER
SUPERGIRL	CHARACTERNAME	MATRIX
JOHN JAMESON	CHARACTERNAME	JOHN JAMESON
XOMBI	CHARACTERNAME	XOMBI
COUNT VERTIGO	CHARACTERNAME	COUNT VERTIGO
KOLE	CHARACTERNAME	KOLE
TOP	CHARACTERNAME	TOP
BATROC THE LEAPER	CHARACTERNAME	BATROC THE LEAPER
GIGANTA	CHARACTERNAME	GIGANTA
CUBITUS	CHARACTERNAME	CUBITUS
MANO	CHARACTERNAME	MANO
BUCKY	CHARACTERNAME	BUCKY
CATSPAW	CHARACTERNAME	CATSPAW
DAMAGE	CHARACTERNAME	DAMAGE
SHIKARI	CHARACTERNAME	SHIKARI
MOLECULE MAN	CHARACTERNAME	MOLECULE MAN
TORO	CHARACTERNAME	TORO
MAELSTROM	CHARACTERNAME	MAELSTROM
MISTER HYDE	CHARACTERNAME	MISTER HYDE
BROTHER POWER THE GEEK	CHARACTERNAME	BROTHER POWER THE GEEK
PHANTOM LADY	CHARACTERNAME	PHANTOM LADY
PREZ	CHARACTERNAME	PREZ
CLEA	CHARACTERNAME	CLEA
PAPA SMURF	CHARACTERNAME	PAPA SMURF
WIDGET	CHARACTERNAME	WIDGET
KARNAK	CHARACTERNAME	KARNAK
DEVIL DINOSAUR	CHARACTERNAME	DEVIL DINOSAUR
KLARION THE WITCH BOY	CHARACTERNAME	KLARION THE WITCH-BOY
SHINING KNIGHT	CHARACTERNAME	SHINING KNIGHT
JUDOMASTER	CHARACTERNAME	JUDOMASTER
NORTHWIND	CHARACTERNAME	NORTHWIND
MAXWELL LORD	CHARACTERNAME	MAXWELL LORD
SMURFETTE	CHARACTERNAME	SMURFETTE
MANDARIN	CHARACTERNAME	MANDARIN
RICOCHET	CHARACTERNAME	RICOCHET
BULLETMAN AND BULLETGIRL	CHARACTERNAME	BULLETMAN AND BULLETGIRL
DOLPHIN	CHARACTERNAME	DOLPHIN
LIBERTY BELLE	CHARACTERNAME	LIBERTY BELLE
CAPTAIN COLD	CHARACTERNAME	CAPTAIN COLD
HARDWARE	CHARACTERNAME	HARDWARE
SERSI	CHARACTERNAME	SERSI
STEPHANIE BROWN	CHARACTERNAME	STEPHANIE BROWN
SCARLET SKIER	CHARACTERNAME	SCARLET SKIER
BIG SIR	CHARACTERNAME	BIG SIR
PLASMUS	CHARACTERNAME	PLASMUS
INQUE	CHARACTERNAME	INQUE
LEADER	CHARACTERNAME	THE LEADER
PLANTMAN	CHARACTERNAME	PLANTMAN
MOLE MAN	CHARACTERNAME	MOLE MAN
SUPER-ADAPTOID	CHARACTERNAME	SUPER-ADAPTOID
ROBO-HUNTER	CHARACTERNAME	ROBO-HUNTER
NUKLA	CHARACTERNAME	NUKLA
SON OF VULCAN	CHARACTERNAME	SON OF VULCAN
SUPREME	CHARACTERNAME	SUPREME
DOOMLORD	CHARACTERNAME	DOOMLORD
HOLDEN CARVER	CHARACTERNAME	HOLDEN CARVER
BROTHER BLOOD	CHARACTERNAME	BROTHER BLOOD
HOLOCAUST	CHARACTERNAME	HOLOCAUST
HUMAN BOMB	CHARACTERNAME	HUMAN BOMB
KOBALT	CHARACTERNAME	KOBALT
MAJOR MAPLELEAF	CHARACTERNAME	MAJOR MAPLELEAF
CINDERBLOCK	CHARACTERNAME	CINDERBLOCK
MORDRU	CHARACTERNAME	MORDRU
QUISLET	CHARACTERNAME	QUISLET
TYPHOID MARY	CHARACTERNAME	TYPHOID MARY
WIZARD	CHARACTERNAME	WIZARD
EXECUTIONER	CHARACTERNAME	THE EXECUTIONER
TATTERDEMALION	CHARACTERNAME	TATTERDEMALION
MR. FISH	CHARACTERNAME	MR. FISH
CHEMISTRO	CHARACTERNAME	CHEMISTRO
CHEMISTRO	CHARACTERNAME	CHEMISTRO II
CHEMISTRO	CHARACTERNAME	CHEMISTRO III
MADCAP	CHARACTERNAME	MADCAP
KARKAS	CHARACTERNAME	KARKAS
MARRINA SMALLWOOD	CHARACTERNAME	MARRINA SMALLWOOD
MISTER JIP	CHARACTERNAME	MISTER JIP
JINX	CHARACTERNAME	JINX
BUMBLEBEE	CHARACTERNAME	BUMBLEBEE
JONATHAN AND MARTHA KENT	CHARACTERNAME	JONATHAN AND MARTHA KENT
JOLT	CHARACTERNAME	JOLT
ICE	CHARACTERNAME	ICE
STARHAWK	CHARACTERNAME	STARHAWK
NOCTURNE	CHARACTERNAME	NOCTURNE
MAD MOD	CHARACTERNAME	MAD MOD
BLACK MANTA	CHARACTERNAME	BLACK MANTA
OMAC	CHARACTERNAME	OMAC
COURTNEY ROSS	CHARACTERNAME	COURTNEY ROSS
UNION JACK	CHARACTERNAME	UNION JACK
VIGILANTE	CHARACTERNAME	VIGILANTE
ISAIAH CROCKETT	CHARACTERNAME	ISAIAH CROCKETT
GIZMO	CHARACTERNAME	GIZMO
CHROMA	CHARACTERNAME	CHROMA
SPIDER	CHARACTERNAME	ALIAS THE SPIDER
BRAINIAC 4	CHARACTERNAME	BRAINIAC 4
GOG	CHARACTERNAME	GOG
GUARDIAN	CHARACTERNAME	GUARDIAN
LADY BLACKHAWK	CHARACTERNAME	LADY BLACKHAWK
LILA CHENEY	CHARACTERNAME	LILA CHENEY
KILOWOG	CHARACTERNAME	KILOWOG
SUPERGIRL	CHARACTERNAME	SUPERGIRL
MOJO	CHARACTERNAME	MOJO
SLAM BRADLEY	CHARACTERNAME	SLAM BRADLEY
NATURE BOY	CHARACTERNAME	NATURE BOY
MERCURY MAN	CHARACTERNAME	MERCURY MAN
WEREWOLF	CHARACTERNAME	WEREWOLF
CASSANDRA NOVA	CHARACTERNAME	CASSANDRA NOVA
HELLHOUND	CHARACTERNAME	HELLHOUND
STUFF THE CHINATOWN KID	CHARACTERNAME	STUFF
DOG LOGAN	CHARACTERNAME	DOG LOGAN
BILLY THE FISH	CHARACTERNAME	BILLY THE FISH
STUDENT GRANT	CHARACTERNAME	STUDENT GRANT
LEGION	CHARACTERNAME	LEGION
BARNELL BOHUSK	CHARACTERNAME	BARNELL BOHUSK
FANTOMEX	CHARACTERNAME	FANTOMEX
KALIMáN	CHARACTERNAME	KALIMAN, EL HOMBRE INCREíBLE.
INFINITY-MAN	CHARACTERNAME	INFINITY-MAN
NAMORA	CHARACTERNAME	NAMORA
LOKI	CHARACTERNAME	LOKI
FELIX FAUST	CHARACTERNAME	FELIX FAUST
WEREWOLF BY NIGHT	CHARACTERNAME	WEREWOLF BY NIGHT
THOMAS LOGAN	CHARACTERNAME	THOMAS LOGAN
HOT STUFF THE LITTLE DEVIL	CHARACTERNAME	HOT STUFF THE LITTLE DEVIL
SPOOKY THE TUFF LITTLE GHOST	CHARACTERNAME	SPOOKY THE TUFF LITTLE GHOST
ACE TRUCKING CO.	CHARACTERNAME	ACE GARP
TOXIN	CHARACTERNAME	TOXIN
JOSEPH	CHARACTERNAME	JOSEPH
SILVER SABLE	CHARACTERNAME	SILVER SABLE
VALERIA RICHARDS	CHARACTERNAME	VALERIA RICHARDS
SUPERGIRL	CHARACTERNAME	SUPERGIRL
WYATT WINGFOOT	CHARACTERNAME	WYATT WINGFOOT
INSPECTOR HENDERSON	CHARACTERNAME	INSPECTOR HENDERSON
VENTRILOQUIST	CHARACTERNAME	THE VENTRILOQUIST
PROTY	CHARACTERNAME	PROTY
EXODUS	CHARACTERNAME	EXODUS
TYROC	CHARACTERNAME	TYROC
SABRA	CHARACTERNAME	SABRA
ROBBIE ROBERTSON	CHARACTERNAME	JOSEPH \
GIDEON STARGRAVE	CHARACTERNAME	GIDEON STARGRAVE
TAG	CHARACTERNAME	TAG
ROCKSLIDE	CHARACTERNAME	ROCKSLIDE
WITHER	CHARACTERNAME	WITHER
CARMINE FALCONE	CHARACTERNAME	CARMINE FALCONE
LADY OCTOPUS	CHARACTERNAME	LADY OCTOPUS
ULTIMATE THOR	CHARACTERNAME	THOR
MERCURY	CHARACTERNAME	MERCURY
SPEED DEMON	CHARACTERNAME	SPEED DEMON
MISTER MIND AND THE MONSTER SOCIETY OF EVIL	CHARACTERNAME	MISTER MIND
MISTER MIND AND THE MONSTER SOCIETY OF EVIL	CHARACTERNAME	WICKED WORM
LUCY LANE	CHARACTERNAME	LUCY LANE
BIBBO BIBBOWSKI	CHARACTERNAME	BIBBO BIBBOWSKI
SAM AND TWITCH	CHARACTERNAME	SAM AND TWITCH
HELLION	CHARACTERNAME	HELLION
MORBIUS, THE LIVING VAMPIRE	CHARACTERNAME	MORBIUS THE LIVING VAMPIRE
DOPPELGANGER	CHARACTERNAME	DOPPELGANGER
SPORTSMASTER	CHARACTERNAME	SPORTSMASTER
HENRI DUCARD	CHARACTERNAME	HENRI DUCARD
DARNA	CHARACTERNAME	DARNA
JESSICA JONES	CHARACTERNAME	JESSICA JONES
KARIMA SHAPANDAR	CHARACTERNAME	KARIMA SHAPANDAR
DAVID CAIN	CHARACTERNAME	DAVID CAIN
BLACK MASK	CHARACTERNAME	BLACK MASK
ANGELA	CHARACTERNAME	ANGELA
KARMATRON	CHARACTERNAME	KARMATRóN
FIRE	CHARACTERNAME	FIRE
BERZERKER	CHARACTERNAME	BERZERKER
ROSE WILSON	CHARACTERNAME	ROSE WILSON
JEAN LORING	CHARACTERNAME	JEAN LORING
JOANNA CARGILL	CHARACTERNAME	JOANNA CARGILL
HANK HENSHAW	CHARACTERNAME	HANK HENSHAW
CH'P	CHARACTERNAME	CH'P
DONNA TROY	CHARACTERNAME	DONNA TROY
RAGMAN	CHARACTERNAME	RAGMAN
NYSSA RAATKO	CHARACTERNAME	NYSSA RAATKO
DUSK	CHARACTERNAME	DUSK
EZEKIEL	CHARACTERNAME	EZEKIEL
MANHUNTER	CHARACTERNAME	MANHUNTER
TRIGON	CHARACTERNAME	TRIGON
U.S. AGENT	CHARACTERNAME	U.S. AGENT
JUDGE GOODMAN	CHARACTERNAME	JUDGE GOODMAN
DARKDEVIL	CHARACTERNAME	DARKDEVIL
SHARD	CHARACTERNAME	SHARD BISHOP
KID FLASH	CHARACTERNAME	IRIS WEST
FREDERICK FOSWELL	CHARACTERNAME	FREDERICK FOSWELL
FRANKLIN STERN	CHARACTERNAME	FRANKLIN STERN
GORGON	CHARACTERNAME	GORGON
FORGOTTEN ONE	CHARACTERNAME	GILGAMESH
MISTER SENSITIVE	CHARACTERNAME	MISTER SENSITIVE
NTH MAN: THE ULTIMATE NINJA	CHARACTERNAME	ALFIE O'MEAGAN
BELASCO	CHARACTERNAME	BELASCO
GATEWAY	CHARACTERNAME	GATEWAY
ELECTRON	CHARACTERNAME	ELECTRON
ORACLE	CHARACTERNAME	ORACLE
MANTA	CHARACTERNAME	MANTA
WARSTAR	CHARACTERNAME	WARSTAR
FLASHFIRE	CHARACTERNAME	FLASHFIRE
GLADIATOR	CHARACTERNAME	GLADIATOR
NIGHTSIDE	CHARACTERNAME	NIGHTSIDE
HOBGOBLIN	CHARACTERNAME	HOBGOBLIN
MAGIQUE	CHARACTERNAME	MAGIQUE
HUSSAR	CHARACTERNAME	HUSSAR
PULSAR	CHARACTERNAME	PULSAR
SMASHER	CHARACTERNAME	SMASHER
CASSANDRA LANG	CHARACTERNAME	CASSANDRA LANG
ASTRA	CHARACTERNAME	ASTRA
MENTOR	CHARACTERNAME	MENTOR
SHOLA INKOSI	CHARACTERNAME	SHOLA INKOSI
COMMANDER STEEL	CHARACTERNAME	COMMANDER STEEL
COMMANDER STEEL	CHARACTERNAME	STEEL
COMMANDER STEEL	CHARACTERNAME	CITIZEN STEEL
HAMMERSTEIN	CHARACTERNAME	HAMMERSTEIN
BLACK WIDOW	CHARACTERNAME	BLACK WIDOW
SLIPSTREAM	CHARACTERNAME	SLIPSTREAM
SHADE, THE CHANGING MAN	CHARACTERNAME	SHADE, THE CHANGING MAN
BLUE EAGLE	CHARACTERNAME	BLUE EAGLE
IRON LAD	CHARACTERNAME	IRON LAD
DOCTOR LIGHT	CHARACTERNAME	DOCTOR LIGHT
RICK FLAG	CHARACTERNAME	RICK FLAG
DOCTOR DESTINY	CHARACTERNAME	DOCTOR DESTINY
PATRIOT	CHARACTERNAME	PATRIOT
DOC STRANGE	CHARACTERNAME	DOC STRANGE
TIMEBROKER	CHARACTERNAME	THE TIMEBROKER
STEPFORD CUCKOOS	CHARACTERNAME	THE THREE-IN-ONE
PARALLAX	CHARACTERNAME	PARALLAX
GRIM REAPER	CHARACTERNAME	GRIM REAPER
COMPOSITE SUPERMAN	CHARACTERNAME	COMPOSITE SUPERMAN
TENTH MUSE	CHARACTERNAME	10
GRIMJACK	CHARACTERNAME	GRIMJACK
PRESIDENT ROBERT L. BOOTH	CHARACTERNAME	PRESIDENT BOOTH
COMPUTER WARRIOR	CHARACTERNAME	COMPUTER WARRIOR
MACHINE TEEN	CHARACTERNAME	MACHINE TEEN
PENANCE	CHARACTERNAME	HOLLOW
SALAAK	CHARACTERNAME	SALAAK
ROBERT KELLY	CHARACTERNAME	ROBERT KELLY
JOE CHILL	CHARACTERNAME	JOE CHILL
SUNPYRE	CHARACTERNAME	SUNPYRE
MARIKO YASHIDA	CHARACTERNAME	MARIKO YASHIDA
MALICE	CHARACTERNAME	MALICE
RENEE MONTOYA	CHARACTERNAME	RENEE MONTOYA
APOLLO	CHARACTERNAME	APOLLO
JOHN STEWART	CHARACTERNAME	JOHN STEWART
COPPERHEAD	CHARACTERNAME	COPPERHEAD
RAKER QARRIGAT	CHARACTERNAME	RAKER QARRIGAT
HARVEY BULLOCK	CHARACTERNAME	HARVEY BULLOCK
SHRIEK	CHARACTERNAME	SHRIEK
VALENTINA	CHARACTERNAME	VALENTINA
DOOP	CHARACTERNAME	DOOP
EL GUAPO	CHARACTERNAME	EL GUAPO
MAXIMA	CHARACTERNAME	MAXIMA
GLORY	CHARACTERNAME	GLORY
URSA MAJOR	CHARACTERNAME	URSA MAJOR
SLAPSTICK	CHARACTERNAME	SLAPSTICK
THUNDERER	CHARACTERNAME	THUNDERER
NIGHT MAN	CHARACTERNAME	NIGHT MAN
VINDICATOR	CHARACTERNAME	VINDICATOR
NEMESIS	CHARACTERNAME	NEMESIS
GREEN ARROW	CHARACTERNAME	GREEN ARROW
GEAR	CHARACTERNAME	GEAR
METRON	CHARACTERNAME	METRON
ANNIHILUS	CHARACTERNAME	ANNIHILUS
BLASTAAR	CHARACTERNAME	BLASTAAR
BLOK	CHARACTERNAME	BLOK
EDWIN JARVIS	CHARACTERNAME	EDWIN JARVIS
MADAME XANADU	CHARACTERNAME	MADAME XANADU
SPY SMASHER	CHARACTERNAME	SPY SMASHER
KILLER MOTH	CHARACTERNAME	KILLER MOTH
ENCHANTRESS	CHARACTERNAME	ENCHANTRESS
FLORONIC MAN	CHARACTERNAME	FLORONIC MAN
CRAZY QUILT	CHARACTERNAME	CRAZY QUILT
STEPPENWOLF	CHARACTERNAME	STEPPENWOLF
PSYCHO-PIRATE	CHARACTERNAME	PSYCHO-PIRATE
JAGUAR	CHARACTERNAME	THE JAGUAR
CHTHON	CHARACTERNAME	CHTHON
VIOLATOR	CHARACTERNAME	VIOLATOR
MARTINEX	CHARACTERNAME	MARTINEX
COPPERHEAD	CHARACTERNAME	COPPERHEAD
MIDNIGHTER	CHARACTERNAME	MIDNIGHTER
JONNI FUTURE	CHARACTERNAME	JONNI FUTURE
SPELLBINDER	CHARACTERNAME	SPELLBINDER
COGLIOSTRO	CHARACTERNAME	COGLIOSTRO
RAZOR FIST	CHARACTERNAME	RAZOR FIST
MAD THINKER	CHARACTERNAME	MAD THINKER
MONICA RAMBEAU	CHARACTERNAME	MONICA RAMBEAU
DOCTOR SIVANA	CHARACTERNAME	DOCTOR SIVANA
GRAVITY	CHARACTERNAME	GRAVITY
GILLIAN B. LOEB	CHARACTERNAME	COMMISSIONER GILLIAN B. LOEB
TOMBSTONE	CHARACTERNAME	TOMBSTONE
TOYMAN	CHARACTERNAME	TOYMAN
NIGHTSTAR	CHARACTERNAME	NIGHTSTAR
SPITFIRE	CHARACTERNAME	SPITFIRE
CAPTAIN NAZI	CHARACTERNAME	CAPTAIN NAZI
UNCLE MARVEL	CHARACTERNAME	UNCLE MARVEL
PINKY THE WHIZ KID	CHARACTERNAME	PINKY
IBIS THE INVINCIBLE	CHARACTERNAME	IBIS THE INVINCIBLE
MINUTE-MAN	CHARACTERNAME	MINUTE-MAN
IBAC	CHARACTERNAME	IBAC
PRIME	CHARACTERNAME	PRIME
SNAPPER CARR	CHARACTERNAME	SNAPPER CARR
RAG DOLL	CHARACTERNAME	RAG DOLL
FLEUR-DE-LIS	CHARACTERNAME	FLEUR-DE-LIS
SPIDER WIDOW	CHARACTERNAME	SPIDER WIDOW
MOLLY HAYES	CHARACTERNAME	MOLLY HAYES
NICO MINORU	CHARACTERNAME	NICO MINORU
TIME TRAPPER	CHARACTERNAME	TIME TRAPPER
WICCAN	CHARACTERNAME	WICCAN
FIREFLY	CHARACTERNAME	FIREFLY
VIPER	CHARACTERNAME	VIPER
WENDIGO	CHARACTERNAME	WENDIGO
HENRY BENDIX	CHARACTERNAME	HENRY BENDIX
LAZARUS CHURCHYARD	CHARACTERNAME	LAZARUS CHURCHYARD
TIGRA	CHARACTERNAME	TIGRA
M	CHARACTERNAME	M
THE CLOCK	CHARACTERNAME	THE CLOCK
RICHARD FISK	CHARACTERNAME	RICHARD FISK
HUGO DANNER	CHARACTERNAME	HUGO DANNER
RIMA	CHARACTERNAME	RIMA
GERTRUDE YORKES	CHARACTERNAME	GERTRUDE YORKES
KAROLINA DEAN	CHARACTERNAME	KAROLINA DEAN
LANCE O'CASEY	CHARACTERNAME	LANCE O'CASEY
SCOOP SMITH	CHARACTERNAME	SCOOP SMITH
GOLDEN ARROW	CHARACTERNAME	GOLDEN ARROW
RANTANPLAN	CHARACTERNAME	RANTANPLAN
EBONY WHITE	CHARACTERNAME	EBONY WHITE
JOYSTICK	CHARACTERNAME	JOYSTICK
SONGBIRD	CHARACTERNAME	SONGBIRD
BLIZZARD	CHARACTERNAME	BLIZZARD
HARLEQUIN	CHARACTERNAME	HARLEQUIN
ROLAND DAGGETT	CHARACTERNAME	ROLAND DAGGETT
MAXIE ZEUS	CHARACTERNAME	MAXIE ZEUS
GARDENER	CHARACTERNAME	GARDENER
ARELLA	CHARACTERNAME	ARELLA
AZAZEL	CHARACTERNAME	AZAZEL
GOLDFACE	CHARACTERNAME	GOLDFACE
RAY	CHARACTERNAME	THE RAY
TORGO	CHARACTERNAME	TORGO
VICTOR MANCHA	CHARACTERNAME	VICTOR MANCHA
MR. A	CHARACTERNAME	MR. A
OGDRU JAHAD	CHARACTERNAME	THE OGDRU JAHAD
MACHINE MAN	CHARACTERNAME	MACHINE MAN
MICHAEL AKINS	CHARACTERNAME	COMMISSIONER AKINS
DEACON FROST	CHARACTERNAME	DEACON FROST
HUSH	CHARACTERNAME	HUSH
TERRAX	CHARACTERNAME	TERRAX
GENERAL GLORY	CHARACTERNAME	GENERAL GLORY
QUENTIN QUIRE	CHARACTERNAME	KID OMEGA
TRAPSTER	CHARACTERNAME	TRAPSTER
ENGINEER	CHARACTERNAME	ENGINEER
GLORIOUS GODFREY	CHARACTERNAME	GLORIOUS GODFREY
FOOLKILLER	CHARACTERNAME	FOOLKILLER
LIVEWIRE	CHARACTERNAME	LIVEWIRE
GRAYVEN	CHARACTERNAME	GRAYVEN
ALBERT	CHARACTERNAME	ALBERT
ELSIE-DEE	CHARACTERNAME	ELSIE-DEE
GENERAL	CHARACTERNAME	THE GENERAL
HANK HALL	CHARACTERNAME	HANK HALL
ISIS	CHARACTERNAME	ISIS
ANCIENT ONE	CHARACTERNAME	ANCIENT ONE
SILVERMANE	CHARACTERNAME	SILVERMANE
PUPPET MASTER	CHARACTERNAME	PUPPET MASTER
DRAGON MAN	CHARACTERNAME	DRAGON MAN
DIABLO	CHARACTERNAME	DIABLO
DARKSTAR	CHARACTERNAME	DARKSTAR
GYPSY	CHARACTERNAME	GYPSY
EL DIABLO	CHARACTERNAME	EL DIABLO
STARRO	CHARACTERNAME	STARRO
RUPERT THORNE	CHARACTERNAME	RUPERT THORNE
SWORDSMAN	CHARACTERNAME	SWORDSMAN
KID COLT	CHARACTERNAME	KID COLT
CARRIE KELLEY	CHARACTERNAME	CARRIE KELLEY
ULTIMATE NICK FURY	CHARACTERNAME	NICK FURY
TECH JACKET	CHARACTERNAME	TECH JACKET
WILLIE LUMPKIN	CHARACTERNAME	WILLIE LUMPKIN
WILD CHILD	CHARACTERNAME	WILD CHILD
KOBRA	CHARACTERNAME	KOBRA
KENNY MCFARLANE	CHARACTERNAME	KENNY MCFARLANE
SPHINX	CHARACTERNAME	SPHINX
TASMANIAN DEVIL	CHARACTERNAME	TASMANIAN DEVIL
NUALA	CHARACTERNAME	NUALA
ESCAPIST	CHARACTERNAME	THE ESCAPIST
LORD DARK WIND	CHARACTERNAME	LORD DARK WIND
CYCLONE	CHARACTERNAME	CYCLONE
VALIDUS	CHARACTERNAME	VALIDUS
JACK O'LANTERN	CHARACTERNAME	JACK O'LANTERN
CATMAN	CHARACTERNAME	CATMAN
BLOODSHOT	CHARACTERNAME	BLOODSHOT
WOOZY WINKS	CHARACTERNAME	WOOZY WINKS
DOIBY DICKLES	CHARACTERNAME	DOIBY DICKLES
SPOT	CHARACTERNAME	THE SPOT
THE SECOND LIFE OF DR. MIRAGE	CHARACTERNAME	DOCTOR MIRAGE
DEATHURGE	CHARACTERNAME	DEATHURGE
MADAME FATAL	CHARACTERNAME	MADAME FATAL
KADE	CHARACTERNAME	KADE
ETERNAL WARRIOR	CHARACTERNAME	ETERNAL WARRIOR
DETECTIVE CHIMP	CHARACTERNAME	DETECTIVE CHIMP
BLACK ALICE	CHARACTERNAME	BLACK ALICE
ICEMAIDEN	CHARACTERNAME	ICEMAIDEN
FIRE LAD	CHARACTERNAME	FIRE LAD
JACK HAWKSMOOR	CHARACTERNAME	JACK HAWKSMOOR
LARA	CHARACTERNAME	LARA
TOKKA AND RAHZAR	CHARACTERNAME	TOKKA AND RAHZAR
LYJA	CHARACTERNAME	LYJA
CAVEWOMAN	CHARACTERNAME	CAVEWOMAN
PROTEUS	CHARACTERNAME	PROTEUS
ANGAR THE SCREAMER	CHARACTERNAME	ANGAR THE SCREAMER
ANTON ARCANE	CHARACTERNAME	ANTON ARCANE
ORPHEUS	CHARACTERNAME	ORPHEUS
ZAGOR	CHARACTERNAME	ZAGOR
ROCKET RACER	CHARACTERNAME	ROCKET RACER
CALENDAR MAN	CHARACTERNAME	CALENDAR MAN
SPIDER-HAM	CHARACTERNAME	SPIDER-HAM
VANCE ASTRO	CHARACTERNAME	VANCE ASTRO
MOCKINGBIRD	CHARACTERNAME	MOCKINGBIRD
HATE-MONGER	CHARACTERNAME	HATE-MONGER
NAMORITA	CHARACTERNAME	NAMORITA PRENTISS
TURBO	CHARACTERNAME	TURBO
HECKLER	CHARACTERNAME	THE HECKLER
WARP	CHARACTERNAME	WARP
SCREAM	CHARACTERNAME	SCREAM
BLOODHAWK	CHARACTERNAME	BLOODHAWK
LIONHEART	CHARACTERNAME	LIONHEART
CAT-MAN AND KITTEN	CHARACTERNAME	CAT-MAN
CAT-MAN AND KITTEN	CHARACTERNAME	KITTEN
SAMARITAN	CHARACTERNAME	THE SAMARITAN
PIED PIPER	CHARACTERNAME	PIED PIPER
SHARON CARTER	CHARACTERNAME	SHARON CARTER
MIRROR MASTER	CHARACTERNAME	MIRROR MASTER
DANGER ROOM	CHARACTERNAME	DANGER
WEATHER WIZARD	CHARACTERNAME	WEATHER WIZARD
ORD	CHARACTERNAME	ORD OF THE BREAKWORLD
MISS X	CHARACTERNAME	MISS X
HEAT WAVE	CHARACTERNAME	HEAT WAVE
JACK-IN-THE-BOX	CHARACTERNAME	JACK-IN-THE-BOX
MAGDALENA	CHARACTERNAME	THE MAGDALENA
PAINKILLER JANE	CHARACTERNAME	PAINKILLER JANE
APHRODITE IX	CHARACTERNAME	APHRODITE IX
ANT-MAN	CHARACTERNAME	ANT-MAN
NORTHGUARD	CHARACTERNAME	NORTHGUARD/LE PROTECTEUR
LUVVIE DARLING	CHARACTERNAME	LUVVIE DARLING
WILDFIRE	CHARACTERNAME	WILDFIRE
RICTOR	CHARACTERNAME	RICTOR
MOONSTONE	CHARACTERNAME	MOONSTONE
RAMPAGE	CHARACTERNAME	RAMPAGE
SILVER BANSHEE	CHARACTERNAME	SILVER BANSHEE
PURPLE MAN	CHARACTERNAME	PURPLE MAN
GENIS-VELL	CHARACTERNAME	GENIS-VELL
SUPREME INTELLIGENCE	CHARACTERNAME	KREE SUPREME INTELLIGENCE
ONYXX	CHARACTERNAME	ONYXX
DIABOLIK	CHARACTERNAME	DIABOLIK
KGBEAST	CHARACTERNAME	KGBEAST
EVIL STAR	CHARACTERNAME	GUY POMPTON
EVIL STAR	CHARACTERNAME	EVIL STAR
BETHANY CABE	CHARACTERNAME	BETHANY CABE
BLING!	CHARACTERNAME	BLING!
JEAN DEWOLFF	CHARACTERNAME	JEAN DEWOLFF
JOCASTA	CHARACTERNAME	JOCASTA
WHIRLWIND	CHARACTERNAME	WHIRLWIND
STILT-MAN	CHARACTERNAME	STILT-MAN
JUSTICE	CHARACTERNAME	JUSTICE
BLOCKBUSTER	CHARACTERNAME	BLOCKBUSTER
DOCTOR POLARIS	CHARACTERNAME	DOCTOR POLARIS
GENTLEMAN GHOST	CHARACTERNAME	GENTLEMAN GHOST
HEIMDALL	CHARACTERNAME	HEIMDALL
FERAL	CHARACTERNAME	FERAL
NOMAD	CHARACTERNAME	NOMAD
SLUG	CHARACTERNAME	SLUG
KENNETH IRONS	CHARACTERNAME	KENNETH IRONS
CATSEYE	CHARACTERNAME	CATSEYE
YONDU	CHARACTERNAME	YONDU
EMPATH	CHARACTERNAME	EMPATH
ROULETTE	CHARACTERNAME	ROULETTE
TAROT	CHARACTERNAME	TAROT
PHAT	CHARACTERNAME	PHAT
BLOKE	CHARACTERNAME	BLOKE
DESPERO	CHARACTERNAME	DESPERO
CASEY JONES	CHARACTERNAME	CASEY JONES
HAMATO YOSHI	CHARACTERNAME	HAMATO YOSHI
FATHER SET	CHARACTERNAME	SET
DOC SAMSON	CHARACTERNAME	DOC SAMSON
MARGALI SZARDOS	CHARACTERNAME	MARGALI SZARDOS
GRAIL	CHARACTERNAME	GRAIL
ANGLE MAN	CHARACTERNAME	ANGLE MAN
BUG-EYED BANDIT	CHARACTERNAME	BUG-EYED BANDIT
TEN-EYED MAN	CHARACTERNAME	THE TEN-EYED MAN
JACK O'LANTERN	CHARACTERNAME	JACK O'LANTERN
POWER RING	CHARACTERNAME	POWER RING
WIZARD	CHARACTERNAME	WIZARD
LLYRA	CHARACTERNAME	LLYRA
KAVITA RAO	CHARACTERNAME	DR. KAVITA RAO
DORMA	CHARACTERNAME	DORMA
SUNBURST	CHARACTERNAME	SUNBURST
CALYPSO	CHARACTERNAME	CALYPSO
FLATTOP	CHARACTERNAME	FLATTOP
GHAUR	CHARACTERNAME	GHAUR
KRO	CHARACTERNAME	KRO
SYNCH	CHARACTERNAME	SYNCH
BLACK CONDOR	CHARACTERNAME	BLACK CONDOR
SCANDAL SAVAGE	CHARACTERNAME	SCANDAL SAVAGE
ARABIAN KNIGHT	CHARACTERNAME	ARABIAN KNIGHT
MIST	CHARACTERNAME	THE MIST
CONDUIT	CHARACTERNAME	CONDUIT
MANHATTAN GUARDIAN	CHARACTERNAME	THE MANHATTAN GUARDIAN
STRANGER	CHARACTERNAME	THE STRANGER
FLEX MENTALLO	CHARACTERNAME	FLEX MENTALLO
CHESHIRE	CHARACTERNAME	CHESHIRE
PANDAY	CHARACTERNAME	PANDAY
GANTHET	CHARACTERNAME	GANTHET
LADY DEATH	CHARACTERNAME	LADY DEATH
KEY	CHARACTERNAME	THE KEY
FENRIS	CHARACTERNAME	FENRIS
JASON WYNN	CHARACTERNAME	JASON WYNN
SOLOVAR	CHARACTERNAME	SOLOVAR
CHANTINELLE	CHARACTERNAME	CHANTINELLE
COCCO BILL	CHARACTERNAME	COCCO BILL
SUPERGIRL	CHARACTERNAME	SUPERGIRL
MERCY GRAVES	CHARACTERNAME	MERCY GRAVES
IRON MAN 2020	CHARACTERNAME	IRON MAN 2020
BOLIVAR TRASK	CHARACTERNAME	BOLIVAR TRASK
MESMERO	CHARACTERNAME	MESMERO
COAGULA	CHARACTERNAME	COAGULA
GLADIATOR	CHARACTERNAME	GLADIATOR
BUSHWACKER	CHARACTERNAME	BUSHWACKER
ANDROMEDA	CHARACTERNAME	ANDROMEDA
TERRIFIC WHATZIT	CHARACTERNAME	THE TERRIFIC WHATZIT
CARRION	CHARACTERNAME	CARRION
PETER PORKCHOPS	CHARACTERNAME	PIG IRON
LORI MORNING	CHARACTERNAME	LORI MORNING
BEAUTIFUL DREAMER	CHARACTERNAME	BEAUTIFUL DREAMER
ERG	CHARACTERNAME	ERG
PLAGUE	CHARACTERNAME	PLAGUE
FERGEE	CHARACTERNAME	FERGEE
VIENNA DREDD	CHARACTERNAME	VIENNA
AMERICAN EAGLE	CHARACTERNAME	AMERICAN EAGLE
ROND VIDAR	CHARACTERNAME	ROND VIDAR
BEDLAM	CHARACTERNAME	BEDLAM
LOCKJAW	CHARACTERNAME	LOCKJAW
LIGHTMASTER	CHARACTERNAME	LIGHTMASTER
GARRISON KANE	CHARACTERNAME	GARRISON KANE
UNCLE SAM	CHARACTERNAME	UNCLE SAM
TINKERER	CHARACTERNAME	TINKERER
XS	CHARACTERNAME	XS
KE'HAAN	CHARACTERNAME	KE'HAAN
TOMAR-TU	CHARACTERNAME	TOMAR-TU
JESSE CUSTER	CHARACTERNAME	JESSE CUSTER
JENNY EVERYWHERE	CHARACTERNAME	JENNY EVERYWHERE
GENERAL WADE EILING	CHARACTERNAME	GENERAL WADE EILING
SWARM	CHARACTERNAME	SWARM
THUNDER AND LIGHTNING	CHARACTERNAME	THUNDER AND LIGHTNING
FIREBREATHER	CHARACTERNAME	FIREBREATHER
MASKED MAN	CHARACTERNAME	MASKED MAN
DEREK POWERS	CHARACTERNAME	DEREK POWERS
HAWKEYE	CHARACTERNAME	HAWKEYE
I…VAMPIRE	CHARACTERNAME	I...VAMPIRE
MALEBOLGIA	CHARACTERNAME	MALEBOLGIA
NUKE	CHARACTERNAME	NUKE
ARCANNA	CHARACTERNAME	ARCANNA
TOM THUMB	CHARACTERNAME	TOM THUMB
ERIK JOSTEN	CHARACTERNAME	ERIK JOSTEN
PRINCESS AURA	CHARACTERNAME	PRINCESS AURA
PRINCE BARIN	CHARACTERNAME	PRINCE BARIN
SHAPE	CHARACTERNAME	SHAPE
KLEINSTOCKS	CHARACTERNAME	KLEINSTOCK BROTHERS
BEEF	CHARACTERNAME	BEEF
CRAZY JANE	CHARACTERNAME	CRAZY JANE
HERO CRUZ	CHARACTERNAME	HERO CRUZ
THE STEEL CLAW	CHARACTERNAME	THE STEEL CLAW
RED HOOD	CHARACTERNAME	THE RED HOOD
BLACK KNIGHT	CHARACTERNAME	BLACK KNIGHT
OFF-RAMP	CHARACTERNAME	OFF-RAMP
ANGEL	CHARACTERNAME	THE ANGEL
VISION	CHARACTERNAME	THE VISION
NAGA	CHARACTERNAME	NAGA
ECHO	CHARACTERNAME	ECHO
BILL FOSTER	CHARACTERNAME	BILL FOSTER
ISAIAH BRADLEY	CHARACTERNAME	ISAIAH BRADLEY
RED SHIFT	CHARACTERNAME	RED SHIFT
HUMPTY DUMPTY	CHARACTERNAME	HUMPTY DUMPTY
HUMAN FLY	CHARACTERNAME	HUMAN FLY
RAT KING	CHARACTERNAME	RAT KING
TERRA-MAN	CHARACTERNAME	TERRA-MAN
PRANKSTER	CHARACTERNAME	PRANKSTER
MOONGLOW	CHARACTERNAME	MOONGLOW
SHAGGY MAN	CHARACTERNAME	SHAGGY MAN
GOLDEN ARCHER	CHARACTERNAME	GOLDEN ARCHER
SAMURAI	CHARACTERNAME	SAMURAI
INERTIA	CHARACTERNAME	INERTIA
RANDOM	CHARACTERNAME	RANDOM
GOLDEN EAGLE	CHARACTERNAME	GOLDEN EAGLE
POLAR BOY	CHARACTERNAME	POLAR BOY
ZARATHOS	CHARACTERNAME	ZARATHOS
LEATHERHEAD	CHARACTERNAME	LEATHERHEAD
TNT	CHARACTERNAME	TNT
REDSTONE	CHARACTERNAME	REDSTONE
EL DORADO	CHARACTERNAME	EL DORADO
SHE-VENOM	CHARACTERNAME	SHE-VENOM
R. J. BRANDE	CHARACTERNAME	R. J. BRANDE
VANISHER	CHARACTERNAME	THE VANISHER
ZARRKO	CHARACTERNAME	ZARRKO, THE TOMORROW MAN
GREY GARGOYLE	CHARACTERNAME	GREY GARGOYLE
COACHWHIP	CHARACTERNAME	COACHWHIP
DEATH ADDER	CHARACTERNAME	DEATH ADDER
PUFF ADDER	CHARACTERNAME	PUFF ADDER
ZABU	CHARACTERNAME	ZABU
ETHAN EDWARDS	CHARACTERNAME	ETHAN EDWARDS
SQUIRE	CHARACTERNAME	SQUIRE
RAINBOW RAIDER	CHARACTERNAME	RAINBOW RAIDER
STICK	CHARACTERNAME	STICK
LEAP-FROG	CHARACTERNAME	LEAP-FROG
RED TORNADO	CHARACTERNAME	RED TORNADO
RAINBOW ARCHER	CHARACTERNAME	RAINBOW ARCHER
NIGHTMARE	CHARACTERNAME	NIGHTMARE
UMAR	CHARACTERNAME	UMAR
GNARRK	CHARACTERNAME	GNARRK
EXTRAñO	CHARACTERNAME	EXTRAñO
MASTER MENACE	CHARACTERNAME	MASTER MENACE
MASTER MENACE	CHARACTERNAME	EMIL BURBANK
THUNDERBIRD	CHARACTERNAME	THUNDERBIRD
MOLTEN MAN	CHARACTERNAME	MOLTEN MAN
JULIA CARPENTER	CHARACTERNAME	JULIA CARPENTER
SPIDER-WOMAN	CHARACTERNAME	SPIDER-WOMAN
DEATHBLOW	CHARACTERNAME	DEATHBLOW
MISTER MAJESTIC	CHARACTERNAME	MR. MAJESTIC
STARBREAKER	CHARACTERNAME	STARBREAKER
SPIDER-WOMAN	CHARACTERNAME	SPIDER-WOMAN
MONSTERGIRL	CHARACTERNAME	MONSTERGIRL
ROCKET RACCOON	CHARACTERNAME	ROCKET RACCOON
RED GHOST	CHARACTERNAME	RED GHOST
FLATMAN	CHARACTERNAME	FLATMAN
FUNKY FLASHMAN	CHARACTERNAME	FUNKY FLASHMAN
REX THE WONDER DOG	CHARACTERNAME	REX THE WONDER DOG
NAGRAJ	CHARACTERNAME	NAGRAJ
HUNTER ZOLOMON	CHARACTERNAME	ZOOM
HATH-SET	CHARACTERNAME	HATH-SET
BLACKLIGHT	CHARACTERNAME	BLACKLIGHT
SKEIN	CHARACTERNAME	SKEIN
MANTIS	CHARACTERNAME	MANTIS
DOGA	CHARACTERNAME	DOGA
DOCTOR MOON	CHARACTERNAME	DOCTOR MOON
PROFESSOR MILO	CHARACTERNAME	PROFESSOR MILO
STAR SAPPHIRE	CHARACTERNAME	STAR SAPPHIRE
SONAR	CHARACTERNAME	SONAR
DAREDEVIL	CHARACTERNAME	DAREDEVIL
NIGHT RAVEN	CHARACTERNAME	NIGHT RAVEN
CALCULATOR	CHARACTERNAME	THE CALCULATOR
DRUNKEN BAKERS	CHARACTERNAME	DRUNKEN BAKERS
LOOKER	CHARACTERNAME	LOOKER
CRIMSON DYNAMO	CHARACTERNAME	CRIMSON DYNAMO
EMPLATE	CHARACTERNAME	EMPLATE
KARL RUPRECHT KROENEN	CHARACTERNAME	KARL RUPRECHT KROENEN
SKIN	CHARACTERNAME	SKIN
MONDO	CHARACTERNAME	MONDO
RUBBERMAID	CHARACTERNAME	RUBBERMAID
BIG BEN	CHARACTERNAME	BIG BEN
OMAC	CHARACTERNAME	OMACS
BRAIN	CHARACTERNAME	BRAIN
SASHA BORDEAUX	CHARACTERNAME	SASHA BORDEAUX
GAROKK	CHARACTERNAME	GAROKK
PHANTOM JACK	CHARACTERNAME	PHANTOM JACK
HOMER THE HAPPY GHOST	CHARACTERNAME	HOMER THE HAPPY GHOST
JEFFREY MACE	CHARACTERNAME	JEFFREY MACE
STYX AND STONE	CHARACTERNAME	STYX AND STONE
TANA MOON	CHARACTERNAME	TANA MOON
URSA	CHARACTERNAME	URSA
MENTALLO	CHARACTERNAME	MENTALLO
WASHOUT	CHARACTERNAME	WASHOUT
HIPPOLYTA	CHARACTERNAME	HIPPOLYTA
ELASTI-GIRL	CHARACTERNAME	ELASTI-GIRL
BULLETEER	CHARACTERNAME	BULLETEER
TREVOR FITZROY	CHARACTERNAME	TREVOR FITZROY
LA LUNATICA	CHARACTERNAME	LA LUNATICA
LILITH	CHARACTERNAME	LILITH
MONSIEUR MALLAH	CHARACTERNAME	MONSIEUR MALLAH
MADAME ROUGE	CHARACTERNAME	MADAME ROUGE
GENERAL ZAHL	CHARACTERNAME	GENERAL ZAHL
FROG-MAN	CHARACTERNAME	THE FABULOUS FROG-MAN
WHITE RABBIT	CHARACTERNAME	THE WHITE RABBIT
CENTRIX	CHARACTERNAME	CENTRIX
DEBRII	CHARACTERNAME	DEBRII
ROULETTE	CHARACTERNAME	ROULETTE
BLOODSPORT	CHARACTERNAME	BLOODSPORT
NEKRA	CHARACTERNAME	NEKRA
ELECTROCUTIONER	CHARACTERNAME	THE ELECTROCUTIONER
TRACER	CHARACTERNAME	TRACER
AMYGDALA	CHARACTERNAME	AMYGDALA
RATCATCHER	CHARACTERNAME	THE RATCATCHER
YELLOW CLAW	CHARACTERNAME	YELLOW CLAW
TEX WILLER	CHARACTERNAME	TEX WILLER
SPIDER GIRL	CHARACTERNAME	SPIDER GIRL
GENERAL IMMORTUS	CHARACTERNAME	GENERAL IMMORTUS
MASQUE	CHARACTERNAME	MASQUE
SUPERMAN	CHARACTERNAME	SUPERMAN
SUPERBOY	CHARACTERNAME	SUPERBOY
PRINCE RA-MAN	CHARACTERNAME	PRINCE RA-MAN
CAVE CARSON	CHARACTERNAME	CAVE CARSON
CAPTAIN COMET	CHARACTERNAME	CAPTAIN COMET
GUNDALA	CHARACTERNAME	GUNDALA
RONAN THE ACCUSER	CHARACTERNAME	RONAN THE ACCUSER
GRIZZLY	CHARACTERNAME	GRIZZLY
BASTION	CHARACTERNAME	BASTION
DOCTOR PSYCHO	CHARACTERNAME	DOCTOR PSYCHO
HINDSIGHT	CHARACTERNAME	HINDSIGHT
OWLWOMAN	CHARACTERNAME	OWLWOMAN
LITTLE MERMAID	CHARACTERNAME	LITTLE MERMAID
DOCTOR MIST	CHARACTERNAME	DOCTOR MIST
SERAPH	CHARACTERNAME	SERAPH
TUATARA	CHARACTERNAME	TUATARA
RISING SUN	CHARACTERNAME	RISING SUN
THUNDERLORD	CHARACTERNAME	THUNDERLORD
OLYMPIAN	CHARACTERNAME	OLYMPIAN
GODIVA	CHARACTERNAME	GODIVA
WILD HUNTSMAN	CHARACTERNAME	WILD HUNTSMAN
BUSHMASTER	CHARACTERNAME	BUSHMASTER
CYTTORAK	CHARACTERNAME	CYTTORAK
FATALITY	CHARACTERNAME	FATALITY
SATURNYNE	CHARACTERNAME	SATURNYNE
FEVER	CHARACTERNAME	FEVER
SLAYMASTER	CHARACTERNAME	SLAYMASTER
CONSTRICTOR	CHARACTERNAME	CONSTRICTOR
WILD THING	CHARACTERNAME	WILD THING
KORVAC	CHARACTERNAME	KORVAC
AMETHYST, PRINCESS OF GEMWORLD	CHARACTERNAME	AMETHYST
JUSTIN HAMMER	CHARACTERNAME	JUSTIN HAMMER
SPARTA OF SYNRIANNAQ	CHARACTERNAME	SPARTA OF SYNRIANNAQ
SHAPER OF WORLDS	CHARACTERNAME	THE SHAPER OF WORLDS
CHRIS BRADLEY	CHARACTERNAME	CHRIS BRADLEY
RAGE	CHARACTERNAME	RAGE
JACK B. QUICK	CHARACTERNAME	JACK B. QUICK
KARAI	CHARACTERNAME	KARAI / OROKU KARAI
INFINITE MAN	CHARACTERNAME	INFINITE MAN
BOOMERANG	CHARACTERNAME	BOOMERANG
COPYCAT	CHARACTERNAME	COPYCAT
COLLECTOR	CHARACTERNAME	THE COLLECTOR
ANTAEUS	CHARACTERNAME	ANTAEUS
ANTAEUS	CHARACTERNAME	MARK ANTAEUS
THE COCKROACH	CHARACTERNAME	THE COCKROACH
ICICLE	CHARACTERNAME	ICICLE
SHARON FRIEDLANDER	CHARACTERNAME	SHARON FRIEDLANDER
SUGAR MAN	CHARACTERNAME	SUGAR MAN
BUSTER GONAD	CHARACTERNAME	BUSTER GONAD
POW WOW SMITH	CHARACTERNAME	POW WOW SMITH
BODY DOUBLES	CHARACTERNAME	BODY DOUBLES
SCORPIO	CHARACTERNAME	SCORPIO
PARADEMON	CHARACTERNAME	PARADEMONS
PARADEMON	CHARACTERNAME	MIKE THE PARADEMON
MANITOU RAVEN	CHARACTERNAME	MANITOU RAVEN
MAGNETIC KID	CHARACTERNAME	MAGNETIC KID
WHITEFACE	CHARACTERNAME	WHITEFACE
TIMOTHY HUNTER	CHARACTERNAME	TIMOTHY HUNTER
GREGORY HERD	CHARACTERNAME	GREGORY HERD
PURGATORI	CHARACTERNAME	PURGATORI
FIDDLER	CHARACTERNAME	THE FIDDLER
JAMIE BRADDOCK	CHARACTERNAME	JAMIE BRADDOCK
CAPTAIN MARVEL	CHARACTERNAME	CAPTAIN MARVEL
ANOLE	CHARACTERNAME	ANOLE
BEPPO	CHARACTERNAME	BEPPO
SHADOW THIEF	CHARACTERNAME	SHADOW THIEF
MISTER TERRIBLE	CHARACTERNAME	MISTER TERRIBLE
SQUIRREL GIRL	CHARACTERNAME	SQUIRREL GIRL
COMET	CHARACTERNAME	COMET THE SUPER-HORSE
COMET	CHARACTERNAME	COMET
OVERMASTER	CHARACTERNAME	OVERMASTER
U-MAN	CHARACTERNAME	U-MAN
HOLIDAY	CHARACTERNAME	HOLIDAY
COMBAT COLIN	CHARACTERNAME	COMBAT COLIN
E-MAN	CHARACTERNAME	E-MAN
ANDRé LEBLANC	CHARACTERNAME	ANDRé LEBLANC
PHOBIA	CHARACTERNAME	PHOBIA
DISRUPTOR	CHARACTERNAME	THE DISRUPTOR
PSIMON	CHARACTERNAME	PSIMON
BLACK MASS	CHARACTERNAME	BLACK MASS
CROWBAR	CHARACTERNAME	CROWBAR
NIGHTFALL	CHARACTERNAME	NIGHTFALL
FASTBALL	CHARACTERNAME	FASTBALL
SHATTERFIST	CHARACTERNAME	SHATTERFIST
SHRIKE	CHARACTERNAME	THE SHRIKE
SHRIKE	CHARACTERNAME	SHRIKE
THINKER	CHARACTERNAME	THINKER
BLAZING SKULL	CHARACTERNAME	BLAZING SKULL
KILLER FROST	CHARACTERNAME	KILLER FROST
CAITLIN FAIRCHILD	CHARACTERNAME	FAIRCHILD
ROY RAYMOND	CHARACTERNAME	ROY RAYMOND
LASHINA	CHARACTERNAME	LASHINA
VIRTUOSO	CHARACTERNAME	VIRTUOSO
BLIND AL	CHARACTERNAME	BLIND AL
BLAQUESMITH	CHARACTERNAME	BLAQUESMITH
TALA	CHARACTERNAME	TALA
MANTIS	CHARACTERNAME	MANTIS
RAVONNA	CHARACTERNAME	RAVONNA
TALLY MAN	CHARACTERNAME	THE TALLY MAN
KANGAROO	CHARACTERNAME	THE KANGAROO
MAGEDDON	CHARACTERNAME	MAGEDDON
THE AMAZING SCREW-ON HEAD	CHARACTERNAME	SCREW-ON HEAD
DING DONG DADDY	CHARACTERNAME	DING DONG DADDY
PER DEGATON	CHARACTERNAME	PER DEGATON
NEGATIVE MAN	CHARACTERNAME	NEGATIVE MAN
THE ROOK	CHARACTERNAME	THE ROOK
ZSAZSA ZATURNNAH	CHARACTERNAME	ZSAZSA ZATURNNAH
MELONI THAWNE	CHARACTERNAME	MELONI THAWNE-ALLEN
GOLDEN GLIDER	CHARACTERNAME	THE GOLDEN GLIDER
VIPER	CHARACTERNAME	VIPER
VIPER	CHARACTERNAME	MADAME HYDRA
OCEAN MASTER	CHARACTERNAME	OCEAN MASTER
ABRA KADABRA	CHARACTERNAME	ABRA KADABRA
DOCTOR PHOSPHORUS	CHARACTERNAME	DOCTOR PHOSPHORUS
NEFARIUS	CHARACTERNAME	NEFARIUS
KISMET	CHARACTERNAME	KISMET
RED CLAW	CHARACTERNAME	RED CLAW
RESURRECTION MAN	CHARACTERNAME	RESURRECTION MAN
INFINITY	CHARACTERNAME	INFINITY
ALEX WILDER	CHARACTERNAME	ALEX WILDER
KNOCKOUT	CHARACTERNAME	KNOCKOUT
EMERALD EMPRESS	CHARACTERNAME	THE EMERALD EMPRESS
GEARHEAD	CHARACTERNAME	GEARHEAD
MADAME WEB	CHARACTERNAME	MADAME WEB
SHIVER MAN	CHARACTERNAME	THE SHIVER MAN
DOCTOR ALCHEMY	CHARACTERNAME	DOCTOR ALCHEMY / MR. ELEMENT
KING MOB	CHARACTERNAME	KING MOB
TELLUS	CHARACTERNAME	TELLUS
TOM CORSI	CHARACTERNAME	TOM CORSI
BRAINWAVE	CHARACTERNAME	BRAINWAVE
FUJI	CHARACTERNAME	FUJI
RIP HUNTER	CHARACTERNAME	RIP HUNTER
PROWLER	CHARACTERNAME	PROWLER
PERSUADER	CHARACTERNAME	THE PERSUADER
LADY MASTERMIND	CHARACTERNAME	LADY MASTERMIND
PRESTOR JON	CHARACTERNAME	PRESTOR JON
RISK	CHARACTERNAME	RISK
HELLSTRIKE	CHARACTERNAME	HELLSTRIKE
RODERICK KINGSLEY	CHARACTERNAME	RODERICK KINGSLEY
TAKI MATSUYA	CHARACTERNAME	TAKI MATSUYA
TIGRESS	CHARACTERNAME	TIGRESS
SHI	CHARACTERNAME	SHI
THUNDERBUNNY	CHARACTERNAME	THUNDER BUNNY
MADAME MASQUE	CHARACTERNAME	MADAME MASQUE
CHANCE	CHARACTERNAME	CHANCE
NORA FRIES	CHARACTERNAME	NORA FRIES
BUSHIDO	CHARACTERNAME	BUSHIDO
PUNCH AND JEWELEE	CHARACTERNAME	PUNCH AND JEWELEE
ABATTOIR	CHARACTERNAME	ABATTOIR
TAR BABY	CHARACTERNAME	TAR BABY
MAL DUNCAN	CHARACTERNAME	MAL DUNCAN
ACCESS	CHARACTERNAME	ACCESS
ARTEMIS OF BANA-MIGHDALL	CHARACTERNAME	ARTEMIS OF BANA-MIGHDALL
WINGED VICTORY	CHARACTERNAME	WINGED VICTORY
WILD DOG	CHARACTERNAME	WILD DOG
XEMNU	CHARACTERNAME	XEMNU THE TITAN
LILANDRA NERAMANI	CHARACTERNAME	PRINCESS-MAJESTRIX LILANDRA NERAMANI
TIGER SHARK	CHARACTERNAME	TIGER SHARK
TERROR INC.	CHARACTERNAME	TERROR INC.
TORNADO TWINS	CHARACTERNAME	TORNADO TWINS
WONDER MAN	CHARACTERNAME	WONDER MAN
VENUS	CHARACTERNAME	VENUS DE MILO
MERA	CHARACTERNAME	MERA
TURNER D. CENTURY	CHARACTERNAME	TURNER D. CENTURY
MASTER MAN	CHARACTERNAME	MASTER MAN
MASTER MAN	CHARACTERNAME	MASTER MAN
TRICKSTER	CHARACTERNAME	TRICKSTER
SHONDRA KINSOLVING	CHARACTERNAME	SHONDRA KINSOLVING
JACK DRAKE	CHARACTERNAME	JACK DRAKE
LESLIE THOMPKINS	CHARACTERNAME	LESLIE THOMPKINS
MARLO CHANDLER	CHARACTERNAME	MARLO CHANDLER
OLIVER %22DADDY%22 WARBUCKS	CHARACTERNAME	DADDY WARBUCKS
EPOCH	CHARACTERNAME	LORD OF TIME, EPOCH
ARCHER & ARMSTRONG	CHARACTERNAME	ARCHER & ARMSTRONG
MICHAEL DEMIURGOS	CHARACTERNAME	MICHAEL DEMIURGOS
FLEX	CHARACTERNAME	FLEX
GRASSHOPPER	CHARACTERNAME	GRASSHOPPER
NINJAK	CHARACTERNAME	NINJAK
KING SHARK	CHARACTERNAME	KING SHARK
EGGHEAD	CHARACTERNAME	EGGHEAD
MORLUN	CHARACTERNAME	MORLUN
MONSIEUR STIGMONUS	CHARACTERNAME	MONSIEUR STIGMONUS
RAI	CHARACTERNAME	RAI
PRANKSTER	CHARACTERNAME	PRANKSTER
MR. MUSCLES	CHARACTERNAME	MR. MUSCLES
SARGE STEEL	CHARACTERNAME	SARGE STEEL
LORD FANNY	CHARACTERNAME	LORD FANNY
FIGHTING YANK	CHARACTERNAME	FIGHTING YANK
EL MUERTO	CHARACTERNAME	EL MUERTO
HARBINGER OF JUSTICE	CHARACTERNAME	HARBINGER OF JUSTICE
EFFIGY	CHARACTERNAME	EFFIGY
NERO	CHARACTERNAME	ALEX NERO
HOP HARRIGAN	CHARACTERNAME	HOP HARRIGAN
TRIGGER TWINS	CHARACTERNAME	TRIGGER TWINS
KULAN GATH	CHARACTERNAME	KULAN GATH
COMET MAN	CHARACTERNAME	COMET MAN
LAYLA MILLER	CHARACTERNAME	LAYLA MILLER
PARAGON	CHARACTERNAME	PARAGON
HIMON	CHARACTERNAME	HIMON
NATHANIEL DUSK	CHARACTERNAME	NATHANIEL DUSK
MYSTO	CHARACTERNAME	MYSTO THE MAGICIAN DETECTIVE
MYRWHYDDEN	CHARACTERNAME	MYRWHYDDEN
SPEEDY	CHARACTERNAME	SPEEDY
CHASE	CHARACTERNAME	CHASE
TED KORD	CHARACTERNAME	BLUE BEETLE
GRIM REAPER	CHARACTERNAME	GRIM REAPER
PHANTOM EAGLE	CHARACTERNAME	PHANTOM EAGLE
FRANKENSTEIN	CHARACTERNAME	FRANKENSTEIN
IRON MUNRO	CHARACTERNAME	IRON MUNRO
SARAH SIMMS	CHARACTERNAME	SARAH SIMMS
NEUTRON	CHARACTERNAME	NEUTRON
MISTER BONES	CHARACTERNAME	MISTER BONES
VANTH DREADSTAR	CHARACTERNAME	VANTH DREADSTAR
ROGER	CHARACTERNAME	ROGER THE HOMUNCULUS
JOHANN KRAUS	CHARACTERNAME	JOHANN KRAUS
KATE CORRIGAN	CHARACTERNAME	KATE CORRIGAN
TOM MANNING	CHARACTERNAME	TOM MANNING
THAROK	CHARACTERNAME	THAROK
ANIMA	CHARACTERNAME	ANIMA
FANDRAL	CHARACTERNAME	FANDRAL
VOLSTAGG	CHARACTERNAME	VOLSTAGG
HOGUN	CHARACTERNAME	HOGUN
NIGHTMASK	CHARACTERNAME	NIGHTMASK
GENIUS JONES	CHARACTERNAME	GENIUS JONES
REVANCHE	CHARACTERNAME	REVANCHE
RAVAN	CHARACTERNAME	RAVAN
J2	CHARACTERNAME	J2
SCARECROW	CHARACTERNAME	SCARECROW
RED STAR	CHARACTERNAME	RED STAR
HER HIGHNESS AND SILK	CHARACTERNAME	HER HIGHNESS AND SILK
MAYA	CHARACTERNAME	MAYA
FOREIGNER	CHARACTERNAME	FOREIGNER
POSTMAN	CHARACTERNAME	POSTMAN
HAYFOOT HENRY	CHARACTERNAME	HAYFOOT HENRY
MISTER IMMORTAL	CHARACTERNAME	MR. IMMORTAL
FOREARM	CHARACTERNAME	FOREARM
CHLOROPHYLL KID	CHARACTERNAME	CHLOROPHYLL KID
DEMON BEAR	CHARACTERNAME	DEMON BEAR
STONE BOY	CHARACTERNAME	STONE BOY
ANT	CHARACTERNAME	ANT
FEVER PITCH	CHARACTERNAME	FEVER PITCH
LE CHAT	CHARACTERNAME	LE CHAT
DOORMAN	CHARACTERNAME	DOORMAN
STINGRAY	CHARACTERNAME	STINGRAY
RADIUS	CHARACTERNAME	RADIUS
ROMA	CHARACTERNAME	ROMA
FOXBAT	CHARACTERNAME	FOXBAT
NEBIROS	CHARACTERNAME	NEBIROS
ATTUMA	CHARACTERNAME	ATTUMA
ALEXANDER LUTHOR JR.	CHARACTERNAME	ALEXANDER LUTHOR JR.
FREAKSHOW	CHARACTERNAME	FREAKSHOW
KID DEVIL	CHARACTERNAME	KID DEVIL
HEATHER HUDSON	CHARACTERNAME	HEATHER HUDSON
PALADIN	CHARACTERNAME	PALADIN
VALKYRIE	CHARACTERNAME	VALKYRIE
SIF	CHARACTERNAME	SIF
FIREBIRD	CHARACTERNAME	FIREBIRD
VENUS	CHARACTERNAME	VENUS
VENUS	CHARACTERNAME	APHRODITE
HARBINGER	CHARACTERNAME	HARBINGER
HOURMAN	CHARACTERNAME	HOURMAN
MATSU'O TSURAYABA	CHARACTERNAME	MATSU'O TSURAYABA
DUM DUM DUGAN	CHARACTERNAME	DUM DUM DUGAN
DESAK	CHARACTERNAME	DESAK, THE GOD SLAYER
OCTOBRIANA	CHARACTERNAME	OCTOBRIANA
WRECKER	CHARACTERNAME	THE WRECKER
HOURMAN	CHARACTERNAME	HOURMAN
GUNFIRE	CHARACTERNAME	GUNFIRE
CHIEF JUDGE FARGO	CHARACTERNAME	CHIEF JUDGE FARGO
ROBOT ARCHIE	CHARACTERNAME	ROBOT ARCHIE
REIGNFIRE	CHARACTERNAME	REIGNFIRE
LASTIKMAN	CHARACTERNAME	LASTIKMAN
ARGENT	CHARACTERNAME	ARGENT
BLACK TALON	CHARACTERNAME	BLACK TALON
LOA	CHARACTERNAME	LOA
WINTER	CHARACTERNAME	WINTER
JULIE MADISON	CHARACTERNAME	JULIE MADISON
BIOTROG	CHARACTERNAME	BIOTROG
MATCH	CHARACTERNAME	MATCH
RADIOACTIVE MAN	CHARACTERNAME	RADIOACTIVE MAN
BLONDE PHANTOM	CHARACTERNAME	BLONDE PHANTOM
AZAZEL	CHARACTERNAME	AZAZEL
WOLF CUB	CHARACTERNAME	WOLF CUB
CENTURY	CHARACTERNAME	CENTURY
FIREBRAND	CHARACTERNAME	FIREBRAND
SAD SACK	CHARACTERNAME	SAD SACK
INDRA	CHARACTERNAME	INDRA
MISTER E	CHARACTERNAME	MISTER E
LIVING LASER	CHARACTERNAME	THE LIVING LASER
JADE	CHARACTERNAME	JADE
AMBER HUNT	CHARACTERNAME	AMBER HUNT
KILLOWAT	CHARACTERNAME	KILLOWATT
PANTHA	CHARACTERNAME	PANTHA
FAMINE	CHARACTERNAME	FAMINE
WAR	CHARACTERNAME	WAR
SIENA BLAZE	CHARACTERNAME	SIENA BLAZE
REAPER	CHARACTERNAME	REAPER
ANTIOPE	CHARACTERNAME	ANTIOPE
PHANTASM	CHARACTERNAME	PHANTASM
GEMINI	CHARACTERNAME	GEMINI
MENTO	CHARACTERNAME	MENTO
PUMA	CHARACTERNAME	PUMA
TARANTULA	CHARACTERNAME	TARANTULA
DOCTOR	CHARACTERNAME	THE DOCTOR
GAIA	CHARACTERNAME	GAIA
LADY DEMON	CHARACTERNAME	LADY DEMON
THOMAS WAYNE	CHARACTERNAME	THOMAS WAYNE
GAEA	CHARACTERNAME	GAEA
FIREARM	CHARACTERNAME	FIREARM
HARDCASE	CHARACTERNAME	HARDCASE
STARFOX	CHARACTERNAME	STARFOX
THORNN	CHARACTERNAME	THORNN
CHOICE	CHARACTERNAME	CHOICE
SILENT MAJORITY	CHARACTERNAME	SILENT MAJORITY
HARDWIRE	CHARACTERNAME	HARDWIRE
KING FARADAY	CHARACTERNAME	KING FARADAY
PRISM	CHARACTERNAME	PRISM
XERO	CHARACTERNAME	XERø
HYBRID	CHARACTERNAME	HYBRID
RAM	CHARACTERNAME	RAM
SPENCER SMYTHE	CHARACTERNAME	SPENCER SMYTHE
CRISPUS ALLEN	CHARACTERNAME	CRISPUS ALLEN
SABBAC	CHARACTERNAME	SABBAC
RED RAZORS	CHARACTERNAME	RED RAZORS
NEOPHYTE	CHARACTERNAME	NEOPHYTE
JOSIAH POWER	CHARACTERNAME	JOSIAH POWER
MEGATON MAN	CHARACTERNAME	MEGATON MAN
SKULLFIRE	CHARACTERNAME	SKULLFIRE
AEGIS	CHARACTERNAME	AEGIS
BATTLESTAR	CHARACTERNAME	BATTLESTAR
BROTHER VOODOO	CHARACTERNAME	BROTHER VOODOO
RUCKUS	CHARACTERNAME	RUCKUS
DEV-EM	CHARACTERNAME	DEV-EM
YUKIO	CHARACTERNAME	YUKIO
HEADKNOCKER	CHARACTERNAME	HEADKNOCKER
HEMINGWAY	CHARACTERNAME	HEMINGWAY
ULTRA-MAN	CHARACTERNAME	ULTRA-MAN
VESSEL	CHARACTERNAME	VESSEL
CARDINAL	CHARACTERNAME	CARDINAL
MAN-APE	CHARACTERNAME	MAN-APE
BISON	CHARACTERNAME	BISON
ICEMASTER	CHARACTERNAME	ICEMASTER
GRIM GHOST	CHARACTERNAME	GRIM GHOST
SORANIK NATU	CHARACTERNAME	SORANIK NATU
COMET	CHARACTERNAME	THE COMET
EVA KANT	CHARACTERNAME	EVA KANT
NESTOR	CHARACTERNAME	NESTOR
DONYELL TAYLOR	CHARACTERNAME	DONYELL TAYLOR
FORAGER	CHARACTERNAME	FORAGER
CONSTANTINE DRAKON	CHARACTERNAME	CONSTANTINE DRAKON
CHTYLOK	CHARACTERNAME	CHTYLOK
ROXY ROCKET	CHARACTERNAME	ROXY ROCKET
TYRANNUS	CHARACTERNAME	TYRANNUS
DOCTOR DOUBLE X	CHARACTERNAME	DOCTOR DOUBLE X
DOCTOR CYBER	CHARACTERNAME	DOCTOR CYBER
KATIE POWER	CHARACTERNAME	KATE POWER
DEATHBOLT	CHARACTERNAME	DEATHBOLT
DOCTOR UB'X	CHARACTERNAME	DOCTOR UB'X
MORG	CHARACTERNAME	MORG
ISAMOT KOL	CHARACTERNAME	ISAMOT KOL
DOCTOR SPECTRO	CHARACTERNAME	DOCTOR SPECTRO
DEIMOS	CHARACTERNAME	DEIMOS
ZOOKEEPER	CHARACTERNAME	ZOOKEEPER
WONDER GIRL	CHARACTERNAME	WONDER GIRL
DOCTOR BEDLAM	CHARACTERNAME	DOCTOR BEDLAM
GIDEON	CHARACTERNAME	GIDEON
TYRANT	CHARACTERNAME	TYRANT
MERLYN	CHARACTERNAME	MERLYN
DEMOLITION MAN	CHARACTERNAME	DEMOLITION MAN
VOLCANA	CHARACTERNAME	VOLCANA
JENNY QUANTUM	CHARACTERNAME	JENNY QUANTUM
TUSK	CHARACTERNAME	TUSK
STEL	CHARACTERNAME	STEL
GREEN MAN	CHARACTERNAME	GREEN MAN
THIALFI	CHARACTERNAME	THIALFI
SUPER COMMANDO DHRUVA	CHARACTERNAME	SUPER COMMANDO DHRUVA
CAPTAIN FREEDOM	CHARACTERNAME	CAPTAIN FREEDOM
SCAVENGER	CHARACTERNAME	SCAVENGER
MAGNI	CHARACTERNAME	MAGNI
RINGMASTER	CHARACTERNAME	THE RINGMASTER
MONOCLE	CHARACTERNAME	MONOCLE
AMOS FORTUNE	CHARACTERNAME	PROFESSOR AMOS FORTUNE
ONIMAR SYNN	CHARACTERNAME	ONIMAR SYNN
OVERTHROW	CHARACTERNAME	OVERTHROW
SCORCH	CHARACTERNAME	SCORCH
FISHERMAN	CHARACTERNAME	FISHERMAN
VARTOX	CHARACTERNAME	VARTOX
SIGNALMAN	CHARACTERNAME	SIGNALMAN
GARGUAX	CHARACTERNAME	GARGUAX
CHEMO	CHARACTERNAME	CHEMO
SWIFT	CHARACTERNAME	SWIFT
NIGHTMASTER	CHARACTERNAME	NIGHTMASTER
ENCHANTRESS	CHARACTERNAME	ENCHANTRESS
ZOR-EL	CHARACTERNAME	ZOR-EL
CRIME DOCTOR	CHARACTERNAME	CRIME DOCTOR
MILLA DONOVAN	CHARACTERNAME	MILLA DONOVAN
JOHAN AND PEEWIT	CHARACTERNAME	JOHAN AND PEEWIT
BACKLASH	CHARACTERNAME	BACKLASH
MANHUNTER	CHARACTERNAME	MANHUNTER
MARTHA JOHANSSON	CHARACTERNAME	NO-GIRL
TIMESLIP	CHARACTERNAME	TIMESLIP
JOHN LYNCH	CHARACTERNAME	LYNCH
LORD EMP	CHARACTERNAME	LORD EMP
DANE	CHARACTERNAME	DANE
OMNI-MAN	CHARACTERNAME	OMNI-MAN
ATOM EVE	CHARACTERNAME	ATOM EVE
YELLOWJACKET	CHARACTERNAME	YELLOWJACKET
MAN OF MIRACLES	CHARACTERNAME	MOTHER OF EXISTENCE
ZERA	CHARACTERNAME	ZERA
HAUPTMANN DEUTSCHLAND	CHARACTERNAME	HAUPTMANN DEUTSCHLAND
MAMMOMAX	CHARACTERNAME	MAMMOMAX
LITTLE LOTTA	CHARACTERNAME	LITTLE LOTTA
ROSE PSYCHIC	CHARACTERNAME	ROSE PSYCHIC
BOLT	CHARACTERNAME	BOLT
REX SPLODE	CHARACTERNAME	REX SPLODE
DAKOTA NORTH	CHARACTERNAME	DAKOTA NORTH
KNIGHT	CHARACTERNAME	THE KNIGHT
MANITOU DAWN	CHARACTERNAME	MANITOU DAWN
SAMUEL SILKE	CHARACTERNAME	SAMMY SILKE
LOCK-UP	CHARACTERNAME	LOCK-UP
CANDRA	CHARACTERNAME	CANDRA
T. O. MORROW	CHARACTERNAME	T. O. MORROW
AEGEUS	CHARACTERNAME	AEGEUS
KURSE	CHARACTERNAME	KURSE
YMIR	CHARACTERNAME	YMIR
MANGOG	CHARACTERNAME	MANGOG
ULIK	CHARACTERNAME	ULIK
RUSSIAN	CHARACTERNAME	THE RUSSIAN
ULYSSES BLOODSTONE	CHARACTERNAME	ULYSSES BLOODSTONE
MAGOG	CHARACTERNAME	MAGOG
AWESOME ANDROID	CHARACTERNAME	AWESOME ANDROID
ORLOK THE ASSASSIN	CHARACTERNAME	ORLOK
PERSUASION	CHARACTERNAME	PURPLE WOMAN
BIG BERTHA	CHARACTERNAME	BIG BERTHA
AMELIA VOGHT	CHARACTERNAME	AMELIA VOGHT
ALCHEMY	CHARACTERNAME	ALCHEMY
MISTER M	CHARACTERNAME	MISTER M
PREVIEW	CHARACTERNAME	PREVIEW
BOBAN AND MOLLY	CHARACTERNAME	BOBAN AND MOLLY
PROFESSOR IVO	CHARACTERNAME	PROFESSOR IVO
SHIP	CHARACTERNAME	SHIP
NATASHA IRONS	CHARACTERNAME	NATASHA IRONS
TRACI THIRTEEN	CHARACTERNAME	TRACI THIRTEEN
BACKLASH	CHARACTERNAME	BACKLASH
BATTALION	CHARACTERNAME	JACKSON KING
ROSE TATTOO	CHARACTERNAME	ROSE TATTOO
JACK POWER	CHARACTERNAME	JACK POWER
JULIE POWER	CHARACTERNAME	JULIE POWER
JACK STAFF	CHARACTERNAME	JACK STAFF
JIM WILSON	CHARACTERNAME	JIM WILSON
LUNA MAXIMOFF	CHARACTERNAME	LUNA MAXIMOFF
OUTLAW	CHARACTERNAME	OUTLAW
ISMAEL ORTEGA	CHARACTERNAME	ISMAEL ORTEGA
ALEXANDER BONT	CHARACTERNAME	ALEXANDER BONT
THE SPIDER	CHARACTERNAME	THE SPIDER
VANESSA FISK	CHARACTERNAME	VANESSA FISK
MICTLANTECUHTLI	CHARACTERNAME	MICTLANTECUHTLI
LINDA PARK	CHARACTERNAME	LINDA PARK
TONY ZUCCO	CHARACTERNAME	TONY ZUCCO
SUPERBOY-PRIME	CHARACTERNAME	SUPERBOY-PRIME
TREVOR BRUTTENHOLM	CHARACTERNAME	TREVOR BRUTTENHOLM
MARTHA WASHINGTON	CHARACTERNAME	MARTHA WASHINGTON
PITT	CHARACTERNAME	PITT
CHARCOAL	CHARACTERNAME	CHARCOAL
FATMAN THE HUMAN FLYING SAUCER	CHARACTERNAME	FATMAN THE HUMAN FLYING SAUCER
BEN DAIMIO	CHARACTERNAME	BEN DAIMIO
BHOKAL	CHARACTERNAME	BHOKAL
FILM FREAK	CHARACTERNAME	FILM FREAK
GREAT WHITE SHARK	CHARACTERNAME	THE GREAT WHITE SHARK
SCALPHUNTER	CHARACTERNAME	SCALPHUNTER
MAXIMUS	CHARACTERNAME	MAXIMUS
GOLDEN GIRL	CHARACTERNAME	GOLDEN GIRL
KUNG	CHARACTERNAME	KUNG
FREEFALL	CHARACTERNAME	FREEFALL
GRUNGE	CHARACTERNAME	GRUNGE
MASADA	CHARACTERNAME	MASADA
LOSS	CHARACTERNAME	LOSS
DARWIN	CHARACTERNAME	DARWIN
SWAY	CHARACTERNAME	SWAY
VULCAN	CHARACTERNAME	VULCAN
PETRA	CHARACTERNAME	PETRA
ASPEN MATTHEWS	CHARACTERNAME	ASPEN MATTHEWS
ALLEY-KAT-ABRA	CHARACTERNAME	ALLEY-KAT-ABRA
QUILL	CHARACTERNAME	QUILL
QUILL	CHARACTERNAME	QUILLS
JUDGE CAL	CHARACTERNAME	JUDGE CAL
CANNON HAWKE	CHARACTERNAME	CANNON
JAX-UR	CHARACTERNAME	JAX-UR
EVANGELINE WHEDON	CHARACTERNAME	EVANGELINE WHEDON
CARDIAC	CHARACTERNAME	CARDIAC
ION	CHARACTERNAME	ION
SPARTAN	CHARACTERNAME	SPARTAN
BLACK SAMSON	CHARACTERNAME	BLACK SAMSON
GRACE	CHARACTERNAME	GRACE
VOODOO	CHARACTERNAME	VOODOO
MAUL	CHARACTERNAME	MAUL
MADISON JEFFRIES	CHARACTERNAME	MADISON JEFFRIES
LOBSTER JOHNSON	CHARACTERNAME	THE LOBSTER
WARBLADE	CHARACTERNAME	WARBLADE
ZEALOT	CHARACTERNAME	ZEALOT
SAVANT	CHARACTERNAME	SAVANT
SAVANT	CHARACTERNAME	SAVANT
BLUE JAY	CHARACTERNAME	BLUE JAY
LADYTRON	CHARACTERNAME	LADYTRON
MAGMA	CHARACTERNAME	MAGMA
TAO	CHARACTERNAME	T.A.O.
KESTREL	CHARACTERNAME	KESTREL
KESTREL	CHARACTERNAME	COLONEL JOHN WRAITH
SIDEWAYS BOB	CHARACTERNAME	SIDEWAYS BOB
BURNOUT	CHARACTERNAME	BURNOUT
IVANA BAIUL	CHARACTERNAME	IVANA
COPYCAT	CHARACTERNAME	COPYCAT
IRON SPIDER	CHARACTERNAME	IRON SPIDER
HELSPONT	CHARACTERNAME	LORD HELSPONT
TURTLE	CHARACTERNAME	THE TURTLE
VOID	CHARACTERNAME	VOID
SUPERGIRL	CHARACTERNAME	SUPERGIRL
NICHOLAS SCRATCH	CHARACTERNAME	NICHOLAS SCRATCH
CONDITION RED	CHARACTERNAME	CONDITION RED
KANJAR RO	CHARACTERNAME	KANJAR RO
ULTIMATE WOLVERINE	CHARACTERNAME	WOLVERINE
UNION	CHARACTERNAME	UNION
BIRANHA	CHARACTERNAME	BIRANHA
PIXIE	CHARACTERNAME	PIXIE
MILAN	CHARACTERNAME	MILAN
JAVITZ	CHARACTERNAME	JAVITZ
ORCA	CHARACTERNAME	ORCA
SPOOR	CHARACTERNAME	SPOOR
ORATOR	CHARACTERNAME	ORATOR
PROJECTOR	CHARACTERNAME	PROJECTOR
SEAMUS MELLENCAMP	CHARACTERNAME	SEANUS MELLENCAMP
THUNDERBALL	CHARACTERNAME	THUNDERBALL
SPYMASTER	CHARACTERNAME	SPYMASTER
BULLDOZER	CHARACTERNAME	BULLDOZER
ZERO	CHARACTERNAME	ZERO
PILEDRIVER	CHARACTERNAME	PILEDRIVER
SARAH RAINMAKER	CHARACTERNAME	SARAH RAINMAKER
IMMORTAL	CHARACTERNAME	THE IMMORTAL
MONSTER GIRL	CHARACTERNAME	MONSTER GIRL
DOCTOR DEATH	CHARACTERNAME	DOCTOR DEATH
REAPER	CHARACTERNAME	REAPER
DEACON BLACKFIRE	CHARACTERNAME	DEACON BLACKFIRE
MONK	CHARACTERNAME	THE MONK
PULSE	CHARACTERNAME	PULSE
JOHNNY SORROW	CHARACTERNAME	JOHNNY SORROW
SAT-YR-9	CHARACTERNAME	SAT-YR-9
MATTER MASTER	CHARACTERNAME	MATTER MASTER
FADEAWAY MAN	CHARACTERNAME	FADEAWAY MAN
SUBLIME	CHARACTERNAME	SUBLIME
BLISS	CHARACTERNAME	BLISS
THRESHOLD	CHARACTERNAME	THRESHOLD
POWERHAUS	CHARACTERNAME	POWERHAUS
EVO	CHARACTERNAME	EVO
FROSTBITE	CHARACTERNAME	FROSTBITE
FREESTYLE	CHARACTERNAME	FREESTYLE
LION-MANE	CHARACTERNAME	LION-MANE
GAZER	CHARACTERNAME	GAZER
NIGHTWATCH	CHARACTERNAME	NIGHTWATCH
MANDRILL	CHARACTERNAME	MANDRILL
CHEECH WIZARD	CHARACTERNAME	CHEECH WIZARD
ELEMENT GIRL	CHARACTERNAME	ELEMENT GIRL
ELEMENT GIRL	CHARACTERNAME	ELEMENT WOMAN
SHADO	CHARACTERNAME	SHADO
LEE FORRESTER	CHARACTERNAME	LEE FORRESTER
NITRO	CHARACTERNAME	NITRO
T-RAY	CHARACTERNAME	T-RAY
ANTHRO	CHARACTERNAME	ANTHRO
BYTH	CHARACTERNAME	BYTH
STEVIE HUNTER	CHARACTERNAME	STEVIE HUNTER
JUDGE SILVER	CHARACTERNAME	JUDGE SILVER
JUDGE VOLT	CHARACTERNAME	JUDGE VOLT
JUDGE GRIFFIN	CHARACTERNAME	JUDGE GRIFFIN
DAISY JOHNSON	CHARACTERNAME	DAISY JOHNSON
SARAH ESSEN GORDON	CHARACTERNAME	SARAH ESSEN GORDON
SUNSET BAIN	CHARACTERNAME	SUNSET BAIN
HELLGRAMMITE	CHARACTERNAME	HELLGRAMMITE
STEEL	CHARACTERNAME	STEEL
CYBERNARY	CHARACTERNAME	CYBERNARY
CHRIS KL-99	CHARACTERNAME	CHRIS KL-99
MAN-BEAST	CHARACTERNAME	MAN-BEAST
PARMANU	CHARACTERNAME	PARMANU
TRANCE	CHARACTERNAME	TRANCE
OMEGA THE UNKNOWN	CHARACTERNAME	OMEGA THE UNKNOWN
BLINDFOLD	CHARACTERNAME	BLINDFOLD
MERCY	CHARACTERNAME	MERCY
DEVIL HULK	CHARACTERNAME	DEVIL HULK
KRYPTONITE MAN	CHARACTERNAME	KRYPTONITE MAN
MICROMAX	CHARACTERNAME	MICROMAX
DAN THE DYNA-MITE	CHARACTERNAME	DAN THE DYNA-MITE
FLUX	CHARACTERNAME	FLUX
GENTLE	CHARACTERNAME	GENTLE
BLACK SPIDER	CHARACTERNAME	BLACK SPIDER
SKULL THE SLAYER	CHARACTERNAME	SKULL THE SLAYER
MARK HAZZARD: MERC	CHARACTERNAME	MARK HAZZARD
TIGER	CHARACTERNAME	TIGER
AGENT ORANGE	CHARACTERNAME	AGENT ORANGE
MAN-BULL	CHARACTERNAME	MAN-BULL
BLACK TARANTULA	CHARACTERNAME	BLACK TARANTULA
BRICK	CHARACTERNAME	BRICK
WINDSHEAR	CHARACTERNAME	WINDSHEAR
SYNERGY	CHARACTERNAME	SYNERGY
HECTOR HAMMOND	CHARACTERNAME	HECTOR HAMMOND
ORKA	CHARACTERNAME	ORKA
LOBO BROTHERS	CHARACTERNAME	LOBO BROTHERS
JUGGERNAUT	CHARACTERNAME	JUGGERNAUT
KAIZEN GAMORRA	CHARACTERNAME	KAIZEN GAMORRA
PABLO'S INFERNO	CHARACTERNAME	PABLO
O-SENSEI	CHARACTERNAME	O-SENSEI
ALPHA CENTURION	CHARACTERNAME	ALPHA CENTURION
KEV HAWKINS	CHARACTERNAME	KEV HAWKINS
PLUTO	CHARACTERNAME	PLUTO
SENSEI	CHARACTERNAME	THE SENSEI
GARTH RANZZ	CHARACTERNAME	GARTH RANZZ
OFFSPRING	CHARACTERNAME	OFFSPRING
BLACK BOX	CHARACTERNAME	BLACK BOX
COLLECTIVE MAN	CHARACTERNAME	COLLECTIVE MAN
SCRAMBLER	CHARACTERNAME	SCRAMBLER
V	CHARACTERNAME	V
HARLEM HEROES	CHARACTERNAME	HARLEM HEROES
CLAW THE UNCONQUERED	CHARACTERNAME	CLAW
THOMAS KALMAKU	CHARACTERNAME	THOMAS KALMAKU
JASON BARD	CHARACTERNAME	JASON BARD
TITANIA	CHARACTERNAME	TITANIA
ARES	CHARACTERNAME	ARES
EVEY HAMMOND	CHARACTERNAME	EVEY HAMMOND
BHERIYA	CHARACTERNAME	BHERIYA
MURMUR	CHARACTERNAME	MURMUR
CHIEF	CHARACTERNAME	THE CHIEF
TABOO	CHARACTERNAME	TABOO
ONOMATOPOEIA	CHARACTERNAME	ONOMATOPOEIA
SUPER INDIAN	CHARACTERNAME	SUPER INDIAN
TITAN	CHARACTERNAME	TITAN
SUBLIME	CHARACTERNAME	SUBLIME
NOH-VARR	CHARACTERNAME	MARVEL BOY
RHAPSODY	CHARACTERNAME	RHAPSODY
SPEED	CHARACTERNAME	SPEED
MALCOLM COLCORD	CHARACTERNAME	DIRECTOR COLCORD
BRENT JACKSON	CHARACTERNAME	BRENT JACKSON
SUPERNOVA	CHARACTERNAME	SUPERNOVA
MATT BRADDOCK	CHARACTERNAME	MATT BRADDOCK
BIG WHEEL	CHARACTERNAME	BIG WHEEL
LACUNA	CHARACTERNAME	LACUNA
GRACE	CHARACTERNAME	GRACE
CIRCUIT BREAKER	CHARACTERNAME	CIRCUIT BREAKER
DARK ANGEL	CHARACTERNAME	DARK ANGEL
PEEPERS	CHARACTERNAME	PEEPERS
NETWORK	CHARACTERNAME	NETWORK
DRYAD	CHARACTERNAME	DRYAD
GIBBON	CHARACTERNAME	GIBBON
FASTBACK	CHARACTERNAME	FASTBACK
YANKEE POODLE	CHARACTERNAME	YANKEE POODLE
RUBBERDUCK	CHARACTERNAME	RUBBERDUCK
GORILLA-MAN	CHARACTERNAME	GORILLA-MAN
LITTLE CHEESE	CHARACTERNAME	LITTLE CHEESE
GRIGORI RASPUTIN	CHARACTERNAME	GRIGORI RASPUTIN
CYBERMANCER	CHARACTERNAME	CYBERMANCER
ACE OF SPADES	CHARACTERNAME	ACE OF SPADES
KITE MAN	CHARACTERNAME	KITE MAN
EON	CHARACTERNAME	EON
PROFESSOR OJO	CHARACTERNAME	PROFESSOR OJO
CONFESSOR	CHARACTERNAME	THE CONFESSOR
IRON MONGER	CHARACTERNAME	IRON MONGER
HENRIETTA HUNTER	CHARACTERNAME	HENRIETTA HUNTER
SPIKE	CHARACTERNAME	SPIKE
ZEITGEIST	CHARACTERNAME	ZEITGEIST
COACH	CHARACTERNAME	THE COACH
SPIKE FREEMAN	CHARACTERNAME	SPIKE FREEMAN
ARCHER	CHARACTERNAME	ARCHER
FIXX	CHARACTERNAME	FIXX
KID MARVELMAN	CHARACTERNAME	KID MARVELMAN
FANG	CHARACTERNAME	FANG
CROSSBONES	CHARACTERNAME	CROSSBONES
JIM CORRIGAN	CHARACTERNAME	JIM CORRIGAN
FIREBRAND	CHARACTERNAME	FIREBRAND
HAPPY HOGAN	CHARACTERNAME	HAPPY HOGAN
TWILIGHT	CHARACTERNAME	TWILIGHT
BLITHE	CHARACTERNAME	BLITHE
WILLIAM STRYKER	CHARACTERNAME	WILLIAM STRYKER
JAIME REYES	CHARACTERNAME	BLUE BEETLE
QUAKEMASTER	CHARACTERNAME	QUAKEMASTER
UNIVERSO	CHARACTERNAME	UNIVERSO
BLACK HAND	CHARACTERNAME	BLACK HAND
NUKE	CHARACTERNAME	NUKE
ETTA CANDY	CHARACTERNAME	ETTA CANDY
GEOFFREY WILDER	CHARACTERNAME	GEOFFREY WILDER
MARIA HILL	CHARACTERNAME	MARIA HILL
JOHN RYKER	CHARACTERNAME	GENERAL JOHN RYKER
HARPOON	CHARACTERNAME	HARPOON
METALHEAD	CHARACTERNAME	METALHEAD
MARTHA WAYNE	CHARACTERNAME	MARTHA WAYNE
MEANSTREAK	CHARACTERNAME	MEANSTREAK
SIN	CHARACTERNAME	SIN
MAGICIAN	CHARACTERNAME	MAGICIAN
VENGEANCE	CHARACTERNAME	VENGEANCE
JUNKPILE	CHARACTERNAME	JUNKPILE
KRYSTALIN	CHARACTERNAME	KRYSTALIN
ARES	CHARACTERNAME	ARES
XI'AN	CHARACTERNAME	XI'AN
CAPTAIN	CHARACTERNAME	CAPTAIN
KAT FARRELL	CHARACTERNAME	KAT FARRELL
HUMUS SAPIEN	CHARACTERNAME	HUMUS SAPIEN
ABRAHAM CORNELIUS	CHARACTERNAME	DOCTOR CORNELIUS
GOLDSTAR	CHARACTERNAME	GOLD STAR
SUPERPATRIOT	CHARACTERNAME	SUPERPATRIOT
MISTER FEAR	CHARACTERNAME	MISTER FEAR
THRENODY	CHARACTERNAME	THRENODY
MAHR VEHL	CHARACTERNAME	CAPTAIN MAHR VEHLL
OVERLORD	CHARACTERNAME	OVERLORD
THIN MAN	CHARACTERNAME	THIN MAN
WHIPLASH	CHARACTERNAME	BLACKLASH
WHIPLASH	CHARACTERNAME	WHIPLASH
RED RAVEN	CHARACTERNAME	RED RAVEN
DAVID MOREAU	CHARACTERNAME	THE GENEGINEER
IRENE MERRYWEATHER	CHARACTERNAME	IRENE MERRYWEATHER
GROWING MAN	CHARACTERNAME	THE GROWING MAN
LADY LIBERTY	CHARACTERNAME	LADY LIBERTY
MAYFLOWER	CHARACTERNAME	MAYFLOWER
SPARKLER	CHARACTERNAME	SPARKLER
ION	CHARACTERNAME	ION
N'ASTIRH	CHARACTERNAME	N'ASTIRH
HERCULES	CHARACTERNAME	HERCULES
NEBULA MAN	CHARACTERNAME	NEBULA MAN
SENTRY	CHARACTERNAME	SENTRY
AMERICAN DREAM	CHARACTERNAME	AMERICAN DREAM
ATOM	CHARACTERNAME	ATOM
MISS MISERY	CHARACTERNAME	MISS MISERY
AQUEDUCT	CHARACTERNAME	AQUEDUCT
COMET	CHARACTERNAME	THE COMET
FLY	CHARACTERNAME	THE FLY
XING LING	CHARACTERNAME	XING LING
XING LING	CHARACTERNAME	幸灵
DRACULA	CHARACTERNAME	DRACULA
WONDER BOY	CHARACTERNAME	WONDER BOY
BUZZ	CHARACTERNAME	THE BUZZ
MERLYN	CHARACTERNAME	MERLYN
CAPTAIN TRIUMPH	CHARACTERNAME	CAPTAIN TRIUMPH
SCANNER	CHARACTERNAME	SCANNER
STOMPA	CHARACTERNAME	STOMPA
BERNADETH	CHARACTERNAME	BERNADETH
MAD HARRIET	CHARACTERNAME	MAD HARRIET
BLOODY MARY	CHARACTERNAME	BLOODY MARY
GILOTINA	CHARACTERNAME	GILOTINA
MALICE VUNDABAR	CHARACTERNAME	MALICE VUNDABAR
ARTEMIZ	CHARACTERNAME	ARTEMIZ
CORDELIA FROST	CHARACTERNAME	CORDELIA FROST
GARGOUILLE	CHARACTERNAME	GARGOUILLE
MARCO DELGADO	CHARACTERNAME	MARCO DELGADO
SENYAKA	CHARACTERNAME	SENYAKA
PSI	CHARACTERNAME	PSI
SATAN GIRL	CHARACTERNAME	SATAN GIRL
WEB	CHARACTERNAME	THE WEB
HEGGRA	CHARACTERNAME	HEGGRA
POWERHOUSE	CHARACTERNAME	POWERHOUSE
HAWKMAN	CHARACTERNAME	HAWKMAN
HAWKMAN	CHARACTERNAME	HAWKMAN
HAWKMAN	CHARACTERNAME	HAWKMAN
KIANI	CHARACTERNAME	KIANI
TRITON	CHARACTERNAME	TRITON
G. W. BRIDGE	CHARACTERNAME	G.W. BRIDGE
MONSTRESS	CHARACTERNAME	MONSTRESS
DEAD BOY DETECTIVES	CHARACTERNAME	THE DEAD BOY DETECTIVES
MISTY KNIGHT	CHARACTERNAME	MISTY KNIGHT
HORNET	CHARACTERNAME	THE HORNET
HORNET	CHARACTERNAME	RED HORNET
MALIKAI	CHARACTERNAME	MALIKAI
FERON	CHARACTERNAME	FERON
SENTRY	CHARACTERNAME	THE SENTRY
VIRMAN VUNDABAR	CHARACTERNAME	VIRMAN VUNDABAR
LAW	CHARACTERNAME	LAW
STAR HAWKINS	CHARACTERNAME	STAR HAWKINS
SPACE RANGER	CHARACTERNAME	SPACE RANGER
ULTRA THE MULTI-ALIEN	CHARACTERNAME	ULTRA THE MULTI-ALIEN
TOMMY TOMORROW	CHARACTERNAME	TOMMY TOMORROW
SPEED QUEEN	CHARACTERNAME	SPEED QUEEN
WILDSIDE	CHARACTERNAME	WILDSIDE
LOCUS	CHARACTERNAME	LOCUS
FATALE	CHARACTERNAME	FATALE
LENA LUTHOR	CHARACTERNAME	LENA LUTHOR
EQUUS	CHARACTERNAME	EQUUS
EL AGUILA	CHARACTERNAME	EL ÁGUILA
NIKKI	CHARACTERNAME	NIKKI
TALON	CHARACTERNAME	TALON
ALLEN THE ALIEN	CHARACTERNAME	ALLEN THE ALIEN
NECROM	CHARACTERNAME	NECROM
MORTALLA	CHARACTERNAME	MORTALLA
NEGASONIC TEENAGE WARHEAD	CHARACTERNAME	NEGASONIC TEENAGE WARHEAD
SAMMY PARé	CHARACTERNAME	SQUID-BOY
HEATWAVE	CHARACTERNAME	HEATWAVE
CYBLADE	CHARACTERNAME	CYBLADE
FLINT	CHARACTERNAME	FLINT
FAHRENHEIT	CHARACTERNAME	FAHRENHEIT
DIVA	CHARACTERNAME	DIVA
CANNON	CHARACTERNAME	CANNON
KING BEDLAM	CHARACTERNAME	KING BEDLAM
DIAMOND LIL	CHARACTERNAME	DIAMOND LIL
TOBIAS WHALE	CHARACTERNAME	TOBIAS WHALE
CIRCE	CHARACTERNAME	CIRCE
SHAMAN	CHARACTERNAME	SHAMAN
RON TROUPE	CHARACTERNAME	RON TROUPE
NUKLO	CHARACTERNAME	NUKLO
TALISMAN	CHARACTERNAME	TALISMAN
ELSA BLOODSTONE	CHARACTERNAME	ELSA BLOODSTONE
DUELA DENT	CHARACTERNAME	DUELA DENT
BOX	CHARACTERNAME	BOX
GARGOYLE	CHARACTERNAME	GARGOYLE
S'YM	CHARACTERNAME	S'YM
MAINFRAME	CHARACTERNAME	MAINFRAME
JESSAN HOAN	CHARACTERNAME	TYGER TIGER
CRIMSON CURSE	CHARACTERNAME	CRIMSON CURSE
MISTER TERRIFIC	CHARACTERNAME	MISTER TERRIFIC
LADYHAWK	CHARACTERNAME	LADYHAWK
FELICITY HARDY	CHARACTERNAME	SCARLET SPIDER
CAT GRANT	CHARACTERNAME	CAT GRANT
PEPPER POTTS	CHARACTERNAME	PEPPER POTTS
DRAGONESS	CHARACTERNAME	DRAGONESS
ALPHA THE ULTIMATE MUTANT	CHARACTERNAME	ALPHA THE ULTIMATE MUTANT
RIPTIDE	CHARACTERNAME	RIPTIDE
GLOB HERMAN	CHARACTERNAME	GLOB HERMAN
PHASER	CHARACTERNAME	PHASER
TATTOO	CHARACTERNAME	TATTOO
MANIKIN	CHARACTERNAME	MANIKIN
JARELLA	CHARACTERNAME	JARELLA
HIPPOLYTA	CHARACTERNAME	HIPPOLYTA
LESLA-LAR	CHARACTERNAME	LESLA-LAR
STONEWALL	CHARACTERNAME	STONEWALL
ULTIMAN	CHARACTERNAME	ULTIMAN
MICROCHIP	CHARACTERNAME	MICROCHIP
CAMERON HODGE	CHARACTERNAME	CAMERON HODGE
ANDREA BEAUMONT	CHARACTERNAME	PHANTASM
RED RONIN	CHARACTERNAME	RED RONIN
COBALT MAN	CHARACTERNAME	COBALT MAN
HARRY LELAND	CHARACTERNAME	HARRY LELAND
JETSTREAM	CHARACTERNAME	JETSTREAM
COAL TIGER	CHARACTERNAME	COAL TIGER
BLACKLIGHT	CHARACTERNAME	BLACKLIGHT
DARK DOMINION	CHARACTERNAME	DARK DOMINION
DOUBLE DARE	CHARACTERNAME	DOUBLE DARE
SILENT ASSASSIN	CHARACTERNAME	SILENT ASSASSIN
MONARCH	CHARACTERNAME	MONARCH
ELECTRIC EVE	CHARACTERNAME	ELECTRIC EVE
LITTERBUG	CHARACTERNAME	LITTERBUG
TRADER	CHARACTERNAME	TRADER
CELL	CHARACTERNAME	CELL
ANGEL DUST	CHARACTERNAME	ANGEL DUST
SHATTER	CHARACTERNAME	SHATTER
NANCY LU	CHARACTERNAME	PUSH
YANKEE GIRL	CHARACTERNAME	YANKEE GIRL
TEXAS TWISTER	CHARACTERNAME	TEXAS TWISTER
WITCHFIRE	CHARACTERNAME	WITCHFIRE
BRUTE	CHARACTERNAME	BRUTE
DIRK ANGER	CHARACTERNAME	DIRK ANGER
MIDNIGHT'S FIRE	CHARACTERNAME	MIDNIGHT'S FIRE
SILHOUETTE	CHARACTERNAME	SILHOUETTE
KANTO	CHARACTERNAME	KANTO
STINGER	CHARACTERNAME	STINGER
SKYROCKET	CHARACTERNAME	SKYROCKET
SOLO	CHARACTERNAME	SOLO
JOSIAH X	CHARACTERNAME	JOSIAH X
FIN	CHARACTERNAME	THE FIN
LADY LOTUS	CHARACTERNAME	LADY LOTUS
WARRIOR WOMAN	CHARACTERNAME	WARRIOR WOMAN
SATANA	CHARACTERNAME	SATANA
ELIAS BOGAN	CHARACTERNAME	ELIAS BOGAN
RED LOTUS	CHARACTERNAME	RED LOTUS
THUNDERSTRIKE	CHARACTERNAME	THUNDERSTRIKE
PRUDENCE & CAUTION	CHARACTERNAME	PRUDENCE & CAUTION
SILVER SORCERESS	CHARACTERNAME	SILVER SORCERESS
DOGS OF WAR	CHARACTERNAME	DOGS OF WAR
JENNIFER KALE	CHARACTERNAME	JENNIFER KALE
TOPAZ	CHARACTERNAME	TOPAZ
SKEETS	CHARACTERNAME	SKEETS
MACHISTE	CHARACTERNAME	MACHISTE
ZEALOT	CHARACTERNAME	ZEALOT
JULIA AND VANESSA KAPATELIS	CHARACTERNAME	JULIA KAPATELIS
KELEX	CHARACTERNAME	KELEX
JOHNNY DEE	CHARACTERNAME	JOHNNY DEE
PSYCHO-MAN	CHARACTERNAME	PSYCHO-MAN
CONAN	CHARACTERNAME	CONAN THE BARBARIAN
BLACK CROW	CHARACTERNAME	BLACK CROW
VAMPIRE BY NIGHT	CHARACTERNAME	VAMPIRE BY NIGHT
HOT SHOT HAMISH AND MIGHTY MOUSE	CHARACTERNAME	HOT SHOT HAMISH AND MIGHTY MOUSE
ROMANY WISDOM	CHARACTERNAME	ROMANY WISDOM
FREEDOM RING	CHARACTERNAME	FREEDOM RING
HOLLY ROBINSON	CHARACTERNAME	HOLLY ROBINSON
WALTER HARDY	CHARACTERNAME	THE CAT
SHIVA	CHARACTERNAME	SHIVA
DEADLINE	CHARACTERNAME	DEADLINE
MYSTEK	CHARACTERNAME	MYSTEK
MUHAMMAD X	CHARACTERNAME	MUHAMMAD X
CRUSADER	CHARACTERNAME	CRUSADER
D'KEN	CHARACTERNAME	D'KEN
D'SPAYRE	CHARACTERNAME	D'SPAYRE
FAORA	CHARACTERNAME	FAORA
STROBE	CHARACTERNAME	STROBE
RANDALL DARBY	CHARACTERNAME	RANDALL DARBY
TETHER	CHARACTERNAME	TETHER
GIM ALLON	CHARACTERNAME	GIM ALLON
HYBRID	CHARACTERNAME	HYBRID
DOCTOR SUN	CHARACTERNAME	DOCTOR SUN
DARKOTH	CHARACTERNAME	DARKOTH
BARON BLOOD	CHARACTERNAME	BARON BLOOD
CONTROLLER	CHARACTERNAME	THE CONTROLLER
DREADKNIGHT	CHARACTERNAME	DREADKNIGHT
DREADNOUGHT	CHARACTERNAME	DREADNOUGHT
EQUINOX	CHARACTERNAME	EQUINOX
EEL	CHARACTERNAME	EEL
MACHINESMITH	CHARACTERNAME	MACHINESMITH
MALEKITH THE ACCURSED	CHARACTERNAME	MALEKITH THE ACCURSED
MASTER OF THE WORLD	CHARACTERNAME	MASTER OF THE WORLD
CHIEF EXAMINER	CHARACTERNAME	CHIEF EXAMINER
GUARDSMAN	CHARACTERNAME	GUARDSMAN
WILL O' THE WISP	CHARACTERNAME	WILL O' THE WISP
MASTER PANDEMONIUM	CHARACTERNAME	MASTER PANDEMONIUM
WONG	CHARACTERNAME	WONG
DOCTOR BONG	CHARACTERNAME	DOCTOR BONG
DOCTOR DEMONICUS	CHARACTERNAME	DOCTOR DEMONICUS
BURNER	CHARACTERNAME	BURNER
CROSSFIRE	CHARACTERNAME	CROSSFIRE
HELIX	CHARACTERNAME	HELIX
BI-BEAST	CHARACTERNAME	BI-BEAST
SURTUR	CHARACTERNAME	SURTUR
IKARIS	CHARACTERNAME	IKARIS
THENA	CHARACTERNAME	THENA
PHASTOS	CHARACTERNAME	PHASTOS
MAKKARI	CHARACTERNAME	MAKKARI
UNI-MIND	CHARACTERNAME	UNI-MIND
MORGAN LE FAY	CHARACTERNAME	MORGAN LE FAY
QUICKSAND	CHARACTERNAME	QUICKSAND
ASTRONOMER	CHARACTERNAME	ASTRONOMER
BLUE SHIELD	CHARACTERNAME	BLUE SHIELD
CONTEMPLATOR	CHARACTERNAME	CONTEMPLATOR
CORRUPTOR	CHARACTERNAME	CORRUPTOR
FAFNIR	CHARACTERNAME	FAFNIR
FLAG-SMASHER	CHARACTERNAME	FLAG-SMASHER
OBLITERATOR	CHARACTERNAME	OBLITERATOR
RUNNER	CHARACTERNAME	RUNNER
POSSESSOR	CHARACTERNAME	POSSESSOR
NIGHT NURSE	CHARACTERNAME	NIGHT NURSE
KARNILLA	CHARACTERNAME	KARNILLA
FRIGGA	CHARACTERNAME	FRIGGA
GLORIAN	CHARACTERNAME	GLORIAN
UNICORN	CHARACTERNAME	UNICORN
LIFTER	CHARACTERNAME	LIFTER
PESTILENCE	CHARACTERNAME	PESTILENCE
JANE FOSTER	CHARACTERNAME	JANE FOSTER
SMUGGLER	CHARACTERNAME	SMUGGLER
RINGER	CHARACTERNAME	THE RINGER
DAMON MATTHEWS	CHARACTERNAME	DAMON MATTHEWS
CHESSURE	CHARACTERNAME	CHESSURE
MR. NOBODY	CHARACTERNAME	MR. NOBODY
MATADOR	CHARACTERNAME	MATADOR
PERUN	CHARACTERNAME	PERUN
HUMBUG	CHARACTERNAME	HUMBUG
COLLEEN WING	CHARACTERNAME	COLLEEN WING
BLUE STREAK	CHARACTERNAME	BLUE STREAK
BLUE STREAK	CHARACTERNAME	BLUESTREAK
JUDGE SOLOMON	CHARACTERNAME	JUDGE SOLOMON
KRISTOFF VERNARD	CHARACTERNAME	KRISTOFF VERNARD
MIRACLE MAN	CHARACTERNAME	MIRACLE MAN
SALLY FLOYD	CHARACTERNAME	SALLY FLOYD
NAHREES	CHARACTERNAME	NAHREES
JOLEN	CHARACTERNAME	JOLEN
HOOD	CHARACTERNAME	THE HOOD
VINCENTE CIMETTA	CHARACTERNAME	VINCENTE CIMETTA
SOLARMAN	CHARACTERNAME	SOLARMAN
FIREBUG	CHARACTERNAME	FIREBUG
NANNY	CHARACTERNAME	NANNY
GREMLIN	CHARACTERNAME	GREMLIN
ORPHAN-MAKER	CHARACTERNAME	ORPHAN-MAKER
CRIMSON COMMANDO	CHARACTERNAME	CRIMSON COMMANDO
HELA	CHARACTERNAME	HELA
MAMMON	CHARACTERNAME	MAMMON
HEAP	CHARACTERNAME	THE HEAP
HERMOD	CHARACTERNAME	HERMOD
SIGYN	CHARACTERNAME	SIGYN
VOLLA	CHARACTERNAME	VOLLA
VIDAR	CHARACTERNAME	VIDAR
OSIRIS	CHARACTERNAME	OSIRIS
TORQUE	CHARACTERNAME	TORQUE
JOSHUA CLAY	CHARACTERNAME	JOSHUA CLAY
GILDED LILY	CHARACTERNAME	GILDED LILY
TYR	CHARACTERNAME	TYR
DEVIL-SLAYER	CHARACTERNAME	DEVIL-SLAYER
LUDI	CHARACTERNAME	LUDI
SLIGGUTH	CHARACTERNAME	SLIGGUTH
THOG	CHARACTERNAME	THOG
EVIL ERNIE	CHARACTERNAME	EVIL ERNIE
JACKIE JOKERS	CHARACTERNAME	JACKIE JOKERS
SATANNISH	CHARACTERNAME	SATANNISH
HARBINGER OF APOCALYPSE	CHARACTERNAME	THE HARBINGER OF APOCALYPSE
JET	CHARACTERNAME	JET
STRAW MAN	CHARACTERNAME	STRAW MAN
DRUIG	CHARACTERNAME	DRUIG
SPRITE	CHARACTERNAME	SPRITE
SKORNN	CHARACTERNAME	SKORNN
OBLIVION	CHARACTERNAME	OBLIVION
TEX THOMPSON	CHARACTERNAME	TEX THOMPSON
NEON THE UNKNOWN	CHARACTERNAME	NEON THE UNKNOWN
CHOPPER	CHARACTERNAME	CHOPPER
RED TORPEDO	CHARACTERNAME	RED TORPEDO
MAGNO	CHARACTERNAME	MAGNO
INVISIBLE HOOD	CHARACTERNAME	INVISIBLE HOOD
OSIRA	CHARACTERNAME	OSIRA
KNIGHT WATCHMAN	CHARACTERNAME	KNIGHT WATCHMAN
LAMPREY	CHARACTERNAME	LAMPREY
PINBALL	CHARACTERNAME	PINBALL
FOXFIRE	CHARACTERNAME	FOXFIRE
HAYWIRE	CHARACTERNAME	HAYWIRE
DEVILANCE	CHARACTERNAME	DEVILANCE THE PURSUER
OLIVIA REYNOLDS	CHARACTERNAME	OLIVIA REYNOLDS
MELTER	CHARACTERNAME	MELTER
SCIMITAR	CHARACTERNAME	SCIMITAR
CANNON AND SABER	CHARACTERNAME	CANNON AND SABER
RUNE	CHARACTERNAME	RUNE
T'CHAKA	CHARACTERNAME	T'CHAKA
SLUDGE	CHARACTERNAME	SLUDGE
CONTRARY	CHARACTERNAME	CONTRARY
PHARZOOF	CHARACTERNAME	PHARZOOF
ORB	CHARACTERNAME	THE ORB
GAMBLER	CHARACTERNAME	GAMBLER
JUDGE NILES	CHARACTERNAME	JUDGE NILES
MIDNIGHT	CHARACTERNAME	MIDNIGHT
ATALON	CHARACTERNAME	ATALON
CREOTE	CHARACTERNAME	CREOTE
TREMOR	CHARACTERNAME	TREMOR
CURSE	CHARACTERNAME	THE CURSE
STARDUST	CHARACTERNAME	STARDUST
INSECT QUEEN	CHARACTERNAME	INSECT QUEEN
PAIBOK	CHARACTERNAME	POWER SKRULL
DEVOS THE DEVASTATOR	CHARACTERNAME	DEVOS THE DEVASTATOR
ARGUS	CHARACTERNAME	ARGUS
NORMIE OSBORN	CHARACTERNAME	NORMIE OSBORN
TORGO	CHARACTERNAME	TORGO
ULTIMO	CHARACTERNAME	ULTIMO
INFECTIA	CHARACTERNAME	INFECTIA
KORG	CHARACTERNAME	KORG
MIEK	CHARACTERNAME	KING MIEK
X-CUTIONER	CHARACTERNAME	X-CUTIONER
AIRMAN	CHARACTERNAME	AIRMAN
ARROW	CHARACTERNAME	THE ARROW
XAVIN	CHARACTERNAME	XAVIN
SCORPIA	CHARACTERNAME	SCORPIA
JOHNNY RAYGUN	CHARACTERNAME	JOHNNY RAYGUN
ELVEN	CHARACTERNAME	ELVEN
PROTOTYPE	CHARACTERNAME	PROTOTYPE
RAFFERTY	CHARACTERNAME	RAFFERTY
HRIMHARI	CHARACTERNAME	HRIMHARI
ARON	CHARACTERNAME	ARON THE ROGUE WATCHER
TIMEWALKER	CHARACTERNAME	TIMEWALKER
MOTHERGOD	CHARACTERNAME	MOTHERGOD
WHITE TIGER	CHARACTERNAME	WHITE TIGER
SHROUD	CHARACTERNAME	SHROUD
SHORTPACK	CHARACTERNAME	SHORTPACK
FORBUSH MAN	CHARACTERNAME	FORBUSH MAN
JACK-A-DANDY	CHARACTERNAME	JACK-A-DANDY
NATIVE	CHARACTERNAME	THE NATIVE
JUNTA	CHARACTERNAME	JUNTA
DONALD & DEBORAH RITTER	CHARACTERNAME	DONALD RITTER
DONALD & DEBORAH RITTER	CHARACTERNAME	DEBORAH RITTER
PARADIGM	CHARACTERNAME	PARADIGM\NIMAGE=
DIRTNAP	CHARACTERNAME	DIRTNAP
CHIMERA	CHARACTERNAME	CHIMERA
FLASHBACK	CHARACTERNAME	FLASHBACK
HAVEN	CHARACTERNAME	HAVEN
SUPER-AXIS	CHARACTERNAME	SUPER-AXIS
JACK FLAG	CHARACTERNAME	JACK FLAG
DEMONS THREE	CHARACTERNAME	DEMONS THREE
BLACK THORN	CHARACTERNAME	BLACK THORN
MISTER MIRACLE	CHARACTERNAME	MISTER MIRACLE
VALENTINA VOSTOK	CHARACTERNAME	VALENTINA VOSTOK
DEATHCRY	CHARACTERNAME	DEATHCRY
MOSES MAGNUM	CHARACTERNAME	MOSES MAGNUM
DEVASTATOR	CHARACTERNAME	DEVASTATOR
MAULER	CHARACTERNAME	MAULER
SUNTURION	CHARACTERNAME	SUNTURION
IRON CORPORAL	CHARACTERNAME	IRON CORPORAL
DUPLI-KATE	CHARACTERNAME	DUPLI-KATE
DINAH SOAR	CHARACTERNAME	DINAH SOAR
STARSHINE	CHARACTERNAME	STARSHINE
BENJAMIN RICHARD PARKER	CHARACTERNAME	BENJAMIN PARKER
LOCUST	CHARACTERNAME	LOCUST
GHOST	CHARACTERNAME	GHOST
NUBIA	CHARACTERNAME	NUBIA / NU'BIA
GAMESMASTER	CHARACTERNAME	GAMESMASTER
MAXIMUM	CHARACTERNAME	MAXIMUM
TECHNOCRAT	CHARACTERNAME	TECHNOCRAT
CINNAMON	CHARACTERNAME	CINNAMON
HARNESS	CHARACTERNAME	HARNESS
GLOSS	CHARACTERNAME	GLOSS
AMERICOP	CHARACTERNAME	AMERICOP
JEFFREY GARRETT	CHARACTERNAME	JEFFREY GARRETT
MOON MAIDEN	CHARACTERNAME	MOON MAIDEN
DUPLICATE BOY	CHARACTERNAME	DUPLICATE BOY
YETI	CHARACTERNAME	YETI
KIWI BLACK	CHARACTERNAME	KIWI BLACK
SPOILSPORT	CHARACTERNAME	SPOILSPORT
NIGHTWIND	CHARACTERNAME	NIGHTWIND
HAZARD	CHARACTERNAME	HAZARD
RANDALL SHIRE	CHARACTERNAME	RANDALL SHIRE
MISS MARTIAN	CHARACTERNAME	MISS MARTIAN
NOCTURNA	CHARACTERNAME	NOCTURNA
NORMAN MCCAY	CHARACTERNAME	NORMAN MCCAY
NIGHT EAGLE	CHARACTERNAME	NIGHT EAGLE
TITANNUS	CHARACTERNAME	TITANNUS
NOVA	CHARACTERNAME	NOVA
GHOUL	CHARACTERNAME	GHOUL
PHAEDER	CHARACTERNAME	PHAEDER
GEPPETTO	CHARACTERNAME	GEPPETTO
TYPEFACE	CHARACTERNAME	TYPEFACE
THUNDERCLAP	CHARACTERNAME	THUNDERCLAP
GILDA DENT	CHARACTERNAME	GILDA DENT
KILLER SHRIKE	CHARACTERNAME	KILLER SHRIKE
PORCUPINE	CHARACTERNAME	PORCUPINE
NEEDLE	CHARACTERNAME	NEEDLE
SHOOTING STAR	CHARACTERNAME	SHOOTING STAR
PRETTY PERSUASIONS	CHARACTERNAME	PRETTY PERSUASIONS
KRAVEN THE HUNTER	CHARACTERNAME	KRAVEN THE HUNTER
BOODIKKA	CHARACTERNAME	BOODIKKA
SUPERWOMAN	CHARACTERNAME	SUPERWOMAN
NNAMDI	CHARACTERNAME	NNAMDI
DALLAS RIORDAN	CHARACTERNAME	DALLAS RIORDAN
MAXIMUS LOBO	CHARACTERNAME	MAXIMUS LOBO
SOLOMON O'SULLIVAN	CHARACTERNAME	SOLOMON O'SULLIVAN
MASTERMIND	CHARACTERNAME	MASTERMIND
SHARON GINSBERG	CHARACTERNAME	SHARON GINSBERG
BUSHMASTER	CHARACTERNAME	BUSHMASTER
CODENAME: FIREARM	CHARACTERNAME	CODENAME: FIREARM
SAM LANE	CHARACTERNAME	SAM LANE
SHREW	CHARACTERNAME	SHREW
SLAB	CHARACTERNAME	SLAB
PRINCE THUN	CHARACTERNAME	PRINCE THUN
HEBE	CHARACTERNAME	HEBE
JADE DRAGON	CHARACTERNAME	JADE DRAGON
WHISPER A'DAIRE	CHARACTERNAME	WHISPER A'DAIRE
TRI-SENTINEL	CHARACTERNAME	TRI-SENTINEL
KYLE ABBOT	CHARACTERNAME	KYLE ABBOT
TEZCATLIPOCA	CHARACTERNAME	TEZCATLIPOCA
MONGOOSE	CHARACTERNAME	MONGOOSE
OX	CHARACTERNAME	OX
PHIL URICH	CHARACTERNAME	PHIL URICH
MAD DOG	CHARACTERNAME	THE MAD DOG
ALPHA	CHARACTERNAME	ALPHA
VULCAN	CHARACTERNAME	VULCAN
SUPER SABRE	CHARACTERNAME	SUPER SABRE
PEDRO PENDUKO	CHARACTERNAME	PEDRO PENDUKO
ISIS	CHARACTERNAME	ISIS
SPACE CABBIE	CHARACTERNAME	SPACE CABBIE
MENDEL STROMM	CHARACTERNAME	DR. MENDEL STROMM
PHYLA-VELL	CHARACTERNAME	PHYLA-VELL
GLADIATRIX	CHARACTERNAME	GLADIATRIX
PRINCESS PYTHON	CHARACTERNAME	PRINCESS PYTHON
SPYNE	CHARACTERNAME	SPYNE
BOOMSLANG	CHARACTERNAME	BOOMSLANG
FER-DE-LANCE	CHARACTERNAME	FER-DE-LANCE
RAKKUS	CHARACTERNAME	RAKKUS
PHISHY MCPHISH	CHARACTERNAME	PHISHY MCPHISH
CAPTAIN AMERICA	CHARACTERNAME	THE GRAND DIRECTOR
ROCK PYTHON	CHARACTERNAME	ROCK PYTHON
BRODIE'S LAW	CHARACTERNAME	BRODIE'S LAW
BLACK RACER	CHARACTERNAME	BLACK RACER
TIGRESS	CHARACTERNAME	TIGRESS
COURIER	CHARACTERNAME	COURIER
RHEA JONES	CHARACTERNAME	RHEA JONES
CELSIUS	CHARACTERNAME	CELSIUS
HYPNO-HUSTLER	CHARACTERNAME	HYPNO-HUSTLER
SLYDE	CHARACTERNAME	SLYDE
SUPER WOMEN	CHARACTERNAME	SUPER WOMEN
CHARLOTTE JONES	CHARACTERNAME	CHARLOTTE JONES
GURAN	CHARACTERNAME	GURAN
ARTIE MADDICKS	CHARACTERNAME	ARTIE MADDICKS
SNOW WHITE	CHARACTERNAME	SNOW WHITE
PROTOCIDE	CHARACTERNAME	PROTOCIDE
LARRY TRASK	CHARACTERNAME	LARRY TRASK
DEBBIE GRAYSON	CHARACTERNAME	DEBBIE GRAYSON
ZEN THE INTERGALACTIC NINJA	CHARACTERNAME	ZEN THE INTERGALACTIC NINJA
SCORPION	CHARACTERNAME	SCORPION
THE CHECKERED DEMON	CHARACTERNAME	THE CHECKERED DEMON
ANELLE	CHARACTERNAME	ANELLE
MIRIAM SHARPE	CHARACTERNAME	MIRIAM SHARPE
DOROTHY SPINNER	CHARACTERNAME	DOROTHY SPINNER
BRIDGETTE CROSBY	CHARACTERNAME	BRIDGETTE CROSBY
ARIES	CHARACTERNAME	ARIES
RISQUE	CHARACTERNAME	RISQUE
FIRST AMERICAN	CHARACTERNAME	FIRST AMERICAN
SAUL	CHARACTERNAME	SAUL
SLITHER	CHARACTERNAME	SLITHER
JESSICA PRIEST	CHARACTERNAME	JESSICA PRIEST
MAN MOUNTAIN MARKO	CHARACTERNAME	MAN MOUNTAIN MARKO
NEBULA	CHARACTERNAME	NEBULA
MASKED MARAUDER	CHARACTERNAME	MASKED MARAUDER
COSMIC KING	CHARACTERNAME	COSMIC KING
BOY BLUE	CHARACTERNAME	BOY BLUE
ZEISS	CHARACTERNAME	ZEISS
WILDSTREAK	CHARACTERNAME	WILDSTREAK
COLDBLOOD	CHARACTERNAME	COLDBLOOD
POLESTAR	CHARACTERNAME	POLESTAR
STEGRON	CHARACTERNAME	STEGRON
LEILA DAVIS	CHARACTERNAME	LEILA DAVIS
CRIMSON COWL	CHARACTERNAME	CRIMSON COWL
TICK-TOCK	CHARACTERNAME	TICK-TOCK
N'KANTU, THE LIVING MUMMY	CHARACTERNAME	LIVING MUMMY
PHONE RANGER	CHARACTERNAME	PHONE RANGER
WITCHFIRE	CHARACTERNAME	WITCHFIRE
PROFILE	CHARACTERNAME	THE PROFILE
SHEPARD	CHARACTERNAME	SHEPARD
PRUDENCE LEIGHTON	CHARACTERNAME	QUIET MAN
STRINGFELLOW	CHARACTERNAME	STRINGFELLOW
ZARAN	CHARACTERNAME	ZARAN
ZARAN	CHARACTERNAME	ZARAN II
SMILING TIGER	CHARACTERNAME	SMILING TIGER
BLOODSTRIKE	CHARACTERNAME	BLOODSTRIKE
PRIMUS	CHARACTERNAME	PRIMUS
SILK FEVER	CHARACTERNAME	SILK FEVER
OVERMIND	CHARACTERNAME	OVERMIND
BOZO THE IRON MAN	CHARACTERNAME	BOZO THE IRON MAN
DANNY THE STREET	CHARACTERNAME	DANNY THE STREET
JUDGE SHENKER	CHARACTERNAME	JUDGE SHENKER
CRULE	CHARACTERNAME	CRULE
METEORITE	CHARACTERNAME	METEORITE
WILL MAGNUS	CHARACTERNAME	WILL MAGNUS
HERMAN VON KLEMPT	CHARACTERNAME	HERMAN VON KLEMPT
KAMIKAZE	CHARACTERNAME	KAMIKAZE
MERLIN	CHARACTERNAME	MERLIN
PROFESSOR NIGHT	CHARACTERNAME	PROFESSOR NIGHT
DUBBILEX	CHARACTERNAME	DUBBILEX
METEOR MAN	CHARACTERNAME	METEOR MAN
OGRE	CHARACTERNAME	OGRE
OMEGA	CHARACTERNAME	OMEGA
8-BALL	CHARACTERNAME	8
ALKHEMA	CHARACTERNAME	ALKHEMA
AMINEDI	CHARACTERNAME	AMINEDI
MODAM	CHARACTERNAME	MODAM
STRATA	CHARACTERNAME	STRATA
SIROCCO	CHARACTERNAME	SIROCCO
JUDGE GRICE	CHARACTERNAME	JUDGE GRICE
HUB	CHARACTERNAME	HUB
LUPO	CHARACTERNAME	LUPO
PISTOLERA	CHARACTERNAME	PISTOLERA
MATCH	CHARACTERNAME	MATCH
TREMOLO	CHARACTERNAME	TREMOLO
LEO ZELINSKY	CHARACTERNAME	ZELINSKY, LEO
TYR	CHARACTERNAME	TYR
WARLOCK'S DAUGHTER	CHARACTERNAME	WARLOCK'S DAUGHTER
BILLY KINCAID	CHARACTERNAME	BILLY KINCAID
TORQUEMADA	CHARACTERNAME	TORQUEMADA
BRIMSTONE LOVE	CHARACTERNAME	BRIMSTONE LOVE
FREDERICK SLADE	CHARACTERNAME	FREDERICK SLADE
SILVER ST. CLOUD	CHARACTERNAME	SILVER ST. CLOUD
AFTERSHOCK	CHARACTERNAME	AFTERSHOCK
DAVA	CHARACTERNAME	DAVA
DABNEY DONOVAN	CHARACTERNAME	DABNEY DONOVAN
HERCULES	CHARACTERNAME	HERCULES
PINK PEARL	CHARACTERNAME	PINK PEARL
PINOCCHIO	CHARACTERNAME	PINOCCHIO
POUNDCAKES	CHARACTERNAME	POUNDCAKES
AMERICAN ACE	CHARACTERNAME	AMERICAN ACE
BLACK MARVEL	CHARACTERNAME	BLACK MARVEL
BLUE DIAMOND	CHARACTERNAME	THE BLUE DIAMOND
JACK FROST	CHARACTERNAME	JACK FROST
SPIRIT OF '76	CHARACTERNAME	SPIRIT OF '76
ZARA	CHARACTERNAME	ZARA, PRIESTESS OF THE CRIMSON FLAME
DOCTOR POISON	CHARACTERNAME	DOCTOR POISON I
DOCTOR POISON	CHARACTERNAME	DOCTOR POISON
ISBISA	CHARACTERNAME	ISBISA
SUN GIRL	CHARACTERNAME	SUN GIRL
KRONOS	CHARACTERNAME	KRONOS
MENTOR	CHARACTERNAME	MENTOR
HYPNOTA	CHARACTERNAME	HYPNOTA THE GREAT
STARBOLT	CHARACTERNAME	STARBOLT
EVILESS	CHARACTERNAME	EVILESS
WING	CHARACTERNAME	WING
DOCTOR IMPOSSIBLE	CHARACTERNAME	DOCTOR IMPOSSIBLE
TIFFANY	CHARACTERNAME	TIFFANY
BLOODSHED	CHARACTERNAME	BLOODSHED
GHOST MAKER	CHARACTERNAME	GHOST MAKER
GOLDBUG	CHARACTERNAME	GOLDBUG
G.I. ROBOT	CHARACTERNAME	G.I. ROBOT
DUKE OF DECEPTION	CHARACTERNAME	DUKE OF DECEPTION
RED PANZER	CHARACTERNAME	RED PANZER
EGG FU	CHARACTERNAME	EGG FU
DEATHWATCH	CHARACTERNAME	DEATHWATCH
QUEEN CLEA	CHARACTERNAME	QUEEN CLEA
BLUE SNOWMAN	CHARACTERNAME	BLUE SNOWMAN
DECAY	CHARACTERNAME	DECAY
CAPTAIN WONDER	CHARACTERNAME	CAPTAIN WONDER
VITA-MAN	CHARACTERNAME	VITA-MAN
ASYLUM	CHARACTERNAME	ASYLUM
JACK HORNER	CHARACTERNAME	JACK HORNER
THUNDER GIRL	CHARACTERNAME	THUNDER GIRL
MISTER U.S.	CHARACTERNAME	MISTER U.S.
PORTAL	CHARACTERNAME	PORTAL
TOYO HARADA	CHARACTERNAME	TOYO HARADA
RAZORBACK	CHARACTERNAME	RAZORBACK
MARCO	CHARACTERNAME	MARCO
SILENT KNIGHT	CHARACTERNAME	SILENT KNIGHT
SUPER-CHIEF	CHARACTERNAME	SUPER-CHIEF
MS. MYSTIC	CHARACTERNAME	MS. MYSTIC
BULLETPROOF	CHARACTERNAME	BULLETPROOF
MR. MARTIAN	CHARACTERNAME	MR. MARTIAN
MIGHTY MAN	CHARACTERNAME	MIGHTY MAN
VALERIE PEREZ	CHARACTERNAME	VALERIE PEREZ
BRUNO MANNHEIM	CHARACTERNAME	BRUNO MANNHEIM
MOXIE %22BOSS%22 MANNHEIM	CHARACTERNAME	BOSS MOXIE
HYDROMAN	CHARACTERNAME	HYDROMAN
FEEDBACK	CHARACTERNAME	FEEDBACK
DUMMY	CHARACTERNAME	DUMMY
DREAMSLAYER	CHARACTERNAME	DREAMSLAYER
GORGON	CHARACTERNAME	GORGON
HADES	CHARACTERNAME	HADES
LORD HAVOK	CHARACTERNAME	LORD HAVOK
BEACON	CHARACTERNAME	THE BEACON
SHOJUN THE WARLORD	CHARACTERNAME	SHOJUN, WARLORD OF JI
SHADOW SLASHER	CHARACTERNAME	SHADOW SLASHER
BULWARK	CHARACTERNAME	BULWARK
BOMB QUEEN	CHARACTERNAME	BOMB QUEEN
JUDGE RICO	CHARACTERNAME	JUDGE RICO
JUDGE GIANT	CHARACTERNAME	JUDGE GIANT
JUDGE GIANT	CHARACTERNAME	JOHN \
QUEEN DESIRA	CHARACTERNAME	QUEEN DESIRA OF VENUS
JUDGE BUELL	CHARACTERNAME	JUDGE BUELL
SUN GIRL	CHARACTERNAME	SUN GIRL
I CHING	CHARACTERNAME	I CHING
TRISH TILBY	CHARACTERNAME	TRISH TILBY
MINISTER BLIZZARD	CHARACTERNAME	MINISTER BLIZZARD
DIANA PALMER	CHARACTERNAME	DIANE PALMER
QUEEN OF FABLES	CHARACTERNAME	QUEEN OF FABLES
RAMA	CHARACTERNAME	RAMA
STARR THE SLAYER	CHARACTERNAME	STARR THE SLAYER
ORANA	CHARACTERNAME	ORANA
EMMA STEED	CHARACTERNAME	BLACK QUEEN
SHIM'TAR	CHARACTERNAME	SHIM'TAR
JUDGE EDGAR	CHARACTERNAME	JUDGE EDGAR
EL PAPAGAYO	CHARACTERNAME	EL PAPAGAYO
SPIROU	CHARACTERNAME	SPIROU
PANARA	CHARACTERNAME	PANARA
TEZCATLIPOCA	CHARACTERNAME	TEZCATLIPOCA
TEZCATLIPOCA	CHARACTERNAME	TEZCATLIPOCA II
DR. WEIRD	CHARACTERNAME	DR. WEIRD
PROTOPLASMAN	CHARACTERNAME	PROTOPLASMAN
VALDA THE IRON MAIDEN	CHARACTERNAME	VALDA
WHITE TIGER	CHARACTERNAME	WHITE TIGER
KOZIOłEK MATOłEK	CHARACTERNAME	KOZIOłEK MATOłEK
MOON-BOY	CHARACTERNAME	MOON-BOY
NORRIN WEISMEYER	CHARACTERNAME	NORRIN WEISMEYER
ROBOT	CHARACTERNAME	ROBOT
DESTINY	CHARACTERNAME	DESTINY
DESTINY	CHARACTERNAME	DESTINY
LORELEI	CHARACTERNAME	LORELEI
TIM TRENCH	CHARACTERNAME	TIM TRENCH
NM-E	CHARACTERNAME	NM-E
NEUTRON	CHARACTERNAME	NEUTRON
PROFESSOR POWER	CHARACTERNAME	PROFESSOR POWER
MAD DOG	CHARACTERNAME	MAD-DOG
SELBY	CHARACTERNAME	SELBY
PINKY PINKERTON	CHARACTERNAME	PINKY PINKERTON
ERIC KOENIG	CHARACTERNAME	ERIC KOENIG
GABE JONES	CHARACTERNAME	GABE JONES
JUNIOR JUNIPER	CHARACTERNAME	JUNIOR JUNIPER
REBEL RALSTON	CHARACTERNAME	REBEL RALSTON
HAPPY SAM SAWYER	CHARACTERNAME	HAPPY SAM SAWYER
NAIAD	CHARACTERNAME	NAIAD
VERONICA CALE	CHARACTERNAME	VERONICA CALE
FASAUD	CHARACTERNAME	FASAUD
MERRY PEMBERTON	CHARACTERNAME	MERRY CREAMER PEMBERTON KING
711	CHARACTERNAME	#711
JESTER	CHARACTERNAME	THE JESTER
JIGSAW	CHARACTERNAME	JIGSAW
JIGSAW	CHARACTERNAME	JIGSAW
HERR KLEISER	CHARACTERNAME	HERR KLEISER
SNAKE MARSTON	CHARACTERNAME	SNAKE MARSTON
MACHETE	CHARACTERNAME	MACHETE
GRINDHOUSE	CHARACTERNAME	GRINDHOUSE
FOUNDRY	CHARACTERNAME	FOUNDRY
SHOCKWAVE	CHARACTERNAME	SHOCKWAVE
ROXXAS	CHARACTERNAME	ROXXAS
PERRIKUS	CHARACTERNAME	PERRIKUS
SCHIZOID MAN	CHARACTERNAME	SCHIZOID MAN
FRIEDRICH VON ROEHM	CHARACTERNAME	FRIEDRICH VON ROEHM
WENDY AND MARVIN	CHARACTERNAME	WENDY AND MARVIN
CAROL FERRIS	CHARACTERNAME	CAROL FERRIS
PAULA BROOKS	CHARACTERNAME	PAULA BROOKS
HAZARD	CHARACTERNAME	HAZARD
MIDGARD SERPENT	CHARACTERNAME	THE MIDGARD SERPENT
JEMM	CHARACTERNAME	JEMM
WITNESS	CHARACTERNAME	THE WITNESS
BEVERLY SWITZLER	CHARACTERNAME	BEVERLY SWITZLER
ELEPHANT MAN	CHARACTERNAME	ELEPHANT MAN
GOLDILOCKS	CHARACTERNAME	GOLDILOCKS
WUNDA	CHARACTERNAME	WUNDA
BAHADUR	CHARACTERNAME	BAHADUR
PANDORA	CHARACTERNAME	PANDORA
THE CREECH	CHARACTERNAME	THE CREECH
DIGITEK	CHARACTERNAME	DIGITEK
HOSS	CHARACTERNAME	HOSS
ECSTASY	CHARACTERNAME	ECSTASY
LIBRA	CHARACTERNAME	LIBRA
DRAGONFLY	CHARACTERNAME	DRAGONFLY
LAGOON BOY	CHARACTERNAME	LAGOON BOY
SOLITAIRE	CHARACTERNAME	SOLITAIRE
BEEFEATER	CHARACTERNAME	THE BEEFEATER
KAZANN	CHARACTERNAME	KAZANN
NON	CHARACTERNAME	NON
MISTER ATOM	CHARACTERNAME	MISTER ATOM
ENIGMA	CHARACTERNAME	ENIGMA
DAN DUNN	CHARACTERNAME	DAN DUNN
OSIRIS	CHARACTERNAME	OSIRIS
MADAME SANCTITY	CHARACTERNAME	MADAME SANCTITY
SYLVESTER PEMBERTON	CHARACTERNAME	SYLVESTER PEMBERTON
BOMBSHELL	CHARACTERNAME	BOMBSHELL
RUBY THURSDAY	CHARACTERNAME	RUBY THURSDAY
YOUNG FRANKENSTEIN	CHARACTERNAME	YOUNG FRANKENSTEIN
HUNTSMAN	CHARACTERNAME	HUNTSMAN
ERIC O'GRADY	CHARACTERNAME	ERIC O'GRADY
HIJITUS	CHARACTERNAME	HIJITUS
DOCTOR FAUSTUS	CHARACTERNAME	DOCTOR FAUSTUS
WILDFIRE	CHARACTERNAME	WILDFIRE
BOOTLEG	CHARACTERNAME	BOOTLEG
THORN	CHARACTERNAME	THORN
ANSWER	CHARACTERNAME	ANSWER
SATANUS	CHARACTERNAME	SATANUS
CUTTHROAT	CHARACTERNAME	CUTTHROAT
VANGUARD	CHARACTERNAME	VANGUARD
CRIMSON AVENGER	CHARACTERNAME	CRIMSON AVENGER
RAY	CHARACTERNAME	THE RAY
SHE-DRAGON	CHARACTERNAME	SHE-DRAGON
SIREN	CHARACTERNAME	SIREN
ERIK KILLMONGER	CHARACTERNAME	ERIK KILLMONGER
TWELVE BROTHERS IN SILK	CHARACTERNAME	WHITE CANARY
YOUNG MARVELMAN	CHARACTERNAME	YOUNG MARVELMAN
GARGANTUA	CHARACTERNAME	GARGANTUA
MONICA RAPPACCINI	CHARACTERNAME	MONICA RAPPACCINI
WALTER THE WOBOT	CHARACTERNAME	WALTER THE WOBOT
ARMON GILL	CHARACTERNAME	ARMON GILL
COGNOSCENTI	CHARACTERNAME	COGNESCENTI
GOLEM	CHARACTERNAME	GOLEM
GORGOLLA	CHARACTERNAME	GORGOLLA
GLOB	CHARACTERNAME	GLOB
GOOM	CHARACTERNAME	GOOM
GROOT	CHARACTERNAME	GROOT
IT! THE LIVING COLOSSUS	CHARACTERNAME	IT! THE LIVING COLOSSUS
MANPHIBIAN	CHARACTERNAME	MANPHIBIAN
HUNTRESS	CHARACTERNAME	HUNTRESS
HUNTRESS	CHARACTERNAME	HUNTRESS
ORRGO	CHARACTERNAME	ORRGO
ROBOTMAN	CHARACTERNAME	ROBOTMAN
CLAY QUARTERMAIN	CHARACTERNAME	CLAY QUARTERMAIN
ROBOTMAN	CHARACTERNAME	ROBOTMAN
JOHNNY QUICK	CHARACTERNAME	JOHNNY QUICK
WARWOLF	CHARACTERNAME	WARWOLF
ZOMBIE	CHARACTERNAME	ZOMBIE
DETECTIVE-JUDGE ARMITAGE	CHARACTERNAME	DETECTIVE-JUDGE ARMITAGE
PRESTER JOHN	CHARACTERNAME	PRESTER JOHN
CONSTRUCT	CHARACTERNAME	CONSTRUCT
CYCLOTRON	CHARACTERNAME	CYCLOTRON
X'HAL	CHARACTERNAME	X'HAL
MULTI-MAN	CHARACTERNAME	MULTI-MAN
DOMINIC FORTUNE	CHARACTERNAME	DOMINIC FORTUNE
PRINCE EVILLO	CHARACTERNAME	PRINCE EVILLO
CALEB HAMMER	CHARACTERNAME	CALEB HAMMER
MODRED THE MYSTIC	CHARACTERNAME	MODRED THE MYSTIC
DAWN	CHARACTERNAME	DAWN
ZACHARY ZATARA	CHARACTERNAME	ZACHARY ZATARA
LORELEI	CHARACTERNAME	LORELEI
JESTER	CHARACTERNAME	JESTER
LYNX	CHARACTERNAME	LYNX
OTTO SUMP	CHARACTERNAME	OTTO SUMP
GALEN DEMARCO	CHARACTERNAME	GALEN DEMARCO
GOSAMYR	CHARACTERNAME	GOSAMYR
SNAPDRAGON	CHARACTERNAME	SNAPDRAGON
STALKER	CHARACTERNAME	STALKER
JONNY DOUBLE	CHARACTERNAME	JONNY DOUBLE
BOMBSHELL	CHARACTERNAME	BOMBSHELL
FANTOM OF THE FAIR	CHARACTERNAME	FANTOM OF THE FAIR
FATHER TIME	CHARACTERNAME	FATHER TIME
MISTER NO	CHARACTERNAME	MISTER NO
MOPEE	CHARACTERNAME	MOPEE
STAN LEE	CHARACTERNAME	STAN LEE
WUNDARR THE AQUARIAN	CHARACTERNAME	WUNDARR THE AQUARIAN
CAVALIER	CHARACTERNAME	THE CAVALIER
PETER %22STING%22 STANCHEK	CHARACTERNAME	STING
COMET QUEEN	CHARACTERNAME	COMET QUEEN
KRANG	CHARACTERNAME	KRANG
GOLDEN KNIGHT	CHARACTERNAME	GOLDEN KNIGHT
LOOSE CANNON	CHARACTERNAME	LOOSE CANNON
MUSTANG IRONHEART	CHARACTERNAME	MUSTANG IRONHEART
BROTHERS GRIMM	CHARACTERNAME	BROTHERS GRIMM
SKYMAN	CHARACTERNAME	THE SKYMAN
FAUSTUS	CHARACTERNAME	FAUSTUS
WEASEL	CHARACTERNAME	WEASEL
PJ MAYBE	CHARACTERNAME	PJ MAYBE
BYRRAH	CHARACTERNAME	BYRRAH
HULK ROBOT	CHARACTERNAME	HULK ROBOT
BARON BRIMSTONE	CHARACTERNAME	BARON BRIMSTONE
MOUTHPIECE	CHARACTERNAME	MOUTHPIECE
DIGGER	CHARACTERNAME	DIGGER
TIMMY THE TIMID GHOST	CHARACTERNAME	TIMMY THE TIMID GHOST
ELAINE BELLOC	CHARACTERNAME	ELAINE BELLOC
ANI-MATOR	CHARACTERNAME	ANI-MATOR
BIRD-BRAIN	CHARACTERNAME	BIRD-BRAIN
BLACK FOX	CHARACTERNAME	BLACK FOX
KILLER WASP	CHARACTERNAME	KILLER WASP
VENOM	CHARACTERNAME	VENOM
BATMAN	CHARACTERNAME	BATMAN
SAL MARONI	CHARACTERNAME	SAL MARONI
JIMMY WOO	CHARACTERNAME	JIMMY WOO
MISS ARROW	CHARACTERNAME	MISS ARROW
PRESENCE	CHARACTERNAME	THE PRESENCE
VALENTINA ALLEGRA DE FONTAINE	CHARACTERNAME	CONTESSA VALENTINA ALLEGRA DE LA FONTAINE
WILLOW	CHARACTERNAME	WILLOW
MIRAGE	CHARACTERNAME	MIRAGE
FORCE	CHARACTERNAME	FORCE
GIANTS	CHARACTERNAME	GIANTS
GROG	CHARACTERNAME	GROG
HEADLOK	CHARACTERNAME	HEADLOK
PRYSM	CHARACTERNAME	PRYSM
PHINEAS HORTON	CHARACTERNAME	PHINEAS T. HORTON
KALA	CHARACTERNAME	KALA
VIKING PRINCE	CHARACTERNAME	VIKING PRINCE
KALUU	CHARACTERNAME	KALUU
GREEN MASK	CHARACTERNAME	THE GREEN MASK
AMAZING-MAN	CHARACTERNAME	AMAZING-MAN
LEFT-WINGER	CHARACTERNAME	LEFT-WINGER
LEIR	CHARACTERNAME	LEIR
DAMIAN TRYP	CHARACTERNAME	DAMIAN TRYP
LUMA LYNAI	CHARACTERNAME	LUMA LYNAI
DAMIAN WAYNE	CHARACTERNAME	DAMIAN WAYNE
SKRULLIAN SKYMASTER	CHARACTERNAME	SKRULLIAN SKYMASTER
BOUNCER	CHARACTERNAME	THE BOUNCER
SHAPESMITH	CHARACTERNAME	SHAPESMITH
HEPZIBAH	CHARACTERNAME	HEPZIBAH
RAZA LONGKNIFE	CHARACTERNAME	RAZA
FLYING TIGER	CHARACTERNAME	FLYING TIGER
JACKHAMMER	CHARACTERNAME	JACKHAMMER
ODDBALL	CHARACTERNAME	ODDBALL
POWDERKEG	CHARACTERNAME	POWDERKEG
BLACKWING	CHARACTERNAME	BLACKWING
LODESTONE	CHARACTERNAME	LODESTONE
SCORCHER	CHARACTERNAME	SCORCHER
SAMSON	CHARACTERNAME	SAMSON
FLAME	CHARACTERNAME	THE FLAME
TITAN	CHARACTERNAME	TITAN
NUMINUS	CHARACTERNAME	NUMINUS
TEK JANSEN	CHARACTERNAME	TEK JANSEN
PEREGRINE	CHARACTERNAME	PEREGRINE
ALEXANDER GOODWIN PIERCE	CHARACTERNAME	ALEXANDER GOODWIN PIERCE
POISON	CHARACTERNAME	POISON
HARRY STEIN	CHARACTERNAME	HARRY STEIN
BORK	CHARACTERNAME	BORK
JAMES POWER	CHARACTERNAME	DR. JAMES \
MARGARET POWER	CHARACTERNAME	MARGARET POWER
VAMPIRE	CHARACTERNAME	NOMAK
RED WOLF	CHARACTERNAME	RED WOLF
RIGHT-WINGER	CHARACTERNAME	RIGHT-WINGER
ARNOLD JOHN FLASS	CHARACTERNAME	ARNOLD FLASS
EMISSARY	CHARACTERNAME	EMISSARY
LOOTER	CHARACTERNAME	LOOTER
SHALLA-BAL	CHARACTERNAME	SHALLA-BAL
WEIRD	CHARACTERNAME	THE WEIRD
BRONZE MAN	CHARACTERNAME	BRONZE MAN
ALPHONSE %22BIG BOY%22 CAPRICE	CHARACTERNAME	\
X	CHARACTERNAME	X
RAA OF THE CAVES	CHARACTERNAME	RAA OF THE CAVES
SPYDER	CHARACTERNAME	SPYDER
MIDNIGHT SUN	CHARACTERNAME	MIDNIGHT SUN
BLACK JACK TARR	CHARACTERNAME	BLACK JACK TARR
TRICK SHOT	CHARACTERNAME	TRICK SHOT
TYRAK	CHARACTERNAME	TYRAK
MERCURIO THE 4-D MAN	CHARACTERNAME	MERCURIO THE 4-D MAN
CYCLONE	CHARACTERNAME	CYCLONE
CHRIS KENT	CHARACTERNAME	CHRISTOPHER KENT
JASPER SITWELL	CHARACTERNAME	JASPER SITWELL
WHITEOUT	CHARACTERNAME	WHITEOUT
BATWING	CHARACTERNAME	BATWING
JOHN CARIK	CHARACTERNAME	JOHN CARIK
WORM	CHARACTERNAME	WORM
MOTORMOUTH	CHARACTERNAME	MOTORMOUTH
ANT	CHARACTERNAME	THE ANT
PASCO	CHARACTERNAME	PASCO
ARAGORN	CHARACTERNAME	ARAGORN
MASKED RAIDER	CHARACTERNAME	THE MASKED RAIDER
BLACK PIRATE	CHARACTERNAME	THE BLACK PIRATE
RUMIKO FUJIKAWA	CHARACTERNAME	RUMIKO FUJIKAWA
MASKED MARVEL	CHARACTERNAME	THE MASKED MARVEL
ENTROPY	CHARACTERNAME	ENTROPY
DARK ANGEL	CHARACTERNAME	DARK ANGEL
STRONGMAN	CHARACTERNAME	STRONGMAN
CLOWN	CHARACTERNAME	THE CLOWN
MISFIT	CHARACTERNAME	MISFIT
HUMAN CANNONBALL	CHARACTERNAME	HUMAN CANNONBALL
GREAT GAMBONNOS	CHARACTERNAME	GREAT GAMBONNOS
STEPPIN' RAZOR	CHARACTERNAME	STEPPIN' RAZOR
DMITRI BUKHARIN	CHARACTERNAME	DMITRI BUKHARIN
ASMODEUS	CHARACTERNAME	ASMODEUS
NULL	CHARACTERNAME	NULL
JEZEBELLE	CHARACTERNAME	JEZEBELLE
ASTERIX	CHARACTERNAME	ASTERIX
MAMMOTH	CHARACTERNAME	MAMMOTH
SHIMMER	CHARACTERNAME	SHIMMER
HAMILTON SLADE	CHARACTERNAME	HAMILTON SLADE
ROBIN	CHARACTERNAME	ROBIN
KARL MALUS	CHARACTERNAME	DR. KARL MALUS
FANCY DAN	CHARACTERNAME	FANCY DAN
MONTANA	CHARACTERNAME	MONTANA
FENRIS WOLF	CHARACTERNAME	FENRIS WOLF
WRATH	CHARACTERNAME	THE WRATH
ARM-FALL-OFF-BOY	CHARACTERNAME	ARM FALL OFF BOY
ARKILLO	CHARACTERNAME	ARKILLO
FRANKENSTEIN'S MONSTER	CHARACTERNAME	FRANKENSTEIN'S MONSTER
AJAX	CHARACTERNAME	AJAX
GHOST RIDER	CHARACTERNAME	GHOST RIDER
GHOST RIDER	CHARACTERNAME	GHOST RIDER
CAIERA	CHARACTERNAME	CAIERA
LETHA	CHARACTERNAME	LETHA
WONDER WOMAN	CHARACTERNAME	WONDER WOMAN
VELOCITY	CHARACTERNAME	VELOCITY
GEIST	CHARACTERNAME	GEIST
MADMEN	CHARACTERNAME	THE MADMEN
SCALPHUNTER	CHARACTERNAME	SCALPHUNTER
UNION JACK	CHARACTERNAME	UNION JACK
CAPTAIN STINGAREE	CHARACTERNAME	CAPTAIN STINGAREE
DEMI THE DEMONESS	CHARACTERNAME	DEMI THE DEMONESS
SUPERMAN	CHARACTERNAME	SUPERMAN
HARM	CHARACTERNAME	HARM
RULAH, JUNGLE GODDESS	CHARACTERNAME	RULAH, JUNGLE GODDESS
SPIDER QUEEN	CHARACTERNAME	SPIDER QUEEN
DYNAMO	CHARACTERNAME	DYNAMO
ZAGO	CHARACTERNAME	ZAGO
DAGAR, THE DESERT HAWK	CHARACTERNAME	DAGAR, THE DESERT HAWK
JO-JO, CONGO KING	CHARACTERNAME	JO-JO, CONGO KING
LADY STYX	CHARACTERNAME	LADY STYX
MOCKER	CHARACTERNAME	THE MOCKER
KID SUPREME	CHARACTERNAME	KID SUPREME
KIMURA	CHARACTERNAME	KIMURA
AHURA	CHARACTERNAME	AHURA
KILLPOWER	CHARACTERNAME	KILLPOWER
EVELYN NECKER	CHARACTERNAME	EVELYN NECKER
DEATH METAL	CHARACTERNAME	DEATH METAL
PLASMER	CHARACTERNAME	PLASMER
GANGBUSTER	CHARACTERNAME	GANGBUSTER
CATHERINE COBERT	CHARACTERNAME	CATHERINE COBERT
KINGMAKER	CHARACTERNAME	KINGMAKER
CANDLEMAKER	CHARACTERNAME	THE CANDLEMAKER
GOOGAM	CHARACTERNAME	GOOGAM
ELEKTRO	CHARACTERNAME	ELEKTRO
HORRIDUS	CHARACTERNAME	HORRIDUS
GRIM HUNTER	CHARACTERNAME	GRIM HUNTER
SEEKER	CHARACTERNAME	SEEKER
FALCONA	CHARACTERNAME	FALCONA
LEONUS	CHARACTERNAME	LEONUS
STALLIOR	CHARACTERNAME	STALLIOR
TIMBERIUS	CHARACTERNAME	TIMBERIUS
UNDERWORLD	CHARACTERNAME	UNDERWORLD
BLACK RAAZER	CHARACTERNAME	BLACK RAAZER
ZAZA THE MYSTIC	CHARACTERNAME	ZAZA THE MYSTIC
DELORES WINTERS	CHARACTERNAME	DELORES WINTERS
CHRISTIAN WALKER	CHARACTERNAME	CHRISTIAN WALKER
IRIS WEST ALLEN	CHARACTERNAME	IRIS WEST-ALLEN
MOTHER-ONE	CHARACTERNAME	MOTHER-ONE
VOICE	CHARACTERNAME	VOICE
THOMAS JAGGER	CHARACTERNAME	TOMMY JAGGER
BLOOD BROTHERS	CHARACTERNAME	THE BLOOD BROTHERS
FREE SPIRIT	CHARACTERNAME	FREE SPIRIT
ARCHIE CORRIGAN	CHARACTERNAME	ARCHIE CORRIGAN
VIBRANIA	CHARACTERNAME	VIBRANIA
SPROCKET	CHARACTERNAME	SPROCKET
TAWKY TAWNY	CHARACTERNAME	MISTER TAWKY TAWNY
ANDREW CHORD	CHARACTERNAME	ANDREW CHORD
ULTRAA	CHARACTERNAME	ULTRAA
GONZO THE MECHANICAL BASTARD	CHARACTERNAME	GONZO THE MECHANICAL BASTARD
BLACK SWAN	CHARACTERNAME	BLACK SWAN
POWER BROKER	CHARACTERNAME	POWER BROKER
STAR THIEF	CHARACTERNAME	STAR THIEF
BETTY CLAWMAN	CHARACTERNAME	BETTY CLAWMAN
CAVALIER	CHARACTERNAME	THE CAVALIER
GHOST	CHARACTERNAME	THE GHOST
PYROMAN	CHARACTERNAME	PYROMAN
WOMAN IN RED	CHARACTERNAME	THE WOMAN IN RED
LIBERATOR	CHARACTERNAME	THE LIBERATOR
SCARAB	CHARACTERNAME	THE SCARAB
ROXANNE SIMPSON	CHARACTERNAME	ROXANNE SIMPSON
MICHAEL COSTNER	CHARACTERNAME	OMAC
LANCE LEWIS, SPACE DETECTIVE	CHARACTERNAME	LANCE LEWIS, SPACE DETECTIVE
ARMOR	CHARACTERNAME	ARMOR
GLOWWORM	CHARACTERNAME	GLOWWORM
CANON FODDER	CHARACTERNAME	CANON FODDER
CARETAKER	CHARACTERNAME	CARETAKER
CARETAKER	CHARACTERNAME	SARA
AURON	CHARACTERNAME	AURON
NOBLE KALE	CHARACTERNAME	NOBLE KALE
TIME COMMANDER	CHARACTERNAME	TIME COMMANDER
PAULA POPHOUSE	CHARACTERNAME	PAULA POPHOUSE
ALYSSA MOY	CHARACTERNAME	ALYSSA MOY
QUENTIN TURNBULL	CHARACTERNAME	QUENTIN TURNBULL
STARFINGER	CHARACTERNAME	STARFINGER
SEPULCHRE	CHARACTERNAME	SEPULCHRE
MAD DOG RASSITANO	CHARACTERNAME	MAD DOG RASSITANO
AMERICAN EAGLE	CHARACTERNAME	AMERICAN EAGLE
SHATHRA	CHARACTERNAME	SHATHRA
WHITE TIGER	CHARACTERNAME	WHITE TIGER
JUDY OF THE JUNGLE	CHARACTERNAME	JUDY OF THE JUNGLE
THERMITE	CHARACTERNAME	THERMITE
ARUNA	CHARACTERNAME	ARUNA
ALTERNATIVE VERSIONS OF SPIDER-MAN	CHARACTERNAME	SPIDER-MAN
ALTERNATIVE VERSIONS OF SPIDER-MAN	CHARACTERNAME	SPIDER-MAN 2211
RED KING	CHARACTERNAME	RED KING
DIE-CUT	CHARACTERNAME	DIE-CUT
FRIGHT	CHARACTERNAME	FRIGHT
DAKEN	CHARACTERNAME	DAKEN
MINION	CHARACTERNAME	MINION
SHELLSHOCK	CHARACTERNAME	SHELLSHOCK
SOBEK	CHARACTERNAME	SOBEK
HIJACKER	CHARACTERNAME	HIJACKER
STEEPLEJACK	CHARACTERNAME	STEEPLEJACK
PRODIGY	CHARACTERNAME	PRODIGY
MIND-WAVE	CHARACTERNAME	MIND-WAVE
MAYHEM	CHARACTERNAME	MAYHEM
TEMUGIN	CHARACTERNAME	TEMUJIN
THE ASTOUNDING WOLF-MAN	CHARACTERNAME	THE ASTOUNDING WOLF-MAN
HELLRAZOR	CHARACTERNAME	HELLRAZOR
BARRACUDA	CHARACTERNAME	BARRACUDA
MUSE	CHARACTERNAME	MUSE
SATURN QUEEN	CHARACTERNAME	SATURN QUEEN
MARIA HERMOSA	CHARACTERNAME	MARIA HERMOSA
ZAK SILVER	CHARACTERNAME	ZAK SILVER
MR. HERO THE NEWMATIC MAN	CHARACTERNAME	MR. HERO
MICHAEL POINTER	CHARACTERNAME	OMEGA
WERNER VON STRUCKER	CHARACTERNAME	WERNER VON STRUCKER
HYATHIS	CHARACTERNAME	HYATHIS
EL MUERTO	CHARACTERNAME	EL MUERTO
CAPTAIN DYNAMO	CHARACTERNAME	CAPTAIN DYNAMO
NIGHTSHADE	CHARACTERNAME	NIGHTSHADE
MA GNUCCI	CHARACTERNAME	MA GNUCCI
WIDOWMAKER	CHARACTERNAME	WIDOWMAKER
SUPERVISION	CHARACTERNAME	SUPERVISION
WRAITH	CHARACTERNAME	WRAITH
MADDIE WARNER	CHARACTERNAME	MADDIE WARNER
SMASHER	CHARACTERNAME	SMASHER
MENAGERIE	CHARACTERNAME	MENAGERIE
RAMJET	CHARACTERNAME	RAMJET
MAGNET	CHARACTERNAME	THE MAGNET
APOLLO	CHARACTERNAME	APOLLO
ARTEMIS	CHARACTERNAME	ARTEMIS
ATHENA	CHARACTERNAME	ATHENA
DIONYSUS	CHARACTERNAME	DIONYSUS
HERA	CHARACTERNAME	HERA
HERMES	CHARACTERNAME	HERMES
NEPTUNE	CHARACTERNAME	NEPTUNE
JERRY JAXON	CHARACTERNAME	JERRY JAXON
OGRE	CHARACTERNAME	OGRE
PULSAR STARGRAVE	CHARACTERNAME	PULSAR STARGRAVE
STEEL SPIDER	CHARACTERNAME	STEEL SPIDER
HAMILTON HILL	CHARACTERNAME	HAMILTON HILL
DRAAGA	CHARACTERNAME	DRAAGA
STARLIGHT	CHARACTERNAME	STARLIGHT
SLEEZ	CHARACTERNAME	SLEEZ
JACOB SHAW	CHARACTERNAME	JACOB SHAW
KALIA THE CROW	CHARACTERNAME	KALIA
LELAND MCCAULEY	CHARACTERNAME	LELAND MCCAULEY
AMON SUR	CHARACTERNAME	AMON SUR
HUGH JONES	CHARACTERNAME	HUGH JONES
KARU-SIL	CHARACTERNAME	KARU-SIL
PSYKLOP	CHARACTERNAME	PSYKLOP
GALAXY MASTER	CHARACTERNAME	GALAXY MASTER
BRAINCHILD	CHARACTERNAME	BRAINCHILD
BENGAL	CHARACTERNAME	BENGAL
SOUTHPAW	CHARACTERNAME	SOUTHPAW
OTOMO	CHARACTERNAME	OTOMO
SENTRY	CHARACTERNAME	SENTRY
RAPTOR	CHARACTERNAME	GARY WILTON, JR.
RAPTOR	CHARACTERNAME	BRENDA DRAGO
RAPTOR	CHARACTERNAME	DAMON RYDER
SIN-EATER	CHARACTERNAME	SIN-EATER
LYSSA DRAK	CHARACTERNAME	LYSSA DRAK
SMARTSHIP FRIDAY	CHARACTERNAME	FRIDAY
LOTUS SHINCHUKO	CHARACTERNAME	LOTUS SHINCHUKO
WHITE TIGER	CHARACTERNAME	WHITE TIGER
PROFESSOR PHOBOS	CHARACTERNAME	PROFESSOR PHOBOS
MYRIAD	CHARACTERNAME	MYRIAD
POSEIDON	CHARACTERNAME	POSEIDON
QUAGMIRE	CHARACTERNAME	QUAGMIRE
MINDGRABBER KID	CHARACTERNAME	MINDGRABBER KID
PANDORA PANN	CHARACTERNAME	PANDORA PANN
SUPER-HIP	CHARACTERNAME	SUPER-HIP
POWERHOUSE PEPPER	CHARACTERNAME	POWERHOUSE PEPPER
GAUNTLET	CHARACTERNAME	GAUNTLET
SIEGE	CHARACTERNAME	SIEGE
CLOUD 9	CHARACTERNAME	CLOUD 9
PIPELINE	CHARACTERNAME	PIPELINE
WIPEOUT	CHARACTERNAME	WIPEOUT
PUNCHOUT	CHARACTERNAME	PUNCHOUT
RON-KARR	CHARACTERNAME	RON-KARR
ESPER LASS	CHARACTERNAME	ESPER LASS
TRAUMA	CHARACTERNAME	TRAUMA
GARTH	CHARACTERNAME	GARTH
LUKE CARLYLE	CHARACTERNAME	LUKE CARLYLE
TRACER	CHARACTERNAME	TRACER
KID AMAZO	CHARACTERNAME	KID AMAZO
ASMODEL	CHARACTERNAME	ASMODEL
DART	CHARACTERNAME	DART
WYSPER	CHARACTERNAME	WYSPER
GAVEL	CHARACTERNAME	GAVEL
IMPALA	CHARACTERNAME	IMPALA
ANTHONY	CHARACTERNAME	ANTHONY
SHAKTI	CHARACTERNAME	SHAKTI
BANKELAL	CHARACTERNAME	BANKELAL
KING KULL	CHARACTERNAME	KING KULL
SHAFT	CHARACTERNAME	SHAFT
EDWIN CORD	CHARACTERNAME	EDWIN CORD
LUMINUS	CHARACTERNAME	LUMINUS
MAXI-MAN	CHARACTERNAME	MAXI-MAN
MORPHEA	CHARACTERNAME	MORPHEA
CHONDU THE MYSTIC	CHARACTERNAME	CHONDU THE MYSTIC
SOFIA CONSTANTINAS	CHARACTERNAME	SOFIA CONSTANTINAS
PRINCESS PANTHA	CHARACTERNAME	PRINCESS PANTHA
RANDY ROBERTSON	CHARACTERNAME	RANDY ROBERTSON
MASK	CHARACTERNAME	THE MASK
PEACE MONGER	CHARACTERNAME	PEACE MONGER
LYNN MICHAELS	CHARACTERNAME	LYNN MICHAELS
BARON VON BLITZSCHLAG	CHARACTERNAME	BARON VON BLITZSCHLAG
MADEMOISELLE MARIE	CHARACTERNAME	MADEMOISELLE MARIE
VISION	CHARACTERNAME	VISION
REBOUND	CHARACTERNAME	REBOUND
MEKANIQUE	CHARACTERNAME	MEKANIQUE
JENNIFER MURPHY	CHARACTERNAME	JENNIFER DRAGON
LIBERTY & JUSTICE	CHARACTERNAME	LIBERTY AND JUSTICE
BURGLAR	CHARACTERNAME	\
BLISS	CHARACTERNAME	BLISS
PLUNDERER	CHARACTERNAME	PLUNDERER
GARGAMEL	CHARACTERNAME	GARGAMEL
LYLA LERROL	CHARACTERNAME	LYLA LERROL
JEREMIAH ARKHAM	CHARACTERNAME	JEREMIAH ARKHAM
KOMODO	CHARACTERNAME	KOMODO
ATMOS	CHARACTERNAME	ATMOS
TYLER STONE	CHARACTERNAME	TYLER STONE
UN-MEN	CHARACTERNAME	THE UN-MEN
WOODGOD	CHARACTERNAME	WOODGOD
PATCHWORK MAN	CHARACTERNAME	PATCHWORK MAN
SPARX	CHARACTERNAME	SPARX
HARDBALL	CHARACTERNAME	HARDBALL
ARMORY	CHARACTERNAME	ARMORY
TAURUS	CHARACTERNAME	TAURUS
CANCER	CHARACTERNAME	CANCER
CAPRICORN	CHARACTERNAME	CAPRICORN
GEMINI	CHARACTERNAME	GEMINI
LEO	CHARACTERNAME	LEO
PISCES	CHARACTERNAME	PISCES
SAGITTARIUS	CHARACTERNAME	SAGITTARIUS
VIRGO	CHARACTERNAME	VIRGO
AQUARIUS	CHARACTERNAME	AQUARIUS
AQUARIUS	CHARACTERNAME	VIRGO
SUPERBOY	CHARACTERNAME	SUPERBOY
LEPER QUEEN	CHARACTERNAME	LEPER QUEEN
MARLEY DAVIDSON	CHARACTERNAME	MARLEY DAVIDSON
BIG MAN	CHARACTERNAME	JANICE FOSWELL
SAPPHIRE	CHARACTERNAME	SAPPHIRE
STRIKER Z	CHARACTERNAME	STRIKER Z
FRAU TOTENKINDER	CHARACTERNAME	FRAU TOTENKINDER
FLYCATCHER	CHARACTERNAME	FLYCATCHER
FUSION	CHARACTERNAME	FUSION
DUKE OF OIL	CHARACTERNAME	DUKE OF OIL
BATTALION	CHARACTERNAME	BATTALION
MERLIN THE MAGICIAN	CHARACTERNAME	MERLIN
APE-MAN	CHARACTERNAME	APE-MAN
PROTECTOR	CHARACTERNAME	PROTECTOR
CAT-MAN	CHARACTERNAME	CAT-MAN
COMMANDER KRAKEN	CHARACTERNAME	COMMANDER KRAKEN
FORERUNNER	CHARACTERNAME	FORERUNNER
DAKIMH THE ENCHANTER	CHARACTERNAME	DAKIMH THE ENCHANTER
REY YAN	CHARACTERNAME	REY YAN
FROG-MAN	CHARACTERNAME	FROG-MAN
FROG-MAN	CHARACTERNAME	FROG-MAN II
BIRD-MAN	CHARACTERNAME	BIRD-MAN
LEMUEL DORCAS	CHARACTERNAME	DOCTOR LEMUEL DORCAS
JIMMY-6	CHARACTERNAME	JIMMY-6
IMMORTAL MAN	CHARACTERNAME	IMMORTAL MAN
MAVIS	CHARACTERNAME	MAVIS
MALA	CHARACTERNAME	MALA
NATAS	CHARACTERNAME	NATAS
ARMOURED GIDEON	CHARACTERNAME	ARMOURED GIDEON
ENFORCER	CHARACTERNAME	ENFORCER
STRANGERS	CHARACTERNAME	STRANGE
STRANGERS	CHARACTERNAME	VINCENT STEVENS
FANTOMAH	CHARACTERNAME	FANTOMAH
HANGMAN	CHARACTERNAME	HANGMAN
KIBER THE CRUEL	CHARACTERNAME	KIBER THE CRUEL
MARVEL BOY	CHARACTERNAME	MARVEL BOY
NEBULON	CHARACTERNAME	NEBULON
LEATHER	CHARACTERNAME	LEATHER
STARDUST THE SUPER WIZARD	CHARACTERNAME	STARDUST THE SUPER WIZARD
SOLARR	CHARACTERNAME	SOLARR
SAYD	CHARACTERNAME	SAYD
FRANKLIN STORM	CHARACTERNAME	FRANKLIN STORM
THUNDERBOLT	CHARACTERNAME	THUNDERBOLT I
THUNDERBOLT	CHARACTERNAME	THUNDERBOLT II
TORPEDO	CHARACTERNAME	TORPEDO
JEBEDIAH GUTHRIE	CHARACTERNAME	JEBEDIAH \
TURAC	CHARACTERNAME	TURAC
PANDEMIC	CHARACTERNAME	PANDEMIC
DON ZAUKER	CHARACTERNAME	DON ZAUKER
GIGANTO	CHARACTERNAME	GIGANTO
AMPHIBION	CHARACTERNAME	AMPHIBION
ARSENAL	CHARACTERNAME	ARSENAL
DIAMONDHEAD	CHARACTERNAME	DIAMONDHEAD
RICHARD RORY	CHARACTERNAME	RICHARD RORY
GRAF TOREN	CHARACTERNAME	GRAF TOREN
JACKPOT	CHARACTERNAME	JACKPOT
JACK T. CHANCE	CHARACTERNAME	JACK T. CHANCE
TURYTT	CHARACTERNAME	TURYTT
LADY VIC	CHARACTERNAME	LADY VIC
LORD CONQUEST	CHARACTERNAME	LORD CONQUEST
EARL OF GREED	CHARACTERNAME	THE EARL OF GREED
BEREET	CHARACTERNAME	BEREET
BLACK SPECTRE	CHARACTERNAME	BLACK SPECTRE
ROMULUS	CHARACTERNAME	ROMULUS
FRANK COBB	CHARACTERNAME	FRANK COBB
BRAIN DRAIN	CHARACTERNAME	BRAIN DRAIN
BROTHER TODE	CHARACTERNAME	TODE
LEW MOXON	CHARACTERNAME	LEW MOXON
STILETTO	CHARACTERNAME	STILETTO
DISCUS	CHARACTERNAME	DISCUS
BRYNOCKI	CHARACTERNAME	BRYNOCKI
HELENA SANDSMARK	CHARACTERNAME	HELENA SANDSMARK
SISE-NEG	CHARACTERNAME	SISE-NEG
WILDSTAR	CHARACTERNAME	WILDSTAR
LAUREL KENT	CHARACTERNAME	LAUREL KENT
SLASH	CHARACTERNAME	SLASH
BOB, AGENT OF HYDRA	CHARACTERNAME	BOBBY
PHLEBIAC BROTHERS	CHARACTERNAME	THE PHLEBIAC BROTHERS
CENTURIUS	CHARACTERNAME	CENTURIUS
JONAS HARROW	CHARACTERNAME	JONAS HARROW
LUCIA VON BARDAS	CHARACTERNAME	LUCIA VON BARDAS
DYESEBEL	CHARACTERNAME	DYESEBEL
CONDOR	CHARACTERNAME	CONDOR
JACK STARSMORE	CHARACTERNAME	JACK STARSMORE
CRUSHER	CHARACTERNAME	CRUSHER I
CRUSHER	CHARACTERNAME	CRUSHER II
CRUSHER	CHARACTERNAME	CRUSHER III
ANGELUS	CHARACTERNAME	THE ANGELUS
MARGARET SLADE	CHARACTERNAME	MARGARET SLADE
AURAKLES	CHARACTERNAME	AURAKLES
ZOM	CHARACTERNAME	ZOM
JASON MACENDALE	CHARACTERNAME	JASON MACENDALE, JR.
BRIT	CHARACTERNAME	BRIT
CELESTINE	CHARACTERNAME	CELESTINE
DRAGON LORD	CHARACTERNAME	DRAGON LORD
DREDMUND THE DRUID	CHARACTERNAME	DREDMUND DRUID
BLUE BLADE	CHARACTERNAME	BLUE BLADE
CROW	CHARACTERNAME	THE CROW
EVERYMAN	CHARACTERNAME	EVERYMAN
SLIPKNOT	CHARACTERNAME	SLIPKNOT
CAPTAIN WONDER	CHARACTERNAME	CAPTAIN WONDER
MARGO LANE	CHARACTERNAME	MARGO LANE
DYNAMIC MAN	CHARACTERNAME	DYNAMIC MAN
DYNAMIC MAN	CHARACTERNAME	DYNAMIC MAN
FIERY MASK	CHARACTERNAME	FIERY MASK
PHANTOM REPORTER	CHARACTERNAME	PHANTOM REPORTER
LAUGHING MASK	CHARACTERNAME	LAUGHING MASK
MISTER E	CHARACTERNAME	MISTER E
ROCKMAN	CHARACTERNAME	ROCKMAN
CECIL STEDMAN	CHARACTERNAME	CECIL STEDMAN
EVERYMAN	CHARACTERNAME	EVERYMAN
NEKRON	CHARACTERNAME	NEKRON
DOCTOR DESTROYER	CHARACTERNAME	DOCTOR DESTROYER
RANX THE SENTIENT CITY	CHARACTERNAME	RANX THE SENTIENT CITY
SUPER-TURTLE	CHARACTERNAME	SUPER-TURTLE
WRAITH	CHARACTERNAME	WRAITH
SILVERSWORD	CHARACTERNAME	SILVERSWORD
FREAK	CHARACTERNAME	FREAK
SCRAMBLE	CHARACTERNAME	SCRAMBLE
FUTURIST	CHARACTERNAME	FUTURIST
GABRIEL THE DEVIL HUNTER	CHARACTERNAME	GABRIEL THE DEVIL HUNTER
MALA	CHARACTERNAME	MALA
WYNONNA EARP	CHARACTERNAME	WYNONNA EARP
GORR	CHARACTERNAME	GORR
RAMA KHAN	CHARACTERNAME	RAMA KHAN
LIVING DIAMOND	CHARACTERNAME	LIVING DIAMOND
HECATE	CHARACTERNAME	HECATE
HECATE	CHARACTERNAME	HECAT'E
PREDATOR X	CHARACTERNAME	PREDATOR X
HITMAN	CHARACTERNAME	HITMAN
HUMAN TOP	CHARACTERNAME	HUMAN TOP
DEFUSER	CHARACTERNAME	THE DEFUSER
SUPER RABBIT	CHARACTERNAME	SUPER RABBIT
IRON CROSS	CHARACTERNAME	IRON CROSS
ISAAC	CHARACTERNAME	ISAAC
JANUS	CHARACTERNAME	JANUS
JUDE THE ENTROPIC MAN	CHARACTERNAME	JUDE THE ENTROPIC MAN
MORPHEUS	CHARACTERNAME	MORPHEUS
FROST	CHARACTERNAME	FROST
KAMUU	CHARACTERNAME	KAMUU
KARTHON THE QUESTER	CHARACTERNAME	KARTHON THE QUESTER
KORREK	CHARACTERNAME	KORREK
CRIME MASTER	CHARACTERNAME	CRIME MASTER I
CRIME MASTER	CHARACTERNAME	CRIME MASTER II
CRIME MASTER	CHARACTERNAME	CRIME-MASTER
JACQUES LALLEAUX	CHARACTERNAME	JACQUES LALLEAUX
LOCKSMITH	CHARACTERNAME	LOCKSMITH
LUNATIK	CHARACTERNAME	LUNATIK
HIROIM	CHARACTERNAME	HIROIM
COMPUTO	CHARACTERNAME	COMPUTO
DOMINO LADY	CHARACTERNAME	THE DOMINO LADY
MAZIKEEN	CHARACTERNAME	MAZIKEEN
DANIELLE BAPTISTE	CHARACTERNAME	DANIELLE BAPTISTE
MAHA YOGI	CHARACTERNAME	MAHA YOGI
MAHKIZMO	CHARACTERNAME	MAHKIZMO
MASTER KHAN	CHARACTERNAME	MASTER KHAN
MATHEMANIC	CHARACTERNAME	MATHEMANIC
METAL MASTER	CHARACTERNAME	METAL MASTER
MIDAS	CHARACTERNAME	MIDAS
MIDAS	CHARACTERNAME	MIDAS II
CYBORG SUPERMAN	CHARACTERNAME	CYBORG SUPERMAN
MISSING LINK	CHARACTERNAME	MISSING LINK
MAGUS	CHARACTERNAME	MAGUS
MOONDARK	CHARACTERNAME	MOONDARK
SCARLET SCARAB	CHARACTERNAME	SCARLET SCARAB
SHAMROCK	CHARACTERNAME	SHAMROCK
MORDRED	CHARACTERNAME	MORDRED
NTH MAN	CHARACTERNAME	NTH MAN
SCALEFACE	CHARACTERNAME	SCALEFACE
JANN OF THE JUNGLE	CHARACTERNAME	JANN OF THE JUNGLE
OMEGA	CHARACTERNAME	OMEGA
RAINBOW GIRL	CHARACTERNAME	RAINBOW GIRL
ZIGGY PIG AND SILLY SEAL	CHARACTERNAME	ZIGGY PIG AND SILLY SEA
PIRANHA	CHARACTERNAME	PIRANHA
PUNISHER	CHARACTERNAME	PUNISHER
 SEñOR SUERTE	CHARACTERNAME	SEñOR SUERTE
 SEñOR SUERTE	CHARACTERNAME	SEñOR SUERTE AND SEñOR MUERTE
SHAKIRA	CHARACTERNAME	SHAKIRA
PLASMA	CHARACTERNAME	PLASMA
SHATTERSTAR	CHARACTERNAME	SHATTERSTAR
SILVER DAGGER	CHARACTERNAME	SILVER DAGGER
SIMON DARK	CHARACTERNAME	SIMON DARK
STEEL SERPENT	CHARACTERNAME	STEEL SERPENT
STUNT-MASTER	CHARACTERNAME	STUNT-MASTER
TAMARA RAHN	CHARACTERNAME	TAMARA RAHN
TANA NILE	CHARACTERNAME	TANA NILE
TEMPUS	CHARACTERNAME	TEMPUS
TIBORO	CHARACTERNAME	TIBORO
TUMBLER	CHARACTERNAME	TUMBLER
TUTINAX	CHARACTERNAME	TUTINAX
TYPHON	CHARACTERNAME	TYPHON
I.Q.	CHARACTERNAME	I.Q.
VENOMM	CHARACTERNAME	VENOMM
VICTORIUS	CHARACTERNAME	VICTORIUS
WINDEAGLE	CHARACTERNAME	WINDEAGLE
KORVUS	CHARACTERNAME	KORVUS
DOUGHBOY	CHARACTERNAME	DOUGHBOY
GAZELLE	CHARACTERNAME	GAZELLE
BALLISTIC	CHARACTERNAME	BALLISTIC
BLACK ZERO	CHARACTERNAME	BLACK ZERO
FIREHAIR	CHARACTERNAME	FIREHAIR
PHOTON	CHARACTERNAME	PHOTON
GATECRASHER	CHARACTERNAME	GATECRASHER
ARCLIGHT	CHARACTERNAME	ARCLIGHT
BLACK KNIGHT	CHARACTERNAME	BLACK KNIGHT
BLACK KNIGHT	CHARACTERNAME	BLACK KNIGHT
CAPTAIN ATLAS	CHARACTERNAME	CAPTAIN ATLAS
CENTURIOUS	CHARACTERNAME	CENTURIOUS
CRIPPLER	CHARACTERNAME	CRIPPLER
DOCTOR MINERVA	CHARACTERNAME	DOCTOR MINERVA
ELYSIUS	CHARACTERNAME	ELYSIUS
EVILHAWK	CHARACTERNAME	EVILHAWK
GAMEMNAE	CHARACTERNAME	GAMEMNAE
SPIRIT KING	CHARACTERNAME	THE SPIRIT KING
MATTHEW RISMAN	CHARACTERNAME	MATTHEW RISMAN
MOTH	CHARACTERNAME	MOTH
ELLOE KAIFI	CHARACTERNAME	ELLOE KAIFI
SKAAR	CHARACTERNAME	SKAAR
AGAMEMNON	CHARACTERNAME	AGAMEMNON
SONAMBULO	CHARACTERNAME	SONAMBULO
THE FACE	CHARACTERNAME	THE FACE
GABRIEL STACY AND SARAH STACY	CHARACTERNAME	GABRIEL STACY AND SARAH STACY
ANNEX	CHARACTERNAME	ANNEX
PARIS	CHARACTERNAME	PARIS
HECTOR	CHARACTERNAME	HECTOR
PROMETHEUS	CHARACTERNAME	PROMETHEUS
PROMETHEUS	CHARACTERNAME	PROMETHEUS II
ATALANTA	CHARACTERNAME	ATALANTA
MIRACLEWOMAN	CHARACTERNAME	MIRACLEWOMAN
WHIZZER	CHARACTERNAME	WHIZZER
MOUNTJOY	CHARACTERNAME	MOUNTJOY
DARK MOTHER	CHARACTERNAME	DARK MOTHER
FIREFLY	CHARACTERNAME	FIREFLY
JOHN LAW	CHARACTERNAME	JOHN LAW
DOCTOR DIEHARD	CHARACTERNAME	DOCTOR DIEHARD
MECHANON	CHARACTERNAME	MECHANON
BRIAN BANNER	CHARACTERNAME	BRIAN BANNER
GLORITH	CHARACTERNAME	GLORITH
GRIMBOR THE CHAINSMAN	CHARACTERNAME	GRIMBOR
SCRIBE	CHARACTERNAME	SCRIBE
SHRAPNEL	CHARACTERNAME	SHRAPNEL
LORD CHAOS	CHARACTERNAME	LORD CHAOS
MICHAEL VAN PATRICK	CHARACTERNAME	MVP
SNOWMAN	CHARACTERNAME	SNOWMAN
INVISIBLE KID	CHARACTERNAME	INVISIBLE KID
BATMAN	CHARACTERNAME	BATMAN
KOBRA	CHARACTERNAME	KOBRA
GOLIATH	CHARACTERNAME	GOLIATH
ISOLATIONIST	CHARACTERNAME	ISOLATIONIST
RELAMPAGO	CHARACTERNAME	RELAMPAGO
THUNDER	CHARACTERNAME	THUNDER
COMPUTO	CHARACTERNAME	COMPUTO
HIRO TAKACHIHO	CHARACTERNAME	HIRO TAKACHIHO
GOGO TOMAGO	CHARACTERNAME	GOGO TOMAGO
HONEY LEMON	CHARACTERNAME	HONEY LEMON
BAYMAX	CHARACTERNAME	BAYMAX
GOG	CHARACTERNAME	GOG
LIVING BRAIN	CHARACTERNAME	LIVING BRAIN
RED NINE	CHARACTERNAME	RED NINE
CAPTAIN BARBELL	CHARACTERNAME	CAPTAIN BARBELL
GEIGER	CHARACTERNAME	GEIGER
EL GRADUADO	CHARACTERNAME	EL GRADUADO
FREAK	CHARACTERNAME	THE FREAK
BASE	CHARACTERNAME	BASE
GORILLA GIRL	CHARACTERNAME	GORILLA GIRL
CARAPAX	CHARACTERNAME	CARAPAX
KORATH THE PURSUER	CHARACTERNAME	KORATH THE PURSUER
LLAN THE SORCERER	CHARACTERNAME	LLAN THE SORCERER
MOTHER NIGHT	CHARACTERNAME	MOTHER NIGHT
OCCULUS	CHARACTERNAME	OCCULUS
PINEAPPLE MAN	CHARACTERNAME	PINEAPPLE MAN
CONAN	CHARACTERNAME	CONAN
JUBILEE	CHARACTERNAME	JUBILEE
MAESTRO	CHARACTERNAME	THE MAESTRO
MISTER NEGATIVE	CHARACTERNAME	MISTER NEGATIVE
SUPERMAN	CHARACTERNAME	SUPERMAN
EDDIE FYERS	CHARACTERNAME	EDDIE FYERS
INK	CHARACTERNAME	INK
GRAYMALKIN	CHARACTERNAME	GRAYMALKIN
THOUSAND	CHARACTERNAME	THE THOUSAND
LIFEFORM	CHARACTERNAME	LIFEFORM
REV	CHARACTERNAME	REV
ROCKET RED	CHARACTERNAME	ROCKET RED
OSHTUR	CHARACTERNAME	OSHTUR
IAN KARKULL	CHARACTERNAME	IAN KARKULL
MENACE	CHARACTERNAME	MENACE
BEKKA	CHARACTERNAME	BEKKA
ZEKE STANE	CHARACTERNAME	ZEKE STANE
MARIA STARK	CHARACTERNAME	MARIA STARK
HOWARD STARK	CHARACTERNAME	HOWARD STARK
ACHEBE	CHARACTERNAME	ACHEBE
GORGON	CHARACTERNAME	THE GORGON
TINA MCGEE	CHARACTERNAME	TINA MCGEE
CAPTAIN PARAGON	CHARACTERNAME	PARAGON
BEAUTIE	CHARACTERNAME	BEAUTIE
HONOR GUARD	CHARACTERNAME	HONOR GUARD
AEGIS	CHARACTERNAME	AEGIS
ALBINO	CHARACTERNAME	ALBINO
DIAMANDA NERO	CHARACTERNAME	DIAMANDA NERO
GRAVEDIGGER	CHARACTERNAME	GRAVEDIGGER
TOPO	CHARACTERNAME	TOPO
DREAM BOY	CHARACTERNAME	DREAM BOY
AKASHA	CHARACTERNAME	AKASHA
ALL-AMERICAN	CHARACTERNAME	ALL-AMERICAN
ABDUL ALHAZRED	CHARACTERNAME	ABDUL ALHAZRED
RAMPAGE	CHARACTERNAME	STUART CLARKE
AMATSU-MIKABOSHI	CHARACTERNAME	MIKABOSHI
GEOMANCER	CHARACTERNAME	GEOMANCER
FRANCISCO GUERRERO	CHARACTERNAME	EL GATO NEGRO
CHAPEL	CHARACTERNAME	CHAPEL
AGUSTIN GUERRERO	CHARACTERNAME	EL GATO NEGRO
LIBRA	CHARACTERNAME	LIBRA
MATTHEW CABLE	CHARACTERNAME	MATTHEW CABLE
CAPTAIN MARVEL	CHARACTERNAME	CAPTAIN MARVEL
KATE WAYNESBORO	CHARACTERNAME	KATE WAYNESBORO
NEMESIS	CHARACTERNAME	NEMESIS
TWEEDLEDUM AND TWEEDLEDEE	CHARACTERNAME	TWEEDLEDUM AND TWEEDLEDEE
PARAGON	CHARACTERNAME	PARAGON
OUTSIDER	CHARACTERNAME	THE OUTSIDER
MA'ALEFA'AK	CHARACTERNAME	MA'ALEFA'AK
GAUNTLET	CHARACTERNAME	GAUNTLET
TARGET AND THE TARGETEERS	CHARACTERNAME	THE TARGET
HO YINSEN	CHARACTERNAME	HO YINSEN
OWL	CHARACTERNAME	THE OWL
DON FORTUNATO	CHARACTERNAME	DON FORTUNATO
ANGEL SALVADORE	CHARACTERNAME	ANGEL SALVADORE
REDNECK	CHARACTERNAME	REDNECK
OCTOPUS	CHARACTERNAME	THE OCTOPUS
ROSE	CHARACTERNAME	ROSE
WOTAN	CHARACTERNAME	WOTAN
FIREPOWER	CHARACTERNAME	FIREPOWER
TRASHMAN	CHARACTERNAME	TRASHMAN
JOHN THE SKRULL	CHARACTERNAME	JOHN THE SKRULL
CAPTAIN MIDLANDS	CHARACTERNAME	CAPTAIN MIDLANDS
ARTHUR LE FANTôME JUSTICIER	CHARACTERNAME	ARTHUR
MASTER MIND EXCELLO	CHARACTERNAME	MASTER MIND EXCELLO
FAIZA HUSSAIN	CHARACTERNAME	FAIZA HUSSAIN
GRIFFIN	CHARACTERNAME	GRIFFIN
KIRT NIEDRIGH	CHARACTERNAME	KIRT NIEDRIGH
VERANKE	CHARACTERNAME	VERANKE
JUDGE BEENY	CHARACTERNAME	JUDGE BEENY
ZEBRA-MAN	CHARACTERNAME	ZEBRA-MAN
ZEBRA-MAN	CHARACTERNAME	VORTEX
CYBERFACE	CHARACTERNAME	CYBERFACE
MOLLY O'REILLY	CHARACTERNAME	MOLLY O'REILLY
REVOLUTIONARY	CHARACTERNAME	REVOLUTIONARY
BUTTERBALL	CHARACTERNAME	BUTTERBALL
HUMAN FLAME	CHARACTERNAME	HUMAN FLAME
STEVE LOMBARD	CHARACTERNAME	STEVE LOMBARD
REPTYL	CHARACTERNAME	REPTYL
SAVAGE STEEL	CHARACTERNAME	SAVAGE STEEL
AUBERON	CHARACTERNAME	AUBERON
SLEEPER	CHARACTERNAME	SLEEPER
URI-ON	CHARACTERNAME	URI-ON
SQUID	CHARACTERNAME	SQUID
TRUMP	CHARACTERNAME	TRUMP
VIBRO	CHARACTERNAME	VIBRO
SKATEMAN	CHARACTERNAME	SKATEMAN
JUNZO MUTO	CHARACTERNAME	JUNZO MUTO
ATROCITUS	CHARACTERNAME	ATROCITUS
SKORPIO	CHARACTERNAME	SKORPIO
CHALLENGER	CHARACTERNAME	CHALLENGER
BEOWULF	CHARACTERNAME	BEOWULF
GELDOFF	CHARACTERNAME	GELDOFF
BLACK BEETLE	CHARACTERNAME	BLACK BEETLE
NYX	CHARACTERNAME	NYX
MORNING STAR	CHARACTERNAME	MORNING STAR
KLARA PRAST	CHARACTERNAME	KLARA PRAST
BUG	CHARACTERNAME	BUG
HOGGOTH	CHARACTERNAME	HOGGOTH
POSTMORTEM	CHARACTERNAME	POSTMORTEM
KLAATU	CHARACTERNAME	KLAATU
JUDGE LOPEZ	CHARACTERNAME	JUDGE LOPEZ
MODULAR MAN	CHARACTERNAME	MODULAR MAN
GENOCIDE	CHARACTERNAME	GENOCIDE
YODDHA	CHARACTERNAME	YODDHA
INSPECTOR STEEL	CHARACTERNAME	STEEL
RED VOLCANO	CHARACTERNAME	RED VOLCANO
OLD LACE	CHARACTERNAME	OLD LACE
LIST OF MARVEL COMICS CHARACTERS: C	CHARACTERNAME	DELPHINE COURTNEY
LIST OF MARVEL COMICS CHARACTERS: S	CHARACTERNAME	SKUNGE
GOJO	CHARACTERNAME	GOJO
GAMRAJ	CHARACTERNAME	GAMRAJ
MAGNETO	CHARACTERNAME	MAGNETO
EYE	CHARACTERNAME	THE EYE
MONSTEROSO	CHARACTERNAME	MONSTEROSO
CASSIE HACK	CHARACTERNAME	CASSIE HACK
FRANKENSTEIN	CHARACTERNAME	FRANKENSTEIN
ATLAS	CHARACTERNAME	ATLAS
STELLARIS	CHARACTERNAME	STELLARIS
V-MAN	CHARACTERNAME	V-MAN
NARCILINA MONTOYA	CHARACTERNAME	NARCILINA MONTOYA
SPUTNIK	CHARACTERNAME	SPUTNIK
EL OBSERVADOR	CHARACTERNAME	EL OBSERVADOR
REPTILLA	CHARACTERNAME	REPTILLA
BRUTALE	CHARACTERNAME	BRUTALE
NORMAN OSBORN	CHARACTERNAME	NORMAN OSBORN
BELYLLIOTH	CHARACTERNAME	BELYLLIOTH
RUBY SUMMERS	CHARACTERNAME	RUBY SUMMERS
BLUEBIRD	CHARACTERNAME	BLUEBIRD
YU-TI	CHARACTERNAME	DRAGON LORD
YERA ALLON	CHARACTERNAME	YERA ALLON
ELLEN DOLAN	CHARACTERNAME	DR. ELLEN DOLAN
JUSTIFIERS	CHARACTERNAME	JUSTIFIERS
OFFICER MERKEL	CHARACTERNAME	STAN MERKEL
SUPER-PATRIOT	CHARACTERNAME	SUPER-PATRIOT
IMAN	CHARACTERNAME	IMAN
CHESTY SANCHEZ	CHARACTERNAME	CHESTY SANCHEZ
SCARAB	CHARACTERNAME	THE SCARAB
BLACK OWL	CHARACTERNAME	BLACK OWL
OGRESS	CHARACTERNAME	OGRESS
YANK & DOODLE	CHARACTERNAME	YANK & DOODLE
WILSON THE WONDER ATHLETE	CHARACTERNAME	WILLIAM WILSON
LIGHTNING	CHARACTERNAME	LIGHTNING
REAPER	CHARACTERNAME	REAPER
MIGUEL BUSTAMONTE	CHARACTERNAME	MIGUEL BUSTAMONTE
WONDER DOG	CHARACTERNAME	WONDER DOG
VIN GONZALES	CHARACTERNAME	VIN GONZALES
SKULLBUSTER	CHARACTERNAME	SKULLBUSTER
THE MASK	CHARACTERNAME	THE MASK
BONEBREAKER	CHARACTERNAME	BONEBREAKER
PRETTY BOY	CHARACTERNAME	PRETTY BOY
SHE-CAT	CHARACTERNAME	SHE-CAT
CODENAME: ASSASSIN	CHARACTERNAME	CODENAME: ASSASSIN
JAZINDA	CHARACTERNAME	JAZINDA
LIST OF CITY OF HEROES CHARACTERS	CHARACTERNAME	LORD RECLUSE
LADY COP	CHARACTERNAME	LADY COP
CHAS CHANDLER	CHARACTERNAME	CHAS CHANDLER
CAPTAIN BATTLE	CHARACTERNAME	CAPTAIN BATTLE
THE MASTER OF THE IRON HAND	CHARACTERNAME	THE MASTER OF THE IRON HAND
CAPTAIN COURAGEOUS	CHARACTERNAME	CAPTAIN COURAGEOUS
LASH LIGHTNING	CHARACTERNAME	LASH LIGHTNING
QUEX-UL	CHARACTERNAME	QUEX-UL
CIPHER	CHARACTERNAME	CIPHER
RAVEN	CHARACTERNAME	THE RAVEN
STARBRAND	CHARACTERNAME	STAR BRAND
SUPERMAN	CHARACTERNAME	SUPERMAN
TILDIE SOAMES	CHARACTERNAME	TILDIE SOAMES
BLACKBRIAR THORN	CHARACTERNAME	BLACKBRIAR THORN
SQUID	CHARACTERNAME	SQUID
DOCTOR NEMESIS	CHARACTERNAME	DOCTOR NEMESIS
BUSTER BUNNY	CHARACTERNAME	BUSTER BUNNY
GARRYN BEK	CHARACTERNAME	GARRYN BEK
CLAW	CHARACTERNAME	THE CLAW
PYRE	CHARACTERNAME	PYRE
BLACK WIDOW	CHARACTERNAME	YELENA BELOVA
MS. GSPTLSNZ	CHARACTERNAME	MS. GSPTLSNZ
MARTIN SOAP	CHARACTERNAME	MARTIN SOAP
FIRST OF THE FALLEN	CHARACTERNAME	FIRST OF THE FALLEN
WINKY, BLINKY, AND NODDY	CHARACTERNAME	WINKY, BLINKY, AND NODDY
WEEPER	CHARACTERNAME	THE WEEPER
PHOBOS	CHARACTERNAME	PHOBOS
LADY BULLSEYE	CHARACTERNAME	LADY BULLSEYE
PROFESSOR CARTER NICHOLS	CHARACTERNAME	PROFESSOR CARTER NICHOLS
STERLING SILVERSMITH	CHARACTERNAME	STERLING T. SILVERSMITH
HOPE SUMMERS	CHARACTERNAME	HOPE SUMMERS
CAPTAIN FUTURE	CHARACTERNAME	CAPTAIN FUTURE
DANIEL HALL	CHARACTERNAME	DANIEL HALL, DREAM OF THE ENDLESS
HFUHRUHURR	CHARACTERNAME	HFUHRUHURR
GREEN GOBLIN	CHARACTERNAME	GREEN GOBLIN
CASPER THE FRIENDLY GHOST	CHARACTERNAME	CASPER THE FRIENDLY GHOST
VAL RHYMIN	CHARACTERNAME	VAL RHYMIN
IRON PATRIOT	CHARACTERNAME	IRON PATRIOT
LOIS LONDON	CHARACTERNAME	LOIS LONDON
CIPHER	CHARACTERNAME	CIPHER
UNKNOWN SOLDIER	CHARACTERNAME	THE UNKNOWN SOLDIER
FIST OF JUSTICE	CHARACTERNAME	FIST OF JUSTICE
CAPTAIN HADDOCK	CHARACTERNAME	CAPTAIN HADDOCK
LIST OF SCOTT PILGRIM CHARACTERS	CHARACTERNAME	SCOTT PILGRIM
THE FAT SLAGS	CHARACTERNAME	THE FAT SLAGS
LANCE HUNTER	CHARACTERNAME	LANCE HUNTER
ELI BARD	CHARACTERNAME	ELI BARD
BIZARRA	CHARACTERNAME	BIZARRA
PAULA VON GUNTHER	CHARACTERNAME	BARONESS PAULA VON GUNTHER
CARLIE COOPER	CHARACTERNAME	CARLIE COOPER
PURGATORY	CHARACTERNAME	PURGATORY
KYU-SHIN	CHARACTERNAME	KYU-SHIN
OGUN	CHARACTERNAME	OGUN
DRAGONMAGE	CHARACTERNAME	DRAGONMAGE
SPIDER-MAN NOIR	CHARACTERNAME	SPIDER-MAN
RAGNAROK	CHARACTERNAME	RAGNARöK
AQUAWOMAN	CHARACTERNAME	AQUAWOMAN
TELEKINESIS	CHARACTERNAME	TELEKINESIS
TITAN GIRL	CHARACTERNAME	TITAN GIRL
SONNY SUMO	CHARACTERNAME	SONNY SUMO
THARA AK-VAR	CHARACTERNAME	THARA AK-VAR
TWISTER	CHARACTERNAME	THE TWISTER
JILLIAN PEARLMAN	CHARACTERNAME	JILLIAN \
U.S. JONES	CHARACTERNAME	U.S. JONES
DRAGONNA	CHARACTERNAME	DRAGONNA
FLASH BOMBA	CHARACTERNAME	FLASH BOMBA
TINY TONY	CHARACTERNAME	TINY TONY
CAPTAIN BOOM	CHARACTERNAME	KAPITAN BOOM
VARGA	CHARACTERNAME	VARGA
GRIFFIN	CHARACTERNAME	THE GRIFFIN
SLASH	CHARACTERNAME	SLASH
SHVAUGHN ERIN	CHARACTERNAME	SHVAUGHN ERIN
CAPTAIN COMPASS	CHARACTERNAME	CAPTAIN COMPASS
TUCKER FORD	CHARACTERNAME	TUCKER FORD
HUNTSMAN	CHARACTERNAME	HUNTSMAN
MERLIN	CHARACTERNAME	MERLIN
SHE-HULK	CHARACTERNAME	SHE-HULK
ZIGOMAR	CHARACTERNAME	ZIGOMAR
MASTER DEATH	CHARACTERNAME	MASTER DEATH
THE MAD MOD WITCH	CHARACTERNAME	THE MAD MOD WITCH
SADIE SINCLAIR	CHARACTERNAME	SADIE SINCLAIR
SMOKESCREEN	CHARACTERNAME	SMOKESCREEN
VOGUE	CHARACTERNAME	VOGUE
RIPTIDE	CHARACTERNAME	RIPTIDE
PSILENCE	CHARACTERNAME	PSILENCE
COUGAR	CHARACTERNAME	COUGAR
SHIKARI SHAMBU	CHARACTERNAME	SHIKARI SHAMBU
FLARE	CHARACTERNAME	FLARE
FIRST BORN	CHARACTERNAME	FIRST BORN
MARUJA	CHARACTERNAME	MARUJA
SPARKPLUG	CHARACTERNAME	SPARKPLUG
HUNTSMAN	CHARACTERNAME	THE HUNTSMAN
JUDGE FRANCISCO	CHARACTERNAME	JUDGE FRANCISCO
SUPERNOVA	CHARACTERNAME	SUPERNOVA
ZOMBO	CHARACTERNAME	ZOMBO
MADAME ZODIAC	CHARACTERNAME	MADAME ZODIAC
PROFESSOR PYG	CHARACTERNAME	PROFESSOR PYG
SUPPANDI	CHARACTERNAME	SUPPANDI
MORRAT	CHARACTERNAME	MORRAT
ZOOK	CHARACTERNAME	ZOOK
VERTIGO	CHARACTERNAME	VERTIGO
KELDA	CHARACTERNAME	KELDA
PRODIGY	CHARACTERNAME	PRODIGY
JEANNETTE	CHARACTERNAME	JEANNETTE
MAN-ELEPHANT	CHARACTERNAME	MAN-ELEPHANT
MAN-ELEPHANT	CHARACTERNAME	MAN-ELEPHANT II
LT. ETHAN WARREN	CHARACTERNAME	LT. ETHAN WARREN
PETER CORBEAU	CHARACTERNAME	PETER CORBEAU
RAIDERS	CHARACTERNAME	MAULER
CHARLIE WEIDERMAN	CHARACTERNAME	CHARLIE WEIDERMAN
TRICEPHALOUS	CHARACTERNAME	TRICEPHALOUS
RADIATION ROY	CHARACTERNAME	RADIATION ROY
HAUNT	CHARACTERNAME	HAUNT
SCORN	CHARACTERNAME	SCORN
CAPTAIN WILLY SCHULTZ	CHARACTERNAME	CAPTAIN WILLY SCHULTZ
MASTER IZO	CHARACTERNAME	MASTER IZO
DELPHYNE GORGON	CHARACTERNAME	DELPHYNE GORGON
PSYNAPSE	CHARACTERNAME	PSYNAPSE
FOXBAT	CHARACTERNAME	FOXBAT
BOBO	CHARACTERNAME	BOBO
HEADSMAN	CHARACTERNAME	HEADSMAN
JOHNNY WITTS	CHARACTERNAME	JOHNNY WITTS
SIMON HURT	CHARACTERNAME	DOCTOR HURT
REPTIL	CHARACTERNAME	REPTIL
SHALOMAN	CHARACTERNAME	SHALOMAN
GLORY GRANT	CHARACTERNAME	GLORY GRANT
LORNA THE JUNGLE GIRL	CHARACTERNAME	LORNA THE JUNGLE GIRL
BOOGIE, EL ACEITOSO	CHARACTERNAME	OILY BOOGIE
WEASEL	CHARACTERNAME	WEASEL
PHILIPPUS	CHARACTERNAME	PHILIPPUS OF THEMYSCIRA
DRUU	CHARACTERNAME	DRUU
JEREMY KARNE	CHARACTERNAME	JEREMY KARNE
KING CHIMERA	CHARACTERNAME	KING CHIMERA
KID PSYCHO	CHARACTERNAME	KID PSYCHO
KONO	CHARACTERNAME	KONO
DAMIEN DARKBLOOD	CHARACTERNAME	DAMIEN DARKBLOOD
KENT SHAKESPEARE	CHARACTERNAME	KENT SHAKESPEARE
VICTORIA HAND	CHARACTERNAME	VICTORIA HAND
DEVLIN O'RYAN	CHARACTERNAME	DEVLIN O'RYAN
TANGERINE	CHARACTERNAME	TANGERINE
BLIGHT	CHARACTERNAME	BLIGHT
SPOOK	CHARACTERNAME	THE SPOOK
MOONBOW	CHARACTERNAME	MOONBOW
KING STANDISH	CHARACTERNAME	KING STANDISH
MYG	CHARACTERNAME	KARATE KID
OL-VIR	CHARACTERNAME	OL-VIR
PLANET MASTER	CHARACTERNAME	PLANET MASTER
DOCTOR HORMONE	CHARACTERNAME	DOCTOR HORMONE
CLYDE WYNCHAM	CHARACTERNAME	CLYDE WYNCHAM
CUPID	CHARACTERNAME	CUPID
JUDGE SINFIELD	CHARACTERNAME	JUDGE SINFIELD
DARWIN JONES	CHARACTERNAME	DARWIN JONES
TIGER SHARK	CHARACTERNAME	TIGER SHARK
HIRO-KALA	CHARACTERNAME	HIRO-KALA
TARKAN	CHARACTERNAME	TARKAN
RAG DOLL	CHARACTERNAME	RAG DOLL
BLACKTHORN	CHARACTERNAME	BLACKTHORN
TOXYN	CHARACTERNAME	TOXYN
SCAREDYCAT	CHARACTERNAME	SCAREDYCAT
RADIAN	CHARACTERNAME	RADIAN
SNAPDRAGON	CHARACTERNAME	SNAPDRAGON
VYKING	CHARACTERNAME	VYKING
SHEAR	CHARACTERNAME	SHEAR
BACKHAND	CHARACTERNAME	BACKHAND
SCATTERBRAIN	CHARACTERNAME	SCATTERBRAIN
WILDCARD	CHARACTERNAME	WILDCARD
SILENCER	CHARACTERNAME	SILENCER
ADEPT	CHARACTERNAME	ADEPT
BLUE MARVEL	CHARACTERNAME	BLUE MARVEL
THE HIGH	CHARACTERNAME	THE HIGH
WARLOCK OF YS	CHARACTERNAME	WARLOCK OF YS
CLIVE RESTON	CHARACTERNAME	CLIVE RESTON
CYNTHIA VON DOOM	CHARACTERNAME	CYNTHIA VON DOOM
JOHN KING	CHARACTERNAME	JOHN KING
REX LEECH	CHARACTERNAME	REX LEECH
ROXY LEECH	CHARACTERNAME	ROXY LEECH
ZEUS	CHARACTERNAME	ZEUS
H.O.M.E.R.	CHARACTERNAME	H.O.M.E.R.
PROFESSOR THORTON	CHARACTERNAME	THE PROFESSOR
DIRTY FRANK	CHARACTERNAME	DIRTY FRANK
DYBBUK	CHARACTERNAME	DYBBUK
DRAGON KING	CHARACTERNAME	DRAGON KING
NIGHTSLAYER	CHARACTERNAME	NIGHTSLAYER
FRENCHIE	CHARACTERNAME	FRENCHIE
RIOT	CHARACTERNAME	RIOT
PEGGY CARTER	CHARACTERNAME	PEGGY CARTER
LIFE ENTITY	CHARACTERNAME	THE LIFE ENTITY
SNOWY	CHARACTERNAME	SNOWY
NIGHTRIDER	CHARACTERNAME	NIGHTRIDER
GORILLA BOSS	CHARACTERNAME	GORILLA BOSS
HOLOCAUST	CHARACTERNAME	HOLOCAUST
KEARSON DEWITT	CHARACTERNAME	KEARSON Z. DEWITT
ANNA FORTUNE	CHARACTERNAME	ANNA FORTUNE
NUIDIS VULKO	CHARACTERNAME	NUIDIS VULKO
KA-ZAR	CHARACTERNAME	KA-ZAR
TURK BARRETT	CHARACTERNAME	TURK BARRETT
JOHN STEELE	CHARACTERNAME	JOHN STEELE
ECHO	CHARACTERNAME	ECHO
EKRON	CHARACTERNAME	EKRON
MISTER AMERICA	CHARACTERNAME	MR. AMERICA
REACTRON	CHARACTERNAME	REACTRON
OLIVIER	CHARACTERNAME	OLIVIER
WONG-CHU	CHARACTERNAME	WONG-CHU
SHRIKER	CHARACTERNAME	SHRIKER
ZADKIEL	CHARACTERNAME	ZADKIEL
DEACON	CHARACTERNAME	THE DEACON
ULTIMATE IRON MAN	CHARACTERNAME	IRON MAN
STACY DOLAN	CHARACTERNAME	STACY DOLAN
STEEL WIND	CHARACTERNAME	STEEL WIND
MORGAN STARK	CHARACTERNAME	MORGAN STARK
METTLE	CHARACTERNAME	METTLE
SCARLET WITCH	CHARACTERNAME	SCARLET WITCH
FRANCINE LANGSTROM	CHARACTERNAME	SHE-BAT
KING ARTHUR	CHARACTERNAME	KING ARTHUR
AQUALAD	CHARACTERNAME	AQUALAD
DANIEL DRUMM	CHARACTERNAME	DANIEL DRUMM
AQUARIUS	CHARACTERNAME	AQUARIUS
SJORS & SJIMMIE	CHARACTERNAME	SJORS & SJIMMIE
TYRONE CASH	CHARACTERNAME	TYRONE CASH
ROBIN HOOD	CHARACTERNAME	ROBIN HOOD
JANU THE JUNGLE BOY	CHARACTERNAME	JANU THE JUNGLE BOY
PHANTOM	CHARACTERNAME	THE PHANTOM
THE WRETCH	CHARACTERNAME	THE WRETCH
SOPHIA %22CHAT%22 SANDUVAL	CHARACTERNAME	SOPHIA “CHAT” SANDUVAL
ISIDORO CAñONES	CHARACTERNAME	ISIDORO CAñONES
CHRISTINE EVERHART	CHARACTERNAME	CHRISTINE EVERHART
SASHA HAMMER	CHARACTERNAME	SASHA HAMMER
AQUAGIRL	CHARACTERNAME	AQUAGIRL
LADY GORGON	CHARACTERNAME	LADY GORGON
GILGAMESH THE IMMORTAL	CHARACTERNAME	GILGAMESH THE IMMORTAL
MIYAMOTO USAGI	CHARACTERNAME	MIYAMOTO USAGI
RED KING	CHARACTERNAME	RED KING
SOLSTICE	CHARACTERNAME	SOLSTICE
JAVELYNN	CHARACTERNAME	JAVELYNN
ATOM	CHARACTERNAME	ATOM
CRIMEBUSTER	CHARACTERNAME	CRIMEBUSTER
SUPERKATT	CHARACTERNAME	SUPERKATT
HOPE PEZZINI	CHARACTERNAME	HOPE PEZZINI
HAND OF THE DRAGON	CHARACTERNAME	THE DRAGON
DEMON HUNTER	CHARACTERNAME	THE DEMON HUNTER
TAMARA FOX	CHARACTERNAME	TAMARA \
MIGHTY MAN	CHARACTERNAME	MIGHTY MAN
AURA	CHARACTERNAME	AURA
BLACKWULF	CHARACTERNAME	BLACKWULF
SUPER ISLAW	CHARACTERNAME	SUPER ISLAW
PROFESSOR HAMILTON	CHARACTERNAME	EMIL HAMILTON
DESTROYER	CHARACTERNAME	THE DESTROYER
PAULIE PROVENZANO	CHARACTERNAME	OMERTà
VERMIN	CHARACTERNAME	VERMIN
MR. SCARLET	CHARACTERNAME	MISTER SCARLET
MODOK	CHARACTERNAME	MODOK
NELVANA OF THE NORTHERN LIGHTS	CHARACTERNAME	NELVANA OF THE NORTHERN LIGHTS
STARFIRE	CHARACTERNAME	STARFIRE
TOMAR-RE	CHARACTERNAME	TOMAR-RE
DEAD GIRL	CHARACTERNAME	DEAD GIRL
BLUE DEVIL	CHARACTERNAME	BLUE DEVIL
JESSE CHAMBERS	CHARACTERNAME	JESSE CHAMBERS
HECTOR HALL	CHARACTERNAME	HECTOR HALL
CHIEF PARKER	CHARACTERNAME	CHIEF PARKER
BARNEY BARTON	CHARACTERNAME	BARNEY BARTON
NIGHTRUNNER	CHARACTERNAME	NIGHTRUNNER
QUARMER	CHARACTERNAME	QUARMER
COMBATRON	CHARACTERNAME	COMBATRON
STUMBO THE GIANT	CHARACTERNAME	STUMBO
SAINT WALKER	CHARACTERNAME	SAINT WALKER
LAUFEY	CHARACTERNAME	LAUFEY
ELVES	CHARACTERNAME	ELVES
LIST OF MINOR DC COMICS CHARACTERS	CHARACTERNAME	MAGPIE
LIST OF MINOR DC COMICS CHARACTERS	CHARACTERNAME	MENAGERIE
RED BEETLE	CHARACTERNAME	RED BEETLE
DWARFSTAR	CHARACTERNAME	DWARFSTAR
KULAFU	CHARACTERNAME	KULAFU
JASON STRYKER	CHARACTERNAME	JASON STRYKER
ROBODUCK	CHARACTERNAME	ROBODUCK
DIAMOND	CHARACTERNAME	DIAMOND
FLYER	CHARACTERNAME	FLYER
MINOTAUR	CHARACTERNAME	MINI
GAZELLE	CHARACTERNAME	GAZELLE
JIM MORITA	CHARACTERNAME	JIM MORITA
DEADALUS	CHARACTERNAME	DEADALUS
POWER MAN	CHARACTERNAME	POWER MAN
GABRIEL	CHARACTERNAME	GABRIEL
DETROIT STEEL	CHARACTERNAME	DETROIT STEEL
G-MAN	CHARACTERNAME	G-MAN
TRANSONIC	CHARACTERNAME	TRANSONIC
VELOCIDAD	CHARACTERNAME	VELOCIDAD
SPIDER-MAN	CHARACTERNAME	SPIDER-MAN
OYA	CHARACTERNAME	OYA
SEAN AND CHRIS	CHARACTERNAME	SEAN AND CHRIS
THEA	CHARACTERNAME	THEA
COWBOY HENK	CHARACTERNAME	COWBOY HENK
PRIMAL	CHARACTERNAME	PRIMAL
KENJI UEDO	CHARACTERNAME	KENJI UEDO
TROLL	CHARACTERNAME	TROLL
FORESKIN MAN	CHARACTERNAME	FORESKIN MAN
HAZMAT	CHARACTERNAME	HAZMAT
PLASTIQUE	CHARACTERNAME	PLASTIQUE
TERRAFORMER	CHARACTERNAME	TERRAFORMER
TIRAMOLLA	CHARACTERNAME	TIRAMOLLA
JUNE COVINGTON	CHARACTERNAME	JUNE COVINGTON
FINESSE	CHARACTERNAME	FINESSE
NOAH VAN HELSING	CHARACTERNAME	NOAH VAN HELSING
LORELEI TRAVIS	CHARACTERNAME	LORELEI
IRON MAN	CHARACTERNAME	IRON MAN
WHITE TIGER	CHARACTERNAME	WHITE TIGER
SUMMER GLEESON	CHARACTERNAME	SUMMER GLEESON
BEE-MAN	CHARACTERNAME	BEE-MAN
MALLEN	CHARACTERNAME	MALLEN
STATIC	CHARACTERNAME	STATIC
MISSING MAN	CHARACTERNAME	MISSING MAN
ALDRICH KILLIAN	CHARACTERNAME	ALDRICH KILIAN
SYDREN	CHARACTERNAME	SYDREN
YON-ROGG	CHARACTERNAME	YON-ROGG
BLOODFANG	CHARACTERNAME	BLOODFANG
DHARMA	CHARACTERNAME	DHARMA
DORREK VII	CHARACTERNAME	DORREK VII
BLUE EAR	CHARACTERNAME	BLUE EAR
NICK FURY JR.	CHARACTERNAME	NICK FURY JR.
MAYA HANSEN	CHARACTERNAME	MAYA HANSEN
LEI KUNG	CHARACTERNAME	LEI KUNG
NORAH WINTERS	CHARACTERNAME	NORAH WINTERS
THE URBAN LEGEND	CHARACTERNAME	THE URBAN LEGEND
NOVA	CHARACTERNAME	SAM ALEXANDER
HUGIN AND MUNIN	CHARACTERNAME	HUGIN AND MUNIN
WHITE DRAGON	CHARACTERNAME	WHITE DRAGON
WHITE DRAGON	CHARACTERNAME	WHITE DRAGON II
STREAMLINE	CHARACTERNAME	STREAMLINE
SHURI	CHARACTERNAME	SHURI
IRON BUTTERFLY	CHARACTERNAME	IRON BUTTERFLY
STAINED GLASS SCARLET	CHARACTERNAME	STAINED GLASS SCARLET
PATTY SPIVOT	CHARACTERNAME	PATTY SPIVOT
WEAPONS MASTER	CHARACTERNAME	XOTAR
BRAIN STORM	CHARACTERNAME	BRAIN STORM
DOLLMAKER	CHARACTERNAME	DOLLMAKER
PIECEMEAL	CHARACTERNAME	PIECEMEAL
ALPHA	CHARACTERNAME	ALPHA
DINKAN	CHARACTERNAME	DINKAN
EDEN FESI	CHARACTERNAME	MANIFOLD
SIMON BAZ	CHARACTERNAME	SIMON BAZ
GOODMAN BEAVER	CHARACTERNAME	GOODMAN BEAVER
JUSTON SEYFERT	CHARACTERNAME	JUSTON SEYFERT
RED BARBARIAN	CHARACTERNAME	RED BARBARIAN
JUDGE BACHMANN	CHARACTERNAME	JUDGE BACHMANN
PROPHET	CHARACTERNAME	PROPHET
FARLEY STILLWELL	CHARACTERNAME	DR. FARLEY STILLWELL
ZOLA	CHARACTERNAME	ZOLA
JIMMY HUDSON	CHARACTERNAME	JIMMY HUDSON
BLEEZ	CHARACTERNAME	BLEEZ
OVERDRIVE	CHARACTERNAME	OVERDRIVE
VYNDKTVX	CHARACTERNAME	VYNDKTVX
FREYA	CHARACTERNAME	FREYA
ANACHRONISM	CHARACTERNAME	ANACHRONISM
LARRY LANCE	CHARACTERNAME	LARRY LANCE
CHINA WHITE	CHARACTERNAME	CHINA WHITE
BABY WILDEBEEST	CHARACTERNAME	BABY WILDEBEEST
DIAN BELMONT	CHARACTERNAME	DIAN BELMONT
CAMMI	CHARACTERNAME	CAMMI
APEX	CHARACTERNAME	APEX
NARA	CHARACTERNAME	NARA
CULLEN BLOODSTONE	CHARACTERNAME	BLOODSTONE
DEATH LOCKET	CHARACTERNAME	DEATH LOCKET
GIDEON MACE	CHARACTERNAME	GIDEON MACE
KRIMSON	CHARACTERNAME	KRIMSON
BUCK ROGERS	CHARACTERNAME	BUCK ROGERS
SARNAK	CHARACTERNAME	SARNAK OR SARNAK, MASTER OF SOUND
HAROLD MEACHUM	CHARACTERNAME	HAROLD MEACHUM
SUPER CHOLITA	CHARACTERNAME	SúPER CHOLITA
TECHNOVORE	CHARACTERNAME	TECHNOVORE
JUAN BOBO	CHARACTERNAME	JUAN BOBO
APOCALYPSE TWINS	CHARACTERNAME	APOCALYPSE TWINS
RHOMANN DEY	CHARACTERNAME	RHOMANN DEY
ARMLESS TIGER MAN	CHARACTERNAME	ARMLESS TIGER MAN
CAVE GIRL	CHARACTERNAME	CAVE GIRL
JOHN GARRETT	CHARACTERNAME	JOHN GARRETT
KANGA	CHARACTERNAME	KANGA
CAPTAIN HURRICANE	CHARACTERNAME	CAPTAIN HURRICANE
RASTAPOPOULOS	CHARACTERNAME	RASTAPOPOULOS
MARIO FALCONE	CHARACTERNAME	MARIO FALCONE
RECORDER 451	CHARACTERNAME	RECORDER 451
EX NIHILO	CHARACTERNAME	EX NIHILO
BREEZE BARTON	CHARACTERNAME	BREEZE BARTON
SCRATCH9	CHARACTERNAME	SCRATCH
SWAGMAN	CHARACTERNAME	SWAGMAN
MS. MARVEL	CHARACTERNAME	MS. MARVEL
FELICITY SMOAK	CHARACTERNAME	FELICITY SMOAK
WASABI-NO-GINGER	CHARACTERNAME	WASABI-NO-GINGER
FREDZILLA	CHARACTERNAME	FREDZILLA
KATHERINE ANNE SUMMERS	CHARACTERNAME	KATHERINE ANNE SUMMERS
HELLCOW	CHARACTERNAME	HELLCOW
JANICE LINCOLN	CHARACTERNAME	JANICE LINCOLN
ANDREW FORSON	CHARACTERNAME	ANDREW FORSON
BLUEBIRD	CHARACTERNAME	BLUEBIRD
MISTER TOAD	CHARACTERNAME	MISTER TOAD
SUPERBOY	CHARACTERNAME	SUPERBOY
ARKHAM KNIGHT	CHARACTERNAME	THE ARKHAM KNIGHT
DWARVES	CHARACTERNAME	DWARVES
THE GREEN TURTLE	CHARACTERNAME	THE GREEN TURTLE
CYPHER	CHARACTERNAME	CYPHER
GUILT HULK	CHARACTERNAME	GUILT HULK
RICK STONE	CHARACTERNAME	RICK STONE
DAISY WATKINS	CHARACTERNAME	DAISY WATKINS
TAZZA	CHARACTERNAME	TAZZA
ZOTA	CHARACTERNAME	ZOTA
MISTER RASPUTIN	CHARACTERNAME	MISTER RASPUTIN
LARRY WADE	CHARACTERNAME	LARRY WADE
FRIEDA GOREN	CHARACTERNAME	FRIEDA GOREN
DIKAN	CHARACTERNAME	DIKAN
PAINTER	CHARACTERNAME	PAINTER
ASBESTOS MAN	CHARACTERNAME	ASBESTOS MAN
PURGE	CHARACTERNAME	PURGE
REBECCA BANNER	CHARACTERNAME	REBECCA BANNER
HUMMINGBIRD	CHARACTERNAME	HUMMINGBIRD
BUNKER	CHARACTERNAME	BUNKER
ELAINE BANNER	CHARACTERNAME	ELAINE BANNER
JAKE RED CLOUD	CHARACTERNAME	JAKE RED CLOUD
JAVA	CHARACTERNAME	JAVA
DAVID SINGH	CHARACTERNAME	DAVID SINGH
EBON SAMURAI	CHARACTERNAME	EBON SAMURAI
GOLDEN BOY	CHARACTERNAME	GOLDEN BOY
BOVA	CHARACTERNAME	BOVA
WILDSTAR	CHARACTERNAME	WILDSTAR
DAVID CORPORON	CHARACTERNAME	COMMISSIONER CORPORON
AYA	CHARACTERNAME	AYA
LIVEWIRE	CHARACTERNAME	LIVEWIRE
SHOCK	CHARACTERNAME	SHOCK
BLUE TALON	CHARACTERNAME	BLUE TALON
SPORE	CHARACTERNAME	SPORE
ODD MAN	CHARACTERNAME	ODD MAN
INODORO PEREYRA	CHARACTERNAME	INODORO PEREYRA
JOE JITSU	CHARACTERNAME	JOE JITSU
HOPE PYM	CHARACTERNAME	HOPE PYM
J'SON	CHARACTERNAME	J'SON
PROFESSOR BARABAS	CHARACTERNAME	PROFESSOR BARABAS
ROGER DOOLEY	CHARACTERNAME	ROGER DOOLEY
CONDIMENT KING	CHARACTERNAME	CONDIMENT KING
CLAIRE TEMPLE	CHARACTERNAME	CLAIRE TEMPLE
JOKER	CHARACTERNAME	THE JOKER
ZED	CHARACTERNAME	ZED
EMPEROR BLACKGATE	CHARACTERNAME	EMPEROR BLACKGATE
DOCTOR MEGALA	CHARACTERNAME	HEINRICH MEGALA
SILK	CHARACTERNAME	SILK
TANYA SPEARS	CHARACTERNAME	POWER GIRL
BAT-COW	CHARACTERNAME	BAT COW
SHIKLAH	CHARACTERNAME	SHIKLAH
KRAVEN THE HUNTER	CHARACTERNAME	KRAVEN THE HUNTER
MICKEY FONDOZZI	CHARACTERNAME	MICKEY FONDOZZI
THORN	CHARACTERNAME	THORN
DAMAGE	CHARACTERNAME	DAMAGE
SNIPER	CHARACTERNAME	SNIPER
RACHEL COLE-ALVES	CHARACTERNAME	RACHEL COLE-ALVES
MASSACRE	CHARACTERNAME	MASSACRE
DARREN CROSS	CHARACTERNAME	DARREN CROSS
SARACEN	CHARACTERNAME	SARACEN
EVERETT K. ROSS	CHARACTERNAME	EVERETT K. ROSS
FU MANCHU	CHARACTERNAME	FU MANCHU
STRIX	CHARACTERNAME	STRIX
INFERNO	CHARACTERNAME	INFERNO
LUCKY THE PIZZA DOG	CHARACTERNAME	LUCKY THE PIZZA DOG
FLAMINGO	CHARACTERNAME	FLAMINGO
MINOTAUR	CHARACTERNAME	MINOTAUR
DRUSILLA	CHARACTERNAME	DRUSILLA
SPIDER-WOMAN	CHARACTERNAME	SPIDER-WOMAN
ADHEMAR	CHARACTERNAME	ADHEMAR
NERO	CHARACTERNAME	NERO
LAMBIK	CHARACTERNAME	LAMBIK
ELDRAC	CHARACTERNAME	ELDRAC
RICARDO	CHARACTERNAME	RICARDO
ABRAHAM TUIZENTFLOOT	CHARACTERNAME	ABRAHAM TUIZENTFLOOT
JEROM	CHARACTERNAME	JEROM
LASH	CHARACTERNAME	LASH
FALLEN ONE	CHARACTERNAME	FALLEN ONE
ROM	CHARACTERNAME	ROM
PIET FLUWIJN EN BOLLEKE	CHARACTERNAME	PIET FLUWIJN EN BOLLEKE
MADAM PHEIP	CHARACTERNAME	MADAM PHEIP
MENEER PHEIP	CHARACTERNAME	MENEER PHEIP
EOBARD THAWNE	CHARACTERNAME	PROFESSOR ZOOM
JERYN HOGARTH	CHARACTERNAME	JERYN HOGARTH
SHOU-LAO	CHARACTERNAME	SHOU-LAO
TITUS	CHARACTERNAME	TITUS
SCHANULLEKE	CHARACTERNAME	SCHANULLEKE
LIST OF INCARNATIONS OF SPIDER-MAN	CHARACTERNAME	SPIDER-X
LIST OF INCARNATIONS OF SPIDER-MAN	CHARACTERNAME	AI APAEC
BERT	CHARACTERNAME	BERT
TANTE SIDONIA	CHARACTERNAME	TANTE SIDONIA
MAPUI	CHARACTERNAME	MAPUI
CAPTAIN RECTITUDE	CHARACTERNAME	CAPTAIN RECTITUDE
KINGSIZE	CHARACTERNAME	KINGSIZE
FLAME	CHARACTERNAME	FLAME
FEROCIA	CHARACTERNAME	FEROCIA
ANTHEM	CHARACTERNAME	ANTHEM
ARDINA	CHARACTERNAME	ARDINA
BLIND JUSTICE	CHARACTERNAME	BLIND JUSTICE
DETECTIVE VAN ZWAM	CHARACTERNAME	DETECTIVE VAN ZWAM
MAGGIE MURDOCK	CHARACTERNAME	MAGGIE MURDOCK
JACK MURDOCK	CHARACTERNAME	JACK MURDOCK
SERPENT	CHARACTERNAME	SERPENT
RAPIDO	CHARACTERNAME	RAPIDO
SHADES	CHARACTERNAME	SHADES
COMANCHE	CHARACTERNAME	COMANCHE
CHESHIRE CAT	CHARACTERNAME	CHESHIRE CAT
DONTRELL HAMILTON	CHARACTERNAME	DONTRELL HAMILTON
SPEAR	CHARACTERNAME	SPEAR
BLACK MARIAH	CHARACTERNAME	BLACK MARIAH
GUILLOTINE	CHARACTERNAME	GUILLOTINE
GEORGE TAYLOR	CHARACTERNAME	GEORGE TAYLOR
AUGUSTINE CROSS	CHARACTERNAME	AUGUSTINE CROSS
ANTIMONY CARVER	CHARACTERNAME	ANTIMONY CARVER
JAGGED BOW	CHARACTERNAME	JAGGED BOW
DEATH-SHIELD	CHARACTERNAME	DEATH-SHIELD
THE CLOWN	CHARACTERNAME	THE CLOWN
JONATHAN SAMUEL KENT	CHARACTERNAME	JONATHAN SAMUEL KENT
LORD SATANIS	CHARACTERNAME	LORD SATANIS
WALLY WEST II	CHARACTERNAME	WALLY WEST II
FRIDAY	CHARACTERNAME	FRIDAY
ULYSSES	CHARACTERNAME	ULYSSES
GODSPEED	CHARACTERNAME	GODSPEED
VERA SWEET	CHARACTERNAME	VERA SWEET
VINCENT YATZ	CHARACTERNAME	VINCENT YATZ
BILL BRANE	CHARACTERNAME	BILL BRANE
PROTEUS	CHARACTERNAME	PROTEUS
TERROR	CHARACTERNAME	TERROR
SUPREME ONE	CHARACTERNAME	SUPREME ONE
YOGI BIZERK	CHARACTERNAME	SUPREME ONE
DOCTOR LITTLEJOHN	CHARACTERNAME	DOCTOR LITTLEJOHN
WINGY AMES	CHARACTERNAME	WINGY AMES
JESSICA CRUZ	CHARACTERNAME	JESSICA CRUZ
EMRYS KILLEBREW	CHARACTERNAME	EMRYS KILLEBREW
ANGEL DEVLIN	CHARACTERNAME	ANGEL DEVLIN
GWENPOOL	CHARACTERNAME	GWENPOOL
RIRI WILLIAMS	CHARACTERNAME	RIRI WILLIAMS
ZILIUS ZOX	CHARACTERNAME	ZILIUS ZOX
KOBIK	CHARACTERNAME	KOBIK
REDWING	CHARACTERNAME	REDWING
RALPHIE HUTCHINS	CHARACTERNAME	RALPH \
SHADOW MAN	CHARACTERNAME	SHADOW MAN
DEVONNE	CHARACTERNAME	DEVONNE
COTTONMOUTH	CHARACTERNAME	COTTONMOUTH
JOY MEACHUM	CHARACTERNAME	JOY MEACHUM
SPIDER-HAM	CHARACTERNAME	SPIDER-HAM
