Proletären	chiefEditor	Lars Rothelius
The Hindu	chiefEditor	Narasimhan Ram
National Post	chiefEditor	Stephen Meurice
Aftonbladet	chiefEditor	Jan Helin
The Indian Express	chiefEditor	Shekhar Gupta
El País	chiefEditor	Javier Moreno Barber
Lianhe Zaobao	chiefEditor	Tan Kah Kee
New York Press	chiefEditor	Jerry Portwood
Wirtschaftswoche	chiefEditor	Roland Tichy
WorldNetDaily	chiefEditor	Joseph Farah
Expressen	chiefEditor	Thomas Mattsson
FrontPage Magazine	chiefEditor	David Horowitz
Berliner Zeitung	chiefEditor	Uwe Vorkötter
Junge Welt	chiefEditor	Arnold Schölzel
Malayala Manorama	chiefEditor	Mammen Mathew
The National (sports newspaper)	chiefEditor	Frank Deford
Kauno diena	chiefEditor	Žilvinė Petrauskaitė-Taranda
Madhyamam Daily	chiefEditor	O. Abdurahman
The New Indian Express	chiefEditor	Prabhu Chawla
The eXile	chiefEditor	Mark Ames
The eXile	chiefEditor	Yasha Levine
Dala-Demokraten	chiefEditor	Göran Greider
Zaman (newspaper)	chiefEditor	Ekrem Dumanlı
Mindanao Times	chiefEditor	Amalia Cabusao
Timpul de dimineaţă	chiefEditor	Sorina Ştefârţă
Women's Wear Daily	chiefEditor	Edward Nardoza
Cotidianul	chiefEditor	Cornel Nistorescu
El Espectador	chiefEditor	Élber Gutiérrez Roa
Deshabhimani	chiefEditor	V. V. Dakshinamoorthi
Hour Community	chiefEditor	Jamie O'Meara
Jasarat	chiefEditor	Athar Hashmi
The Sunday Times (Sri Lanka)	chiefEditor	Sinha Migara Ratnatunga
Burlington Post	chiefEditor	Jill Davis
The Daily Mirror (Sri Lanka)	chiefEditor	Champika Liyanaarachchi
Federal Times	chiefEditor	Tobias Naegele
The Hilltop (newspaper)	chiefEditor	Aleesa Mann
Luxemburger Wort	chiefEditor	Marc Glesener
De Pers	chiefEditor	Ben Rogmans
Mindanao Post	chiefEditor	Doming Rosal
Mindanao Pulse	chiefEditor	Elmer Yaun
Politico (newspaper)	chiefEditor	John F. Harris
Hamburger Abendblatt	chiefEditor	Claus Strunz
Lok Samvad	chiefEditor	S.P. Kashyap
Mindanao Examiner	chiefEditor	Al Jacinto
Nya Wermlands-Tidningen	chiefEditor	Staffan Ander
Qué!	chiefEditor	Pedro Biurrun
The Juba Post	chiefEditor	Bullen Kenyi
Kantipur (daily)	chiefEditor	Sudhir Sharma
Haugesunds Avis	chiefEditor	Pål André Berg
Saamana	chiefEditor	Bal Thackeray
Calcalist	chiefEditor	Yoel Esteron
Proletarian Era	chiefEditor	Provash Ghosh
Ullern Avis Akersposten	chiefEditor	Ivar Brynildsen
Asia Inc.	chiefEditor	Ho Kay Tat
PR-e-Sense	chiefEditor	Krishnaswamy Srinivasan
Swadeshabhimani (newspaper)	chiefEditor	Swadeshabhimani Ramakrishna Pillai
GAO Journal	chiefEditor	Stephen Altman
International Journal of Government Auditing	chiefEditor	Donald R. Drach
Colonial Times	chiefEditor	Andrew Bent
Wolverine Citizen	chiefEditor	Francis H. Rankin, Sr.
Poduniversal	chiefEditor	Krishnaswamy Srinivasan
Kievan Past	chiefEditor	Feofan Lebedyntsev
North Bay Bohemian	chiefEditor	Dan Pulcrano
Hastings & St. Leonards Observer	chiefEditor	Keith Ridley
The Insider (newspaper)	chiefEditor	Albert J. Neri
The Insider (newspaper)	chiefEditor	John Verbanac
Hamburger Morgenpost	chiefEditor	Frank Niggemeier
The Public Record (newspaper)	chiefEditor	James Tayoun
Rahbar (newspaper)	chiefEditor	Iraj Eskandari
Cartoon Watch	chiefEditor	Triambak sharma
Chegemskaya Pravda	chiefEditor	Inal Khashig
Cuvânt moldovenesc	chiefEditor	Nicolae Alexandri
Cuvânt moldovenesc	chiefEditor	Pan Halippa
Literatura şi Arta	chiefEditor	Nicolae Dabija
La Gerbe	chiefEditor	Marc Augier
The Milli Gazette	chiefEditor	Zafarul Islam Khan
Iso-Polifonia	chiefEditor	Ramadan Sokoli
Iso-Polifonia	chiefEditor	Vasil Tole
Rilindja Demokratike	chiefEditor	Bledi Kasmi
Jurnal de Chişinău	chiefEditor	Rodica Mahu
Daily FT	chiefEditor	Nisthar Cassim
Tiedonantaja	chiefEditor	Erkki Susi
Union times today	chiefEditor	Sanjiv Desai
Union Times Today	chiefEditor	Sanjiv Desai
Deşteptarea (newspaper)	chiefEditor	Ştefan Secăreanu
Ţara	chiefEditor	Ştefan Secăreanu
Observatorul de Nord	chiefEditor	Victor Cobăsneanu
Gazeta Românească	chiefEditor	Valeriu Saharneanu
Sfatul Ţării (newspaper, 1917-1920)	chiefEditor	Nicolae Alexandri
Ardealul	chiefEditor	Onisifor Ghibu
România Nouă	chiefEditor	Onisifor Ghibu
Glasul Basarabiei	chiefEditor	Grigore Constantinescu
Art press	chiefEditor	Catherine Millet
Cuvântul Liber (Leova)	chiefEditor	Ion Mititelu
Moldavskie Vedomosti	chiefEditor	Dumitru Ciubaşenco
Unghiul	chiefEditor	Tatiana Cuibaru, Valentina Slotina
Sud-Est (magazine)	chiefEditor	Valentina Tăzlăuanu
Contrafort	chiefEditor	Vitalie Ciobanu
The Agatya	chiefEditor	Mahbub Jamal Zahedi
General (newspaper)	chiefEditor	K.D. Joseph
The Daily (News Corporation)	chiefEditor	Jesse Angelo
Cahiers Octave Mirbeau	chiefEditor	Pierre Michel
