WEDNESDAY MORNING, 3 A.M.	COVER	SIMON & GARFUNKEL, WEDNESDAY MORNING, 3 A.M. .PNG
MEDAL OF HONOR: ALLIED ASSAULT	COVER	MEDAL OF HONOR, ALLIED ASSAULT ORIGINAL SOUNDTRACK COVER.PNG
HEAD OVER HEELS	COVER	COCTEAU TWINS, HEAD OVER HEELS .JPG
EXODUS	COVER	BOB MARLEY AND THE WAILERS - EXODUS.PNG
WISH YOU WERE HERE	COVER	PINK FLOYD, WISH YOU WERE HERE .PNG
ENGLAND, HALF-ENGLISH	COVER	ENGLAND, HALF ENGLISH.JPG
HEARTS OF OAK	COVER	TED LEO AND THE PHARMACISTS - HEARTS OF OAK COVER.JPG
MEDAL OF HONOR: FRONTLINE	COVER	MEDAL OF HONOR, FRONTLINE ORIGINAL SOUNDTRACK RECORDING COVER.PNG
JUSTIFY MY LOVE	COVER	MADONNA,_JUSTIFY_MY_LOVE_SINGLE_COVER.PNG
PAPA DON'T PREACH	COVER	MADONNA, PAPA DON'T PREACH COVER.PNG
DON'T TELL ME	COVER	MADONNA,_DON'T_TELL_ME_COVER.PNG
CIVILIZATION PHAZE III	COVER	FRANK ZAPPA, CIVILIZATION PHAZE III.JPG
JAMES TAYLOR	COVER	JAMES TAYLOR, JAMES TAYLOR .PNG
EPITAPH	COVER	EPITAPH, KING CRIMSON.JPG
CLOSE MY EYES	COVER	THE SLACKERS, CLOSE MY EYES- ALBUM COVEART.JPG
MATERIAL GIRL	COVER	MADONNA, MATERIAL GIRL US VINYL COVER.PNG
THE BEST BAND YOU NEVER HEARD IN YOUR LIFE	COVER	FRANK ZAPPA, BEST BAND YOU NEVER HEARD.JPG
ROCK AGAINST BUSH, VOL. 2	COVER	ROCK AGAINST BUSH, VOL. 2.JPG
ROCK AGAINST BUSH, VOL. 1	COVER	ROCK AGAINST BUSH, VOL. 1.JPG
ARENA	COVER	ARENA,DURAN DURAN,VHSBOX.JPG
REDEMPTION SONG	COVER	BOB MARLEY AND THE WAILERS - REDEMPTION SONG.JPG
SHERYL CROW	COVER	SHERYL CROW, ALBUM.PNG
SHERYL CROW AND FRIENDS: LIVE FROM CENTRAL PARK	COVER	SHERYL CROW AND FRIENDS.JPG
MADONNA	COVER	MADONNA,_DEBUT_ALBUM_COVER.PNG
SPORTS	COVER	HUEY LEWIS AND THE NEWS - SPORTS.PNG
YOU CAN'T DO THAT ON STAGE ANYMORE, VOL. 4	COVER	FRANK ZAPPA, YOU CAN'T DO THAT ON STAGE ANYMORE 4.JPG
FROZEN	COVER	MADONNA, FROZEN.PNG
1984	COVER	ROGER MIRET AND THE DISASTERS 1984.JPG
ROGER MIRET AND THE DISASTERS	COVER	ROGER MIRET AND THE DISASTERS SELF-TITLED.JPG
DUSTY IN MEMPHIS	COVER	DUSTY SPRINGFIELD, DUSTY IN MEMPHIS .PNG
BEFORE THE FLOOD	COVER	BOB DYLAN AND THE BAND - BEFORE THE FLOOD.JPG
DYLAN & THE DEAD	COVER	BOB DYLAN AND THE GRATEFUL DEAD - DYLAN & THE DEAD.JPG
TELL BALGEARY, BALGURY IS DEAD	COVER	TED LEO AND THE PHARMACISTS - TELL BALGEARY, BALGURY IS DEAD COVER.JPG
SHAKE THE SHEETS	COVER	TED LEO AND THE PHARMACISTS - SHAKE THE SHEETS COVER.JPG
OLD FRIENDS: LIVE ON STAGE	COVER	OLD FRIENDS, LIVE ON STAGE  COVERART.JPG
MOONDOG MATINEE	COVER	MOONDOG MATINEE, THE BAND, ORIGINAL COVER.JPG
PHIL OCHS IN CONCERT	COVER	PHIL OCHS IN CONCERT .JPG
ALIENS: COLONIAL MARINES	COVER	ALIENS, COLONIAL MARINES SOUNDTRACK COVER.PNG
BUDDHA AND THE CHOCOLATE BOX	COVER	BUDDHA AND THE CHOCOLATE BOX .JPG
FIRE & WATER	COVER	DAVE GREENFIELD AND JEAN JACQUES BURNEL - FIRE AND WATER ALBUM COVER.JPG
IN YOUR HONOR	COVER	FOO FIGHTERS IN YOUR HONOR.JPG
THE YELLOW SHARK	COVER	FRANK ZAPPA, YELLOW SHARK.JPG
MIGHTY REARRANGER	COVER	ROBERT PLANT AND THE STRANGE SENSATION MIGHTY REARRANGER.JPG
SEXUAL HEALING	COVER	MARVIN GAYE AND KYGO SEXUAL HEALING COVER.JPG
YOUR PRECIOUS LOVE	COVER	MARVIN GAYE AND TAMMI TERRELL YOUR PRECIOUS LOVE SINGLE LABEL.JPG
IN ABSENTIA	COVER	PORCUPINE TREE IN ABSENTIA.JPG
SOME MIGHT SAY	COVER	OASIS,_SOME_MIGHT_SAY_COVER.PNG
ROLL WITH IT	COVER	OASIS,_ROLL_WITH_IT_SINGLE.PNG
CRIMSON AND CLOVER	COVER	CRIMSON AND CLOVER.JPG
BéLA FLECK AND THE FLECKTONES	COVER	BéLA FLECK AND THE FLECKTONES .JPG
TREBLE IN TROUBLE	COVER	TED LEO AND THE PHARMACISTS - TREBLE IN TROUBLE COVER.JPG
THE WIZARD	COVER	PARANOID AND THE WIZARD DUTCH PICTURE SLEEVE.PNG
THE ADVENTURES OF SHARKBOY AND LAVAGIRL IN 3-D	COVER	SHARK BOY AND LAVA GIRL, CD, BACK COVER .JPG
THE FAMILY	COVER	MASHMAKHAN AND THE FAMILY REGULAR.JPG
MEDAL OF HONOR: AIRBORNE	COVER	MEDAL OF HONOR, AIRBORNE SOUNDTRACK COVER.PNG
JAGGED LITTLE PILL, LIVE	COVER	JAGGED LITTLE PILL, LIVE.JPG
MUSIC	COVER	MADONNA,_MUSIC_SINGLE_COVER.PNG
WHAT IT FEELS LIKE FOR A GIRL	COVER	MADONNA,_WHAT_IT_FEELS_LIKE_FOR_A_GIRL.PNG
BEAUTIFUL STRANGER	COVER	MADONNA,_BEAUTIFUL_STRANGER_COVER.PNG
NOTHING REALLY MATTERS	COVER	MADONNA,_NOTHING_REALLY_MATTERS_COVER.PNG
THE POWER OF GOOD-BYE	COVER	MADONNA,_THE_POWER_OF_GOOD-BYE_COVER.PNG
SUBSTITUTE FOR LOVE	COVER	MADONNA,_DROWNED_WORLD_1998_COVER.PNG
YOU CAN'T DO THAT ON STAGE ANYMORE, VOL. 3	COVER	FRANK ZAPPA, YOU CAN'T DO THAT ON STAGE ANYMORE 3.JPG
YOU CAN'T DO THAT ON STAGE ANYMORE, VOL. 5	COVER	FRANK ZAPPA, YOU CAN'T DO THAT ON STAGE ANYMORE 5.JPG
YOU CAN'T DO THAT ON STAGE ANYMORE, VOL. 6	COVER	FRANK ZAPPA, YOU CAN'T DO THAT ON STAGE ANYMORE 6.JPG
THE CURE IN ORANGE	COVER	THE CURE IN ORANGE.JPG
GENIE IN A BOTTLE	COVER	GENIE IN A BOTTLE.PNG
MCDONALD AND GILES	COVER	MCDONALD AND GILES.JPG
DIFFORD & TILBROOK	COVER	DIFFORD AND TILBROOK COVER.JPG
TILT YA HEAD BACK	COVER	NELLY AND CHRISTINA AGUILERA - TILT YA HEAD BACK CD COVER.JPG
PTAH, THE EL DAOUD	COVER	PTAH, THE EL DAOUD .JPG
BATTER UP	COVER	NELLY  AND ST. LUNATICS - BATTER UP CD COVER.JPG
LIVE TO TELL	COVER	MADONNA,_LIVE_TO_TELL_SINGLE_COVER.PNG
LäTHER	COVER	FRANK ZAPPA, LäTHER.JPG
DOES HUMOR BELONG IN MUSIC%3F	COVER	FRANK ZAPPA, DOES HUMOR BELONG IN MUSIC.JPG
SECRET	COVER	MADONNA, SECRET SINGLE COVER.PNG
MAKE A JAZZ NOISE HERE	COVER	FRANK ZAPPA, MAKE A JAZZ NOISE HERE.JPG
LA ISLA BONITA	COVER	MADONNA,_LA_ISLA_BONITA_COVER.PNG
VOGUE	COVER	MADONNA,_VOGUE_COVER.PNG
 PHARMACISTS	COVER	TED LEO AND THE PHARMACISTS - TEJ LEO, RX-PHARMACISTS COVER.JPG
PLAYGROUND PSYCHOTICS	COVER	FRANK ZAPPA, PLAYGROUND PSYCHOTICS.JPG
OOH LA LA	COVER	GOLDFRAPP,_OOH_LA_LA_COVER.PNG
THE LOST EPISODES	COVER	FRANK ZAPPA, LOST EPISODES.JPG
SOMETHIN' STUPID	COVER	ROBBIE WILLIAMS AND NICOLE KIDMAN - SOMETHIN STUPID - CD SINGLE COVER.JPG
MYSTERY DISC	COVER	FRANK ZAPPA, MYSTERY DISC.JPG
THE STRANGLERS AND FRIENDS – LIVE IN CONCERT	COVER	THE STRANGLERS AND FRIENDS – LIVE IN CONCERT.JPG
EBONY AND IVORY	COVER	EBONY AND IVORY.JPG
UNFABULOUS AND MORE	COVER	UNFABULOUS AND MORE EMMA ROBERTS.JPG
PROTEST	COVER	THE DEARS, PROTEST EP COVER.JPG
JOHNNY DIESEL AND THE INJECTORS	COVER	JOHNNY DIESEL AND THE INJECTORS ALBUM COVER.JPG
JOHNNY DIESEL AND THE INJECTORS	COVER	JOHNNY DIESEL AND THE INJECTORS VHS.JPG
CHERISH	COVER	MADONNA,_CHERISH_SINGLE_COVER.PNG
EXPRESS YOURSELF	COVER	MADONNA,_EXPRESS_YOURSELF_SINGLE_COVER.PNG
STR8 OFF THA STREETZ OF MUTHAPHUKKIN COMPTON	COVER	1280X1280.JPG
OH FATHER	COVER	MADONNA,_OH_FATHER_SINGLE_COVER.PNG
THE HUSH	COVER	TEXAS,_THE_HUSH.PNG
BITTERSWEET	COVER	BLU CANTRELL, BITTERSWEET.JPG
DREAMING OF YOU	COVER	SELENA QUINTANILLA, DREAMING OF YOU .PNG
UNREAL	COVER	UNREAL, ORIGINAL SOUNDTRACK COVER.PNG
UNREAL	COVER	UNREAL TOURNAMENT 3, THE SOUNDTRACK COVER.PNG
WEATHER AND FORECASTING	COVER	FILE:WFCOVER.JPG
WEATHER AND FORECASTING	COVER	THE COVER OF WEATHER AND FORECASTING
MY LOVE	COVER	MY LOVE, WHERE AM I GOING .JPG
VIKING	COVER	LARS FREDERIKSEN AND THE BASTARDS-VIKING.JPG
LARS FREDERIKSEN AND THE BASTARDS	COVER	LARS FREDERIKSEN AND THE BASTARDS-LARS FREDERIKSEN AND THE BASTARDS.JPG
MAGIC AND LOSS	COVER	MAGIC AND LOSS  ALBUM COVER.JPG
HAMMERSMITH ODEON LONDON '75	COVER	HAMMERSMITH ODEON, LONDON '75.JPG
S.O.B. SPLIT 7%22	COVER	NAPALM DEATH AND S.O.B. SPLIT ALBUM.JPG
FISHBONE AND THE FAMILYHOOD NEXTPERIENCE PRESENT: THE PSYCHOTIC FRIENDS NUTTWERX	COVER	FISHBONE AND THE FAMILYHOOD NEXTPERIENCE PRESENT - THE PSYCHOTIC FRIENDS NUTTWERX .JPG
FISHBONE AND THE FAMILYHOOD NEXTPERIENCE PRESENT: THE FRIENDLIEST PSYCHOSIS OF ALL	COVER	FISHBONE AND THE FAMILYHOOD NEXTPERIENCE PRESENT - THE FRIENDLIEST PSYCHOSIS OF ALL .JPG
ELEPHANT MICAH, YOUR DREAMS ARE FEEDING BACK	COVER	ELEPHANT MICAH, YOUR DREAMS ARE FEEDING BACK.JPG
20 åR MED OSS – VEM é Dé DU VILL HA	COVER	KIKKI, BETTAN, LOTTA - 20 åR MED OSS – VEM é Dé DU VILL HA.JPG
 NEST	COVER	AGALLOCH AND NEST - SPLIT EP.JPG
MY DESTINY	COVER	SOMEWHERE OVER THE RAINBOW,MY DESTINY.JPG
28	COVER	AOKI TAKAMASA AND TUJIKO NORIKO - 28.JPG
IN COLOUR	COVER	THE CONCRETES IN COLOUR.JPG
FACE DANCES, PT. 2	COVER	FACE DANCES, PT. 2.JPG
A CERTAIN SMILE, A CERTAIN SADNESS	COVER	A CERTAIN SMILE, A CERTAIN SADNESS.JPG
FLEETWOOD MAC IN CHICAGO	COVER	FLEETWOOD MAC IN CHICAGO.JPG
MY LOVE	COVER	PAUL MCCARTNEY AND WINGS - MY LOVE ALBUM COVER.JPG
CELEBRATE ME HOME	COVER	KENNY LOGGINS, CELEBRATE ME HOME .PNG
CRY BABY CRY	COVER	SANTANA, SEAN PAUL & JOSS STONE - CRY BABY CRY.JPG
MY BOO	COVER	USHER AND ALICIA KEYS - MY BOO - CD COVER.JPG
HARRY POTTER AND THE GOBLET OF FIRE	COVER	HARRY POTTER AND THE GOBLET OF FIRE SOUNDTRACK.JPG
SOMETIMES I'M HAPPY, SOMETIMES I'M BLUE	COVER	SOMETIMES I'M HAPPY, SOMETIMES I'M BLUE .JPEG
JULIE DOIRON AND THE WOODEN STARS	COVER	JULIE DOIRON AND THE WOODEN STARS .PNG
THE TIN ANGEL	COVER	ODETTA AND LARRY - THE TIN ANGEL CD COVER.JPG
BBC IN SESSION	COVER	BBC IN SESSION.JPG
QUEENS OF NOISE	COVER	THE RUNAWAYS, QUEENS OF NOISE.JPG
CHILD OF GLASS	COVER	BLUTENGEL,_1ST_ALBUM.JPG
VALSES VENEZOLANOS	COVER	ALDEMARO ROMERO AND HIS HALL ORCHESTRA INTERPRETING VENEZUELAN WALTZES .JPG
SATYAM	COVER	COVER600X600.JPEG
KOSSOFF, KIRKE, TETSU AND RABBIT	COVER	PAUL KOSSOFF - KOSSOFF, KIRKE, TETSU AND RABBIT.JPG
U MAKE MY SUN SHINE	COVER	PRINCE AND ANGIE STONE - U MAKE MY SUN SHINE SINGLE COVER.JPG
73	COVER	NASSAU COLISEUM, UNIONDALE ALBUM COVER.JPG
THE SAINTS ARE COMING	COVER	U2 AND GREEN DAY - THE SAINTS ARE COMING COVER.JPG
BOBBIE GENTRY AND GLEN CAMPBELL	COVER	BOBBIE GENTRY AND GLEN CAMPBELL - BOBBIE GENTRY & GLEN CAMPBELL.JPG
UNDER CONSTRUCTION, PART II	COVER	UNDER CONSTRUCTION, PART II.JPG
STAR WARS AND OTHER GALACTIC FUNK	COVER	STAR WARS AND GALACTIC FUNK.JPG
THE BLUETONES	COVER	MY NEIGHBOUR'S HOUSE, THE BLUETONES.JPG
ROGER MCGUINN & BAND	COVER	ROGER MCGUINN AND BAND COVER.JPG
FRANCESCO ZAPPA	COVER	FRANK ZAPPA, FRANCESCO ZAPPA.JPG
THE POACHER DIARIES	COVER	CONVERGE AND AGORAPHOBIC NOSEBLEED - THE POACHER DIARIES.JPG
IN CONCERT	COVER	AMERICA IN CONCERT.JPG
4,000 WEEKS' HOLIDAY	COVER	IAN DURY AND THE MUSIC STUDENTS - 4000 WEEKS' HOLIDAY.JPG
HAWKWIND, FRIENDS AND RELATIONS	COVER	HAWKWIND, FRIENDS AND RELATIONS.JPG
LIVING WITH THE LIVING	COVER	TED LEO AND THE PHARMACISTS - LIVING WITH THE LIVING COVER.JPG
WORKING IN THE COAL MINE	COVER	WORKING IN THE COAL MINE LEE DORSEY.JPG
CHRISTMAS IN MY HEART	COVER	CHRISTMAS IN MY HEART.JPG
BAD SNEAKERS AND A PIñA COLADA	COVER	BAD SNEAKERS AND A PIñA COLADA.JPG
LEATHER SO SOFT	COVER	BIRDMAN AND LIL WAYNE LEATHER SO SOFT.JPG
TOGETHER AGAIN	COVER	GEORGE JONES AND TAMMY WYNETTE TOGETHER AGAIN EPIC RECORDS.JPG
PUT YOURSELF IN MY SHOES	COVER	CLINT BLACK, PUT YOURSELF IN MY SHOES.JPG
NOTHIN' BUT THE TAILLIGHTS	COVER	CLINT BLACK, NOTHIN' BUT THE TAILLIGHTS.JPG
GREATEST HITS	COVER	CLINT BLACK, GREATEST HITS.JPG
GREATEST HITS II	COVER	CLINT BLACK, GREATEST HITS II.JPG
DRINKIN' SONGS AND OTHER LOGIC	COVER	CLINT BLACK, DRINKIN' SONGS AND OTHER LOGIC.JPG
SPEND MY TIME	COVER	CLINT BLACK, SPEND MY TIME.JPG
VICTIMS OF DECEPTION	COVER	HEATHEN,_2_ALBUM_COVER.JPG
NICK LOWE AND HIS COWBOY OUTFIT	COVER	NICK LOWE AND HIS COWBOY OUTFIT .JPG
FAMILY VALUES TOUR 2006	COVER	FAMILY VALUES TOUR; 2006 ALBUM COVER.JPG
JOHN COLTRANE AND JOHNNY HARTMAN	COVER	JOHN COLTRANE AND JOHNNY HARTMAN .JPG
THE LOVE SONGS	COVER	CLINT BLACK, THE LOVE SONGS.JPG
WHY DOES LOVE DO THIS TO ME	COVER	THE EXPONENTS, WHY DOES LOVE DO THIS TO ME, SINGLE COVER.JPG
INDIANA JONES AND THE LAST CRUSADE	COVER	INDIANA JONES AND THE LAST CRUSADE SOUNDTRACK.JPG
KING OF HEARTS	COVER	RICK VITO, KING OF HEARTS ALBUM COVER.JPEG
FIREFLY AND LIVE!	COVER	FIREFLY AND LIVE.JPG
LYLE LOVETT AND HIS LARGE BAND	COVER	LYLE LOVETT AND HIS LARGE BAND.JPG
4-STARR COLLECTION	COVER	RINGO STARR AND HIS ALL-STARR BAND - 4-STARR COLLECTION.JPG
THE BASEMENT TAPES	COVER	BOB DYLAN AND THE BAND - THE BASEMENT TAPES.JPG
BONGO BONG AND JE NE T'AIME PLUS	COVER	BONGO BONG AND JE NE T'AIME PLUS.JPG
BEST FRIEND	COVER	50
JOANNA NEWSOM AND THE YS STREET BAND	COVER	JOANNA NEWSOM AND THE YS STREET BAND.JPG
DARYL HALL & JOHN OATES	COVER	HALL AND OATES, DARYL HALL AND JOHN OATES , 1975.PNG
FOR THE FIRST TIME! TWO GREAT STARS - GEORGE JONES AND GENE PITNEY	COVER	GEORGE JONES AND GENE PITNEY FOR THE FIRST TIME! TWO GREAT SINGERS.JPEG
ALICE COOPER AND FRIENDS	COVER	ALICE COOPER AND FRIENDS VHS COVER.JPG
THE MOTORCYCLE DIARIES	COVER	THE MOTORCYCLE DIARIES, SOUNDTRACK ALBUM COVER.JPG
GUITAR FOR JODI	COVER	TED LEO AND THE PHARMACISTS - GUITAR FOR JODI COVER.JPG
MO' LIVING	COVER	TED LEO AND THE PHARMACISTS - MO' LIVING COVER.JPG
MONSTEREO DELICIO	COVER	MONSTEREO.JPG
ALL ANGELS	COVER	ALL ANGELS, 2006 ALBUM COVER.JPG
BURL IVES AND THE KOREAN ORPHAN CHOIR SING OF FAITH AND JOY	COVER	BURL IVES AND THE KOREAN ORPHAN CHOIR SING OF FAITH AND JOY COVER.JPG
UNTOLD PASSION	COVER	SCHON AND HAMMER UNTOLD PASSION.JPG
HERE TO STAY	COVER	SCHON AND HAMMER HERE TO STAY.JPG
ALVIN LEE AND COMPANY	COVER	ALVIN LEE AND COMPANY - TEN YEARS AFTER.JPG
FEELS SO GOOD	COVER	CHUCK MANGIONE, FEELS SO GOOD .PNG
KENNY BURRELL & JOHN COLTRANE	COVER	KENNY BURRELL AND JOHN COLTRANE.JPEG
GOOD MUSIC	COVER	JOAN JETT AND THE BLACKHEARTS - GOOD MUSIC COVERART.JPG
FLASHBACK	COVER	JOAN JETT AND THE BLACKHEARTS - FLASHBACK COVERART.JPG
THE HIT LIST	COVER	JOAN JETT AND THE BLACKHEARTS - THE HIT LIST COVERART.JPG
NOTORIOUS	COVER	JOAN JETT AND THE BLACKHEARTS - NOTORIOUS COVERART.JPG
FIT TO BE TIED	COVER	JOAN JETT AND THE BLACKHEARTS - FIT TO BE TIED COVERART.JPG
NAKED	COVER	JOAN JETT AND THE BLACKHEARTS - NAKED COVERART.JPG
EVIL STIG	COVER	JOAN JETT AND THE GITS - EVIL STIG COVERART.JPG
JOHNNY AND MARY	COVER	TODD TERJE AND BRYAN FERRY - JOHNNY AND MARY COVER ART.JPG
LIVE FROM EARTH	COVER	PAT BENATAR IN CONCERT.JPG
BOP TILL YOU DROP	COVER	RY COODER, BOP TILL YOU DROP .PNG
VIVA LA BANDS, VOLUME 2	COVER	VIVA LA BANDS, VOLUME 2.JPG
SONNY BOY WILLIAMSON AND THE YARDBIRDS	COVER	SONNY BOY WILLIAMSON AND THE YARDBIRDS.JPEG
ONE WITH EVERYTHING: STYX AND THE CONTEMPORARY YOUTH ORCHESTRA	COVER	STYX AND THE CONTEMPORARY YOUTH ORCHESTR- 3.JPG
THUG IN THUG OUT	COVER	YOUNG NOBLE AND HUSSEIN FATAL-THUG IN THUG OUT.JPG
GENE VINCENT AND HIS BLUE CAPS	COVER	GENE VINCENT AND HIS BLUE CAPS.JPEG
BLOOD BROTHERS	COVER	KASTRO AND EDI-BLOOD BROTHERS.JPG
COCO	COVER	COLBIE CAILLAT, COCO .PNG
CARLOS SANTANA AND WAYNE SHORTER – LIVE AT THE MONTREUX JAZZ FESTIVAL 1988	COVER	CARLOS SANTANA AND WAYNE SHORTER - LIVE AT THE MONTREUX JAZZ FESTIVAL 1988.JPG
EARTHLING IN THE CITY	COVER	EARTHLING IN THE CITY.JPEG
AKIRA TORIYAMA: THE WORLD	COVER	AKIRA TORIYAMA, THE WORLD COVER.PNG
A COUPLE MORE YEARS	COVER	RONNIE DREW AND ELEANOR SHANLEY - A COUPLE MORE YEARS.JPG
KING OF THE WORLD	COVER	SHEILA AND B. DEVOTION - KING OF THE WORLD.JPG
B.B. KING IN LONDON	COVER	B.B. KING IN LONDON.JPG
RAISING SAND	COVER	ROBERT PLANT AND ALISON KRAUSS - RAISING SAND.PNG
CHRISTMAS IN BROBDINGNAG, VOL 1	COVER	CHRISTMAS IN BROBDINGNAG.JPG
CARAVAN AND THE NEW SYMPHONIA	COVER	CARAVAN AND THE NEW SYMPHONIA COVER.JPG
BOBBY BLAND AND B. B. KING TOGETHER AGAIN...LIVE	COVER	BOBBY BLAND AND B.B. KING TOGETHER AGAIN...LIVE COVER.JPG
MARK MALLMAN AND VERMONT	COVER	MARK MALLMAN AND VERMONT.JPG
BUDDY & JULIE MILLER	COVER	BUDDY AND JULIE MILLER.JPG
THE BUDDY HOLLY STORY, VOL. 2	COVER	THE BUDDY HOLLY STORY, VOL. 2.JPEG
BILL HALEY AND HIS COMETS	COVER	BILL HALEY AND HIS COMETS  COVER.JPG
SANDY DENNY AND THE STRAWBS	COVER	SANDY DENNY AND THE STRAWBS 1991.JPG
VIVA LA VIDA OR DEATH AND ALL HIS FRIENDS	COVER	VIVA LA VIDA OR DEATH AND ALL HIS FRIENDS.JPG
DIG, LAZARUS, DIG!!!	COVER	NICK CAVE & THE BAD SEEDS - DIG, LAZARUS, DIG!!! COVERART.JPG
CHRISTMAS WITH YOU	COVER	CLINT BLACK, CHRISTMAS WITH YOU.JPG
LOOKING FOR CHRISTMAS	COVER	CLINT BLACK, LOOKING FOR CHRISTMAS.JPG
STRAWBS IN CONCERT	COVER	STRAWBS IN CONCERT.JPG
TIëSTO IN CONCERT 2	COVER	TIëSTO IN CONCERT 2 POSTER.JPG
TIëSTO IN CONCERT	COVER	TIëSTO IN CONCERT POSTER.JPG
GOT LYRICS%3F	COVER	WTIL2001CD.JPG
YES, FRIENDS AND RELATIVES	COVER	YES, FRIENDS AND RELATIVES ALBUM COVER.JPG
JAZZ IN PARIS: NUAGES	COVER	JAZZ IN PARIS NUAGES.JPG
DAVID BOWIE	COVER	BOWIE BOX SET .JPG
ZOO GANG	COVER	PAUL MCCARTNEY AND WINGS - ZOO GANG SINGLE COVER.JPG
MAGNETO AND TITANIUM MAN	COVER	MAGNETO AND TITANIUM MAN COVER.JPG
15 YEARS DEEP	COVER	MAC DRE AND DA'UNDA'DOGG - 15 YEARS DEEP.JPG
CALYPSO IN BRASS	COVER	CALYPSO IN BRASS.JPG
OUT IN THE FIELDS	COVER	GARY MOORE AND PHIL LYNOTT OUT IN THE FIELDS SINGLE COVER.JPG
ALEX CAMPBELL AND HIS FRIENDS	COVER	ALEX CAMPBELL AND HIS FRIENDS.JPEG
OFF WHITE	COVER	JAMES WHITE AND THE BLACKS - OFF WHITE.JPG
BELLE	COVER	BELLE .JPG
BBC IN CONCERT 1972–1973	COVER	BBC IN CONCERT 1972–1973.JPG
IN MY MIND 1997–2007 THE BEST OF BERTINE ZETLITZ	COVER	BERTINE ZETLITZ IN MY MIND.JPG
HORACE SILVER AND THE JAZZ MESSENGERS	COVER	HORACE SILVER AND THE JAZZ MESSENGERS.JPG
ALBERT AYLER IN GREENWICH VILLAGE	COVER	ALBERT AYLER IN GREENWICH VILLAGE.JPG
ELSA, L'ESSENTIEL 1986–1993	COVER	ELSA,_L'ESSENTIEL.JPEG
ONOMATOPOEIA	COVER	HTTP://ECX.IMAGES-AMAZON.COM/IMAGES/I/51IT9VBRK9L. SL500 AA280 .JPG
EVERYTHING THAT HAPPENS WILL HAPPEN TODAY	COVER	DAVID BYRNE AND BRIAN ENO -- EVERYTHING THAT HAPPENS WILL HAPPEN TODAY ALBUM COVER.JPG
STRANGE OVERTONES	COVER	DAVID BYRNE AND BRIAN ENO - STRANGE OVERTONES.PNG
VOLUMES 1 & 2	COVER	THE DESERT SESSIONS, VOLUMES 1 & 2.JPG
ANOTHER WORLD	COVER	ANTONY AND THE JOHNSONS ANOTHER WORLD COVER.JPG
JOEL TURNER AND THE MODERN DAY POETS WITH THE BEATBOX ALLIANCE	COVER	JOEL TURNER AND THE MODERN DAY POETS WITH THE BEATBOX ALLIANCE.PNG
LOVE IS ALL AROUND	COVER	ERIC BURDON AND WAR - LOVE IS ALL AROUND.PNG
BILL FRISELL, RON CARTER, PAUL MOTIAN	COVER	BILL FRISELL, RON CARTER, PAUL MOTIAN.JPG
OLé, OLé, OLé	COVER	OLé, OLé, OLé.JPEG
DEEP PURPLE IN ROCK	COVER	DEEP PURPLE IN ROCK.JPG
GLEN CAMPBELL IN CONCERT WITH THE SOUTH DAKOTA SYMPHONY	COVER	GLEN CAMPBELL IN CONCERT ALBUM COVER.JPG
MOJO NIXON AND SKID ROPER	COVER	MOJO NIXON AND SKID ROPER .JPG
THE VERY THOUGHT OF YOU	COVER	EMILIE-CLAIRE BARLOW,..JPG
LUMPY MONEY	COVER	FRANK ZAPPA, LUMPY MONEY.JPG
NORMAN BLAKE AND RED RECTOR	COVER	NORMAN BLAKE AND RED RECTOR.JPG
INCANTO	COVER	ANDREA BOCELLI, INCANTO.JPG
I WANTA SING	COVER	GEORGE JONES, I WANTA SING ALBUM COVER.JPG
RHINESTONE COWBOY LIVE, ON THE AIR & IN THE STUDIO	COVER	GLEN CAMPBELL LIVE, ON THE AIR & IN THE STUDIO ALBUM COVER.JPG
SUPER DISCOUNT	COVER	URL?SA=I&RCT=J&Q=&ESRC=S&SOURCE=IMAGES&CD=&CAD=RJA&UACT=8&VED=0AHUKEWJG26 XGYRKAHUKDPAKHRVNBS8QJRWIBW&URL=HTTP%3A%2F%2FWWW.EMUSIC.COM%2FALBUM%2FETIENNE-DE-CRECY%2FSUPER-DISCOUNT%2F15368088%2F&PSIG=AFQJCNHNRTQ5XYI2RRRCLXQXX5PHYVP2CQ&UST=1451785795125824
TAKE MY HEAD	COVER	ARCHIVE,_TAKE_MY_HEAD,_COVER_ART_,_1999.JPG
THE ANNUAL	COVER	100000X100000-999.JPG
HANK MOBLEY AND HIS ALL STARS	COVER	HANK MOBLEY AND HIS ALL STARS.JPG
CHRISTMAS IN HOLLIS	COVER	CHRISTMAS IN HOLLIS.JPG
SMOOTH & LEGIT	COVER	SMOOTH AND LEGIT.JPG
SOMEONE SOMEWHERE...	COVER	517X1HFTNBL. SL500 AA280 .JPG
RITA LEE	COVER	RITA LEE; SELF-TITLED 1979 ALBUM COVER.JPG
MCCOY TYNER AND THE LATIN ALL-STARS	COVER	MCCOY TYNER AND THE LATIN ALL-STARS.JPG
JAKE THACKRAY AND SONGS	COVER	JAKE THACKRAY AND SONGS .JPG
MARVELLOUS YEAR	COVER	DON MCGLASHAN AND THE SEVEN SISTERS - MARVELLOUS YEAR, ALBUM COVER.JPG
LIVE IN CONCERT	COVER	LIVE IN CONCERT  COVERART.JPG
IN JESUS	COVER	PHATFISH IN JESUS.PNG
TOUS LES GARçONS ET LES FILLES	COVER	F.HARDY, 1TH SP, FRANCE, SIDE B, 1962.JPG
BOB BROOKMEYER AND FRIENDS	COVER	BOB BROOKMEYER AND FRIENDS.JPEG
PAULINE MURRAY AND THE INVISIBLE GIRLS	COVER	PAULINE MURRAY AND THE INVISIBLE GIRLS 1980 LP SLEEVE.JPG
THE TREATMENT	COVER	EARLY DAY MINERS, THE TREATMENT.JPG
21 GUNS	COVER	GREEN DAY AND THE CAST OF AMERICAN IDIOT - 21 GUNS COVER.JPG
REV	COVER	B00002MZ0N&H=355&W=355&TBNID=RELABSDAD0NDTM:&DOCID=ND9ZU6QQ1CGCHM&HL=EN&EI=03HKVVKZOCI9EMEBTTGB&TBM=ISCH
 JESU	COVER	ENVY AND JESU - SPLIT.JPG
NUCLEAR INSTRUMENTS AND METHODS IN PHYSICS RESEARCH	COVER	S01689002.GIF
COOTIE WILLIAMS AND HIS ORCHESTRA 1941–1944	COVER	COOTIE WILLIAMS AND HIS ORCHESTRA 1941-44 .JPG
SEBASTIEN GRAINGER & THE MOUNTAINS	COVER	SEBASTIEN GRAINGER AND THE MOUNTAINS.JPG
ARCHIE SHEPP AND THE FULL MOON ENSEMBLE	COVER	ARCHIE SHEPP AND THE FULL MOON ENSEMBLE.JPG
THE BEATLES IN MONO	COVER	THE BEATLES IN MONO.JPEG
SONNY ROLLINS, VOLUME 1	COVER	SONNY ROLLINS, VOL. 1.JPEG
%22THE SPAGHETTI INCIDENT%3F%22	COVER	GUNS N' ROSES; SPAGHETTI INCIDENT? COVER.JPG
BUD POWELL IN PARIS	COVER	BUD POWELL IN PARIS .JPG
JAZZ IN THE SPACE AGE	COVER	JAZZ IN THE SPACE AGE.JPG
QNTAL III: TRISTAN UND ISOLDE	COVER	QNTAL,_TRISTAN_UND_ISOLDE.JPG
JOHNNY BURNETTE AND THE ROCK 'N ROLL TRIO	COVER	JOHNNY BURNETTE AND THE ROCK 'N ROLL TRIO.JPG
THE BEAU BRUMMELS, VOLUME 2	COVER	THE BEAU BRUMMELS, VOLUME 2 .JPG
HEAR THIS!!	COVER	61Z2GIYDXBL. SL500 AA280 .JPG
SONNY ROLLINS AND THE BIG BRASS	COVER	SONNY ROLLINS AND THE BIG BRASS.JPG
GOOD EVENING NEW YORK CITY	COVER	PAUL MCCARTNEY, GOOD EVENING NEW YORK CITY .PNG
SONNY ROLLINS AND THE CONTEMPORARY LEADERS	COVER	SONNY ROLLINS AND THE CONTEMPORARY LEADERS.JPG
THELONIOUS MONK AND SONNY ROLLINS	COVER	THELONIOUS MONK AND SONNY ROLLINS.JPG
CANNONBALL ADDERLEY AND THE POLL-WINNERS	COVER	CANNONBALL ADDERLEY AND THE POLL WINNERS.JPG
BING CROSBY: THE VOICE OF CHRISTMAS	COVER	BING CROSBY; VOICE OF CHRISTMAS .JPG
THE BRUTALIST BRICKS	COVER	TED LEO AND THE PHARMACISTS - THE BRUTALIST BRICKS COVER.JPG
LAURA BRANIGAN IN CONCERT	COVER	LAURA BRANIGAN IN CONCERT 1990.GIF
JAZZ IN THE GARDEN	COVER	JAZZ IN THE GARDEN.JPG
EN VIVO, VOL. 2	COVER	EN VIVO, VOL 2 COVER.JPG
KATE EARL	COVER	KATE EARL, KATE EARL .PNG
CHARLES LLOYD IN EUROPE	COVER	CHARLES LLOYD IN EUROPE.JPG
FRANK SINATRA'S GREATEST HITS, VOL. 2	COVER	FRANK SINATRA'S GREATEST HITS, VOL. 2.JPG
LIVE & MORE	COVER	MARCUS MILLER, LIVE & MORE ALBUM COVER.JPG
IN THE NIGHT	COVER	DREAM EVIL IN THE NIGHT.JPG
JOAN BAEZ IN SAN FRANCISCO	COVER	JOAN BAEZ IN SAN FRANCISCO.JPEG
VIVERE	COVER	ANDREA BOCELLI AND LAURA PAUSINI - VIVERE .JPG
TO LOVE A WOMAN	COVER	ENRIQUE IGLESIAS AND LIONEL RICHIE - TO LOVE A WOMAN - EP.JPG
MTV UNPLUGGED	COVER	MTV UNPLUGGED, DIEGO TORRES.JPG
SWANLIGHTS	COVER	ANTONY AND THE JOHNSONS - SWANLIGHTS.JPG
PIANO IN THE FOREGROUND	COVER	PIANO IN THE FOREGROUND.JPG
PIANO IN THE BACKGROUND	COVER	PIANO IN THE BACKGROUND.JPG
GEORGE SHEARING AND THE MONTGOMERY BROTHERS	COVER	GEORGE SHEARING AND THE MONTGOMERY BROTHERS.JPG
THE MONTGOMERY BROTHERS IN CANADA	COVER	THE MONTGOMERY BROTHERS IN CANADA.JPEG
BENNY GOODMAN IN MOSCOW	COVER	BENNY GOODMAN IN MOSCOW.JPG
STATIC MIGRATION	COVER	TRIBES OF NEUROT AND WALKING TIME BOMBS STATIC MIGRATION.JPEG
JOE HENDERSON IN JAPAN	COVER	JOE HENDERSON IN JAPAN.JPG
WARRIOR	COVER	KESHA,_DECONSTRUCTED.JPEG
ANAHí	COVER	ANAHí, ANAHí.JPG
JEAN LEE AND THE YELLOW DOG	COVER	JEAN LEE AND THE YELLOW DOG.JPG
DIZZY GILLESPIE AND THE DOUBLE SIX OF PARIS	COVER	DIZZY GILLESPIE AND THE DOUBLE SIX OF PARIS.JPEG
LORD STEPPINGTON	COVER	STEP BROTHERS, LORD STEPPINGTON, COVER ART, OCT 2013.JPG
BROADCAST AND THE FOCUS GROUP INVESTIGATE WITCH CULTS OF THE RADIO AGE	COVER	BROADCAST AND THE FOCUS GROUP INVESTIGATE WITCH CULTS OF THE RADIO AGE.JPG
GOD WILLIN' & THE CREEK DON'T RISE	COVER	RAY LAMONTAGNE AND THE PARIAH DOGS, GOD WILLIN' AND THE CREEK DON'T RISE.JPG
THE DAY THE LAUGHTER DIED, PART II	COVER	THE DAY THE LAUGHTER DIED, PART II.JPG
CHRISTMAS IN HARMONY	COVER	CHRISTMAS IN HARMONY.PNG
POLKA! ALL NIGHT LONG	COVER	JIMMY STURR, POLKA ALL NIGHT LONG.JPG
LIVING ON POLKA TIME	COVER	JIMMY STURR, LIVING ON POLKA TIME.JPG
LET'S KISS: 25TH ANNIVERSARY ALBUM	COVER	BRAVE COMBO, LET'S KISS ALBUM COVER.JPG
TOP OF THE WORLD	COVER	JIMMY STURR, TOP OF THE WORLD.JPG
WHEN IT'S POLKA TIME AT YOUR HOUSE	COVER	JIMMY STURR, WHEN IT'S POLKA TIME AT YOUR HOUSE.JPG
HENRY MANCINI: PINK GUITAR	COVER	HENRY MANCINI, PINK GUITAR ALBUM COVER.JPG
JUST CHILLIN'	COVER	NORMAN BROWN, JUST CHILLIN' ALBUM COVER.JPG
GOTTA KNOW	COVER	GOTTA KNOW, MALAIKA, FRONT.JPG
INSIDE	COVER	DAVID SANBORN, INSIDE ALBUM COVER.JPG
75	COVER	JOE ZAWINUL, 75 ALBUM COVER.JPG
KEITH POTGER AND THE NEW SEEKERS	COVER	KEITH POTGER AND THE NEW SEEKERS.JPG
DANZóN	COVER	ARTURO SANDOVAL, DANZóN COVER.JPG
PORTRAITS OF CUBA	COVER	PAQUITO D'RIVERA, PORTRAITS OF CUBA COVER.JPG
LAND OF THE SUN	COVER	CHARLIE HADEN, LAND OF THE SUN COVER.JPG
NOCTURNE	COVER	CHARLIE HADEN, NOCTURNE COVER.JPG
LIVE AT THE VILLAGE VANGUARD	COVER	CHUCHO VALDéS, LIVE AT THE VILLAGE VANGUARD.JPG
LISTEN HERE!	COVER	EDDIE PALMIERI, LISTEN HERE ALBUM COVER.JPG
SONG FOR CHICO	COVER	ARTURO O'FARRILL, SONG FOR CHICO ALBUM COVER.JPG
CLIFF HANGER	COVER	JIMMY CLIFF, CLIFF HANGER COVER.JPG
HALL OF FAME: A TRIBUTE TO BOB MARLEY'S 50TH ANNIVERSARY	COVER	BUNNY WAILER, HALL OF FAME ALBUM COVER.JPG
CRUCIAL! ROOTS CLASSICS	COVER	BUNNY WAILER, CRUCIAL ROOTS CLASSICS COVER.JPG
DOC SOUCHON AND HIS MILNEBURG BOYS	COVER	DOC SOUCHON AND HIS MILNEBURG BOYS.JPEG
LET IT BE ME: MATHIS IN NASHVILLE	COVER	JOHNNY MATHIS, LET IT BE ME ALBUM COVER.JPG
LIVE AT CARNEGIE HALL: THE 50TH ANNIVERSARY CONCERT	COVER	PATTI PAGE, LIVE AT CARNEGIE HALL ALBUM.JPG
TIMELESS LOVE	COVER	SMOKEY ROBINSON, TIMELESS LOVE.JPG
PRAYER FOR COMPASSION	COVER	DAVID DARLING, PRAYER FOR COMPASSION.JPG
BELLA	COVER	TEDDY THOMPSON, BELLA ALBUM COVER.JPG
IN DEEP	COVER	ARGENT IN DEEP.JPG
MUNDO	COVER	RUBéN BLADES, MUNDO ALBUM COVER.JPG
NASCIMENTO	COVER	MILTON NASCIMENTO, NASCIMENTO ALBUM COVER.JPG
FULL CIRCLE: CARNEGIE HALL 2000	COVER	RAVI SHANKAR, FULL CIRCLE CARNEGIE HALL 2000.JPG
SANTIAGO	COVER	THE CHIEFTAINS, SANTIAGO ALBUM COVER.JPG
HARRY & LENA	COVER	HARRY BELAFONTE AND LENA HORNE - HARRY & LENA.JPG
LIVRO	COVER	CAETANO VELOSO, LIVRO ALBUM COVER.JPG
BOOKER LITTLE AND FRIEND	COVER	BOOKER LITTLE AND FRIEND.JPG
YOU CAN'T DO THAT ON STAGE ANYMORE, VOL. 2	COVER	FRANK ZAPPA, YOU CAN'T DO THAT ON STAGE ANYMORE 2.JPG
AHEAD OF THEIR TIME	COVER	FRANK ZAPPA, AHEAD OF THEIR TIME.JPG
BOB, PETER, BUNNY & RITA	COVER	BOB MARLEY AND THE WAILERS - BOB, PETER, BUNNY AND RITA ALBUM COVER.JPG
ALICE IN WONDERLAND	COVER	ALICE IN WONDERLAND K3.JPG
HORROR FIRE	COVER	HALLOWEEN,_HORROR_FIRE_ALBUM_COVER_2006.JPG
CORNERSHOP AND THE DOUBLE 'O' GROOVE OF	COVER	CORNERSHOP AND THE DOUBLE-O GROOVE OF.PNG
COUNT BASIE AND THE KANSAS CITY 7	COVER	COUNT BASIE AND THE KANSAS CITY 7.JPG
JO & FRIENDS	COVER	JO STAFFORD AND FRIENDS.JPG
CELIA CRUZ AND FRIENDS: A NIGHT OF SALSA	COVER	CELIA CRUZ AND FRIENDS A NIGHT OF SALSA.JPG
LIVE AT BENAROYA HALL WITH THE SEATTLE SYMPHONY	COVER	BRANDI CARLILE, LIVE AT BENAROYA HALL.JPG
SARAH VAUGHAN IN HI-FI	COVER	SARAH VAUGHAN IN HI-FI.JPG
CHARLES MINGUS AND FRIENDS IN CONCERT	COVER	CHARLES MINGUS AND FRIENDS IN CONCERT.JPG
LIVE AT THE 2008 NEW ORLEANS JAZZ & HERITAGE FESTIVAL	COVER	BEAUSOLEIL AND MICHAEL DOUCET - LIVE AT THE 2008 NEW ORLEANS JAZZ AND HERITAGE FESTIVAL.JPG
IN LOVE	COVER	MI0003579221.JPG?PARTNER=ALLROVI.COM
THE BACHELORS AND 16 GREAT SONGS	COVER	THE BACHELORS AND 16 GREAT SONGS.JPEG
ROSCOE MITCHELL AND THE SOUND AND SPACE ENSEMBLES	COVER	ROSCOE MITCHELL AND THE SOUND AND SPACE ENSEMBLES.JPG
LULU	COVER	LOU REED AND METALLICA - LULU.JPG
PAUL MOTIAN AND THE ELECTRIC BEBOP BAND	COVER	PAUL MOTIAN AND THE ELECTRIC BEBOP BAND.JPG
BLUE GARDENIA	COVER	ETTA JAMES, BLUE GARDENIA.JPG
MATRIARCH OF THE BLUES	COVER	ETTA JAMES, MATRIARCH OF THE BLUES.JPG
HOLLY & IVY	COVER	NATALIE COLE, HOLLY AND IVY.JPG
THE CONCERT	COVER	BARBRA STREISAND, THE CONCERT ALBUM COVER.JPG
HEART OF A WOMAN	COVER	ETTA JAMES, HEART OF A WOMAN.JPG
12 SONGS OF CHRISTMAS	COVER	ETTA JAMES, 12 SONGS OF CHRISTMAS.JPG
HAVE SOME FUN: LIVE AT UNGANO'S	COVER	THE STOOGES, LIVE AT UNGANO'S.JPG
MATHEW KNOWLES & MUSIC WORLD PRESENT VOL.1: LOVE DESTINY	COVER	MATHEW KNOWLES AND MUSIC WORLD.JPG
IN EUROPE '82	COVER	MEAT LOAF IN EUROPE '82.JPEG
A RETROSPECTIVE	COVER	PINK MARTINI, A RETROSPECTIVE.JPG
TIM CHRISTENSEN AND THE DAMN CRYSTALS	COVER	TIM CHRISTENSEN AND THE DAMN CRYSTALS.JPG
LONDON, PARIS, NEW YORK	COVER	LONDON, PARIS, NEW YORK ALBUM COVER.JPG
 PART CHIMP	COVER	PART CHIMP AND TORCHE SPLIT.JPG
FOR THE RECORD	COVER	TORAE, 'FOR THE RECORD', FRONT ARTWORK, AUG 2011.JPG
WISH UPON A STAR: A TRIBUTE TO THE MUSIC OF WALT DISNEY	COVER	JENNY OAKS BAKER, WISH UPON A STAR.JPG
PRINCE AND THE REVOLUTION: LIVE	COVER	PRINCE AND THE REVOLUTION LIVE VHS.JPG
ARMAGEDDON: THE ALBUM	COVER	ARMAGEDDON, THE ALBUM.JPEG
MILT JACKSON AND THE HIP STRING QUARTET	COVER	MILT JACKSON AND THE HIP STRING QUARTET.JPG
I GOT A WOMAN AND SOME BLUES	COVER	I GOT A WOMAN AND SOME BLUES.JPG
THE GAME OF TRIANGLES	COVER	BOBBY BARE, NORMA JEAN, LIZ ANDERSON THE GAME OF TRIANGLES LP FRONT.JPG
DARKBLOOM	COVER	GRIMES AND D'EON - DARKBLOOM COVER.JPG
IN MY DREAMS	COVER	MILITARY WIVES IN MY DREAMS.JPG
IN THE AIR	COVER	MORGAN PAGE, IN THE AIR.JPG
MERMAID AVENUE: THE COMPLETE SESSIONS	COVER	BILLY BRAGG AND WILCO - MERMAID AVENUE - THE COMPLETE SESSIONS.JPG
PIANO, STRINGS AND BOSSA NOVA	COVER	PIANO, STRINGS AND BOSSA NOVA.JPG
DRANK IN MY CUP	COVER	DRANK IN MY CUP BY KIRKO BANGZ.JPEG
ONCE A THIEF AND OTHER THEMES	COVER	ONCE A THIEF AND OTHER THEMES.JPG
THE FLAMING LIPS AND HEADY FWENDS	COVER	THE FLAMING LIPS AND HEADY FWENDS.JPG
DIZZY GILLESPIE AND STUFF SMITH	COVER	DIZZY GILLESPIE AND STUFF SMITH.JPG
PINES	COVER	A FINE FRENZY, PINES.JPG
DIZZY GILLESPIE AND THE MITCHELL RUFF DUO IN CONCERT	COVER	DIZZY GILLESPIE AND THE MITCHELL RUFF DUO IN CONCERT.JPG
BEST OF...	COVER	SIA, BEST OF ALBUM COVER.JPG
 YEAR OF NO LIGHT	COVER	KARYSUN AND YEAR OF NO LIGHT SPLIT COVER.JPG
I'M ON A ROLL	COVER	STEFANO,_I'M_ON_A_ROLL.JPG
THE LEGENDARY DEMOS	COVER	CAROLE KING, THE LEGENDARY DEMOS .PNG
 NAPALM DEATH	COVER	CONVERGE AND NAPALM DEATH SPLIT.JPG
SOMETHING IN THE WAY SHE MOVES	COVER	SOMETHING IN THE WAY SHE MOVES LABEL.JPEG
KENNY DREW AND HIS PROGRESSIVE PIANO	COVER	KENNY DREW AND HIS PROGRESSIVE PIANO.JPG
LOVE THIS GIANT	COVER	DAVID BYRNE AND ST. VINCENT - LOVE THIS GIANT.JPG
THE JAZZTET AND JOHN LEWIS	COVER	THE JAZZTET AND JOHN LEWIS.JPG
LIVE AT CARNEGIE HALL	COVER	DAVID BYRNE AND CAETANO VELOSO - LIVE AT CARNEGIE HALL.JPG
GOOD TIME	COVER	OWL CITY AND CARLY RAE JEPSEN - GOOD TIME.PNG
BENNY GOLSON AND THE PHILADELPHIANS	COVER	BENNY GOLSON AND THE PHILADELPHIANS.JPG
GIA 'SENA TON AGNOSTO	COVER	MARINELLA,_AGNOSTOS,_1983.JPG
LEGE MOU %22S' AGAPO%22	COVER	MARINELLA,_LEGE_MOU,_1990.JPG
JAZZ AND THE SOUNDS OF NATURE	COVER	JAZZ AND THE SOUNDS OF NATURE.JPG
WIE'S BANG	COVER	VAN COKE KARTEL, WIE'S BANG ALBUM COVER.JPG
COME HOME TO MAMA	COVER	MARTHA WAINWRIGHT, COME HOME TO MAMA.JPG
AN ADVENTURE IN SPACE AND TIME	COVER	AN ADVENTURE IN SPACE AND TIME  COVER.JPG
COLE PORTER IN A MODERN MOOD	COVER	COLE PORTER IN A MODERN MOOD.JPG
CUT THE WORLD	COVER	ANTONY AND THE JOHNSONS - CUT THE WORLD.JPG
VACATION CLUB	COVER	AEROSMITH,_VACATION_CLUB.JPG
RADIOACTIVE	COVER	IMAGINE DRAGONS AND KENDRICK LAMAR - \
BEN WEBSTER AND ASSOCIATES	COVER	BEN WEBSTER AND ASSOCIATES.JPG
GIGI GRYCE AND THE JAZZ LAB QUINTET	COVER	GIGI GRYCE AND THE JAZZ LAB QUINTET.JPG
CURTIS FULLER AND HAMPTON HAWES WITH FRENCH HORNS	COVER	CURTIS FULLER AND HAMPTON HAWES WITH FRENCH HORNS.JPG
RAMSEY LEWIS AND HIS GENTLE-MEN OF SWING	COVER	RAMSEY LEWIS AND HIS GENTLE-MEN OF SWING.JPG
RAMSEY LEWIS AND HIS GENTLE-MEN OF JAZZ	COVER	RAMSEY LEWIS AND HIS GENTLE-MEN OF JAZZ.JPG
LEM WINCHESTER AND THE RAMSEY LEWIS TRIO	COVER	LEM WINCHESTER AND THE RAMSEY LEWIS TRIO.JPG
4 TIME	COVER	JAZZ IN ¾ TIME.JPG
SENSITIVE TO A SMILE	COVER	HERBS, SENSITIVE TO A SMILE, SINGLE COVER.JPEG
PUHA AND PAKEHA	COVER	PUHA AND PAKEHA.JPG
ENIGMA	COVER	AEON ZEN, ENIGMA ALBUM COVER.JPG
IRON	COVER	NICKY ROMERO AND CALVIN HARRIS IRON.JPG
WU BLOCK	COVER	GHOSTFACE KILLAH AND SHEEK LOUCH - WU-BLOCK .JPG
WIZARD	COVER	MARTIN GARRIX AND JAY HARDWAY WIZARD.JPG
DIAMOND IN THE RUFF	COVER	FREEWAY, DIAMOND IN THE RUFF, FRONTAL ARTWORK, OCT 2012.JPG
DUO	COVER	MERZBOW, DUO.JPG
FULL CIRCLE	COVER	HOLGER CZUKAY, JAH WOBBLE, JAKI LIEBEZEIT - FULL CIRCLE.JPEG
SNAKE CHARMER	COVER	JAH WOBBLE, THE EDGE, HOLGER CZUKAY - SNAKE CHARMER.JPG
CLASH	COVER	HOLGER CZUKAY AND DOCTOR WALKER - CLASH.JPG
CHRISTMAS IN THE SAND	COVER	CHRISTMAS IN THE SAND BY COLBIE CAILLAT.JPG
THELONIOUS MONK IN ITALY	COVER	THELONIOUS MONK IN ITALY.JPG
NORTH	COVER	MARY DILLON, NORTH - ALBUM ARTWORK.JPG
VIOLENT SKY	COVER	LISA MISKOVSKY, VIOLENT SKY.JPG
DET BäSTA AV	COVER	DARIN, DET BäSTA AV, ALBUM ARTWORK 2012.JPG
DIFFERENT	COVER	ROBBIE WILLIAMS, DIFFERENT.JPG
CHARLES MINGUS IN PARIS: THE COMPLETE AMERICA SESSION	COVER	CHARLES MINGUS IN PARIS THE COMPLETE AMERICA SESSION.JPG
A GOOD COUNTRY MILE	COVER	KEVN KINNEY AND THE GOLDEN PALOMINOS - A GOOD COUNTRY MILE.JPG
LOVE IS ALL I GOT	COVER	FEED ME AND CRYSTAL FIGHTERS LOVE IS ALL I GOT COVER ARTWORK.JPG
THE LAST GOODBYE	COVER	STEVE HARLEY AND COCKNEY REBEL THE LAST GOODBYE SINGLE COVER 2006.JPEG
DAMAGE	COVER	PHAROAHE MONCH, DAMAGE, SINGLE ARTWORK, SEP 2012.JPG
STAMPEDE OF THE DISCO ELEPHANTS	COVER	STOPEJU8YOI.JPG
GENE AMMONS IN SWEDEN	COVER	GENE AMMONS IN SWEDEN.JPG
GENE AMMONS AND FRIENDS AT MONTREUX	COVER	GENE AMMONS AND FRIENDS AT MONTREUX.JPG
MOTHER	COVER	MOTHER, BY NATALIE MAINES.JPG
PERFECT WORLD	COVER	PERFECT WORLD, CLINT CRISHER, 1999.JPG
UNDERSTANDING AMERICA	COVER	FRANK ZAPPA, UNDERSTANDING AMERICA.JPG
PAPER BAG	COVER	FIONA APPLE, PAPER BAG.JPG
CHANNEL 42	COVER	DEADMAU5 AND WOLFGANG GARTNER - CHANNEL 42 - COVER ART.JPG
HOT DAY IN WACO	COVER	DOGBOWL AND KRAMER - HOT DAY IN WACO.JPG
GUNSMOKE	COVER	DOGBOWL AND KRAMER - GUNSMOKE.JPG
HAPPINESS FINALLY CAME TO THEM	COVER	RALPH CARNEY AND DAVED HILD AND KRAMER - HAPPINESS FINALLY CAME TO THEM.JPG
ROLL OUT THE BARREL	COVER	JAD FAIR AND KRAMER - ROLL OUT THE BARREL.JPEG
TOGETHER AGAIN!	COVER	WILLIS JACKSON AND JACK MCDUFF - TOGETHER AGAIN!.JPG
HUGE	COVER	HUGH HOPPER AND KRAMER - HUGE.JPG
RUBBER HAIR	COVER	KRAMER AND DAVED HILD - RUBBER HAIR.JPG
HIT MEN	COVER	DAEVID ALLEN AND KRAMER - HIT MEN.JPEG
BLACK POWER	COVER	RALPH CARNEY AND DAVED HILD AND KRAMER - BLACK POWER.JPG
A REMARK HUGH MADE	COVER	HUGH HOPPER AND KRAMER - A REMARK HUGH MADE.JPEG
WHO'S AFRAID%3F	COVER	DAEVID ALLEN AND KRAMER - WHO'S AFRAID.JPG
THE SOUND OF MUSIC	COVER	JAD FAIR AND KRAMER - THE SOUND OF MUSIC.JPEG
EGOMANIACS	COVER	FAHY AND HARLEY AND KRAMER - EGOMANIACS.JPG
EVENING AT THE GRANGE	COVER	LIDA HUSIK AND BEAUMONT HANNANT - EVENING AT THE GRANGE.JPG
THE AGONY IS THE ECSTACY	COVER	THE BIRTHDAY PARTY AND LYDIA LUNCH - 1982 SPLIT EP.JPEG
FOSSIL CULTURE	COVER	PETER FROHMADER AND RICHARD PINHAS - FOSSIL CULTURE.JPG
THE DROWNING OF LUCY HAMILTON	COVER	LYDIA LUNCH AND LUCY HAMILTON - THE DROWNING OF LUCY HAMILTON.JPG
ESCAPE	COVER	JODY HARRIS AND ROBERT QUINE - ESCAPE.JPG
30 YEARS SODOMIZED: 1982–2012	COVER	SODOM, 30 YEARS SODOMIZED 1982-2012 .JPG
OUTKASTED OUTLAWZ	COVER	OUTKASTED OUTLAWZ BY NUTT-SO AND HUSSEIN FATAL IN 2010.JPG
TRUE	COVER	ROY MONTGOMERY AND CHRIS HEAPHY - TRUE.JPG
WHAT ABOUT NOW	COVER	WHAT ABOUT NOW, BON JOVI ALBUM ARTWORK, 2013.PNG
YOUR LOVE	COVER	MARIé DIGBY, YOUR LOVE ALBUM COVER, 2011.JPG
CLAWFIST - THE PEEL SESSIONS	COVER	GALLON DRUNK AND BREED - CLAWFIST - THE PEEL SESSIONS.JPG
SUBSONIC 3: SKINNER'S BLACK LABORATORIES	COVER	ANDY HAWKINS AND JUSTIN BROADRICK - SKINNER'S BLACK LABORATORIES.JPG
JOSEPH SCHWANTNER: NEW MORNING FOR THE WORLD; NICOLAS FLAGELLO: THE PASSION OF MARTIN LUTHER KING	COVER	OREGON SYMPHONY, NEW MORNING FOR THE WORLD.JPG
THE SLEEPING SICKNESS	COVER	SUBARACHNOID SPACE AND WALKING TIME BOMBS - THE SLEEPING SICKNESS.JPG
RED CITIES	COVER	CHRIS BROKAW, RED CITIES  ALBUM COVER.GIF
WANDERING AS WATER	COVER	CHRIS BROKAW, WANDERING AS WATER  ALBUM COVER.JPG
THUG MONEY	COVER	YUKMOUTH AND C-BO AS THUG LORDZ - THUG MONEY IN 2010.JPG
STORIES	COVER	CHRIS BROKAW, STORIES  EP COVER.JPG
CANARIS	COVER	CHRIS BROKAW, CANARIS  CD COVER.JPG
LUCIFER RISING AND OTHER SOUND TRACKS	COVER	LUCIFER RISING AND OTHER SOUND TRACKS.JPG
ABHAYAMUDRA	COVER	CUL DE SAC AND DAMO SUZUKI - ABHAYAMUDRA.JPG
JA A TY	COVER	CELESTE BUCKINGHAM AND MAJK SPIRIT BY LUKAS DVORAK.JPG
GAMBLER'S ECSTASY	COVER	CHRIS BROKAW, GAMBLER'S ECSTASY  CD COVER.JPG
CONNECT	COVER	CONNECT, SICK PUPPIES COVER ART.JPG
THE FEATURES	COVER	THE FEATURES, COVER FOR EPONYMOUS ALBUM.PNG
TUMBLING DOWN	COVER	STEVE HARLEY AND COCKNEY REBEL TUMBLING DOWN 1974 SINGLE.JPG
TOGETHER AGAIN!!!!	COVER	HOWARD MCGHEE AND TEDDY EDWARDS - TOGETHER AGAIN.JPG
INCREDIBLE LOVE	COVER	CHRIS BROKAW, INCREDIBLE LOVE  ALBUM COVER.JPG
A LITTLE PARTY NEVER KILLED NOBODY	COVER	FERGIE, Q-TIP, GOONROCK - \
I'M WAITING HERE	COVER	DAVID LYNCH AND LYKKE LI - I'M WAITING HERE.JPG
COMMON COURTESY	COVER	A DAY TO REMEMBER, COMMON COURTESY 2013 ALBUM.PNG
SYMBIOTICS	COVER	PORTER RICKS AND TECHNO ANIMAL - SYMBIOTICS.JPEG
CHEEK TO CHEEK	COVER	TONY BENNETT AND LADY GAGA_- CHEEK TO CHEEK.PNG
MORE PELVIS WICK FOR THE BALONEY BONERS	COVER	ELECTRIC COMPANY AND VAS DEFERENS ORGANIZATION - MORE PELVIS WICK FOR THE BALONEY BONERS.JPG
JUMP, JUMP	COVER	JUMP, JUMP COVER ART.JPG
ART BLAKEY IN SWEDEN	COVER	ART BLAKEY IN SWEDEN.JPG
BACHATA NUMBER 1'S	COVER	BACHATA ,1'S.JPG
SWANGIN	COVER	STALLEY,SWANGIN.PNG
LYIJY	COVER	URL?SA=I&RCT=J&Q=&ESRC=S&SOURCE=IMAGES&CD=&VED=0AHUKEWIN7L2R-OLNAHWIFZAKHDZKBO0QJBWIBA&URL=HTTPS%3A%2F%2FFANART.TV%2FAPI%2FDOWNLOAD.PHP%3FTYPE%3DDOWNLOAD%26IMAGE%3D100090%26SECTION%3D2&PSIG=AFQJCNFOHDDHWJR5BLOPPNLD5QI8QYISHW&UST=1464737433265671
MARCI BEAUCOUP	COVER	ROC MARCIANO, 'MARCI BEAUCOUP', COVER ARTWORK, OCT 2013.JPG
LIVE AT THE ROSELAND BALLROOM, NYC	COVER	BACHMAN & TURNER, LIVE AT THE ROSELAND BALLROOM NYC ALBUM COVER.JPG
CHET BAKER IN EUROPE	COVER	CHET BAKER IN EUROPE.JPG
CHET BAKER SINGS AND PLAYS	COVER	CHET BAKER SINGS AND PLAYS.JPG
ESCAPISM	COVER	FALLULAH, ESCAPISM.JPG
CHET BAKER IN NEW YORK	COVER	CHET BAKER IN NEW YORK.JPG
CHET BAKER IN MILAN	COVER	CHET BAKER IN MILAN.JPG
SEUL AU PIANO	COVER	PIERRE LAPOINTE, SEUL AU PIANO.JPG
VERSIONS	COVER	ZOLA JESUS, VERSIONS ALBUM ARTWORK.JPG
TREASURE BOX	COVER	T-ARA, TREASURE BOX, ALBUM COVER.JPG
FAITH MOVES	COVER	NICKY SKOPELITIS AND SONNY SHARROCK - FAITH MOVES.JPG
WAITING FOR SUPERMAN	COVER	DAUGHTRY, WAITING FOR SUPERMAN.JPEG
DIAL: M-A-C-E-O	COVER	ALBUM COVER, MACEO PARKER, DIALMACEO.JPG
MO' ROOTS	COVER	ALBUM COVER, MACEO PARKER, MO ROOTS.JPG
GRAVITY: ORIGINAL MOTION PICTURE SOUNDTRACK	COVER	GRAVITY, ORIGINAL MOTION PICTURE SOUNDTRACK.JPG
KISS: MUSIC FOR THE FILMS BY ANDY WARHOL	COVER	EAT AND KISS JOHN CALE.JPG
UNDER CONTROL	COVER	CALVIN HARRIS AND ALESSO FEAT HURTS - UNDER CONTROL.PNG
THE QUARTERBACK	COVER	GLEE,_THE_QUARTERBACK.JPG
RUNNIN'	COVER	DAVID DALLAS, RUNNIN', COVER ART.JPG
LAST NIGHT ON EARTH	COVER	LEE RANALDO AND THE DUST - LAST NIGHT ON EARTH.JPG
THAT'S THE WAY GOD PLANNED IT	COVER	BILLY PRESTON, THAT'S THE WAY GOD PLANNED IT, UK PICTURE SLEEVE.JPG
LIVE FROM KCRW	COVER	NICK CAVE AND THE BAD SEEDS - LIVE FROM KCRW.JPG
SUNSET BLVD.	COVER	YANCEY BOYS, SUNSET BLVD, FRONT ARTWORK, 2013.JPG
OLD 97'S & WAYLON JENNINGS	COVER	OLD 97'S AND WAYLON JENNINGS.JPG
YANCEY BOYS	COVER	\
FADEN AWAY	COVER	7
MY 1ST CHEMISTRY SET	COVER	BOLDY JAMES, MY 1ST CHEMISTRY SET, FRONT COVER ART, 2013.JPG
HEALTH SERVICES MANAGEMENT RESEARCH	COVER	HOME COVER.GIF
SCANDINAVIAN JOURNAL OF SURGERY	COVER	54304 SJS.JPG
ROBBIE WILLIAMS: CLASSIC ALBUM SELECTION	COVER	ROBBIE WILLIAMS, CLASSIC ALBUM SELECTION ALBUM COVER.JPEG
UNDERSTAND ME	COVER	PROBLEM, 'UNDERSTAND ME', COVER ART, NOV 2013.JPG
ANYTHING AT ALL	COVER	AUTUMN HILL, ANYTHING AT ALL.JPG
CAN'T KEEP WAITING	COVER	AUTUMN HILL, CAN'T KEEP WAITING.JPG
FIRE	COVER	AUTUMN HILL, FIRE.JPG
PA2: THE DIRECTOR'S CUT	COVER	MARCO POLO, 'PA2 - THE DIRECTOR'S CUT,' COVER ART, NOV 2013.JPG
HARD-FI: BEST OF 2004 – 2014	COVER	HARD-FI,BESTOF2004-2014.JPEG
BORN AND RAISED	COVER	SMIF-N-WESSUN, 'BORN AND RAISED,' COVER ART, 2013.JPG
BACK TO THE BASICS	COVER	TWISTA, 'BACK TO THE BASICS', COVER ART, NOV 2013.JPG
TOM PETERSON AND ANOTHER LANGUAGE	COVER	TOM PETERSON AND ANOTHER LANGUAGE 1984 EP.JPEG
DIRTY GOLD	COVER	ANGEL HAZE, 'DIRTY GOLD', COVER ARTWORK, DEC 14, 2013.JPG
CONVERTIBLES	COVER	CHUCK INGLISH, 'COVERTIBLES', FRONT COVER ARTWORK, JAN 2014.JPG
SEO TAIJI AND BOYS	COVER	SEO TAIJI AND BOYS FIRST ALBUM.JPG
DREAM A LITTLE DREAM	COVER	PINK MARTINI, DREAM A LITTLE DREAM.JPG
THE SEA OF TRANQUILITY	COVER	NEOGRASS,_THE_SEA_OF_TRANQUILITY_ALBUMFRONT.JPG
DIE KNOWING	COVER	COMEBACK KID, DIE KNOWING ALBUM COVER.JPG
HELICOPTER	COVER	MARTIN GARRIX AND FIREBEATZ HELICOPTER.JPG
ATLA: ALL THIS LIFE ALLOWS, VOL. 1	COVER	STAT QUO, 'ATLA', FRONT ARTWORK, FEB 2014.JPG
SAY IT AIN'T SO, JOE	COVER	SAY IT AIN'T SO, JOE.JPG
I'LL SHOW YOU	COVER	ALEXANDER RYBAK AND PAULA SELING I’LL SHOW YOU.JPG
PARAISO	COVER	HARUOMI HOSONO AND THE YELLOW MAGIC BAND PARAISO.JPG
THE HUNTING PARTY	COVER	LINKIN PARK, THE HUNTING PARTY, ALBUM ART FINAL.JPG
IN UTERO, IN TRIBUTE, IN ENTIRETY	COVER	IN UTERO, IN TRIBUTE, IN ENTIRETY - ROBOTIC EMPIRE.JPG
TREMOR	COVER	TREMOR DIMITRI VEGAS, MARTIN GARRIX AND LIKE MIKE.JPG
CHACO	COVER	ILLYA-KURYAKI.JPG
DAILY CONVERSATION	COVER	TORAE, 'DAILY CONVERSATION', FRONT ARTWORK, JAN 2008.JPG
THESE DAYS...	COVER	--05-30
DO IT AGAIN	COVER	RöYKSOPP AND ROBYN_-_DO IT AGAIN.PNG
DISGUSTING	COVER	BEARTOOTH,_DISGUSTING_ALBUM_ART.JPEG
PARA LAS MADRECITAS	COVER	AL HURRICANE AND TINY MORRIE'S PARA LAS MADRECITAS.PNG
DO IT AGAIN	COVER	RöYKSOPP AND ROBYN - DO IT AGAIN .PNG
KIDS	COVER	STYLE OF EYE, KIDS SINGLE COVER.JPG
MALL	COVER	MALL, PHOTO FROM LPASSOCIATION, DEC 2014.JPG
OTHER WORLD	COVER	PETER HAMMILL AND GARY LUCAS - OTHER WORLD.JPG
GOLD SKIES	COVER	SANDER VAN DOORN, MARTIN GARRIX AND DVBBS GOLD SKIES.JPG
WILLINGLY	COVER	WILLIE NELSON AND SHIRLEY COLLIE - WILLINGLY.JPG
COLLABORATIONS	COVER	RAVI SHANKAR, GEORGE HARRISON \
THE APPLE YEARS 1968–75	COVER	GEORGE HARRISON, THE APPLE YEARS COVER.JPG
GUSTAV MAHLER IN TOBLACH	COVER	GUSTAV MAHLER IN TOBLACH.JPG
WHERE THERE'S A WILL THERE'S A WAY	COVER	THE SLITS AND THE POP GROUP.JPEG
AND & END	COVER	T-ARA AND & END.JPG
SINEMA	COVER	--08-05
15 EXITOS RANCHEROS, VOL. 2	COVER	15
BITTERSWEET JULY	COVER	BITTERSWEET JULY, PT. 2 EP ARTWORK.JPG
GREG OSBY AND SOUND THEATRE	COVER	GREG OSBY AND SOUND THEATRE.JPG
WE GO HOME	COVER	FILE:WE GO HOME.JPG
IL PRIMO GIORNO D'ESTATE	COVER	IL PRIMO GIORNO D'ESTATE, VIOLETTA, COVER ART.JPG
PSYCHONAVIGATION	COVER	PETE NAMLOOK AND BILL LASWELL - PSYCHONAVIGATION.JPEG
OUTLAND	COVER	PETE NAMLOOK AND BILL LASWELL - OUTLAND.JPG
CYMATIC SCAN	COVER	BILL LASWELL AND TETSU INOUE - CYMATIC SCAN.JPEG
VISITATION	COVER	JONAH SHARP AND BILL LASWELL - VISITATION.JPG
WEB	COVER	BILL LASWELL AND TERRE THAEMLITZ - WEB.GIF
SUBSONIC 2: BASS TERROR	COVER	BILL LASWELL AND NICHOLAS BULLEN - SUBSONIC 2 - BASS TERROR.JPG
SOMNIFIC FLUX	COVER	MICK HARRIS AND BILL LASWELL - SOMNIFIC FLUX.JPEG
PSYCHONAVIGATION 2	COVER	PETE NAMLOOK AND BILL LASWELL - PSYCHONAVIGATION TWO.JPEG
OUTLAND 3	COVER	PETE NAMLOOK AND BILL LASWELL - OUTLAND THREE.JPG
OUTLAND 2	COVER	PETE NAMLOOK AND BILL LASWELL - OUTLAND TWO.JPEG
DUB MELTDOWN	COVER	BILL LASWELL AND STYLE SCOTT - DUB MELTDOWN.JPEG
PSYCHONAVIGATION 4	COVER	PETE NAMLOOK AND BILL LASWELL - PSYCHONAVIGATION FOUR.JPG
PSYCHONAVIGATION 3	COVER	PETE NAMLOOK AND BILL LASWELL - PSYCHONAVIGATION THREE.JPG
OUTLAND IV	COVER	PETE NAMLOOK AND BILL LASWELL - OUTLAND FOUR.JPG
LIFE SPACE DEATH	COVER	TOSHINORI KONDO AND BILL LASWELL - LIFE SPACE DEATH.JPG
CHARGED	COVER	ERALDO BERNOCCHI, TOSHINORI KONDO, BILL LASWELL - CHARGED.JPEG
RADIOAXIOM: A DUB TRANSMISSION	COVER	JAH WOBBLE AND BILL LASWELL - RADIOAXIOM - A DUB TRANSMISSION.JPG
PSYCHONAVIGATION 5	COVER	PETE NAMLOOK AND BILL LASWELL - PSYCHONAVIGATION FIVE.JPG
SOUP	COVER	OTOMO YOSHIHIDE, BILL LASWELL AND YASUHIRO YOSHIGAKI - SOUP.JPEG
AFTERMATHEMATICS	COVER	BILL LASWELL AND GRAND MIXER DXT - AFTERMATHEMATICS.JPG
NO ONE IS THERE	COVER	HOPPY KAMIYAMA AND BILL LASWELL - A NAVEL CITY AND NO ONE IS THERE.JPG
BRUTAL CALLING	COVER	BILL LASWELL AND SUBMERGED - BRUTAL CALLING.JPEG
SOUP LIVE	COVER	OTOMO YOSHIHIDE, BILL LASWELL AND YASUHIRO YOSHIGAKI - SOUP LIVE.JPG
OUTLAND 5	COVER	PETE NAMLOOK AND BILL LASWELL - OUTLAND FIVE.JPG
LODGE	COVER	FANU AND BILL LASWELL - LODGE.JPG
BILL DIXON IN ITALY VOLUME ONE	COVER	BILL DIXON IN ITALY VOLUME ONE.JPG
BILL DIXON IN ITALY VOLUME TWO	COVER	BILL DIXON IN ITALY VOLUME TWO.JPG
 NOTHING	COVER	WHIRR AND NOTHING SPLIT EP.JPG
PNDCOLOURS	COVER	PARTYNEXTDOOR PNDCOLOURS-FRONT-LARGE.JPG
HEY MAMA	COVER	DAVID GUETTA - HEY MAMA .PNG
TIME OF OUR LIVES	COVER	PITBULL AND NE-YO - TIME OF OUR LIVES.PNG
THE FIREWATCHER'S DAUGHTER	COVER	BRANDI CARLILE, THE FIREWATCHER'S DAUGHTER.JPG
DEAD, EVERYWHERE	COVER	SEARCH?Q=DEAD+EVERYWHERE&RLZ=1C1AVNE ENUS616US631&ESPV=2&BIW=1517&BIH=714&SOURCE=LNMS&TBM=ISCH&SA=X&VED=0CACQ AUOAMOVCHMI47PQLPX2YAIVRLKMCH3HBACV&DPR=0.9#IMGRC=CNQGMNA8XD B6M%3A
CONNECTED	COVER	LIL FLIP AND MR- CAPONE-E-STILL CONNECTED-2008-FRONT.JPG
FUTURE HEARTS	COVER	ALL TIME LOW, FUTURE HEARTS ALBUM COVER, 2015.JPG
WE FALL	COVER	EMILE HAYNIE, WE FALL.JPG
MATRYOSHKA	COVER	LYAPIS TRUBETSKOY, MATRYOSHKA ALBUM COVER.JPG
SKRILLEX AND DIPLO PRESENT JACK Ü	COVER	SKRILLEX AND DIPLO PRESENT JACK Ü.PNG
LEAN ON	COVER	MAJOR LAZER AND DJ SNAKE - LEAN ON .PNG
KADAVAR	COVER	KADAVAR, DEBUT ALBUM.JPG
IT'S ALL GOING TO POT	COVER	WILLIE NELSON AND MERLE HAGGARD - IT'S ALL GOING TO POT.JPG
CHI-RAQ	COVER	CHI-RAQ-640X640.JPG
FRANçOISE IN ITALIAN	COVER	F. HARDY, FRANçOISE IN ITALIAN, COMPIL SOUTH AFRICA 1970.JPG
HOW DEEP IS YOUR LOVE	COVER	CALVIN HARRIS AND DISCIPLES - HOW DEEP IS YOUR LOVE.PNG
STASH UP	COVER	OPM,_STASH_UP,_CD_SINGLE_FRONT_COVER.JPG
BLOOD	COVER	STAN RIDGWAY AND PIETRA WEXSTUN - BLOOD.JPG
SOUTH PACIFIC IN HI-FI	COVER	SOUTH PACIFIC IN HI-FI.JPG
JAMES BROWN AND HIS FAMOUS FLAMES TOUR THE U.S.A.	COVER	JAMES BROWN AND HIS FAMOUS FLAMES TOUR THE USA.JPG
BOYFRIEND IN WONDERLAND	COVER	BOYFRIEND IN WONDERLAND ALBUM COVER.JPG
FLUTE, BRASS, VIBES AND PERCUSSION	COVER	FLUTE, BRASS, VIBES & PERCUSSION.JPG
BRAZIL, BOSSA NOVA & BLUES	COVER	BRAZIL, BOSSA NOVA & BLUES.JPG
KEIO LINE	COVER	RICHARD PINHAS AND MERZBOW - KEIO LINE CD.JPG
INSIDE OUT	COVER	AVALANCHE CITY, \
SUUNS AND JERUSALEM IN MY HEART	COVER	SUUNS AND JERUSALEM IN MY HEART SELT TITLED.JPG
FRED KATZ AND HIS JAMMERS	COVER	FRED KATZ AND HIS JAMMERS.JPG
A+	COVER	A+, HYUNA, 3RD EP.JPG
LOVE, FEAR AND THE TIME MACHINE	COVER	RIVERSIDE.JPG
RAVI SHANKAR'S FESTIVAL FROM INDIA	COVER	FILE:LP COVER, RAVI SHANKAR'S MUSIC FESTIVAL FROM INDIA, 1968.JPG
MAMMOTH	COVER	DIMITRI VEGAS, MOGUAI & LIKE MIKE - MAMMOTH.JPG
ANGELS & GHOSTS	COVER	FILE:DAVE GAHAN AND SOULSAVERS, ANGELS & GHOSTS COVER.JPG
VICE SQUAD DICK	COVER	FOETUS AND CHROME CRANKS - VICE SQUAD DICK.JPG
RAMMSTEIN IN AMERIKA	COVER	RAMMSTEIN IN AMERIKA.JPG
WHAT'S INSIDE: SONGS FROM WAITRESS	COVER	SARA BAREILLES, WHAT'S INSIDE – SONGS FROM WAITRESS .PNG
MYSTERIOUS PHONK: CHRONICLES OF SPACEGHOSTPURRP	COVER	SGP-MYSTERIOUS.JPEG
SPACE ICON	COVER	ARTEMIY ARTEMIEV AND PETER FROHMADER - SPACE ICON.JPG
DAS IST ALLES	COVER	FROHMADER AND FUCHS-GAMBOCK - DAS IST ALLES.JPG
TRANSFIGURATION	COVER	ARTEMIY ARTEMIEV AND PETER FROHMADER - TRANSFIGURATION.JPG
SLIDE HAMPTON AND HIS HORN OF PLENTY	COVER	SLIDE HAMPTON AND HIS HORN OF PLENTY.JPG
LOVE, SAX AND FLASHBACKS	COVER	FLEUR EAST_-_LOVE, SAX AND FLASHBACKS .PNG
ADVENTURE OF A LIFETIME	COVER	COLDPLAY, ADVENTURE OF A LIFETIME, ARTWORK.JPG
UP & UP	COVER	COLDPLAY, UP&UP, ARTWORK.JPG
HYMN FOR THE WEEKEND	COVER	COLDPLAY, HYMN FOR THE WEEKEND, ARTWORK.JPG
FAMILY DINNER – VOLUME 2	COVER	FD2.JPG
ILLINOIS JACQUET AND HIS ORCHESTRA	COVER	ILLINOIS JACQUET AND HIS ORCHESTRA.JPG
REVOLUTION	COVER	REVOLUTION BY R3HAB AND NERVO AND UMMET OZCAN.JPG
GLOOMY SUNDAY AND OTHER BRIGHT MOMENTS	COVER	GLOOMY SUNDAY AND OTHER BRIGHT MOMENTS.JPG
SUMMER OF LOVE	COVER	0020187322.JPG
LOS DúO, VOL. 2	COVER	LOS DúO, VOL. 2 COVER.JPG
CHRISTMAS & CHILL	COVER	CHRISTMAS AND CHILL.JPG
STAN GETZ IN STOCKHOLM	COVER	STAN GETZ IN STOCKHOLM.JPG
SUMMERTIME: WILLIE NELSON SINGS GERSHWIN	COVER	SUMMERTIME, WILLIE NELSON SINGS GERSHWIN.JPG
EMPATHY	COVER	JUNG YONG-HWA AND SUNWOO JUNG-A - EMPATHY.JPG
METAL RESISTANCE	COVER	BABYMETAL, METAL RESISTANCE ART.JPG
DOUG SAHM AND BAND	COVER	DOUG SAHM AND BAND 1973.JPG
5TEARS VOL. 3 ~SWEET DRAGON~	COVER	61WZE9BIW-L. SY355 .JPG
DANCE OFF	COVER	MACKLEMORE AND RYAN LEWIS - DANCE OFF.PNG
BRAD PITT'S COUSIN	COVER	MACKLEMORE AND RYAN LEWIS - BRAD PITT'S COUSIN.JPG
PERFECTAMUNDO	COVER	BILLY GIBBONS AND THE BFG'S PERFECTAMUNDO.JPG
WORSHIP AND BELIEVE	COVER	WORSHIP AND BELIEVE BY STEVEN CURTIS CHAPMAN.JPG
JOSH ROUSE AND THE LONG VACATIONS	COVER	JOSH ROUSE AND THE LONG VACATIONS COVER.JPG
INNER PASSION	COVER	PETER KATER AND TINA GUO - INNER PASSION COVER ART.PNG
JAMES REYNE AND THE MAGNIFICENT FEW	COVER	JAMES REYNE AND THE MAGNIFICENT FEW .JPG
HITCH	COVER	THE JOY FORMIDABLE, HITCH.JPG
SHORTY ROGERS AND HIS GIANTS	COVER	SHORTY ROGERS AND HIS GIANTS.JPG
THE WIZARD OF OZ AND OTHER HAROLD ARLEN SONGS	COVER	THE WIZARD OF OZ AND OTHER HAROLD ARLEN SONGS.JPG
GIGI IN JAZZ	COVER	GIGI IN JAZZ.JPG
FEVER DREAM	COVER	MI0004030540.JPG?PARTNER=ALLROVI.COM
THE GOLDEN RECORD	COVER	LITTLE SCREAM, THE GOLDEN RECORD COVER.JPG
THE PRICE TO PLAY THE ALAN PRICE SET	COVER	IMAGES
OK	COVER	COVER 53882042016 R.JPG
HYPE	COVER	DIZZEE RASCAL AND CALVIN HARRIS - HYPE.PNG
LIVE AT THE ISLE OF WIGHT FESTIVAL	COVER	STEVE HARLEY AND COCKNEY REBEL LIVE AT THE ISLE OF WIGHT FESTIVAL 2004 DVD.JPG
INNOCENCE REACHES	COVER	SEARCH?Q=OF+MONTREAL+INNOCENCE+REACHES&CLIENT=SAFARI&HL=EN-US&TBM=ISCH&PRMD=NVI&SOURCE=LNMS&SA=X&VED=0AHUKEWITU RB9RLPAHUNXMMKHQDDAUSQ AUIBYGD&BIW=320&BIH=460&DPR=2#IMGRC=PQBDOFZ8IMWPRM%3A
RED ALLEN, KID ORY & JACK TEAGARDEN AT NEWPORT	COVER	RED ALLEN, KID ORY & JACK TEAGARDEN AT NEWPORT.JPG
EDDIE COSTA, MAT MATHEWS & DON ELLIOTT AT NEWPORT	COVER	EDDIE COSTA, MAT MATHEWS & DON ELLIOTT AT NEWPORT.JPG
THE COLEMAN HAWKINS, ROY ELDRIDGE, PETE BROWN, JO JONES ALL STARS AT NEWPORT	COVER	THE COLEMAN HAWKINS, ROY ELDRIDGE, PETE BROWN, JO JONES ALL STARS AT NEWPORT.JPG
STAN GETZ AND THE COOL SOUNDS	COVER	STAN GETZ AND THE COOL SOUNDS.JPG
FEELINS'	COVER	LORETTA LYNN AND CONWAY TWITTY FEELINS'.JPG
UNITED TALENT	COVER	LORETTA LYNN AND CONWAY TWITTY UNITED TALENT.JPG
HONKY TONK HEROES	COVER	LORETTA LYNN AND CONWAY TWITTY HONKY TONK HEROES.JPG
SEO TAIJI AND BOYS IV	COVER	SEO TAIJI AND BOYS FOURTH ALBUM.JPG
SEO TAIJI AND BOYS III	COVER	SEO TAIJI AND BOYS THIRD ALBUM.JPG
TWO'S A PARTY	COVER	LORETTA LYNN AND CONWAY TWITTY TWO'S A PARTY.JPG
DAVE BRUBECK AND JAY & KAI AT NEWPORT	COVER	DAVE BRUBECK AND JAY & KAI AT NEWPORT.JPG
ANDRé PREVIN AND J. J. JOHNSON	COVER	ANDRé PREVIN AND J J JOHNSON.JPG
FIVE	COVER	THEAGONISTFIVEALBUM.JPG
WHATEVER YOU BELIEVE	COVER	ANDERSON, HARLEY & BATT - WHATEVER YOU BELIEVE 1988 SINGLE.JPG
CARL REINER AND MEL BROOKS AT THE CANNES FILM FESTIVAL	COVER	CARL REINER AND MEL BROOKS AT THE CANNES FILM_FESTIVAL.JPEG
LIVE AT THE STEPHEN TALKHOUSE	COVER	2208676.JPG
STORYMAN	COVER	SAM BUSH, STORYMAN COVER.JPG
THE BOLL WEEVIL SONG AND 11 OTHER GREAT HITS	COVER	THE BOLL WEEVIL SONG AND 11 OTHER HITS.JPG
19 TO 20	COVER	JIMIN PARK, 19 TO 20.JPG
TINTYPE	COVER	D111-PACK-TINTYPEA-250.JPG?ITOK=W6DCHCXJ
12%22 MASTERS – ESSENTIAL MIXES	COVER	KYLIE MINOGUE, ESSENTIAL MIXES.JPEG
STRIPPED	COVER	MACY-GRAY-STRIPPED-DIGIPAK-1500X1500-01H.JPG
SAMO	COVER	NINA KRALJIć, \
ROCK CANDY FUNK PARTY TAKES NEW YORK - LIVE AT THE IRIDIUM	COVER	39709235 700X700MIN 1.JPG
A NEW EMPIRE	COVER	A NEW EMPIRE, AILEE, 4TH MINI ALBUM.JPG
WINGS	COVER	BTS, WINGS.JPG
AN ADVENTURE IN SOUND: REEDS IN HI-FI	COVER	REEDS IN HI-FI.JPG
