COLUMBIA BUSINESS SCHOOL	DEAN	R. GLENN HUBBARD
TECHNICAL UNIVERSITY OF DENMARK	DEAN	MARTIN P. BENDSøE
TECHNICAL UNIVERSITY OF DENMARK	DEAN	MARTIN VIGILD
WILLIAM E. SIMON GRADUATE SCHOOL OF BUSINESS ADMINISTRATION	DEAN	ANDREW AINSLIE
MIT SLOAN SCHOOL OF MANAGEMENT	DEAN	DAVID SCHMITTLEIN
COLLEGE OF CREATIVE STUDIES	DEAN	BRUCE TIFFNEY
COOPER UNION	DEAN	RICHARD STOCK
COOPER UNION	DEAN	MIKE ESSL
COOPER UNION	DEAN	NADER TEHRANI
INSEAD	DEAN	ILIAN MIHOV
HEINZ COLLEGE	DEAN	RAMAYYA KRISHNAN
ALBERT EINSTEIN COLLEGE OF MEDICINE	DEAN	ALLEN M. SPIEGEL, M.D.
JOHN F. KENNEDY SCHOOL OF GOVERNMENT	DEAN	DOUGLAS ELMENDORF
HAAS SCHOOL OF BUSINESS	DEAN	RICHARD LYONS
UC BERKELEY COLLEGE OF ENGINEERING	DEAN	S. SHANKAR SASTRY
NEW YORK UNIVERSITY TANDON SCHOOL OF ENGINEERING	DEAN	KATEPALLI R. SREENIVASAN
COLUMBIA UNIVERSITY GRADUATE SCHOOL OF JOURNALISM	DEAN	STEVE COLL
SANTA FE)	DEAN	JOSEPH MACFARLAND, ANNAPOLIS
SANTA FE)	DEAN	MATTHEW DAVIS, SANTA FE
GROVE CITY COLLEGE	DEAN	DAVID AYERS  & STACY G. BIRMINGHAM
WOODROW WILSON SCHOOL OF PUBLIC AND INTERNATIONAL AFFAIRS	DEAN	CECILIA ROUSE
STANFORD GRADUATE SCHOOL OF BUSINESS	DEAN	JONATHAN LEVIN
YALE LAW SCHOOL	DEAN	ROBERT POST
EDMUND A. WALSH SCHOOL OF FOREIGN SERVICE	DEAN	JOEL HELLMAN
UNIVERSITY OF WISCONSIN–BARRON COUNTY	DEAN	PAUL CHASE
USC VITERBI SCHOOL OF ENGINEERING	DEAN	YANNIS C. YORTSOS
LONDON BUSINESS SCHOOL	DEAN	ANDREW LIKIERMAN
SCHOOL OF ADVANCED STUDY	DEAN	ROGER KAIN
KELLOGG SCHOOL OF MANAGEMENT	DEAN	SALLY BLOUNT
GRANT MEDICAL COLLEGE AND SIR JAMSHEDJEE JEEJEEBHOY GROUP OF HOSPITALS	DEAN	DR. TATYARAO LAHANE
GEORGETOWN UNIVERSITY LAW CENTER	DEAN	WILLIAM TREANOR
NOTTINGHAM UNIVERSITY BUSINESS SCHOOL	DEAN	MARTIN BINKS
UNIVERSITY OF TORONTO FACULTY OF INFORMATION	DEAN	WENDY DUFF
UNIVERSITY OF TEXAS SOUTHWESTERN MEDICAL CENTER	DEAN	J. GREGORY FITZ, M.D.
ROTMAN SCHOOL OF MANAGEMENT	DEAN	TIFF MACKLEM
TUFTS SCHOOL OF THE MUSEUM OF FINE ARTS	DEAN	NANCY BAUER
TUCK SCHOOL OF BUSINESS	DEAN	MATTHEW J. SLAUGHTER
COLUMBIA COLLEGE, COLUMBIA UNIVERSITY	DEAN	JAMES J. VALENTINI
ALPERT MEDICAL SCHOOL	DEAN	JACK A. ELIAS, M.D.
INDIAN INSTITUTE OF PLANNING AND MANAGEMENT	DEAN	ARINDAM CHAUDHURI
MIDWESTERN UNIVERSITY	DEAN	TERESA A. DOMBROWSKI, PH.D.
COLUMBIA SCHOOL OF ENGINEERING AND APPLIED SCIENCE	DEAN	MARY CUNNINGHAM BOYCE
UC DAVIS GRADUATE SCHOOL OF MANAGEMENT	DEAN	ANN H. STEVENS
PAUL H. NITZE SCHOOL OF ADVANCED INTERNATIONAL STUDIES	DEAN	VALI R. NASR
PEABODY COLLEGE	DEAN	CAMILLA BENBOW
PEABODY INSTITUTE	DEAN	FRED BRONSTEIN, DMA
COLUMBIA GRADUATE SCHOOL OF ARCHITECTURE, PLANNING AND PRESERVATION	DEAN	AMALE ANDRAOS
UNIVERSITY OF MICHIGAN LAW SCHOOL	DEAN	MARK D. WEST
J. REUBEN CLARK LAW SCHOOL	DEAN	D. GORDON SMITH
CLINTON SCHOOL OF PUBLIC SERVICE	DEAN	JAMES RUTHERFORD III
HARVARD GRADUATE SCHOOL OF ARTS AND SCIENCES	DEAN	XIAO-LI MENG
AALTO UNIVERSITY SCHOOL OF ARTS, DESIGN AND ARCHITECTURE	DEAN	PROFESSOR HELENA HYVöNEN
HARVARD EXTENSION SCHOOL	DEAN	HUNTINGTON D. LAMBERT
NOTRE DAME PREPARATORY HIGH SCHOOL	DEAN	CARL HESS
OXFORD COLLEGE OF EMORY UNIVERSITY	DEAN	DOUGLAS HICKS
UC BERKELEY COLLEGE OF ENVIRONMENTAL DESIGN	DEAN	JENNIFER WOLCH
MANNES SCHOOL OF MUSIC	DEAN	RICHARD KESSLER
HARVARD GRADUATE SCHOOL OF DESIGN	DEAN	MOHSEN MOSTAFAVI
SAïD BUSINESS SCHOOL	DEAN	PETER TUFANO
UNIVERSITY OF CONNECTICUT SCHOOL OF LAW	DEAN	TIMOTHY S. FISHER
NEW YORK UNIVERSITY SCHOOL OF MEDICINE	DEAN	ROBERT I. GROSSMAN
CASS BUSINESS SCHOOL	DEAN	MARIANNE W. LEWIS
SAMUEL CURTIS JOHNSON GRADUATE SCHOOL OF MANAGEMENT	DEAN	MARK W. NELSON
NEW YORK LAW SCHOOL	DEAN	ANTHONY CROWELL
ATENEO LAW SCHOOL	DEAN	SEDFREY CANDELARIA
WARWICK BUSINESS SCHOOL	DEAN	ANDY LOCKETT
KOGOD SCHOOL OF BUSINESS	DEAN	ERRAN CARMEL, PHD, INTERIM DEAN
KECK SCHOOL OF MEDICINE OF USC	DEAN	ROHIT VARMA, M.D., M.P.H., INTERIM
SCHOOL OF DIPLOMACY AND INTERNATIONAL RELATIONS	DEAN	DR. ANDREA BARTOLI, PH.D.
AMERICAN UNIVERSITY SCHOOL OF INTERNATIONAL SERVICE	DEAN	JAMES M. GOLDGEIER
WESTMINSTER CHOIR COLLEGE	DEAN	MATTHEW R. SHAFTEL
CHICAGO THEOLOGICAL SEMINARY	DEAN	KEN STONE
CARNEGIE MELLON UNIVERSITY IN QATAR	DEAN	DEANBAYBARSBIOENGLISH.PDF
AUSTRALIA AND NEW ZEALAND SCHOOL OF GOVERNMENT	DEAN	PROFESSOR GARY BANKS AO
INDIAN SCHOOL OF BUSINESS	DEAN	RAJENDRA SRIVASTAVA
JOHNS HOPKINS BLOOMBERG SCHOOL OF PUBLIC HEALTH	DEAN	MICHAEL J. KLAG
GEORGE WASHINGTON UNIVERSITY LAW SCHOOL	DEAN	BLAKE MORANT
UNIVERSITY OF PUERTO RICO SCHOOL OF MEDICINE	DEAN	EDGAR COLóN MD
VIRGINIA THEOLOGICAL SEMINARY	DEAN	IAN MARKHAM
JOHNS HOPKINS SCHOOL OF MEDICINE	DEAN	PAUL B. ROTHMAN
IESE BUSINESS SCHOOL	DEAN	FRANZ HEUKAMP
INSTITUTE OF PSYCHIATRY, PSYCHOLOGY AND NEUROSCIENCE	DEAN	SHITIJ KAPUR
MCDONOUGH SCHOOL OF BUSINESS	DEAN	DAVID A. THOMAS
WATSON SCHOOL OF BIOLOGICAL SCIENCES	DEAN	ALEXANDER GANN
TEMPLE UNIVERSITY BEASLEY SCHOOL OF LAW	DEAN	GREGORY MANDEL
USC MARSHALL SCHOOL OF BUSINESS	DEAN	JAMES G. ELLIS
CARDIFF UNIVERSITY SCHOOL OF MEDICINE	DEAN	JOHN BLIGH
AFI CONSERVATORY	DEAN	JAN SCHüTTE
UNIVERSITY OF MICHIGAN SCHOOL OF MUSIC, THEATRE & DANCE	DEAN	AARON DWORKIN
ANTONIN SCALIA LAW SCHOOL	DEAN	HENRY N. BUTLER
WASHINGTON COLLEGE OF LAW	DEAN	CAMILLE A. NELSON
ROTTERDAM SCHOOL OF MANAGEMENT, ERASMUS UNIVERSITY	DEAN	
PAUL M. HEBERT LAW CENTER	DEAN	TOM GALLIGAN
UNIVERSITY OF MAINE SCHOOL OF LAW	DEAN	DANIELLE CONWAY
UNIVERSITY OF WISCONSIN LAW SCHOOL	DEAN	MARGARET RAYMOND
MSU FACULTY OF COMPUTATIONAL MATHEMATICS AND CYBERNETICS	DEAN	PROFESSOR
MSU FACULTY OF COMPUTATIONAL MATHEMATICS AND CYBERNETICS	DEAN	ACADEMICIAN RAS
MSU FACULTY OF COMPUTATIONAL MATHEMATICS AND CYBERNETICS	DEAN	EVGENY MOISEEV
IE BUSINESS SCHOOL	DEAN	SANTIAGO IñIGUEZ
GEORGETOWN UNIVERSITY SCHOOL OF FOREIGN SERVICE IN QATAR	DEAN	GERD NONNEMAN
ALBA GRADUATE BUSINESS SCHOOL	DEAN	INDEX.ASP?PROF ID=9
FACULTAD DE CIENCIAS EXACTAS, INGENIERíA Y AGRIMENSURA	DEAN	OSCAR PEIRE
CAMBRIDGE JUDGE BUSINESS SCHOOL	DEAN	CHRISTOPH LOCH
UNIVERSITY OF MIAMI SCHOOL OF LAW	DEAN	PATRICIA D. WHITE
LEONARD M. MILLER SCHOOL OF MEDICINE	DEAN	PASCAL GOLDSCHMIDT, MD
UC BERKELEY GRADUATE SCHOOL OF EDUCATION	DEAN	ELLIOT TURIEL
UCLA ANDERSON SCHOOL OF MANAGEMENT	DEAN	JUDY D. OLIAN
UNIVERSITY OF MICHIGAN COLLEGE OF LITERATURE, SCIENCE, AND THE ARTS	DEAN	ANDREW D. MARTIN
EMMAUS BIBLE COLLEGE	DEAN	ISRAEL CHAVEZ
UNIVERSITY OF CINCINNATI COLLEGE OF LAW	DEAN	JENNIFER-S-BARD
ALBANY LAW SCHOOL	DEAN	ALICIA OUELLETTE
JESUIT SCHOOL OF THEOLOGY OF SANTA CLARA UNIVERSITY	DEAN	REV. THOMAS J. MASSARO, S.J
UBC SAUDER SCHOOL OF BUSINESS	DEAN	ROBERT HELSLEY
CHENNAI MATHEMATICAL INSTITUTE	DEAN	MADHAVAN MUKUND
UNIVERSITY OF CALIFORNIA, BERKELEY SCHOOL OF INFORMATION	DEAN	ANNALEE SAXENIAN
OHIO STATE UNIVERSITY, MANSFIELD CAMPUS	DEAN	STEPHEN M. GAVAZZI
OHIO STATE UNIVERSITY, NEWARK CAMPUS	DEAN	WILLIAM L. MACDONALD
ASPER SCHOOL OF BUSINESS	DEAN	689.HTM
RABBI ISAAC ELCHANAN THEOLOGICAL SEMINARY	DEAN	RABBI MENACHEM PENNER
MORITZ COLLEGE OF LAW	DEAN	ALAN C. MICHAELS
HUMPHREY SCHOOL OF PUBLIC AFFAIRS	DEAN	ERIC P. SCHWARTZ
SCHOOL OF INTERNATIONAL AND PUBLIC AFFAIRS, COLUMBIA UNIVERSITY	DEAN	MERIT JANOW
PENN STATE MILTON S. HERSHEY MEDICAL CENTER	DEAN	HILLEMEIER
JAYPEE INSTITUTE OF INFORMATION TECHNOLOGY	DEAN	1
JAYPEE INSTITUTE OF INFORMATION TECHNOLOGY	DEAN	2
JAYPEE INSTITUTE OF INFORMATION TECHNOLOGY	DEAN	3
IAE UNIVERSIDAD AUSTRAL	DEAN	GABRIEL NOUSSAN
IDA CROWN JEWISH ACADEMY	DEAN	RABBI LEONARD MATANKY
LYNDON B. JOHNSON SCHOOL OF PUBLIC AFFAIRS	DEAN	ANGELA EVANS
ICAHN SCHOOL OF MEDICINE AT MOUNT SINAI	DEAN	DENNIS S. CHARNEY, MD
MONASH UNIVERSITY, PARKVILLE CAMPUS	DEAN	PROFESSOR BILL CHARMAN
FACULTY OF MEDICINE SIRIRAJ HOSPITAL, MAHIDOL UNIVERSITY	DEAN	UDOM KACHINTORN, M.D.
UNIVERSITY OF CHICAGO SCHOOL OF SOCIAL SERVICE ADMINISTRATION	DEAN	NEIL B. GUTERMAN
MCGILL UNIVERSITY FACULTY OF MEDICINE	DEAN	DAVID EIDELMAN
JAMES MADISON COLLEGE	DEAN	SHERMAN GARNETT
ROBERT R. MCCORMICK SCHOOL OF ENGINEERING AND APPLIED SCIENCE	DEAN	JULIO M. OTTINO HTTP://WWW.MCCORMICK.NORTHWESTERN.EDU/ABOUT/LEADERSHIP/DEAN_JULIO_OTTINO.HTML
ARIEL UNIVERSITY	DEAN	SHMUEL SHACHAM
MCMASTER FACULTY OF HEALTH SCIENCES	DEAN	JOHN G. KELTON
JACK BASKIN SCHOOL OF ENGINEERING	DEAN	ALEXANDER L. WOLF
MARRIOTT SCHOOL OF MANAGEMENT	DEAN	LEE TOM PERRY
BOSTON UNIVERSITY SCHOOL OF THEOLOGY	DEAN	MARY ELIZABETH MOORE
MSU FACULTY OF GEOGRAPHY	DEAN	SERGEI DOBROLYUBOV
VANDERBILT UNIVERSITY SCHOOL OF NURSING	DEAN	LINDA NORMAN
MARTIN J. WHITMAN SCHOOL OF MANAGEMENT	DEAN	S.P. RAJ
CHARLESTON SCHOOL OF LAW	DEAN	ANDREW L. ABRAMS
UCL FACULTY OF LAWS	DEAN	HAZEL GENN
BRODY SCHOOL OF MEDICINE AT EAST CAROLINA UNIVERSITY	DEAN	PAUL R. G. CUNNINGHAM, M.D., F.A.C.S.
SETON HALL UNIVERSITY SCHOOL OF LAW	DEAN	KATHLEEN M. BOOZANG
UNIVERSITY OF TEXAS SCHOOL OF LAW	DEAN	WARD FARNSWORTH
UNIVERSITY OF VIRGINIA COLLEGE OF ARTS AND SCIENCES	DEAN	IAN BAUCOM
DUKE UNIVERSITY SCHOOL OF MEDICINE	DEAN	NANCY ANDREWS
DAVID GEFFEN SCHOOL OF MEDICINE AT UCLA	DEAN	KELSEY MARTIN
MONASH UNIVERSITY FACULTY OF LAW	DEAN	BRYAN HORRIGAN
UNIVERSITY OF WASHINGTON SCHOOL OF PUBLIC HEALTH	DEAN	HOWARD FRUMKIN
UNIVERSITY OF MICHIGAN SCHOOL OF INFORMATION	DEAN	THOMAS FINHOLT
LEEDS SCHOOL OF MEDICINE	DEAN	PROFESSOR PAUL STEWART
LEICESTER MEDICAL SCHOOL	DEAN	PROFESSOR NICK JM LONDON
ENERGY AND ENVIRONMENTAL SECURITY INITIATIVE	DEAN	DAVID GETCHES, DEAN AND RAPHAEL MOSES PROFESSOR OF LAW
WARWICK MEDICAL SCHOOL	DEAN	PROFESSOR SUDHESH KUMAR
ELLIOTT SCHOOL OF INTERNATIONAL AFFAIRS	DEAN	REUBEN BRIGETY
ROBERT H. SMITH SCHOOL OF BUSINESS	DEAN	ALEXANDER J. TRIANTIS
RICE UNIVERSITY SCHOOL OF ARCHITECTURE	DEAN	SARAH WHITING
UNIVERSITY OF ABERDEEN SCHOOL OF MEDICINE AND DENTISTRY	DEAN	MICHAEL GREAVES
UNIVERSITY OF ABERDEEN SCHOOL OF MEDICINE AND DENTISTRY	DEAN	ROYAL COLLEGE OF PATHOLOGISTS
UNIVERSITY OF ABERDEEN SCHOOL OF MEDICINE AND DENTISTRY	DEAN	ROYAL COLLEGE OF PHYSICIANS
UNIVERSITY OF ABERDEEN SCHOOL OF MEDICINE AND DENTISTRY	DEAN	ROYAL COLLEGE OF PHYSICIANS OF EDINBURGH
UNIVERSITY OF ABERDEEN SCHOOL OF MEDICINE AND DENTISTRY	DEAN	ROYAL COLLEGE OF PHYSICIANS AND SURGEONS OF GLASGOW
COLLEGE OF THE UNIVERSITY OF CHICAGO	DEAN	JOHN W. BOYER
WEILL CORNELL MEDICINE	DEAN	AUGUSTINE M. K. CHOI
UNIVERSITY OF VIRGINIA SCHOOL OF MEDICINE	DEAN	DAVID S. WILKES
UIUC COLLEGE OF EDUCATION	DEAN	MARY KALANTZIS
UNIVERSITY OF CALIFORNIA, IRVINE SCHOOL OF MEDICINE	DEAN	HOWARD FEDEROFF, M.D.
ROYAL	DEAN	SIR JOHN SAVILL
UNSW FACULTY OF LAW	DEAN	GEORGE WILLIAMS
UNIVERSITY OF CINCINNATI COLLEGE OF DESIGN, ARCHITECTURE, ART, AND PLANNING	DEAN	STAFF.HTML?EID=PROBSTR&THECOMP=UCEPROF
S P JAIN SCHOOL OF GLOBAL MANAGEMENT	DEAN	JOHN LODEWIJKS, DEAN, UNDERGRADUATE
S P JAIN SCHOOL OF GLOBAL MANAGEMENT	DEAN	PREETHA GEORGE
S P JAIN SCHOOL OF GLOBAL MANAGEMENT	DEAN	BALAKRISHNA GRANDHI
S P JAIN SCHOOL OF GLOBAL MANAGEMENT	DEAN	INDU NIRANJAN
WILLAMETTE UNIVERSITY MBA	DEAN	DEBRA RINGOLD
VALPARAISO UNIVERSITY SCHOOL OF LAW	DEAN	ANDREA LYON
UNIVERSITY OF CINCINNATI – COLLEGE-CONSERVATORY OF MUSIC	DEAN	PETER LANDGREN
TIFR CENTRE FOR APPLICABLE MATHEMATICS	DEAN	G D V GOWDA
MCGILL UNIVERSITY FACULTY OF DENTISTRY	DEAN	PAUL ALLISON
DESAUTELS FACULTY OF MANAGEMENT	DEAN	ISABELLE BAJEUX-BESNAINOU
VANDERBILT UNIVERSITY COLLEGE OF ARTS AND SCIENCE	DEAN	CAROLYN DEVER
UNIVERSITY OF ALBERTA SCHOOL OF BUSINESS	DEAN	JOSEPH DOUCET
PLM GRADUATE SCHOOL OF LAW	DEAN	JUSTICE ANGELINA SANDOVAL-GUTIERREZ
UNIVERSITY OF WISCONSIN–MADISON SCHOOL OF EDUCATION	DEAN	DIANA HESS
UNIVERSITY OF WISCONSIN–SHEBOYGAN	DEAN	JACKIE JOSEPH-SILVERSTEIN, ED.D.
JACKSON SCHOOL OF GEOSCIENCES	DEAN	SHARON MOSHER
ROBERT D. CLARK HONORS COLLEGE	DEAN	TERRY HUNT
CATHOLIC THEOLOGICAL UNION	DEAN	SISTER BARBARA E. REID, O.P., PH.D.
GONZAGA UNIVERSITY SCHOOL OF LAW	DEAN	JANE B. KORN
ASU COLLEGE OF PUBLIC SERVICE & COMMUNITY SOLUTIONS	DEAN	JONATHAN KOPPELL
SYDNEY LAW SCHOOL	DEAN	JOELLEN RILEY
J. MACK ROBINSON COLLEGE OF BUSINESS	DEAN	RICHARD D. PHILLIPS
FUNDAçãO DOM CABRAL	DEAN	WAGNER FURTADO VELOSO
UNIVERSITY OF MICHIGAN SCHOOL OF EDUCATION	DEAN	DEBORAH LOEWENBERG BALL
PURDUE POLYTECHNIC INSTITUTE	DEAN	GARY BERTOLINE
UNIVERSITY OF THE PHILIPPINES COLLEGE OF SCIENCE	DEAN	JOSE MARIA P. BALMACEDA, PH.D.
MAASTRICHT SCHOOL OF MANAGEMENT	DEAN	PROF. WIM A. NAUDé, PHD
UNIVERSITY OF GASTRONOMIC SCIENCES	DEAN	PIERCARLO GRIMALDI
SAINT LOUIS UNIVERSITY SCHOOL OF LAW	DEAN	MICHAEL A. WOLFF
GEORGIA INSTITUTE OF TECHNOLOGY COLLEGE OF DESIGN	DEAN	STEVEN P. FRENCH
GEORGIA INSTITUTE OF TECHNOLOGY COLLEGE OF COMPUTING	DEAN	ZVI GALIL
GEORGIA INSTITUTE OF TECHNOLOGY COLLEGE OF ENGINEERING	DEAN	GARY S. MAY
RENSSELAER AT HARTFORD	DEAN	JOHN A. MINASIAN, PH.D. HTTP://WWW.RPI.EDU/PRESIDENT/CABINET/MINASIAN.HTMLHTTP://NEWS.RPI.EDU/UPDATE.DO?ARTCENTERKEY=931&SETAPPVAR=PAGE(1)
UNIVERSITY OF THE EAST COLLEGE OF LAW	DEAN	WILLARD B. RIANO, LL.B.
SHRI BHAUSAHEB HIRE GOVERNMENT MEDICAL COLLEGE, DHULE	DEAN	DR.S.S.GUPTA
MACDONALD CAMPUS	DEAN	ANJA GEITMANN
SCHULICH SCHOOL OF MUSIC	DEAN	JULIE E. CUMMING
DIVINE WORD SEMINARY	DEAN	FR. RANDOLF FLORES, SVD, SSL, PHD AND STD
YALE SCHOOL OF ART	DEAN	MARTA KUZMA
INSTITUTE OF MEDICINE, NEPAL	DEAN	RAKESH PRASAD SHRIVASTAV
NEW YORK UNIVERSITY STERN SCHOOL OF BUSINESS	DEAN	PETER BLAIR HENRY
UNIVERSITY OF CINCINNATI ACADEMIC HEALTH CENTER	DEAN	TINA F. WHALEN, EDD
UNIVERSITY OF MICHIGAN COLLEGE OF PHARMACY	DEAN	JAMES T. DALTON
TEXAS TECH UNIVERSITY COLLEGE OF ARCHITECTURE	DEAN	ANDREW VERNOOY
AMERICAN UNIVERSITY OF THE CARIBBEAN	DEAN	WILLIAM F. OWEN, MD, FACP
SYMS SCHOOL OF BUSINESS	DEAN	DEFAULT.ASPX?ID=MPAVA
AMERICAN UNIVERSITY SCHOOL OF PUBLIC AFFAIRS	DEAN	BARBARA S. ROMZEK
AMERICAN UNIVERSITY COLLEGE OF ARTS AND SCIENCES	DEAN	DR. PETER STARR
UNIVERSITY OF MARYLAND SCHOOL OF PUBLIC POLICY	DEAN	ROBERT C. ORR
HIGHER COLLEGE OF TECHNOLOGY	DEAN	DR.KHALID AMBUSAIDI
ASU COLLEGE OF LIBERAL ARTS AND SCIENCES	DEAN	PATRICK J. KENNEY
UNIVERSITY OF MINNESOTA COLLEGE OF SCIENCE AND ENGINEERING	DEAN	STEVEN L. CROUCH HTTP://WWW.IT.UMN.EDU/ABOUT/CROUCH.HTML
FAIRFIELD UNIVERSITY DOLAN SCHOOL OF BUSINESS	DEAN	DONALD E. GIBSON
MIR YESHIVA	DEAN	ELIEZER YEHUDA FINKEL
BOSTON COLLEGE SCHOOL OF THEOLOGY AND MINISTRY	DEAN	THOMAS D. STEGMAN, S.J.
IRELL & MANELLA GRADUATE SCHOOL OF BIOLOGICAL SCIENCES	DEAN	JOHN J. ROSSI, PH.D.
RUTGERS SCHOOL OF LAW – NEWARK	DEAN	RONALD CHEN
FACULTY OF MEDICINE, NARESUAN UNIVERSITY	DEAN	ASSOC. PROF. SIRIKASEM SIRILAK, MD
MCCOURT SCHOOL OF PUBLIC POLICY	DEAN	EDWARD B. MONTGOMERY
TULANE SCHOOL OF ARCHITECTURE	DEAN	KENNETH A. SCHWARTZ
TULANE SCHOOL OF ARCHITECTURE	DEAN	FAIA
DURHAM UNIVERSITY SCHOOL OF MEDICINE, PHARMACY AND HEALTH	DEAN	APS HUNGIN OBE
EAST CAROLINA UNIVERSITY SCHOOL OF DENTAL MEDICINE	DEAN	DR. GREGORY CHADWICK, DDS, MS
NOTRE DAME SCHOOL OF ARCHITECTURE	DEAN	MICHAEL LYKOUDIS
DUQUESNE UNIVERSITY SCHOOL OF LAW	DEAN	NANCY PERKINS
FAIRFIELD UNIVERSITY EGAN SCHOOL OF NURSING AND HEALTH STUDIES	DEAN	MEREDITH WALLACE KAZER
IRA A. FULTON COLLEGE OF ENGINEERING AND TECHNOLOGY	DEAN	ALAN R. PARKINSON
KELLSTADT GRADUATE SCHOOL OF BUSINESS	DEAN	RAY WHITTINGTON
WAYNE STATE UNIVERSITY LAW SCHOOL	DEAN	JOCELYN BENSON
PENN STATE COLLEGE OF INFORMATION SCIENCES AND TECHNOLOGY	DEAN	ANDREW SEARS
SOUTH ASIA THEOLOGICAL RESEARCH INSTITUTE	DEAN	THE REV. P. G. GEORGE, TH.D.
JOHN WESLEY COLLEGE	DEAN	DION FORSTER
UNIVERSIDAD DE MENDOZA	DEAN	SALVADOR B. NAVARRíA PHD
BOSTON UNIVERSITY SCHOOL OF MEDICINE	DEAN	KAREN H. ANTMAN
PARIS SCHOOL OF ECONOMICS	DEAN	PIERRE-YVES GEOFFARD
UNIVERSITY OF WISCONSIN SCHOOL OF MEDICINE AND PUBLIC HEALTH	DEAN	ROBERT N. GOLDEN
UNIVERSITY OF WISCONSIN SCHOOL OF MEDICINE AND PUBLIC HEALTH	DEAN	DOCTOR OF MEDICINE
BOSTON UNIVERSITY SCHOOL OF EDUCATION	DEAN	HARDIN L.K. COLEMAN
LIBERTY UNIVERSITY SCHOOL OF LAW	DEAN	RENA LINDEVALDSEN
FACULTY OF SCIENCE, MAHIDOL UNIVERSITY	DEAN	PROF. SKORN MONGKOLSUK PH.D.
UNIVERSITY OF WISCONSIN–MILWAUKEE COLLEGE OF ENGINEERING AND APPLIED SCIENCE	DEAN	BRETT PETERS
WHITACRE COLLEGE OF ENGINEERING	DEAN	ALBERT SACCO
ROTTERDAM BUSINESS SCHOOL	DEAN	DRS. C.
FRANCISCAN SCHOOL OF THEOLOGY	DEAN	BR. WILLIAM J. SHORT, OFM
TEXAS TECH UNIVERSITY COLLEGE OF MEDIA & COMMUNICATION	DEAN	DAVID D. PERLMUTTER
WHITING SCHOOL OF ENGINEERING	DEAN	T.E. SCHLESINGER
ZANVYL KRIEGER SCHOOL OF ARTS AND SCIENCES	DEAN	BEVERLY WENDLAND
CAREY BUSINESS SCHOOL	DEAN	BERNARD T. FERRARI
INDIANA UNIVERSITY SCHOOL OF PUBLIC AND ENVIRONMENTAL AFFAIRS	DEAN	JOHN GRAHAM
CAP COLLEGE FOUNDATION	DEAN	ANGEL ALCALA, PH.D.
FAR EASTERN UNIVERSITY INSTITUTE OF LAW	DEAN	MEL STA. MARIA
ANTWERP MANAGEMENT SCHOOL	DEAN	PAUL MATTHYSSENS
KANSAS CITY UNIVERSITY OF MEDICINE AND BIOSCIENCES	DEAN	BRUCE DUBIN, D.O., J.D.
MAASTRICHT GRADUATE SCHOOL OF GOVERNANCE	DEAN	PROF. DR. BART VERSPAGEN
UNIVERSITY OF PENNSYLVANIA SCHOOL OF DESIGN	DEAN	MARILYN JORDAN TAYLOR
ATENEO SCHOOL OF GOVERNMENT	DEAN	ANTONIO G. M. LA VIñA, J.S.D.
SAVANNAH STATE UNIVERSITY COLLEGE OF BUSINESS ADMINISTRATION	DEAN	MOSTAFA SARHAN
UNIVERSITY OF SANTO TOMAS GRADUATE SCHOOL	DEAN	PROF. MARILU R. MADRUNIO, PHD
NORTHWESTERN UNIVERSITY SCHOOL OF EDUCATION AND SOCIAL POLICY	DEAN	PENELOPE PETERSON
CALLOWAY SCHOOL OF BUSINESS AND ACCOUNTANCY	DEAN	STEVEN REINEMUND
PRIYADARSHINI COLLEGE OF ENGINEERING	DEAN	DR. J. P. MODAK,
PRIYADARSHINI COLLEGE OF ENGINEERING	DEAN	DR. K. S. ZAKIUDDIN,
PRIYADARSHINI COLLEGE OF ENGINEERING	DEAN	DR. M. M. NANOTI,
PRIYADARSHINI COLLEGE OF ENGINEERING	DEAN	DR. H. HAZARE,
PRIYADARSHINI COLLEGE OF ENGINEERING	DEAN	AICTE/DTE COORDINATOR
ATENEO SCHOOL OF MEDICINE AND PUBLIC HEALTH	DEAN	MANUEL M. DAYRIT, MD, MSC
NATO SCHOOL	DEAN	COL. TIMOTHY DREIFKE, USAF
CARAGA STATE UNIVERSITY – CABADBARAN	DEAN	MARILYN CASTILLO ED. D
SCRIPPS RESEARCH INSTITUTE GRADUATE PROGRAM	DEAN	JAMES R. WILLIAMSON
SHALHEVET HIGH SCHOOL	DEAN	MR. JASON FELD
LYMAN WARD MILITARY ACADEMY	DEAN	LTC JEFF DAMRON
GRADUATE SCHOOL OF INTERNATIONAL CORPORATE STRATEGY	DEAN	KAZUO ICHIJO
JAMES MADISON UNIVERSITY COLLEGE OF BUSINESS	DEAN	DR. MARY GOWAN
GEORGETOWN COLLEGE	DEAN	CHESTER GILLIS
CHARLOTTE SCHOOL OF LAW	DEAN	JAY CONISON
COLLEGE OF MUSIC, MAHIDOL UNIVERSITY	DEAN	SUGREE CHAROENSOOK
JUNíPERO SERRA HIGH SCHOOL	DEAN	DWAN HURT
MIT SCHOOL OF ARCHITECTURE AND PLANNING	DEAN	HASHIM SARKIS
FAIRFIELD UNIVERSITY COLLEGE OF ARTS AND SCIENCES	DEAN	YOHURU WILLIAMS
UNIVERSITY OF CALIFORNIA, IRVINE SCHOOL OF LAW	DEAN	ERWIN CHEMERINSKY
UCLA COLLEGE OF LETTERS AND SCIENCE	DEAN	HUMANITIES: TIM STOWELL
UCLA COLLEGE OF LETTERS AND SCIENCE	DEAN	LIFE SCIENCES: VICTORIA SORK
UCLA COLLEGE OF LETTERS AND SCIENCE	DEAN	PHYSICAL SCIENCES: JOSEPH RUDNICK
UCLA COLLEGE OF LETTERS AND SCIENCE	DEAN	SOCIAL SCIENCES: ALESSANDRO DURANTI
UCLA COLLEGE OF LETTERS AND SCIENCE	DEAN	UNDERGRADUATE EDUCATION: JUDITH L. SMITH
VANDERBILT UNIVERSITY SCHOOL OF ENGINEERING	DEAN	PHILIPPE FAUCHET
NATIONAL UNIVERSITY OF EQUATORIAL GUINEA	DEAN	FEDERICO EDJO OVONO
BLAIR SCHOOL OF MUSIC	DEAN	MARK WAIT
PURDUE UNIVERSITY COLLEGE OF LIBERAL ARTS	DEAN	DAVID REINGOLD
PURDUE UNIVERSITY COLLEGE OF EDUCATION	DEAN	MARYANN SANTOS DE BARONA
PURDUE UNIVERSITY COLLEGE OF ENGINEERING	DEAN	LEAH JAMIESON
GEORGE MASON UNIVERSITY SCHOOL OF POLICY, GOVERNMENT, AND INTERNATIONAL AFFAIRS	DEAN	
VANDERBILT UNIVERSITY SCHOOL OF MEDICINE	DEAN	JEFF BALSER
NCKU IMBA	DEAN	YU-HERN CHANG
PURDUE UNIVERSITY COLLEGE OF HEALTH AND HUMAN SCIENCES	DEAN	CHRISTINE LADISCH
UNIVERSITY OF CINCINNATI COLLEGE OF ENGINEERING AND APPLIED SCIENCE	DEAN	TEIK LIM
UNIVERSITY OF EDINBURGH MEDICAL SCHOOL	DEAN	SIR JOHN SAVILL
LEE KUAN YEW SCHOOL OF PUBLIC POLICY	DEAN	KISHORE MAHBUBANI
ANDREW YOUNG SCHOOL OF POLICY STUDIES	DEAN	MARY-BETH-WALKER.HTML
PENN STATE COLLEGE OF COMMUNICATIONS	DEAN	MARIE-HARDIN
UNIVERSITY OF THE PHILIPPINES COLLEGE OF ENGINEERING	DEAN	AURA C. MATIAS, PH. D.
FACULTY OF MEDICINE, CHULALONGKORN UNIVERSITY	DEAN	PROF. SUTHIPONG WACHARASINDHU, MD
IAE LYON	DEAN	JéRôME RIVE
UIC COLLEGE OF BUSINESS ADMINISTRATION	DEAN	MICHAEL MIKHAIL
UNIVERSITY OF FREIBURG FACULTY OF MEDICINE	DEAN	KERSTIN KRIEGLSTEIN, PHD
COLUMBIA UNIVERSITY SCHOOL OF PROFESSIONAL STUDIES	DEAN	JASON WINGARD
UNIVERSITY OF OREGON SCHOOL OF ARCHITECTURE AND ALLIED ARTS	DEAN	BROOK MULLER
MANNHEIM BUSINESS SCHOOL	DEAN	JENS WüSTEMANN
UNIVERSITY OF ILLINOIS AT CHICAGO COLLEGE OF ENGINEERING	DEAN	PETER NELSON
WISCONSIN SCHOOL OF BUSINESS	DEAN	19549
IEDC-BLED SCHOOL OF MANAGEMENT	DEAN	DR. DANICA PURG
UCLA HENRY SAMUELI SCHOOL OF ENGINEERING AND APPLIED SCIENCE	DEAN	JAYATHI MURTHY
JOSEF KORBEL SCHOOL OF INTERNATIONAL STUDIES	DEAN	CHRISTOPHER R. HILL
FACULTY OF POLITICAL SCIENCE, CHULALONGKORN UNIVERSITY	DEAN	ASSOC. PROF. AKE TANGSUPVATTANA, PHD
ANU COLLEGE OF LAW	DEAN	PROFESSOR STEPHEN BOTTOMLEY
INTERNATIONAL SCHOOL OF SOFTWARE, WUHAN UNIVERSITY	DEAN	HUAIBEI ZHOU
HEIDER COLLEGE OF BUSINESS	DEAN	DR. ANTHONY HENDRICKSON
COLLEGE OF WILLIAM & MARY SCHOOL OF EDUCATION	DEAN	INDEX.PHP
FACULTY OF LAW, UNIVERSITY OF BELGRADE	DEAN	SIMA AVRAMOVIć
HARVARD BUSINESS SCHOOL	DEAN	NITIN NOHRIA
FACULTY OF MEDICINE RAMATHIBODI HOSPITAL, MAHIDOL UNIVERSITY	DEAN	WINIT PUAPRADITT, M.D.
AMSTERDAM UNIVERSITY COLLEGE	DEAN	PROF. DR. MURRAY PRATT
JOHN B. GODDARD SCHOOL OF BUSINESS & ECONOMICS	DEAN	MESSAGE FROM THE DEAN.HTML
CAL POLY POMONA COLLEGE OF ENVIRONMENTAL DESIGN	DEAN	MICHAEL WOO
WILLIAM E. MACAULAY HONORS COLLEGE	DEAN	DR. MARY C. PEARL
DAVID ECCLES SCHOOL OF BUSINESS	DEAN	INDEX.HML
ASU SCHOOL OF SUSTAINABILITY	DEAN	CHRISTOPHER G. BOONE
PURDUE UNIVERSITY COLLEGE OF PHARMACY	DEAN	CRAIG K. SVENSSON, PHARM.D., PH.D.
UNIVERSITY OF SANTO TOMAS COLLEGE OF ARCHITECTURE	DEAN	ARCH. JOHN JOSEPH T. FERNáNDEZ, UAP, MS
TULANE UNIVERSITY SCHOOL OF SCIENCE AND ENGINEERING	DEAN	NICHOLAS-ALTIERO-DEAN.CFM
NEWCOMB–TULANE COLLEGE	DEAN	DEANSOFFICE.HTML
MICHIGAN STATE UNIVERSITY COLLEGE OF NURSING	DEAN	RANDOLPH F. R. RASCH, PHD, RN, FAANP
FIU ROBERT STEMPEL COLLEGE OF PUBLIC HEALTH AND SOCIAL WORK	DEAN	TOMáS R. GUILARTE
CUMBERLAND SCHOOL OF LAW'S CENTER FOR BIOTECHNOLOGY, LAW, AND ETHICS	DEAN	JOHN L. CARROLL
DON BOSCO COLLEGE, CANLUBANG	DEAN	FR. NESTY PIDAZO, SDB
UNIVERSITY OF SANTO TOMAS COLLEGE OF NURSING	DEAN	ASSOC. PROF. SUSAN N. MARAVILLA, R.N., M.A.N.
PURDUE UNIVERSITY COLLEGE OF PHARMACY, NURSING, AND HEALTH SCIENCES	DEAN	CRAIG K. SVENSSON
BARD COLLEGE BERLIN	DEAN	CATHERINE TOAL
PARKS COLLEGE OF ENGINEERING, AVIATION AND TECHNOLOGY	DEAN	MICHELLE B. SABICK
CHEUNG KONG GRADUATE SCHOOL OF BUSINESS	DEAN	XIANG BING
GEORGE WASHINGTON UNIVERSITY SCHOOL OF MEDICINE & HEALTH SCIENCES	DEAN	JEFFREY S. AKMAN
UNIVERSITY OF UTAH COLLEGE OF ENGINEERING	DEAN	RICHARD B. BROWN
PURDUE UNIVERSITY COLLEGE OF AGRICULTURE	DEAN	JAY AKRIDGE
SEATTLE UNIVERSITY COLLEGE OF ARTS AND SCIENCES	DEAN	DEFAULT.ASPX?ID=45534
MAURICE H. KORNBERG SCHOOL OF DENTISTRY	DEAN	AMID I. ISMAIL
SAN AGUSTIN INSTITUTE OF TECHNOLOGY	DEAN	COLLEGE: AIDA C. SELECIOS
TC BEIRNE SCHOOL OF LAW	DEAN	SARAH DERRINGTON
SOLVAY BRUSSELS SCHOOL OF ECONOMICS AND MANAGEMENT	DEAN	BRUNO VAN POTTELSBERGHE
ESME-SUDRIA	DEAN	VéRONIQUE BONNET
THE DICKSON POON SCHOOL OF LAW	DEAN	DAVID CARON
MAHARAJA AGRASEN COLLEGE OF ENGINEERING AND TECHNOLOGY	DEAN	PROF.OMKAR SINGH
GOVERNMENT MEDICAL COLLEGE	DEAN	ASHOK SHINDE
GRADUATE SCHOOL OF ECONOMICS, FINANCE, AND MANAGEMENT	DEAN	PROFESSOR MICHAEL BINDER, PH.D.
UNIVERSITY HIGH SCHOOL OF SCIENCE AND ENGINEERING	DEAN	HADAD.HTML
MAHARASHTRA INSTITUTE OF MEDICAL SCIENCE AND RESEARCH, LATUR	DEAN	DR. A.G. CHANDORKAR
VAN XUAN UNIVERSITY OF TECHNOLOGY	DEAN	PROF. DR. ĐáI DUY BAN
ABILENE CHRISTIAN UNIVERSITY COLLEGE OF ARTS AND SCIENCES	DEAN	GREGORY STRAUGHN
MAKERERE UNIVERSITY SCHOOL OF PUBLIC HEALTH	DEAN	WILLIAM BAZEYO
WOMEN'S COLLEGE OF THE UNIVERSITY OF DENVER	DEAN	LGANGONE
FACULTY OF SOCIOLOGY AND ANTHROPOLOGY, THAMMASAT UNIVERSITY	DEAN	ASST. PROF. JIRAPA VARASIANGSUK
MILKEN INSTITUTE SCHOOL OF PUBLIC HEALTH	DEAN	LYNN R. GOLDMAN, MD, MPH
UNIVERSITY OF NEW ENGLAND COLLEGE OF OSTEOPATHIC MEDICINE	DEAN	DOUGLAS L. WOOD, D.O., PH.D.
WESTERN UNIVERSITY COLLEGE OF PODIATRIC MEDICINE	DEAN	LAWRENCE B. HARKLESS, DPM
AUSTRALIAN SCHOOL OF ADVANCED MEDICINE	DEAN	
BERLIN SCHOOL OF LIBRARY AND INFORMATION SCIENCE	DEAN	MICHAEL SEADLE
FACULTY OF ENGINEERING, UNIVERSITY OF PERADENIYA	DEAN	PROF.LEELANANDA RAJAPAKSHA
UNIVERSITY OF SANTO TOMAS FACULTIES OF ECCLESIASTICAL STUDIES	DEAN	REV. FR. RICHARD G. ANG, OP, PHD
UNIVERSITY OF SANTO TOMAS FACULTIES OF ECCLESIASTICAL STUDIES	DEAN	REV. FR. JOSE MA. B. TINOKO, O.P., JCD
OMAN MEDICAL COLLEGE	DEAN	SALEH AL KHUSAIBY
LIBERAL ARTS AND SCIENCES AT TILBURG UNIVERSITY	DEAN	PROF.DR. ALKELING VAN LENNING,
EHESP	DEAN	LAURENT CHAMBAUD
BALAJI INSTITUTE OF MODERN MANAGEMENT PUNE	DEAN	DR.  A. BALASUBRAMANIAN
BALAJI INSTITUTE OF TELECOM AND MANAGEMENT PUNE	DEAN	DR.COL.A. BALASUBRAMANIAN
ACCADEMIA DI ARCHITETTURA DI MENDRISIO	DEAN	MARIO BOTTA
CENTRAL PHILIPPINE UNIVERSITY COLLEGE OF MEDICINE	DEAN	DR. HENRY GONZALES
ITU SCHOOL OF CIVIL ENGINEERING	DEAN	PROF. DR. GAYE ONURSAL DENLI
ITU SCHOOL OF ARCHITECTURE	DEAN	PROF. DR. SINAN MERT ŞENER
ITU SCHOOL OF MECHANICAL ENGINEERING	DEAN	PROF. DR. ATA MUğAN
ITU SCHOOL OF NAVAL ARCHITECTURE AND OCEAN ENGINEERING	DEAN	PROF. DR. ALI İHSAN ALDOğAN
ITU SCHOOL OF AERONAUTICS AND ASTRONAUTICS	DEAN	PROF. DR. FEVZI UNAL
USC SCHOOL OF ARCHITECTURE	DEAN	QINGYUN MA
BYU COLLEGE OF FINE ARTS AND COMMUNICATIONS	DEAN	STEPHEN M. JONES
IBRICT	DEAN	ABDULLAH AL MASKARI
ITU SCHOOL OF TEXTILE TECHNOLOGIES AND DESIGN	DEAN	PROF. DR. EMEL ONDER KARAOGLU
UNIVERSITY OF BELGRADE FACULTY OF PHILOLOGY	DEAN	ALEKSANDRA VRANEš
ITU SCHOOL OF MINES	DEAN	PROF. DR. FATMA ARSLAN
ITU SCHOOL OF MARITIME	DEAN	PROF. DR. OGUZ SALIM SOGUT
ITU TURKISH MUSIC STATE CONSERVATORY	DEAN	PROF. DR. CIHAT ASKIN
FACULTY OF ADMINISTRATION, LJUBLJANA	DEAN	JANEZ STARE
UAMS NORTHWEST	DEAN	PETER O. KOHLER, M.D.
GENEVA MEDICAL COLLEGE	DEAN	EDWARD CUTBUSH, MD
FACULTY OF ARTS, UNIVERSITY OF PERADENIYA	DEAN	PROF. A.M. NAVARATHNA BANDARA
UNIVERSITY OF MISSISSIPPI SCHOOL OF LAW	DEAN	DEBORAH H. BELL
THE ENGLISH SCHOOL	DEAN	CHARLES WESTON, OBE
FACULTY OF SCIENCE, UNIVERSITY OF PERADENIYA	DEAN	PROF. S.H.P.P. KARUNARATNE
FACULTY OF MEDICINE, UNIVERSITY OF PERADENIYA	DEAN	PROF. VAJIRA S. WEERASINGHE
HASKAYNE SCHOOL OF BUSINESS	DEAN	JIM DEWALD
GEORGIA INSTITUTE OF TECHNOLOGY	DEAN	JOHN STEIN
RUTGERS SCHOOL OF MANAGEMENT AND LABOR RELATIONS	DEAN	SUSAN J. SCHURMAN
UCL FACULTY OF MATHEMATICAL AND PHYSICAL SCIENCES	DEAN	PROFESSOR RICHARD CATLOW
BLAVATNIK SCHOOL OF GOVERNMENT	DEAN	NGAIRE WOODS
FACULTY OF MEDICINE, DIPONEGORO UNIVERSITY	DEAN	TRI NUR KRISTINA, PROF. M.D.
UNIVERSITY SCHOOL OF INFORMATION, COMMUNICATION AND TECHNOLOGY	DEAN	DRCSRAI.HTM
HACETTEPE UNIVERSITY MEDICAL SCHOOL	DEAN	PROF. DR. ÇAğATAY GüLER
VILNIUS UNIVERSITY FACULTY OF COMMUNICATION	DEAN	ANDRIUS VAIšNYS
CENTRE DE FORMATION MéDICALE DU NOUVEAU-BRUNSWICK	DEAN	DR AUREL SCHOFIELD
FRONTIER MEDICAL COLLEGE	DEAN	PROF. DR. GUL MUHAMMAD
KHAZAR UNIVERSITY SCHOOL OF HUMANITIES AND SOCIAL SCIENCES	DEAN	JABIR KHALILOV, SJD
SIUE SCHOOL OF PHARMACY	DEAN	GIREESH GUPCHUP
UNIVERSITY OF AUCKLAND FACULTY OF SCIENCE	DEAN	PROFESSOR GRANT GUILFORD
FACULTY OF AGRICULTURE, UNIVERSITY OF PERADENIYA	DEAN	DR. K SAMARASINGHE
FACULTY OF VETERINARY MEDICINE & ANIMAL SCIENCE, UNIVERSITY OF PERADENIYA	DEAN	PROF. H.B.S. ARIYARATHNE
FACULTY OF DENTAL SCIENCES, UNIVERSITY OF PERADENIYA	DEAN	PROF. W.M. TILAKARATNE
FACULTY OF ALLIED HEALTH SCIENCES, UNIVERSITY OF PERADENIYA	DEAN	PROF. D.B.M. WICKRAMARATHNE
TEXAS TECH UNIVERSITY HEALTH SCIENCES CENTER SCHOOL OF MEDICINE	DEAN	STEVEN LEE BERK, MD
UC RIVERSIDE SCHOOL OF MEDICINE	DEAN	DEBORAH V. DEAS, M.D.
HUTTON HONORS COLLEGE	DEAN	ANDREA CICCARELLI
UNIVERSITY SCHOOL OF CHEMICAL TECHNOLOGY	DEAN	ARINJAY.HTM
INSTITUTE OF BUSINESS ADMINISTRATION, KARACHI	DEAN	
FLETCHER SCHOOL OF LAW AND DIPLOMACY	DEAN	JAMES G. STAVRIDIS
DUKE UNIVERSITY SCHOOL OF LAW	DEAN	DAVID F. LEVI
BUSH SCHOOL OF GOVERNMENT AND PUBLIC SERVICE	DEAN	MARK WELSH
FACULTY OF ECONOMICS, LJUBLJANA	DEAN	METKA TEKAVčIč
VCU SCHOOL OF THE ARTS	DEAN	JOSEPH H. SEIPEL
LONDON SCHOOL OF COMMERCE	DEAN	
FACULTY OF ARTS, BANARAS HINDU UNIVERSITY	DEAN	PRO. KUMAR PANKAJ
SMU SCHOOL OF LAW	DEAN	YEO-TIONG-MIN
A.T. STILL UNIVERSITY SCHOOL OF OSTEOPATHIC MEDICINE IN ARIZONA	DEAN	KAY KALOUSEK, DO
UNIVERSITY OF EDINBURGH ACADEMY OF GOVERNMENT	DEAN	CHARLIE JEFFERY
ELMEZZI GRADUATE SCHOOL OF MOLECULAR MEDICINE	DEAN	BETTIE STEINBERG
BERLIN GRADUATE SCHOOL FOR TRANSNATIONAL STUDIES	DEAN	MARKUS JACHTENFUCHS
WESTERN CUNA MANAGEMENT SCHOOL	DEAN	DR. MICHAEL STEINBERGER
THE COLLEGE AT SOUTHEASTERN	DEAN	JAMIE K. DEW
DAR AL-MUSTAFA	DEAN	HABIB UMAR BIN HAFIZ
LIAUTAUD GRADUATE SCHOOL OF BUSINESS	DEAN	MICHAEL MIKHAIL
FACULTY OF MEDICINE, PRINCESS OF NARADHIWAS UNIVERSITY	DEAN	ACM. OUICHAI PLEANGPRASITI, MD
BAYAN COLLEGE FOR SCIENCE & TECHNOLOGY	DEAN	JAFAR MOHAMMED BASHIR
SILLIMAN UNIVERSITY DIVINITY SCHOOL	DEAN	DR. LOPE B. ROBIN
SILLIMAN UNIVERSITY DIVINITY SCHOOL	DEAN	BACHELOR OF THEOLOGY
SILLIMAN UNIVERSITY DIVINITY SCHOOL	DEAN	MASTER OF DIVINITY
SILLIMAN UNIVERSITY DIVINITY SCHOOL	DEAN	MASTER OF THEOLOGY
INSTITUTE OF BUSINESS & TECHNOLOGY, KARACHI	DEAN	M. A. KHAN
LOUISIANA STATE UNIVERSITY BUSINESS EDUCATION COMPLEX	DEAN	BIOGRAPHY.ASPX
STONY BROOK UNIVERSITY SCHOOL OF MEDICINE	DEAN	KENNETH KAUSHANSKY
ALTIS – POSTGRADUATE SCHOOL BUSINESS & SOCIETY	DEAN	MARIO MOLTENI
GRADUATE SCHOOL OF ECONOMICS AND INTERNATIONAL RELATIONS	DEAN	VITTORIO EMANUELE PARSI
GLASGOW SCHOOL FOR BUSINESS AND SOCIETY	DEAN	JOHN WILSON
DODGE COLLEGE OF FILM AND MEDIA ARTS	DEAN	BOB BASSETT
MINERVA SCHOOLS AT KGI	DEAN	STEPHEN KOSSLYN
PRINCETON UNIVERSITY SCHOOL OF ENGINEERING AND APPLIED SCIENCE	DEAN	EMILY A. CARTER
CENTRAL PHILIPPINE UNIVERSITY COLLEGE OF LAW	DEAN	ATTY. ZACARIAS BEDONA, JR., LL.B., MM-PM
FACULTY OF DENTISTRY, CHULALONGKORN UNIVERSITY	DEAN	ASSISTANT PROF. SUCHIT POOLTHONG, DDS
UNIVERSITY OF MISSOURI COLLEGE OF AGRICULTURE, FOOD AND NATURAL RESOURCES	DEAN	THOMAS L. PAYNE
ADAMSON UNIVERSITY COLLEGE OF LAW	DEAN	ALICIA AUSTRIA-MARTINEZ
AUGUSTINE COLLEGE	DEAN	ANDREW P. W. BENNETT
FACULTY OF MEDICINE, ÇOMÜ	DEAN	PROF. DR. YAVUZ DEMIRARAN
MCMASTER UNIVERSITY MEDICAL SCHOOL	DEAN	PAUL O'BYRNE
UNIVERSITY OF MONTENEGRO FACULTY OF POLITICAL SCIENCES	DEAN	SAšA KNEžEVIć, PH.D.
UNIVERSITY OF MONTENEGRO FACULTY OF APPLIED PHYSIOTHERAPY	DEAN	SOFIJA ŽITNIK-SIVAčKI
UNIVERSITY OF MONTENEGRO FACULTY OF PHILOSOPHY	DEAN	BLAGOJE CEROVIć
FACULTY FOR INTERDISCIPLINARY RESEARCH AND CONTINUING EDUCATION	DEAN	VERENA WINIWARTER
UNIVERSITY OF MONTENEGRO FACULTY OF FINE ARTS	DEAN	MILENA JOVIćEVIć
UNIVERSITY OF MONTENEGRO FACULTY OF MEDICINE	DEAN	GORAN NIKOLIć
UNIVERSITY OF MONTENEGRO FACULTY OF DRAMA	DEAN	RADMILA VOJVODIć
UNIVERSITY OF MONTENEGRO FACULTY OF BIOTECHNOLOGY	DEAN	NATALIJA PEROVIć
DUKE KUNSHAN UNIVERSITY	DEAN	LIU JINGNAN
UNIVERSITY OF MONTENEGRO FACULTY OF LAW	DEAN	DRAGO RADULOVIć
JESSENIUS FACULTY OF MEDICINE	DEAN	PROF. JáN DANKO, M.D., PHD.
UNIVERSITY OF MONTENEGRO FACULTY FOR SPORT AND PHYSICAL EDUCATION	DEAN	DUšKO BJELICA
LI KA SHING FACULTY OF MEDICINE	DEAN	PROFESSOR GABRIEL MATTHEW LEUNG
UNIVERSITY OF NORTH DAKOTA COLLEGE OF ARTS AND SCIENCES	DEAN	DEBBIE STORRS
UNIVERSITY OF WASHINGTON SCHOOL OF NURSING	DEAN	PAMELA MITCHELL
HELEN WAY KLINGLER COLLEGE OF ARTS AND SCIENCES	DEAN	PHILIP J. ROSSI, S.J.
ACıBADEM UNIVERSITY SCHOOL OF MEDICINE	DEAN	PROF. DR. YASEMIN ALANAY
IPMI INTERNATIONAL BUSINESS SCHOOL	DEAN	PROF. ROY SEMBEL, PH.D
UNIVERSITY AT BUFFALO SCHOOL OF ENGINEERING AND APPLIED SCIENCES	DEAN	LIESL FOLKS
IE SCHOOL OF INTERNATIONAL RELATIONS	DEAN	ARANTZA DE AREILZA
INSTITUTE OF PAPER SCIENCE AND TECHNOLOGY	DEAN	NORMAN MARSOLAN
INSTITUTE OF PAPER SCIENCE AND TECHNOLOGY	DEAN	(EXECUTIVE DIRECTOR)
FACULTY OF SCIENCE, UNIVERSITY OF ZAGREB	DEAN	PROFESSOR
FACULTY OF SCIENCE, UNIVERSITY OF ZAGREB	DEAN	ZORAN CURIć
FACULTY OF SCIENCE, UNIVERSITY OF ZAGREB	DEAN	PHD
PARKER H. PETIT INSTITUTE FOR BIOENGINEERING & BIOSCIENCE	DEAN	ROBERT E. GULDBERG
PARKER H. PETIT INSTITUTE FOR BIOENGINEERING & BIOSCIENCE	DEAN	(EXECUTIVE DIRECTOR)
SCHOOL OF MEDICINE, SIAM UNIVERSITY	DEAN	ASST. PROF. DR. CHOOKIET ASAWANICH, MD
CONSTANTINE THE PHILOSOPHER UNIVERSITY IN NITRA	DEAN	PROF. LIBOR VOZáR, CSC.
KING SAUD UNIVERSITY COLLEGE OF MEDICINE	DEAN	PROF. FAHAD ABDULLAH AL ZAMIL
UNIVERSITY OF CALIFORNIA, IRVINE SCHOOL OF EDUCATION	DEAN	RICHARD ARUM
RADZYNER LAW SCHOOL	DEAN	SHARON RABIN-MARGALIOT
FACULTY OF FOREIGN LANGUAGES	DEAN	GINKA BOGDAN IVANOVYCH
WAYNE STATE UNIVERSITY COLLEGE OF ENGINEERING	DEAN	FARSHAD FOTOUHI
BALAJI INSTITUTE OF INTERNATIONAL BUSINESS	DEAN	A. BALASUBRAMANIAN
MSU GRADUATE SCHOOL OF BUSINESS ADMINISTRATION	DEAN	OLEG VIKHANSKIY
UNIVERSITETI I PRISHTINëS FACULTY OF ARTS	DEAN	ADEM RUSINOVCI
SCHOOL FOR CONFLICT ANALYSIS AND RESOLUTION	DEAN	KEVIN AVRUCH
UNIVERSITY OF TEXAS SCHOOL OF BIOMEDICAL INFORMATICS	DEAN	DEANS-MESSAGE.HTM
ERASMUS UNIVERSITY COLLEGE	DEAN	MAARTEN FRENS
GEORGE WASHINGTON UNIVERSITY COLLEGE OF PROFESSIONAL STUDIES	DEAN	ALI ESKANDARIAN
KHADIM ALI SHAH BUKHARI INSTITUTE OF TECHNOLOGY	DEAN	DR. NOOR AHMED MEMON
JULIO C. TEEHANKEE	DEAN	COLLEGE OF LIBERAL ARTS, DE LA SALLE UNIVERSITY, MANILA
PENN STATE LAW	DEAN	JAMES W. HOUCK
UNIVERSITY OF OREGON COLLEGE OF ARTS AND SCIENCES	DEAN	W. ANDREW MARCUS
FACULTY OF HUMANITIES, UNIVERSITY OF MOSTAR	DEAN	ZORAN TOMIć
UNIVERSITY OF TEXAS AT AUSTIN SCHOOL OF SOCIAL WORK	DEAN	LUIS H. ZAYAS
CHARLES H. LUNDQUIST COLLEGE OF BUSINESS	DEAN	JAMES-TERBORG
STRATHMORE BUSINESS SCHOOL	DEAN	GEORGE NJENGA
UNIVERSITY OF OREGON COLLEGE OF EDUCATION	DEAN	RANDY-KAMPHAUS
DELL MEDICAL SCHOOL	DEAN	CLAY JOHNSTON
FREDERICK S. PARDEE SCHOOL OF GLOBAL STUDIES	DEAN	ADIL NAJAM
BARBARA JORDAN - MICKEY LELAND SCHOOL OF PUBLIC AFFAIRS	DEAN	ROBERT D. BULLARD
FACULTY OF COMMERCE, BANARAS HINDU UNIVERSITY	DEAN	PROFESSOR A. R. TRIPATHI
FACULTY OF EDUCATION, BANARAS HINDU UNIVERSITY	DEAN	DR. S. B. BHATTACHARYA
FACULTY OF LAW, BANARAS HINDU UNIVERSITY	DEAN	PROF. D. K. SHARMA
FACULTY OF PERFORMING ARTS, BANARAS HINDU UNIVERSITY	DEAN	PROF. BIRENDRA NATH MISHRA
DHURAKIJ PUNDIT UNIVERSITY INTERNATIONAL COLLEGE	DEAN	PAGE.PHP?ACT=PROFILE&ID=33
CUNY SCHOOL OF MEDICINE	DEAN	MAURIZIO TREVISAN
HOFSTRA NORTHWELL SCHOOL OF MEDICINE	DEAN	LAWRENCE G. SMITH
FACULTY OF THEOLOGY, ALIGARH MUSLIM UNIVERSITY	DEAN	PROF. SYED ALI MOHAMMAD NAQVI
FACULTY OF SANSKRIT VIDYA DHARMA VIGYAN, BANARAS HINDU UNIVERSITY	DEAN	PROFESSOR G. A. SASTRI
FACULTY OF POLITICAL SCIENCES AT SAKARYA UNIVERSITY	DEAN	HAMZA AL
VIRGINIA TECH PAMPLIN COLLEGE OF BUSINESS	DEAN	ROBERT SUMICHRAST
OXFORD UNIVERSITY MEDICAL SCHOOL	DEAN	ALASTAIR BUCHAN
COLLEGE OF HORTICULTURE MUDIGERE	DEAN	DR.D.MADAIAH
