SOLNECHNOGORSKY DISTRICT	ENNAME	SOLNECHNOGORSKY DISTRICT
KRYUKOVO DISTRICT	ENNAME	KRYUKOVO DISTRICT
PAVLOVO-POSADSKY DISTRICT	ENNAME	PAVLOVO-POSADSKY DISTRICT
SERGIYEVO-POSADSKY DISTRICT	ENNAME	SERGIYEVO-POSADSKY DISTRICT
GORODISHCHENSKY DISTRICT, VOLGOGRAD OBLAST	ENNAME	GORODISHCHENSKY DISTRICT
LYUBERETSKY DISTRICT	ENNAME	LYUBERETSKY DISTRICT
KONSTANTINOVSKY DISTRICT, ROSTOV OBLAST	ENNAME	KONSTANTINOVSKY DISTRICT
MINUSINSKY DISTRICT	ENNAME	MINUSINSKY DISTRICT
NAGAYBAKSKY DISTRICT	ENNAME	NAGAYBAKSKY DISTRICT
KOVROVSKY DISTRICT	ENNAME	KOVROVSKY DISTRICT
KOLOMENSKY DISTRICT	ENNAME	KOLOMENSKY DISTRICT
LISKINSKY DISTRICT	ENNAME	LISKINSKY DISTRICT
VOLOSOVSKY DISTRICT	ENNAME	VOLOSOVSKY DISTRICT
BAGRATIONOVSKY DISTRICT	ENNAME	BAGRATIONOVSKY DISTRICT
CHERNYAKHOVSKY DISTRICT	ENNAME	CHERNYAKHOVSKY DISTRICT
KRASNOZNAMENSKY DISTRICT	ENNAME	KRASNOZNAMENSKY DISTRICT
NEMANSKY DISTRICT	ENNAME	NEMANSKY DISTRICT
NESTEROVSKY DISTRICT	ENNAME	NESTEROVSKY DISTRICT
POLESSKY DISTRICT	ENNAME	POLESSKY DISTRICT
PRAVDINSKY DISTRICT	ENNAME	PRAVDINSKY DISTRICT
GURYEVSKY DISTRICT, KEMEROVO OBLAST	ENNAME	GURYEVSKY DISTRICT
SHATURSKY DISTRICT	ENNAME	SHATURSKY DISTRICT
OKTYABRSKY DISTRICT, VOLGOGRAD OBLAST	ENNAME	OKTYABRSKY DISTRICT
KAMYSHINSKY DISTRICT	ENNAME	KAMYSHINSKY DISTRICT
ANDREAPOLSKY DISTRICT	ENNAME	ANDREAPOLSKY DISTRICT
KASHINSKY DISTRICT	ENNAME	KASHINSKY DISTRICT
RAMENKI DISTRICT	ENNAME	RAMENKI DISTRICT
PLESETSKY DISTRICT	ENNAME	PLESETSKY DISTRICT
KHOLMOGORSKY DISTRICT	ENNAME	KHOLMOGORSKY DISTRICT
AKHTUBINSKY DISTRICT	ENNAME	AKHTUBINSKY DISTRICT
KSTOVSKY DISTRICT	ENNAME	KSTOVSKY DISTRICT
LYSKOVSKY DISTRICT	ENNAME	LYSKOVSKY DISTRICT
MAYKOPSKY DISTRICT	ENNAME	MAYKOPSKY DISTRICT
UST-YANSKY DISTRICT	ENNAME	UST-YANSKY DISTRICT
PRIOZERSKY DISTRICT	ENNAME	PRIOZERSKY DISTRICT
KRASNOGVARDEYSKY DISTRICT, BELGOROD OBLAST	ENNAME	KRASNOGVARDEYSKY DISTRICT
ADLERSKY CITY DISTRICT	ENNAME	ADLERSKY CITY DISTRICT
OREKHOVO-BORISOVO YUZHNOYE DISTRICT	ENNAME	OREKHOVO-BORISOVO YUZHNOYE DISTRICT
DOROGOMILOVO DISTRICT	ENNAME	DOROGOMILOVO DISTRICT
VYBORGSKY DISTRICT, LENINGRAD OBLAST	ENNAME	VYBORGSKY DISTRICT
VSEVOLOZHSKY DISTRICT	ENNAME	VSEVOLOZHSKY DISTRICT
CHURAPCHINSKY DISTRICT	ENNAME	CHURAPCHINSKY DISTRICT
ABYYSKY DISTRICT	ENNAME	ABYYSKY DISTRICT
ALLAIKHOVSKY DISTRICT	ENNAME	ALLAIKHOVSKY DISTRICT
ALDANSKY DISTRICT	ENNAME	ALDANSKY DISTRICT
SREDNEKANSKY DISTRICT	ENNAME	SREDNEKANSKY DISTRICT
YURYEV-POLSKY DISTRICT	ENNAME	YURYEV-POLSKY DISTRICT
SOLOVETSKY DISTRICT	ENNAME	SOLOVETSKY DISTRICT
RAMENSKY DISTRICT	ENNAME	RAMENSKY DISTRICT
SOKOLNIKI DISTRICT	ENNAME	SOKOLNIKI DISTRICT
TOSNENSKY DISTRICT	ENNAME	TOSNENSKY DISTRICT
NIZHNEKOLYMSKY DISTRICT	ENNAME	NIZHNEKOLYMSKY DISTRICT
BERYOZOVSKY DISTRICT, KHANTY-MANSI AUTONOMOUS OKRUG	ENNAME	BERYOZOVSKY DISTRICT
TATISHCHEVSKY DISTRICT	ENNAME	TATISHCHEVSKY DISTRICT
GATCHINSKY DISTRICT	ENNAME	GATCHINSKY DISTRICT
KRASNENSKY DISTRICT	ENNAME	KRASNENSKY DISTRICT
ONGUDAYSKY DISTRICT	ENNAME	ONGUDAYSKY DISTRICT
AMGINSKY DISTRICT	ENNAME	AMGINSKY DISTRICT
EVENO-BYTANTAYSKY NATIONAL DISTRICT	ENNAME	EVENO-BYTANTAYSKY NATIONAL DISTRICT
GORNY DISTRICT	ENNAME	GORNY DISTRICT
KHANGALASSKY DISTRICT	ENNAME	KHANGALASSKY DISTRICT
LENSKY DISTRICT, SAKHA REPUBLIC	ENNAME	LENSKY DISTRICT
ANABARSKY DISTRICT	ENNAME	ANABARSKY DISTRICT
MOMSKY DISTRICT	ENNAME	MOMSKY DISTRICT
NYURBINSKY DISTRICT	ENNAME	NYURBINSKY DISTRICT
BULUNSKY DISTRICT	ENNAME	BULUNSKY DISTRICT
SUNTARSKY DISTRICT	ENNAME	SUNTARSKY DISTRICT
KOBYAYSKY DISTRICT	ENNAME	KOBYAYSKY DISTRICT
MEGINO-KANGALASSKY DISTRICT	ENNAME	MEGINO-KANGALASSKY DISTRICT
NAMSKY DISTRICT	ENNAME	NAMSKY DISTRICT
OLENYOKSKY DISTRICT	ENNAME	OLENYOKSKY DISTRICT
ZHIGANSKY DISTRICT	ENNAME	ZHIGANSKY DISTRICT
VERKHNEVILYUYSKY DISTRICT	ENNAME	VERKHNEVILYUYSKY DISTRICT
MIRNINSKY DISTRICT	ENNAME	MIRNINSKY DISTRICT
OLYOKMINSKY DISTRICT	ENNAME	OLYOKMINSKY DISTRICT
OYMYAKONSKY DISTRICT	ENNAME	OYMYAKONSKY DISTRICT
TATTINSKY DISTRICT	ENNAME	TATTINSKY DISTRICT
TOMPONSKY DISTRICT	ENNAME	TOMPONSKY DISTRICT
UST-MAYSKY DISTRICT	ENNAME	UST-MAYSKY DISTRICT
VERKHNEKOLYMSKY DISTRICT	ENNAME	VERKHNEKOLYMSKY DISTRICT
VERKHOYANSKY DISTRICT	ENNAME	VERKHOYANSKY DISTRICT
VILYUYSKY DISTRICT	ENNAME	VILYUYSKY DISTRICT
SREDNEKOLYMSKY DISTRICT	ENNAME	SREDNEKOLYMSKY DISTRICT
UST-ALDANSKY DISTRICT	ENNAME	UST-ALDANSKY DISTRICT
NERYUNGRINSKY DISTRICT	ENNAME	NERYUNGRINSKY DISTRICT
KARGASOKSKY DISTRICT	ENNAME	KARGASOKSKY DISTRICT
ALEXANDROVSKY DISTRICT, TOMSK OBLAST	ENNAME	ALEXANDROVSKY DISTRICT
KUNTSEVO DISTRICT	ENNAME	KUNTSEVO DISTRICT
SHERBAKULSKY DISTRICT	ENNAME	SHERBAKULSKY DISTRICT
SEDELNIKOVSKY DISTRICT	ENNAME	SEDELNIKOVSKY DISTRICT
IZMAYLOVO DISTRICT	ENNAME	IZMAYLOVO DISTRICT
CHAUNSKY DISTRICT	ENNAME	CHAUNSKY DISTRICT
ANADYRSKY DISTRICT	ENNAME	ANADYRSKY DISTRICT
BILIBINSKY DISTRICT	ENNAME	BILIBINSKY DISTRICT
CHUKOTSKY DISTRICT	ENNAME	CHUKOTSKY DISTRICT
IULTINSKY DISTRICT	ENNAME	IULTINSKY DISTRICT
PROVIDENSKY DISTRICT	ENNAME	PROVIDENSKY DISTRICT
NADYMSKY DISTRICT	ENNAME	NADYMSKY DISTRICT
SUKHOBUZIMSKY DISTRICT	ENNAME	SUKHOBUZIMSKY DISTRICT
ULAGANSKY DISTRICT	ENNAME	ULAGANSKY DISTRICT
KOSH-AGACHSKY DISTRICT	ENNAME	KOSH-AGACHSKY DISTRICT
TUROCHAKSKY DISTRICT	ENNAME	TUROCHAKSKY DISTRICT
UST-KOKSINSKY DISTRICT	ENNAME	UST-KOKSINSKY DISTRICT
MAYMINSKY DISTRICT	ENNAME	MAYMINSKY DISTRICT
CHEMALSKY DISTRICT	ENNAME	CHEMALSKY DISTRICT
CHOYSKY DISTRICT	ENNAME	CHOYSKY DISTRICT
UST-KANSKY DISTRICT	ENNAME	UST-KANSKY DISTRICT
SHEBALINSKY DISTRICT	ENNAME	SHEBALINSKY DISTRICT
BABYNINSKY DISTRICT	ENNAME	BABYNINSKY DISTRICT
YEMELYANOVSKY DISTRICT	ENNAME	YEMELYANOVSKY DISTRICT
ABANSKY DISTRICT	ENNAME	ABANSKY DISTRICT
ACHINSKY DISTRICT	ENNAME	ACHINSKY DISTRICT
BALAKHTINSKY DISTRICT	ENNAME	BALAKHTINSKY DISTRICT
BERYOZOVSKY DISTRICT, KRASNOYARSK KRAI	ENNAME	BERYOZOVSKY DISTRICT
BIRILYUSSKY DISTRICT	ENNAME	BIRILYUSSKY DISTRICT
BOGOTOLSKY DISTRICT	ENNAME	BOGOTOLSKY DISTRICT
BOGUCHANSKY DISTRICT	ENNAME	BOGUCHANSKY DISTRICT
KHOROSHEVO-MNEVNIKI DISTRICT	ENNAME	KHOROSHEVO-MNEVNIKI DISTRICT
DZERZHINSKY DISTRICT, KRASNOYARSK KRAI	ENNAME	DZERZHINSKY DISTRICT
BOLSHEULUYSKY DISTRICT	ENNAME	BOLSHEULUYSKY DISTRICT
BOLSHEMURTINSKY DISTRICT	ENNAME	BOLSHEMURTINSKY DISTRICT
EVENKIYSKY DISTRICT	ENNAME	EVENKIYSKY DISTRICT
IDRINSKY DISTRICT	ENNAME	IDRINSKY DISTRICT
ILANSKY DISTRICT	ENNAME	ILANSKY DISTRICT
IRBEYSKY DISTRICT	ENNAME	IRBEYSKY DISTRICT
KANSKY DISTRICT	ENNAME	KANSKY DISTRICT
KARATUZSKY DISTRICT	ENNAME	KARATUZSKY DISTRICT
KEZHEMSKY DISTRICT	ENNAME	KEZHEMSKY DISTRICT
KAZACHINSKY DISTRICT	ENNAME	KAZACHINSKY DISTRICT
KOZULSKY DISTRICT	ENNAME	KOZULSKY DISTRICT
KRASNOTURANSKY DISTRICT	ENNAME	KRASNOTURANSKY DISTRICT
KURAGINSKY DISTRICT	ENNAME	KURAGINSKY DISTRICT
MANSKY DISTRICT	ENNAME	MANSKY DISTRICT
MOTYGINSKY DISTRICT	ENNAME	MOTYGINSKY DISTRICT
NAZAROVSKY DISTRICT	ENNAME	NAZAROVSKY DISTRICT
NIZHNEINGASHSKY DISTRICT	ENNAME	NIZHNEINGASHSKY DISTRICT
NOVOSYOLOVSKY DISTRICT	ENNAME	NOVOSYOLOVSKY DISTRICT
PARTIZANSKY DISTRICT, KRASNOYARSK KRAI	ENNAME	PARTIZANSKY DISTRICT
PIROVSKY DISTRICT	ENNAME	PIROVSKY DISTRICT
RYBINSKY DISTRICT, KRASNOYARSK KRAI	ENNAME	RYBINSKY DISTRICT
SAYANSKY DISTRICT	ENNAME	SAYANSKY DISTRICT
SEVERO-YENISEYSKY DISTRICT	ENNAME	SEVERO-YENISEYSKY DISTRICT
SHARYPOVSKY DISTRICT	ENNAME	SHARYPOVSKY DISTRICT
TASEYEVSKY DISTRICT	ENNAME	TASEYEVSKY DISTRICT
SHUSHENSKY DISTRICT	ENNAME	SHUSHENSKY DISTRICT
TURUKHANSKY DISTRICT	ENNAME	TURUKHANSKY DISTRICT
TYUKHTETSKY DISTRICT	ENNAME	TYUKHTETSKY DISTRICT
UZHURSKY DISTRICT	ENNAME	UZHURSKY DISTRICT
UYARSKY DISTRICT	ENNAME	UYARSKY DISTRICT
YENISEYSKY DISTRICT	ENNAME	YENISEYSKY DISTRICT
YERMAKOVSKY DISTRICT	ENNAME	YERMAKOVSKY DISTRICT
ZAPOLYARNY DISTRICT	ENNAME	ZAPOLYARNY DISTRICT
AZOVSKY NEMETSKY NATIONAL DISTRICT	ENNAME	AZOVSKY NEMETSKY NATIONAL DISTRICT
ZNAMENSKY DISTRICT, ORYOL OBLAST	ENNAME	ZNAMENSKY DISTRICT
KRASNINSKY DISTRICT, SMOLENSK OBLAST	ENNAME	KRASNINSKY DISTRICT
USOLSKY DISTRICT, IRKUTSK OBLAST	ENNAME	USOLSKY DISTRICT
BOKHANSKY DISTRICT	ENNAME	BOKHANSKY DISTRICT
KOVDORSKY DISTRICT	ENNAME	KOVDORSKY DISTRICT
KOLSKY DISTRICT	ENNAME	KOLSKY DISTRICT
BEZHANITSKY DISTRICT	ENNAME	BEZHANITSKY DISTRICT
USTYANSKY DISTRICT	ENNAME	USTYANSKY DISTRICT
CHERTANOVO	ENNAME	CHERTANOVO
SLADKOVSKY DISTRICT	ENNAME	SLADKOVSKY DISTRICT
SHCHUKINO DISTRICT	ENNAME	SHCHUKINO DISTRICT
FILYOVSKY PARK DISTRICT	ENNAME	FILYOVSKY PARK DISTRICT
ZNAMENSKY DISTRICT, TAMBOV OBLAST	ENNAME	ZNAMENSKY DISTRICT
VILEGODSKY DISTRICT	ENNAME	VILEGODSKY DISTRICT
VERKHNETOYEMSKY DISTRICT	ENNAME	VERKHNETOYEMSKY DISTRICT
VELSKY DISTRICT	ENNAME	VELSKY DISTRICT
SHENKURSKY DISTRICT	ENNAME	SHENKURSKY DISTRICT
NYANDOMSKY DISTRICT	ENNAME	NYANDOMSKY DISTRICT
BRATEYEVO DISTRICT	ENNAME	BRATEYEVO DISTRICT
PINEZHSKY DISTRICT	ENNAME	PINEZHSKY DISTRICT
BELOGORSKY DISTRICT	ENNAME	BELOGORSKY DISTRICT
ARKHARINSKY DISTRICT	ENNAME	ARKHARINSKY DISTRICT
BLAGOVESHCHENSKY DISTRICT, AMUR OBLAST	ENNAME	BLAGOVESHCHENSKY DISTRICT
PETROVSK-ZABAYKALSKY DISTRICT	ENNAME	PETROVSK-ZABAYKALSKY DISTRICT
MAZANOVSKY DISTRICT	ENNAME	MAZANOVSKY DISTRICT
KONSTANTINOVSKY DISTRICT, AMUR OBLAST	ENNAME	KONSTANTINOVSKY DISTRICT
OKTYABRSKY DISTRICT, AMUR OBLAST	ENNAME	OKTYABRSKY DISTRICT
SHIMANOVSKY DISTRICT	ENNAME	SHIMANOVSKY DISTRICT
ROMNENSKY DISTRICT	ENNAME	ROMNENSKY DISTRICT
SVOBODNENSKY DISTRICT	ENNAME	SVOBODNENSKY DISTRICT
IVANOVSKY DISTRICT, AMUR OBLAST	ENNAME	IVANOVSKY DISTRICT
TYNDINSKY DISTRICT	ENNAME	TYNDINSKY DISTRICT
TAMBOVSKY DISTRICT, AMUR OBLAST	ENNAME	TAMBOVSKY DISTRICT
ZEYSKY DISTRICT	ENNAME	ZEYSKY DISTRICT
PRIMORSKY DISTRICT, ARKHANGELSK OBLAST	ENNAME	PRIMORSKY DISTRICT
KHARABALINSKY DISTRICT	ENNAME	KHARABALINSKY DISTRICT
LIMANSKY DISTRICT	ENNAME	LIMANSKY DISTRICT
SERYSHEVSKY DISTRICT	ENNAME	SERYSHEVSKY DISTRICT
CHERNOYARSKY DISTRICT	ENNAME	CHERNOYARSKY DISTRICT
ONEZHSKY DISTRICT	ENNAME	ONEZHSKY DISTRICT
YENOTAYEVSKY DISTRICT	ENNAME	YENOTAYEVSKY DISTRICT
IKRYANINSKY DISTRICT	ENNAME	IKRYANINSKY DISTRICT
KAMYZYAKSKY DISTRICT	ENNAME	KAMYZYAKSKY DISTRICT
KRASNOYARSKY DISTRICT, ASTRAKHAN OBLAST	ENNAME	KRASNOYARSKY DISTRICT
VOLODARSKY DISTRICT, ASTRAKHAN OBLAST	ENNAME	VOLODARSKY DISTRICT
PRIVOLZHSKY DISTRICT, ASTRAKHAN OBLAST	ENNAME	PRIVOLZHSKY DISTRICT
GRAYVORONSKY DISTRICT	ENNAME	GRAYVORONSKY DISTRICT
KRASNOYARUZHSKY DISTRICT	ENNAME	KRASNOYARUZHSKY DISTRICT
BORISOVSKY DISTRICT	ENNAME	BORISOVSKY DISTRICT
ALEXEYEVSKY DISTRICT, BELGOROD OBLAST	ENNAME	ALEXEYEVSKY DISTRICT
KOROCHANSKY DISTRICT	ENNAME	KOROCHANSKY DISTRICT
IVNYANSKY DISTRICT	ENNAME	IVNYANSKY DISTRICT
BELGORODSKY DISTRICT	ENNAME	BELGORODSKY DISTRICT
RAKITYANSKY DISTRICT	ENNAME	RAKITYANSKY DISTRICT
ROVENSKY DISTRICT, BELGOROD OBLAST	ENNAME	ROVENSKY DISTRICT
VOLOKONOVSKY DISTRICT	ENNAME	VOLOKONOVSKY DISTRICT
VALUYSKY DISTRICT	ENNAME	VALUYSKY DISTRICT
VEYDELEVSKY DISTRICT	ENNAME	VEYDELEVSKY DISTRICT
DUBROVSKY DISTRICT	ENNAME	DUBROVSKY DISTRICT
YAKOVLEVSKY DISTRICT, BELGOROD OBLAST	ENNAME	YAKOVLEVSKY DISTRICT
GORDEYEVSKY DISTRICT	ENNAME	GORDEYEVSKY DISTRICT
KARACHEVSKY DISTRICT	ENNAME	KARACHEVSKY DISTRICT
BRASOVSKY DISTRICT	ENNAME	BRASOVSKY DISTRICT
DYATKOVSKY DISTRICT	ENNAME	DYATKOVSKY DISTRICT
BRYANSKY DISTRICT	ENNAME	BRYANSKY DISTRICT
SHEBEKINSKY DISTRICT	ENNAME	SHEBEKINSKY DISTRICT
KOMARICHSKY DISTRICT	ENNAME	KOMARICHSKY DISTRICT
KLIMOVSKY DISTRICT	ENNAME	KLIMOVSKY DISTRICT
KRASNOGORSKY DISTRICT, BRYANSK OBLAST	ENNAME	KRASNOGORSKY DISTRICT
KLETNYANSKY DISTRICT	ENNAME	KLETNYANSKY DISTRICT
MGLINSKY DISTRICT	ENNAME	MGLINSKY DISTRICT
KLINTSOVSKY DISTRICT	ENNAME	KLINTSOVSKY DISTRICT
POGARSKY DISTRICT	ENNAME	POGARSKY DISTRICT
NOVOZYBKOVSKY DISTRICT	ENNAME	NOVOZYBKOVSKY DISTRICT
NAVLINSKY DISTRICT	ENNAME	NAVLINSKY DISTRICT
SEVSKY DISTRICT	ENNAME	SEVSKY DISTRICT
POCHEPSKY DISTRICT	ENNAME	POCHEPSKY DISTRICT
ROGNEDINSKY DISTRICT	ENNAME	ROGNEDINSKY DISTRICT
STARODUBSKY DISTRICT	ENNAME	STARODUBSKY DISTRICT
VYGONICHSKY DISTRICT	ENNAME	VYGONICHSKY DISTRICT
SURAZHSKY DISTRICT	ENNAME	SURAZHSKY DISTRICT
TRUBCHEVSKY DISTRICT	ENNAME	TRUBCHEVSKY DISTRICT
ZHIRYATINSKY DISTRICT	ENNAME	ZHIRYATINSKY DISTRICT
UNECHSKY DISTRICT	ENNAME	UNECHSKY DISTRICT
BREDINSKY DISTRICT	ENNAME	BREDINSKY DISTRICT
KARTALINSKY DISTRICT	ENNAME	KARTALINSKY DISTRICT
ZLYNKOVSKY DISTRICT	ENNAME	ZLYNKOVSKY DISTRICT
ZHUKOVSKY DISTRICT, BRYANSK OBLAST	ENNAME	ZHUKOVSKY DISTRICT
PALEKHSKY DISTRICT	ENNAME	PALEKHSKY DISTRICT
SHUYSKY DISTRICT	ENNAME	SHUYSKY DISTRICT
LUKHSKY DISTRICT	ENNAME	LUKHSKY DISTRICT
PESTYAKOVSKY DISTRICT	ENNAME	PESTYAKOVSKY DISTRICT
ILYINSKY DISTRICT, IVANOVO OBLAST	ENNAME	ILYINSKY DISTRICT
LEZHNEVSKY DISTRICT	ENNAME	LEZHNEVSKY DISTRICT
GAVRILOVO-POSADSKY DISTRICT	ENNAME	GAVRILOVO-POSADSKY DISTRICT
KINESHEMSKY DISTRICT	ENNAME	KINESHEMSKY DISTRICT
IVANOVSKY DISTRICT, IVANOVO OBLAST	ENNAME	IVANOVSKY DISTRICT
FURMANOVSKY DISTRICT	ENNAME	FURMANOVSKY DISTRICT
TULUNSKY DISTRICT	ENNAME	TULUNSKY DISTRICT
TAYSHETSKY DISTRICT	ENNAME	TAYSHETSKY DISTRICT
SLYUDYANSKY DISTRICT	ENNAME	SLYUDYANSKY DISTRICT
UST-ILIMSKY DISTRICT	ENNAME	UST-ILIMSKY DISTRICT
UST-UDINSKY DISTRICT	ENNAME	UST-UDINSKY DISTRICT
KIRENSKY DISTRICT	ENNAME	KIRENSKY DISTRICT
MAMSKO-CHUYSKY DISTRICT	ENNAME	MAMSKO-CHUYSKY DISTRICT
ZALARINSKY DISTRICT	ENNAME	ZALARINSKY DISTRICT
ZIMINSKY DISTRICT	ENNAME	ZIMINSKY DISTRICT
ZHIGALOVSKY DISTRICT	ENNAME	ZHIGALOVSKY DISTRICT
UST-KUTSKY DISTRICT	ENNAME	UST-KUTSKY DISTRICT
KACHUGSKY DISTRICT	ENNAME	KACHUGSKY DISTRICT
NIZHNEUDINSKY DISTRICT	ENNAME	NIZHNEUDINSKY DISTRICT
KAZACHINSKO-LENSKY DISTRICT	ENNAME	KAZACHINSKO-LENSKY DISTRICT
KUYTUNSKY DISTRICT	ENNAME	KUYTUNSKY DISTRICT
OLKHONSKY DISTRICT	ENNAME	OLKHONSKY DISTRICT
NIZHNEILIMSKY DISTRICT	ENNAME	NIZHNEILIMSKY DISTRICT
SHELEKHOVSKY DISTRICT	ENNAME	SHELEKHOVSKY DISTRICT
VARNENSKY DISTRICT	ENNAME	VARNENSKY DISTRICT
SOSNOVSKY DISTRICT, CHELYABINSK OBLAST	ENNAME	SOSNOVSKY DISTRICT
SATKINSKY DISTRICT	ENNAME	SATKINSKY DISTRICT
VERKHNEURALSKY DISTRICT	ENNAME	VERKHNEURALSKY DISTRICT
BODAYBINSKY DISTRICT	ENNAME	BODAYBINSKY DISTRICT
YETKULSKY DISTRICT	ENNAME	YETKULSKY DISTRICT
IZHMORSKY DISTRICT	ENNAME	IZHMORSKY DISTRICT
OKTYABRSKY DISTRICT, JEWISH AUTONOMOUS OBLAST	ENNAME	OKTYABRSKY DISTRICT
SMIDOVICHSKY DISTRICT	ENNAME	SMIDOVICHSKY DISTRICT
BELOVSKY DISTRICT, KEMEROVO OBLAST	ENNAME	BELOVSKY DISTRICT
CHEBULINSKY DISTRICT	ENNAME	CHEBULINSKY DISTRICT
SPAS-DEMENSKY DISTRICT	ENNAME	SPAS-DEMENSKY DISTRICT
ZAVOLZHSKY DISTRICT, IVANOVO OBLAST	ENNAME	ZAVOLZHSKY DISTRICT
BIROBIDZHANSKY DISTRICT	ENNAME	BIROBIDZHANSKY DISTRICT
LENINSKY DISTRICT, JEWISH AUTONOMOUS OBLAST	ENNAME	LENINSKY DISTRICT
OBLUCHENSKY DISTRICT	ENNAME	OBLUCHENSKY DISTRICT
VERKHNELANDEKHOVSKY DISTRICT	ENNAME	VERKHNELANDEKHOVSKY DISTRICT
VICHUGSKY DISTRICT	ENNAME	VICHUGSKY DISTRICT
TEYKOVSKY DISTRICT	ENNAME	TEYKOVSKY DISTRICT
YUZHSKY DISTRICT	ENNAME	YUZHSKY DISTRICT
YURYEVETSKY DISTRICT	ENNAME	YURYEVETSKY DISTRICT
KIZILSKY DISTRICT	ENNAME	KIZILSKY DISTRICT
KRASNOARMEYSKY DISTRICT, CHELYABINSK OBLAST	ENNAME	KRASNOARMEYSKY DISTRICT
MESHCHOVSKY DISTRICT	ENNAME	MESHCHOVSKY DISTRICT
SLAVSKY DISTRICT	ENNAME	SLAVSKY DISTRICT
ASHINSKY DISTRICT	ENNAME	ASHINSKY DISTRICT
ARGAYASHSKY DISTRICT	ENNAME	ARGAYASHSKY DISTRICT
KASLINSKY DISTRICT	ENNAME	KASLINSKY DISTRICT
CHEBARKULSKY DISTRICT	ENNAME	CHEBARKULSKY DISTRICT
KATAV-IVANOVSKY DISTRICT	ENNAME	KATAV-IVANOVSKY DISTRICT
CHESMENSKY DISTRICT	ENNAME	CHESMENSKY DISTRICT
KUNASHAKSKY DISTRICT	ENNAME	KUNASHAKSKY DISTRICT
UVELSKY DISTRICT	ENNAME	UVELSKY DISTRICT
NYAZEPETROVSKY DISTRICT	ENNAME	NYAZEPETROVSKY DISTRICT
PLASTOVSKY DISTRICT	ENNAME	PLASTOVSKY DISTRICT
UYSKY DISTRICT	ENNAME	UYSKY DISTRICT
IRKUTSKY DISTRICT	ENNAME	IRKUTSKY DISTRICT
CHEREMKHOVSKY DISTRICT	ENNAME	CHEREMKHOVSKY DISTRICT
BRATSKY DISTRICT	ENNAME	BRATSKY DISTRICT
SUZEMSKY DISTRICT	ENNAME	SUZEMSKY DISTRICT
AGAPOVSKY DISTRICT	ENNAME	AGAPOVSKY DISTRICT
TROITSKY DISTRICT, CHELYABINSK OBLAST	ENNAME	TROITSKY DISTRICT
YEMANZHELINSKY DISTRICT	ENNAME	YEMANZHELINSKY DISTRICT
CHUNSKY DISTRICT	ENNAME	CHUNSKY DISTRICT
KORKINSKY DISTRICT	ENNAME	KORKINSKY DISTRICT
OKTYABRSKY DISTRICT, CHELYABINSK OBLAST	ENNAME	OKTYABRSKY DISTRICT
KUSINSKY DISTRICT	ENNAME	KUSINSKY DISTRICT
POSHEKHONSKY DISTRICT	ENNAME	POSHEKHONSKY DISTRICT
NEKRASOVSKY DISTRICT	ENNAME	NEKRASOVSKY DISTRICT
PODOSINOVSKY DISTRICT	ENNAME	PODOSINOVSKY DISTRICT
OPARINSKY DISTRICT	ENNAME	OPARINSKY DISTRICT
LYUBIMSKY DISTRICT	ENNAME	LYUBIMSKY DISTRICT
ROSTOVSKY DISTRICT	ENNAME	ROSTOVSKY DISTRICT
BREYTOVSKY DISTRICT	ENNAME	BREYTOVSKY DISTRICT
BOLSHESELSKY DISTRICT	ENNAME	BOLSHESELSKY DISTRICT
BORISOGLEBSKY DISTRICT, YAROSLAVL OBLAST	ENNAME	BORISOGLEBSKY DISTRICT
PERESLAVSKY DISTRICT	ENNAME	PERESLAVSKY DISTRICT
GAVRILOV-YAMSKY DISTRICT	ENNAME	GAVRILOV-YAMSKY DISTRICT
MYSHKINSKY DISTRICT	ENNAME	MYSHKINSKY DISTRICT
PERVOMAYSKY DISTRICT, YAROSLAVL OBLAST	ENNAME	PERVOMAYSKY DISTRICT
BELOKHOLUNITSKY DISTRICT	ENNAME	BELOKHOLUNITSKY DISTRICT
NEKOUZSKY DISTRICT	ENNAME	NEKOUZSKY DISTRICT
DANILOVSKY DISTRICT, YAROSLAVL OBLAST	ENNAME	DANILOVSKY DISTRICT
KIROVO-CHEPETSKY DISTRICT	ENNAME	KIROVO-CHEPETSKY DISTRICT
ARBAZHSKY DISTRICT	ENNAME	ARBAZHSKY DISTRICT
BOGORODSKY DISTRICT, KIROV OBLAST	ENNAME	BOGORODSKY DISTRICT
KUMYONSKY DISTRICT	ENNAME	KUMYONSKY DISTRICT
KILMEZSKY DISTRICT	ENNAME	KILMEZSKY DISTRICT
MALMYZHSKY DISTRICT	ENNAME	MALMYZHSKY DISTRICT
LUZSKY DISTRICT	ENNAME	LUZSKY DISTRICT
LEBYAZHSKY DISTRICT	ENNAME	LEBYAZHSKY DISTRICT
MURASHINSKY DISTRICT	ENNAME	MURASHINSKY DISTRICT
NEMSKY DISTRICT	ENNAME	NEMSKY DISTRICT
NOLINSKY DISTRICT	ENNAME	NOLINSKY DISTRICT
ORICHEVSKY DISTRICT	ENNAME	ORICHEVSKY DISTRICT
OMUTNINSKY DISTRICT	ENNAME	OMUTNINSKY DISTRICT
PIZHANSKY DISTRICT	ENNAME	PIZHANSKY DISTRICT
SOVETSKY DISTRICT, KIROV OBLAST	ENNAME	SOVETSKY DISTRICT
ORLOVSKY DISTRICT, KIROV OBLAST	ENNAME	ORLOVSKY DISTRICT
URZHUMSKY DISTRICT	ENNAME	URZHUMSKY DISTRICT
SHABALINSKY DISTRICT	ENNAME	SHABALINSKY DISTRICT
VERKHNEKAMSKY DISTRICT	ENNAME	VERKHNEKAMSKY DISTRICT
SLOBODSKOY DISTRICT	ENNAME	SLOBODSKOY DISTRICT
YARANSKY DISTRICT	ENNAME	YARANSKY DISTRICT
SUNSKY DISTRICT	ENNAME	SUNSKY DISTRICT
VERKHOSHIZHEMSKY DISTRICT	ENNAME	VERKHOSHIZHEMSKY DISTRICT
TUZHINSKY DISTRICT	ENNAME	TUZHINSKY DISTRICT
ZUYEVSKY DISTRICT	ENNAME	ZUYEVSKY DISTRICT
VYATSKOPOLYANSKY DISTRICT	ENNAME	VYATSKOPOLYANSKY DISTRICT
TOPKINSKY DISTRICT	ENNAME	TOPKINSKY DISTRICT
AFANASYEVSKY DISTRICT	ENNAME	AFANASYEVSKY DISTRICT
KOTELNICHSKY DISTRICT	ENNAME	KOTELNICHSKY DISTRICT
KIKNURSKY DISTRICT	ENNAME	KIKNURSKY DISTRICT
FALYONSKY DISTRICT	ENNAME	FALYONSKY DISTRICT
DAROVSKOY DISTRICT	ENNAME	DAROVSKOY DISTRICT
RYBINSKY DISTRICT, YAROSLAVL OBLAST	ENNAME	RYBINSKY DISTRICT
GALICHSKY DISTRICT	ENNAME	GALICHSKY DISTRICT
CHUKHLOMSKY DISTRICT	ENNAME	CHUKHLOMSKY DISTRICT
BUYSKY DISTRICT	ENNAME	BUYSKY DISTRICT
NOVOKUZNETSKY DISTRICT	ENNAME	NOVOKUZNETSKY DISTRICT
TUTAYEVSKY DISTRICT	ENNAME	TUTAYEVSKY DISTRICT
UGLICHSKY DISTRICT	ENNAME	UGLICHSKY DISTRICT
ANTROPOVSKY DISTRICT	ENNAME	ANTROPOVSKY DISTRICT
KOSTROMSKOY DISTRICT	ENNAME	KOSTROMSKOY DISTRICT
KADYYSKY DISTRICT	ENNAME	KADYYSKY DISTRICT
YAROSLAVSKY DISTRICT, YAROSLAVL OBLAST	ENNAME	YAROSLAVSKY DISTRICT
KRASNOSELSKY DISTRICT, KOSTROMA OBLAST	ENNAME	KRASNOSELSKY DISTRICT
KOLOGRIVSKY DISTRICT	ENNAME	KOLOGRIVSKY DISTRICT
MANTUROVSKY DISTRICT, KOSTROMA OBLAST	ENNAME	MANTUROVSKY DISTRICT
MEZHEVSKOY DISTRICT	ENNAME	MEZHEVSKOY DISTRICT
NEYSKY DISTRICT	ENNAME	NEYSKY DISTRICT
NEREKHTSKY DISTRICT	ENNAME	NEREKHTSKY DISTRICT
OSTROVSKY DISTRICT, KOSTROMA OBLAST	ENNAME	OSTROVSKY DISTRICT
PAVINSKY DISTRICT	ENNAME	PAVINSKY DISTRICT
PARFENYEVSKY DISTRICT	ENNAME	PARFENYEVSKY DISTRICT
OKTYABRSKY DISTRICT, KOSTROMA OBLAST	ENNAME	OKTYABRSKY DISTRICT
PYSHCHUGSKY DISTRICT	ENNAME	PYSHCHUGSKY DISTRICT
SOLIGALICHSKY DISTRICT	ENNAME	SOLIGALICHSKY DISTRICT
SUDISLAVSKY DISTRICT	ENNAME	SUDISLAVSKY DISTRICT
SHARYINSKY DISTRICT	ENNAME	SHARYINSKY DISTRICT
SUSANINSKY DISTRICT	ENNAME	SUSANINSKY DISTRICT
VOKHOMSKY DISTRICT	ENNAME	VOKHOMSKY DISTRICT
PONAZYREVSKY DISTRICT	ENNAME	PONAZYREVSKY DISTRICT
BELOZERSKY DISTRICT, KURGAN OBLAST	ENNAME	BELOZERSKY  DISTRICT
DALMATOVSKY DISTRICT	ENNAME	DALMATOVSKY DISTRICT
SHADRINSKY DISTRICT	ENNAME	SHADRINSKY DISTRICT
TSELINNY DISTRICT, KURGAN OBLAST	ENNAME	TSELINNY DISTRICT
PETUKHOVSKY DISTRICT	ENNAME	PETUKHOVSKY DISTRICT
MISHKINSKY DISTRICT, KURGAN OBLAST	ENNAME	MISHKINSKY DISTRICT
KHOMUTOVSKY DISTRICT	ENNAME	KHOMUTOVSKY DISTRICT
CHEREMISINOVSKY DISTRICT	ENNAME	CHEREMISINOVSKY DISTRICT
FATEZHSKY DISTRICT	ENNAME	FATEZHSKY DISTRICT
GLUSHKOVSKY DISTRICT	ENNAME	GLUSHKOVSKY DISTRICT
BOLSHESOLDATSKY DISTRICT	ENNAME	BOLSHESOLDATSKY DISTRICT
KORENEVSKY DISTRICT	ENNAME	KORENEVSKY DISTRICT
GORSHECHENSKY DISTRICT	ENNAME	GORSHECHENSKY DISTRICT
DMITRIYEVSKY DISTRICT	ENNAME	DMITRIYEVSKY DISTRICT
BELOVSKY DISTRICT, KURSK OBLAST	ENNAME	BELOVSKY DISTRICT
KURSKY DISTRICT, KURSK OBLAST	ENNAME	KURSKY DISTRICT
KONYSHYOVSKY DISTRICT	ENNAME	KONYSHYOVSKY DISTRICT
KURCHATOVSKY DISTRICT, KURSK OBLAST	ENNAME	KURCHATOVSKY DISTRICT
LGOVSKY DISTRICT	ENNAME	LGOVSKY DISTRICT
MANTUROVSKY DISTRICT, KURSK OBLAST	ENNAME	MANTUROVSKY DISTRICT
OKTYABRSKY DISTRICT, KURSK OBLAST	ENNAME	OKTYABRSKY DISTRICT
MEDVENSKY DISTRICT	ENNAME	MEDVENSKY DISTRICT
OBOYANSKY DISTRICT	ENNAME	OBOYANSKY DISTRICT
PONYROVSKY DISTRICT	ENNAME	PONYROVSKY DISTRICT
SHCHIGROVSKY DISTRICT	ENNAME	SHCHIGROVSKY DISTRICT
PRISTENSKY DISTRICT	ENNAME	PRISTENSKY DISTRICT
TIMSKY DISTRICT	ENNAME	TIMSKY DISTRICT
SOLNTSEVSKY DISTRICT	ENNAME	SOLNTSEVSKY DISTRICT
RYLSKY DISTRICT	ENNAME	RYLSKY DISTRICT
SOVETSKY DISTRICT, KURSK OBLAST	ENNAME	SOVETSKY DISTRICT
SUDZHANSKY DISTRICT	ENNAME	SUDZHANSKY DISTRICT
ZOLOTUKHINSKY DISTRICT	ENNAME	ZOLOTUKHINSKY DISTRICT
KIRISHSKY DISTRICT	ENNAME	KIRISHSKY DISTRICT
ZHELEZNOGORSKY DISTRICT	ENNAME	ZHELEZNOGORSKY DISTRICT
KIROVSKY DISTRICT, LENINGRAD OBLAST	ENNAME	KIROVSKY DISTRICT
KINGISEPPSKY DISTRICT	ENNAME	KINGISEPPSKY DISTRICT
LOMONOSOVSKY DISTRICT, LENINGRAD OBLAST	ENNAME	LOMONOSOVSKY DISTRICT
LODEYNOPOLSKY DISTRICT	ENNAME	LODEYNOPOLSKY DISTRICT
PODPOROZHSKY DISTRICT	ENNAME	PODPOROZHSKY DISTRICT
LUZHSKY DISTRICT	ENNAME	LUZHSKY DISTRICT
TIKHVINSKY DISTRICT	ENNAME	TIKHVINSKY DISTRICT
SLANTSEVSKY DISTRICT	ENNAME	SLANTSEVSKY DISTRICT
CHAPLYGINSKY DISTRICT	ENNAME	CHAPLYGINSKY DISTRICT
VOLKHOVSKY DISTRICT	ENNAME	VOLKHOVSKY DISTRICT
DOBRINSKY DISTRICT	ENNAME	DOBRINSKY DISTRICT
DOBROVSKY DISTRICT	ENNAME	DOBROVSKY DISTRICT
GRYAZINSKY DISTRICT	ENNAME	GRYAZINSKY DISTRICT
KHLEVENSKY DISTRICT	ENNAME	KHLEVENSKY DISTRICT
IZMALKOVSKY DISTRICT	ENNAME	IZMALKOVSKY DISTRICT
DOLGORUKOVSKY DISTRICT	ENNAME	DOLGORUKOVSKY DISTRICT
KRASNINSKY DISTRICT, LIPETSK OBLAST	ENNAME	KRASNINSKY DISTRICT
STANOVLYANSKY DISTRICT	ENNAME	STANOVLYANSKY DISTRICT
LIPETSKY DISTRICT	ENNAME	LIPETSKY DISTRICT
LEBEDYANSKY DISTRICT	ENNAME	LEBEDYANSKY DISTRICT
TERBUNSKY DISTRICT	ENNAME	TERBUNSKY DISTRICT
LEV-TOLSTOVSKY DISTRICT	ENNAME	LEV-TOLSTOVSKY DISTRICT
YELETSKY DISTRICT	ENNAME	YELETSKY DISTRICT
USMANSKY DISTRICT	ENNAME	USMANSKY DISTRICT
VOLOVSKY DISTRICT, LIPETSK OBLAST	ENNAME	VOLOVSKY DISTRICT
OMSUKCHANSKY DISTRICT	ENNAME	OMSUKCHANSKY DISTRICT
OLSKY DISTRICT	ENNAME	OLSKY DISTRICT
KHASYNSKY DISTRICT	ENNAME	KHASYNSKY DISTRICT
ZADONSKY DISTRICT	ENNAME	ZADONSKY DISTRICT
TENKINSKY DISTRICT	ENNAME	TENKINSKY DISTRICT
DANKOVSKY DISTRICT	ENNAME	DANKOVSKY DISTRICT
YAGODNINSKY DISTRICT	ENNAME	YAGODNINSKY DISTRICT
SEVERO-EVENSKY DISTRICT	ENNAME	SEVERO-EVENSKY DISTRICT
KASHIRSKY DISTRICT, MOSCOW OBLAST	ENNAME	KASHIRSKY DISTRICT
DMITROVSKY DISTRICT, MOSCOW OBLAST	ENNAME	DMITROVSKY DISTRICT
CHEKHOVSKY DISTRICT	ENNAME	CHEKHOVSKY DISTRICT
LENINSKY DISTRICT, MOSCOW OBLAST	ENNAME	LENINSKY DISTRICT
ISTRINSKY DISTRICT	ENNAME	ISTRINSKY DISTRICT
LUKHOVITSKY DISTRICT	ENNAME	LUKHOVITSKY DISTRICT
KRASNOGORSKY DISTRICT, MOSCOW OBLAST	ENNAME	KRASNOGORSKY DISTRICT
LOTOSHINSKY DISTRICT	ENNAME	LOTOSHINSKY DISTRICT
OZYORSKY DISTRICT, MOSCOW OBLAST	ENNAME	OZYORSKY DISTRICT
MYTISHCHINSKY DISTRICT	ENNAME	MYTISHCHINSKY DISTRICT
NARO-FOMINSKY DISTRICT	ENNAME	NARO-FOMINSKY DISTRICT
OREKHOVO-ZUYEVSKY DISTRICT	ENNAME	OREKHOVO-ZUYEVSKY DISTRICT
NOGINSKY DISTRICT	ENNAME	NOGINSKY DISTRICT
KLINSKY DISTRICT	ENNAME	KLINSKY DISTRICT
MOZHAYSKY DISTRICT, MOSCOW OBLAST	ENNAME	MOZHAYSKY DISTRICT
SEREBRYANO-PRUDSKY DISTRICT	ENNAME	SEREBRYANO-PRUDSKY DISTRICT
SHAKHOVSKOY DISTRICT	ENNAME	SHAKHOVSKOY DISTRICT
RUZSKY DISTRICT	ENNAME	RUZSKY DISTRICT
PODOLSKY DISTRICT	ENNAME	PODOLSKY DISTRICT
PUSHKINSKY DISTRICT, MOSCOW OBLAST	ENNAME	PUSHKINSKY DISTRICT
SHCHYOLKOVSKY DISTRICT	ENNAME	SHCHYOLKOVSKY DISTRICT
ODINTSOVSKY DISTRICT	ENNAME	ODINTSOVSKY DISTRICT
SERPUKHOVSKY DISTRICT	ENNAME	SERPUKHOVSKY DISTRICT
STUPINSKY DISTRICT	ENNAME	STUPINSKY DISTRICT
ZARAYSKY DISTRICT	ENNAME	ZARAYSKY DISTRICT
TALDOMSKY DISTRICT	ENNAME	TALDOMSKY DISTRICT
YEGORYEVSKY DISTRICT, MOSCOW OBLAST	ENNAME	YEGORYEVSKY DISTRICT
ARDATOVSKY DISTRICT, NIZHNY NOVGOROD OBLAST	ENNAME	ARDATOVSKY DISTRICT
VOSKRESENSKY DISTRICT, MOSCOW OBLAST	ENNAME	VOSKRESENSKY DISTRICT
VOLOKOLAMSKY DISTRICT	ENNAME	VOLOKOLAMSKY DISTRICT
ARZAMASSKY DISTRICT	ENNAME	ARZAMASSKY DISTRICT
BALAKHNINSKY DISTRICT	ENNAME	BALAKHNINSKY DISTRICT
BOLSHEBOLDINSKY DISTRICT	ENNAME	BOLSHEBOLDINSKY DISTRICT
BUTURLINSKY DISTRICT	ENNAME	BUTURLINSKY DISTRICT
BOGORODSKY DISTRICT, NIZHNY NOVGOROD OBLAST	ENNAME	BOGORODSKY DISTRICT
CHKALOVSKY DISTRICT, NIZHNY NOVGOROD OBLAST	ENNAME	CHKALOVSKY DISTRICT
BOLSHEMURASHKINSKY DISTRICT	ENNAME	BOLSHEMURASHKINSKY DISTRICT
DIVEYEVSKY DISTRICT	ENNAME	DIVEYEVSKY DISTRICT
GAGINSKY DISTRICT	ENNAME	GAGINSKY DISTRICT
KNYAGININSKY DISTRICT	ENNAME	KNYAGININSKY DISTRICT
SECHENOVSKY DISTRICT	ENNAME	SECHENOVSKY DISTRICT
GORODETSKY DISTRICT	ENNAME	GORODETSKY DISTRICT
KRASNOBAKOVSKY DISTRICT	ENNAME	KRASNOBAKOVSKY DISTRICT
DALNEKONSTANTINOVSKY DISTRICT	ENNAME	DALNEKONSTANTINOVSKY DISTRICT
KULEBAKSKY DISTRICT	ENNAME	KULEBAKSKY DISTRICT
POCHINKOVSKY DISTRICT, NIZHNY NOVGOROD OBLAST	ENNAME	POCHINKOVSKY DISTRICT
KRASNOOKTYABRSKY DISTRICT, NIZHNY NOVGOROD OBLAST	ENNAME	KRASNOOKTYABRSKY DISTRICT
PILNINSKY DISTRICT	ENNAME	PILNINSKY DISTRICT
LUKOYANOVSKY DISTRICT	ENNAME	LUKOYANOVSKY DISTRICT
KOVERNINSKY DISTRICT	ENNAME	KOVERNINSKY DISTRICT
SERGACHSKY DISTRICT	ENNAME	SERGACHSKY DISTRICT
NAVASHINSKY DISTRICT	ENNAME	NAVASHINSKY DISTRICT
PAVLOVSKY DISTRICT, NIZHNY NOVGOROD OBLAST	ENNAME	PAVLOVSKY DISTRICT
SOSNOVSKY DISTRICT, NIZHNY NOVGOROD OBLAST	ENNAME	SOSNOVSKY DISTRICT
SHATKOVSKY DISTRICT	ENNAME	SHATKOVSKY DISTRICT
PEREVOZSKY DISTRICT	ENNAME	PEREVOZSKY DISTRICT
SOKOLSKY DISTRICT, NIZHNY NOVGOROD OBLAST	ENNAME	SOKOLSKY DISTRICT
VADSKY DISTRICT	ENNAME	VADSKY DISTRICT
SPASSKY DISTRICT, NIZHNY NOVGOROD OBLAST	ENNAME	SPASSKYDISTRICT
URENSKY DISTRICT	ENNAME	URENSKY DISTRICT
SHARANGSKY DISTRICT	ENNAME	SHARANGSKY DISTRICT
VACHSKY DISTRICT	ENNAME	VACHSKY DISTRICT
TONKINSKY DISTRICT	ENNAME	TONKINSKY DISTRICT
VARNAVINSKY DISTRICT	ENNAME	VARNAVINSKY DISTRICT
TONSHAYEVSKY DISTRICT	ENNAME	TONSHAYEVSKY DISTRICT
VETLUZHSKY DISTRICT	ENNAME	VETLUZHSKY DISTRICT
VOLODARSKY DISTRICT, NIZHNY NOVGOROD OBLAST	ENNAME	VOLODARSKY DISTRICT
VOSKRESENSKY DISTRICT, NIZHNY NOVGOROD OBLAST	ENNAME	VOSKRESENSKY DISTRICT
VOROTYNSKY DISTRICT	ENNAME	VOROTYNSKY DISTRICT
VOZNESENSKY DISTRICT	ENNAME	VOZNESENSKY DISTRICT
BAGANSKY DISTRICT	ENNAME	BAGANSKY DISTRICT
CHISTOOZYORNY DISTRICT	ENNAME	CHISTOOZYORNY DISTRICT
BARABINSKY DISTRICT	ENNAME	BARABINSKY DISTRICT
CHULYMSKY DISTRICT	ENNAME	CHULYMSKY DISTRICT
KARASUKSKY DISTRICT	ENNAME	KARASUKSKY DISTRICT
ISKITIMSKY DISTRICT	ENNAME	ISKITIMSKY DISTRICT
CHEREPANOVSKY DISTRICT	ENNAME	CHEREPANOVSKY DISTRICT
DOVOLENSKY DISTRICT	ENNAME	DOVOLENSKY DISTRICT
KARGATSKY DISTRICT	ENNAME	KARGATSKY DISTRICT
KOCHKOVSKY DISTRICT	ENNAME	KOCHKOVSKY DISTRICT
KOCHENYOVSKY DISTRICT	ENNAME	KOCHENYOVSKY DISTRICT
KOLYVANSKY DISTRICT	ENNAME	KOLYVANSKY DISTRICT
KUPINSKY DISTRICT	ENNAME	KUPINSKY DISTRICT
CHANOVSKY DISTRICT	ENNAME	CHANOVSKY DISTRICT
KUYBYSHEVSKY DISTRICT, NOVOSIBIRSK OBLAST	ENNAME	KUYBYSHEVSKY DISTRICT
KRASNOZYORSKY DISTRICT	ENNAME	KRASNOZYORSKY DISTRICT
ORDYNSKY DISTRICT	ENNAME	ORDYNSKY DISTRICT
MOSHKOVSKY DISTRICT	ENNAME	MOSHKOVSKY DISTRICT
BOLOTNINSKY DISTRICT	ENNAME	BOLOTNINSKY DISTRICT
MASLYANINSKY DISTRICT	ENNAME	MASLYANINSKY DISTRICT
UST-TARKSKY DISTRICT	ENNAME	UST-TARKSKY DISTRICT
UBINSKY DISTRICT	ENNAME	UBINSKY DISTRICT
TATARSKY DISTRICT	ENNAME	TATARSKY DISTRICT
NOVOSIBIRSKY DISTRICT	ENNAME	NOVOSIBIRSKY DISTRICT
SUZUNSKY DISTRICT	ENNAME	SUZUNSKY DISTRICT
TOGUCHINSKY DISTRICT	ENNAME	TOGUCHINSKY DISTRICT
KYSHTOVSKY DISTRICT	ENNAME	KYSHTOVSKY DISTRICT
VENGEROVSKY DISTRICT	ENNAME	VENGEROVSKY DISTRICT
ZDVINSKY DISTRICT	ENNAME	ZDVINSKY DISTRICT
SEVERNY DISTRICT, NOVOSIBIRSK OBLAST	ENNAME	SEVERNY DISTRICT
BOLSHEUKOVSKY DISTRICT	ENNAME	BOLSHEUKOVSKY DISTRICT
ISILKULSKY DISTRICT	ENNAME	ISILKULSKY DISTRICT
GORKOVSKY DISTRICT	ENNAME	GORKOVSKY DISTRICT
BOLSHERECHENSKY DISTRICT	ENNAME	BOLSHERECHENSKY DISTRICT
CHERLAKSKY DISTRICT	ENNAME	CHERLAKSKY DISTRICT
KALACHINSKY DISTRICT	ENNAME	KALACHINSKY DISTRICT
KOLOSOVSKY DISTRICT	ENNAME	KOLOSOVSKY DISTRICT
LYUBINSKY DISTRICT	ENNAME	LYUBINSKY DISTRICT
KRUTINSKY DISTRICT	ENNAME	KRUTINSKY DISTRICT
MUROMTSEVSKY DISTRICT	ENNAME	MUROMTSEVSKY DISTRICT
NAZYVAYEVSKY DISTRICT	ENNAME	NAZYVAYEVSKY DISTRICT
ODESSKY DISTRICT	ENNAME	ODESSKY DISTRICT
KORMILOVSKY DISTRICT	ENNAME	KORMILOVSKY DISTRICT
MOSKALENSKY DISTRICT	ENNAME	MOSKALENSKY DISTRICT
MARYANOVSKY DISTRICT	ENNAME	MARYANOVSKY DISTRICT
OMSKY DISTRICT	ENNAME	OMSKY DISTRICT
POLTAVSKY DISTRICT	ENNAME	POLTAVSKY DISTRICT
NIZHNEOMSKY DISTRICT	ENNAME	NIZHNEOMSKY DISTRICT
RUSSKO-POLYANSKY DISTRICT	ENNAME	RUSSKO-POLYANSKY DISTRICT
PAVLOGRADSKY DISTRICT	ENNAME	PAVLOGRADSKY DISTRICT
OKONESHNIKOVSKY DISTRICT	ENNAME	OKONESHNIKOVSKY DISTRICT
NOVOVARSHAVSKY DISTRICT	ENNAME	NOVOVARSHAVSKY DISTRICT
SARGATSKY DISTRICT	ENNAME	SARGATSKY DISTRICT
TYUKALINSKY DISTRICT	ENNAME	TYUKALINSKY DISTRICT
ZNAMENSKY DISTRICT, OMSK OBLAST	ENNAME	ZNAMENSKY DISTRICT
TARSKY DISTRICT	ENNAME	TARSKY DISTRICT
TAVRICHESKY DISTRICT	ENNAME	TAVRICHESKY DISTRICT
ASEKEYEVSKY DISTRICT	ENNAME	ASEKEYEVSKY DISTRICT
TEVRIZSKY DISTRICT	ENNAME	TEVRIZSKY DISTRICT
AKBULAKSKY DISTRICT	ENNAME	AKBULAKSKY DISTRICT
ALEXANDROVSKY DISTRICT, ORENBURG OBLAST	ENNAME	ALEXANDROVSKY DISTRICT
BUZULUKSKY DISTRICT	ENNAME	BUZULUKSKY DISTRICT
UST-ISHIMSKY DISTRICT	ENNAME	UST-ISHIMSKY DISTRICT
GRACHYOVSKY DISTRICT, ORENBURG OBLAST	ENNAME	GRACHYOVSKY DISTRICT
ADAMOVSKY DISTRICT	ENNAME	ADAMOVSKY DISTRICT
ABDULINSKY DISTRICT	ENNAME	ABDULINSKY DISTRICT
DOMBAROVSKY DISTRICT	ENNAME	DOMBAROVSKY DISTRICT
BUGURUSLANSKY DISTRICT	ENNAME	BUGURUSLANSKY DISTRICT
BELYAYEVSKY DISTRICT	ENNAME	BELYAYEVSKY DISTRICT
GAYSKY DISTRICT	ENNAME	GAYSKY DISTRICT
KVARKENSKY DISTRICT	ENNAME	KVARKENSKY DISTRICT
KUVANDYKSKY DISTRICT	ENNAME	KUVANDYKSKY DISTRICT
KURMANAYEVSKY DISTRICT	ENNAME	KURMANAYEVSKY DISTRICT
MATVEYEVSKY DISTRICT	ENNAME	MATVEYEVSKY DISTRICT
ILEKSKY DISTRICT	ENNAME	ILEKSKY DISTRICT
KRASNOGVARDEYSKY DISTRICT, ORENBURG OBLAST	ENNAME	KRASNOGVARDEYSKY DISTRICT
NOVOORSKY DISTRICT	ENNAME	NOVOORSKY DISTRICT
OKTYABRSKY DISTRICT, ORENBURG OBLAST	ENNAME	OKTYABRSKY DISTRICT
PEREVOLOTSKY DISTRICT	ENNAME	PEREVOLOTSKY DISTRICT
ORENBURGSKY DISTRICT	ENNAME	ORENBURGSKY DISTRICT
NOVOSERGIYEVSKY DISTRICT	ENNAME	NOVOSERGIYEVSKY DISTRICT
PERVOMAYSKY DISTRICT, ORENBURG OBLAST	ENNAME	PERVOMAYSKY DISTRICT
PONOMARYOVSKY DISTRICT	ENNAME	PONOMARYOVSKY DISTRICT
SHARLYKSKY DISTRICT	ENNAME	SHARLYKSKY DISTRICT
SOL-ILETSKY DISTRICT	ENNAME	SOL-ILETSKY DISTRICT
SAKMARSKY DISTRICT	ENNAME	SAKMARSKY DISTRICT
SARAKTASHSKY DISTRICT	ENNAME	SARAKTASHSKY DISTRICT
SEVERNY DISTRICT, ORENBURG OBLAST	ENNAME	SEVERNY DISTRICT
SOROCHINSKY DISTRICT	ENNAME	SOROCHINSKY DISTRICT
TASHLINSKY DISTRICT	ENNAME	TASHLINSKY DISTRICT
SVETLINSKY DISTRICT	ENNAME	SVETLINSKY DISTRICT
TOTSKY DISTRICT	ENNAME	TOTSKY DISTRICT
TYULGANSKY DISTRICT	ENNAME	TYULGANSKY DISTRICT
DOLZHANSKY DISTRICT	ENNAME	DOLZHANSKY DISTRICT
GLAZUNOVSKY DISTRICT	ENNAME	GLAZUNOVSKY DISTRICT
KHOTYNETSKY DISTRICT	ENNAME	KHOTYNETSKY DISTRICT
MALOSERDOBINSKY DISTRICT	ENNAME	MALOSERDOBINSKY DISTRICT
NAROVCHATSKY DISTRICT	ENNAME	NAROVCHATSKY DISTRICT
MOKSHANSKY DISTRICT	ENNAME	MOKSHANSKY DISTRICT
LOPATINSKY DISTRICT	ENNAME	LOPATINSKY DISTRICT
KUZNETSKY DISTRICT, PENZA OBLAST	ENNAME	KUZNETSKY DISTRICT
LUNINSKY DISTRICT	ENNAME	LUNINSKY DISTRICT
KOLYSHLEYSKY DISTRICT	ENNAME	KOLYSHLEYSKY DISTRICT
KAMESHKIRSKY DISTRICT	ENNAME	KAMESHKIRSKY DISTRICT
KAMENSKY DISTRICT, PENZA OBLAST	ENNAME	KAMENSKY DISTRICT
ISSINSKY DISTRICT	ENNAME	ISSINSKY DISTRICT
BESSONOVSKY DISTRICT	ENNAME	BESSONOVSKY DISTRICT
GORODISHCHENSKY DISTRICT, PENZA OBLAST	ENNAME	GORODISHCHENSKY DISTRICT
BEKOVSKY DISTRICT	ENNAME	BEKOVSKY DISTRICT
BELINSKY DISTRICT	ENNAME	BELINSKY DISTRICT
URITSKY DISTRICT	ENNAME	URITSKY DISTRICT
BASHMAKOVSKY DISTRICT	ENNAME	BASHMAKOVSKY DISTRICT
ZALEGOSHCHENSKY DISTRICT	ENNAME	ZALEGOSHCHENSKY DISTRICT
VERKHOVSKY DISTRICT	ENNAME	VERKHOVSKY DISTRICT
TROSNYANSKY DISTRICT	ENNAME	TROSNYANSKY DISTRICT
POKROVSKY DISTRICT	ENNAME	POKROVSKY DISTRICT
SOSKOVSKY DISTRICT	ENNAME	SOSKOVSKY DISTRICT
SVERDLOVSKY DISTRICT, ORYOL OBLAST	ENNAME	SVERDLOVSKY DISTRICT
KRASNOZORENSKY DISTRICT	ENNAME	KRASNOZORENSKY DISTRICT
NOVODEREVENKOVSKY DISTRICT	ENNAME	NOVODEREVENKOVSKY DISTRICT
SHABLYKINSKY DISTRICT	ENNAME	SHABLYKINSKY DISTRICT
NOVOSILSKY DISTRICT	ENNAME	NOVOSILSKY DISTRICT
ORLOVSKY DISTRICT, ORYOL OBLAST	ENNAME	ORLOVSKY DISTRICT
MALOARKHANGELSKY DISTRICT	ENNAME	MALOARKHANGELSKY DISTRICT
MTSENSKY DISTRICT	ENNAME	MTSENSKY DISTRICT
KROMSKOY DISTRICT	ENNAME	KROMSKOY DISTRICT
LIVENSKY DISTRICT	ENNAME	LIVENSKY DISTRICT
KORSAKOVSKY DISTRICT, ORYOL OBLAST	ENNAME	KORSAKOVSKY DISTRICT
KOLPNYANSKY DISTRICT	ENNAME	KOLPNYANSKY DISTRICT
BOLKHOVSKY DISTRICT	ENNAME	BOLKHOVSKY DISTRICT
DMITROVSKY DISTRICT, ORYOL OBLAST	ENNAME	DMITROVSKY DISTRICT
YASNENSKY DISTRICT	ENNAME	YASNENSKY DISTRICT
NEVERKINSKY DISTRICT	ENNAME	NEVERKINSKY DISTRICT
NIZHNELOMOVSKY DISTRICT	ENNAME	NIZHNELOMOVSKY DISTRICT
PACHELMSKY DISTRICT	ENNAME	PACHELMSKY DISTRICT
VADINSKY DISTRICT	ENNAME	VADINSKY DISTRICT
DEDOVICHSKY DISTRICT	ENNAME	DEDOVICHSKY DISTRICT
SHEMYSHEYSKY DISTRICT	ENNAME	SHEMYSHEYSKY DISTRICT
NIKOLSKY DISTRICT, PENZA OBLAST	ENNAME	NIKOLSKY DISTRICT
ZEMETCHINSKY DISTRICT	ENNAME	ZEMETCHINSKY DISTRICT
PENZENSKY DISTRICT	ENNAME	PENZENSKY DISTRICT
TAMALINSKY DISTRICT	ENNAME	TAMALINSKY DISTRICT
GDOVSKY DISTRICT	ENNAME	GDOVSKY DISTRICT
SPASSKY DISTRICT, PENZA OBLAST	ENNAME	SPASSKY DISTRICT
DNOVSKY DISTRICT	ENNAME	DNOVSKY DISTRICT
KRASNOGORODSKY DISTRICT	ENNAME	KRASNOGORODSKY DISTRICT
SERDOBSKY DISTRICT	ENNAME	SERDOBSKY DISTRICT
KUNYINSKY DISTRICT	ENNAME	KUNYINSKY DISTRICT
LOKNYANSKY DISTRICT	ENNAME	LOKNYANSKY DISTRICT
SOSNOVOBORSKY DISTRICT	ENNAME	SOSNOVOBORSKY DISTRICT
NOVORZHEVSKY DISTRICT	ENNAME	NOVORZHEVSKY DISTRICT
OPOCHETSKY DISTRICT	ENNAME	OPOCHETSKY DISTRICT
NEVELSKY DISTRICT, PSKOV OBLAST	ENNAME	NEVELSKY DISTRICT
PALKINSKY DISTRICT	ENNAME	PALKINSKY DISTRICT
NOVOSOKOLNICHESKY DISTRICT	ENNAME	NOVOSOKOLNICHESKY DISTRICT
OSTROVSKY DISTRICT, PSKOV OBLAST	ENNAME	OSTROVSKY DISTRICT
PECHORSKY DISTRICT	ENNAME	PECHORSKY DISTRICT
PORKHOVSKY DISTRICT	ENNAME	PORKHOVSKY DISTRICT
PSKOVSKY DISTRICT	ENNAME	PSKOVSKY DISTRICT
PUSHKINOGORSKY DISTRICT	ENNAME	PUSHKINOGORSKY DISTRICT
PYTALOVSKY DISTRICT	ENNAME	PYTALOVSKY DISTRICT
SEBEZHSKY DISTRICT	ENNAME	SEBEZHSKY DISTRICT
PUSTOSHKINSKY DISTRICT	ENNAME	PUSTOSHKINSKY DISTRICT
USVYATSKY DISTRICT	ENNAME	USVYATSKY DISTRICT
VELIKOLUKSKY DISTRICT	ENNAME	VELIKOLUKSKY DISTRICT
AKSAYSKY DISTRICT	ENNAME	AKSAYSKY DISTRICT
BAGAYEVSKY DISTRICT	ENNAME	BAGAYEVSKY DISTRICT
KAGALNITSKY DISTRICT	ENNAME	KAGALNITSKY DISTRICT
KRASNOSULINSKY DISTRICT	ENNAME	KRASNOSULINSKY DISTRICT
BOKOVSKY DISTRICT	ENNAME	BOKOVSKY DISTRICT
AZOVSKY DISTRICT	ENNAME	AZOVSKY DISTRICT
BELOKALITVINSKY DISTRICT	ENNAME	BELOKALITVINSKY DISTRICT
MATVEYEVO-KURGANSKY DISTRICT	ENNAME	MATVEYEVO-KURGANSKY DISTRICT
KAMENSKY DISTRICT, ROSTOV OBLAST	ENNAME	KAMENSKY DISTRICT
KUYBYSHEVSKY DISTRICT, ROSTOV OBLAST	ENNAME	KUYBYSHEVSKY DISTRICT
DUBOVSKY DISTRICT, ROSTOV OBLAST	ENNAME	DUBOVSKY DISTRICT
MARTYNOVSKY DISTRICT	ENNAME	MARTYNOVSKY DISTRICT
MYASNIKOVSKY DISTRICT	ENNAME	MYASNIKOVSKY DISTRICT
KASHARSKY DISTRICT	ENNAME	KASHARSKY DISTRICT
CHERTKOVSKY DISTRICT	ENNAME	CHERTKOVSKY DISTRICT
MILYUTINSKY DISTRICT	ENNAME	MILYUTINSKY DISTRICT
MILLEROVSKY DISTRICT	ENNAME	MILLEROVSKY DISTRICT
NEKLINOVSKY DISTRICT	ENNAME	NEKLINOVSKY DISTRICT
MOROZOVSKY DISTRICT	ENNAME	MOROZOVSKY DISTRICT
OBLIVSKY DISTRICT	ENNAME	OBLIVSKY DISTRICT
ORLOVSKY DISTRICT, ROSTOV OBLAST	ENNAME	ORLOVSKY DISTRICT
SALSKY DISTRICT	ENNAME	SALSKY DISTRICT
REMONTNENSKY DISTRICT	ENNAME	REMONTNENSKY DISTRICT
OKTYABRSKY DISTRICT, ROSTOV OBLAST	ENNAME	OKTYABRSKY DISTRICT
PROLETARSKY DISTRICT, ROSTOV OBLAST	ENNAME	PROLETARSKY DISTRICT
TATSINSKY DISTRICT	ENNAME	TATSINSKY DISTRICT
SEMIKARAKORSKY DISTRICT	ENNAME	SEMIKARAKORSKY DISTRICT
RODIONOVO-NESVETAYSKY DISTRICT	ENNAME	RODIONOVO-NESVETAYSKY DISTRICT
SOVETSKY DISTRICT, ROSTOV OBLAST	ENNAME	SOVETSKY DISTRICT
SHOLOKHOVSKY DISTRICT	ENNAME	SHOLOKHOVSKY DISTRICT
TSELINSKY DISTRICT	ENNAME	TSELINSKY DISTRICT
PESCHANOKOPSKY DISTRICT	ENNAME	PESCHANOKOPSKY DISTRICT
TARASOVSKY DISTRICT	ENNAME	TARASOVSKY DISTRICT
TSIMLYANSKY DISTRICT	ENNAME	TSIMLYANSKY DISTRICT
VERKHNEDONSKOY DISTRICT	ENNAME	VERKHNEDONSKOY DISTRICT
VESYOLOVSKY DISTRICT	ENNAME	VESYOLOVSKY DISTRICT
ZAVETINSKY DISTRICT	ENNAME	ZAVETINSKY DISTRICT
YEGORLYKSKY DISTRICT	ENNAME	YEGORLYKSKY DISTRICT
VOLGODONSKOY DISTRICT	ENNAME	VOLGODONSKOY DISTRICT
ZERNOGRADSKY DISTRICT	ENNAME	ZERNOGRADSKY DISTRICT
UST-DONETSKY DISTRICT	ENNAME	UST-DONETSKY DISTRICT
CHUCHKOVSKY DISTRICT	ENNAME	CHUCHKOVSKY DISTRICT
KADOMSKY DISTRICT	ENNAME	KADOMSKY DISTRICT
ZIMOVNIKOVSKY DISTRICT	ENNAME	ZIMOVNIKOVSKY DISTRICT
KASIMOVSKY DISTRICT	ENNAME	KASIMOVSKY DISTRICT
KORABLINSKY DISTRICT	ENNAME	KORABLINSKY DISTRICT
KLEPIKOVSKY DISTRICT	ENNAME	KLEPIKOVSKY DISTRICT
MILOSLAVSKY DISTRICT	ENNAME	MILOSLAVSKY DISTRICT
ALEXANDRO-NEVSKY DISTRICT	ENNAME	ALEXANDRO-NEVSKY DISTRICT
MIKHAYLOVSKY DISTRICT, RYAZAN OBLAST	ENNAME	MIKHAYLOVSKY DISTRICT
PITELINSKY DISTRICT	ENNAME	PITELINSKY DISTRICT
RYAZANSKY DISTRICT, RYAZAN OBLAST	ENNAME	RYAZANSKY DISTRICT
PUTYATINSKY DISTRICT	ENNAME	PUTYATINSKY DISTRICT
PRONSKY DISTRICT	ENNAME	PRONSKY DISTRICT
SHATSKY DISTRICT	ENNAME	SHATSKY DISTRICT
SAPOZHKOVSKY DISTRICT	ENNAME	SAPOZHKOVSKY DISTRICT
SASOVSKY DISTRICT	ENNAME	SASOVSKY DISTRICT
RYAZHSKY DISTRICT	ENNAME	RYAZHSKY DISTRICT
RYBNOVSKY DISTRICT	ENNAME	RYBNOVSKY DISTRICT
SKOPINSKY DISTRICT	ENNAME	SKOPINSKY DISTRICT
UKHOLOVSKY DISTRICT	ENNAME	UKHOLOVSKY DISTRICT
SARAYEVSKY DISTRICT	ENNAME	SARAYEVSKY DISTRICT
SHILOVSKY DISTRICT	ENNAME	SHILOVSKY DISTRICT
STAROZHILOVSKY DISTRICT	ENNAME	STAROZHILOVSKY DISTRICT
ZAKHAROVSKY DISTRICT	ENNAME	ZAKHAROVSKY DISTRICT
YERMISHINSKY DISTRICT	ENNAME	YERMISHINSKY DISTRICT
SPASSKY DISTRICT, RYAZAN OBLAST	ENNAME	SPASSKY DISTRICT
KRASNOARMEYSKY DISTRICT, SAMARA OBLAST	ENNAME	KRASNOARMEYSKY DISTRICT
KOSHKINSKY DISTRICT	ENNAME	KOSHKINSKY DISTRICT
KAMYSHLINSKY DISTRICT	ENNAME	KAMYSHLINSKY DISTRICT
BOLSHEGLUSHITSKY DISTRICT	ENNAME	BOLSHEGLUSHITSKY DISTRICT
ALEXEYEVSKY DISTRICT, SAMARA OBLAST	ENNAME	ALEXEYEVSKY DISTRICT
BOGATOVSKY DISTRICT	ENNAME	BOGATOVSKY DISTRICT
POKHVISTNEVSKY DISTRICT	ENNAME	POKHVISTNEVSKY DISTRICT
PESTRAVSKY DISTRICT	ENNAME	PESTRAVSKY DISTRICT
KHVOROSTYANSKY DISTRICT	ENNAME	KHVOROSTYANSKY DISTRICT
BEZENCHUKSKY DISTRICT	ENNAME	BEZENCHUKSKY DISTRICT
ISAKLINSKY DISTRICT	ENNAME	ISAKLINSKY DISTRICT
KINEL-CHERKASSKY DISTRICT	ENNAME	KINEL-CHERKASSKY DISTRICT
NEFTEGORSKY DISTRICT	ENNAME	NEFTEGORSKY DISTRICT
BORSKY DISTRICT, SAMARA OBLAST	ENNAME	BORSKY DISTRICT
BOLSHECHERNIGOVSKY DISTRICT	ENNAME	BOLSHECHERNIGOVSKY DISTRICT
KLYAVLINSKY DISTRICT	ENNAME	KLYAVLINSKY DISTRICT
CHELNO-VERSHINSKY DISTRICT	ENNAME	CHELNO-VERSHINSKY DISTRICT
KINELSKY DISTRICT	ENNAME	KINELSKY DISTRICT
STAVROPOLSKY DISTRICT	ENNAME	STAVROPOLSKY DISTRICT
KRASNOYARSKY DISTRICT, SAMARA OBLAST	ENNAME	KRASNOYARSKY DISTRICT
PRIVOLZHSKY DISTRICT, SAMARA OBLAST	ENNAME	PRIVOLZHSKY DISTRICT
SHENTALINSKY DISTRICT	ENNAME	SHENTALINSKY DISTRICT
SERGIYEVSKY DISTRICT	ENNAME	SERGIYEVSKY DISTRICT
SHIGONSKY DISTRICT	ENNAME	SHIGONSKY DISTRICT
SYZRANSKY DISTRICT	ENNAME	SYZRANSKY DISTRICT
ALEXANDROVO-GAYSKY DISTRICT	ENNAME	ALEXANDROVO-GAYSKY DISTRICT
VOLZHSKY DISTRICT, SAMARA OBLAST	ENNAME	VOLZHSKY DISTRICT
YELKHOVSKY DISTRICT	ENNAME	YELKHOVSKY DISTRICT
ATKARSKY DISTRICT	ENNAME	ATKARSKY DISTRICT
ARKADAKSKY DISTRICT	ENNAME	ARKADAKSKY DISTRICT
BALAKOVSKY DISTRICT	ENNAME	BALAKOVSKY DISTRICT
BALASHOVSKY DISTRICT	ENNAME	BALASHOVSKY DISTRICT
DERGACHYOVSKY DISTRICT	ENNAME	DERGACHYOVSKY DISTRICT
DUKHOVNITSKY DISTRICT	ENNAME	DUKHOVNITSKY DISTRICT
BALTAYSKY DISTRICT	ENNAME	BALTAYSKY DISTRICT
FYODOROVSKY DISTRICT, SARATOV OBLAST	ENNAME	FYODOROVSKY DISTRICT
KALININSKY DISTRICT, SARATOV OBLAST	ENNAME	KALININSKY DISTRICT
KHVALYNSKY DISTRICT	ENNAME	KHVALYNSKY DISTRICT
BAZARNO-KARABULAKSKY DISTRICT	ENNAME	BAZARNO-KARABULAKSKY DISTRICT
ENGELSSKY DISTRICT	ENNAME	ENGELSSKY DISTRICT
KRASNOARMEYSKY DISTRICT, SARATOV OBLAST	ENNAME	KRASNOARMEYSKY DISTRICT
IVANTEYEVSKY DISTRICT	ENNAME	IVANTEYEVSKY DISTRICT
KRASNOKUTSKY DISTRICT	ENNAME	KRASNOKUTSKY DISTRICT
OZINSKY DISTRICT	ENNAME	OZINSKY DISTRICT
MARKSOVSKY DISTRICT	ENNAME	MARKSOVSKY DISTRICT
NOVOUZENSKY DISTRICT	ENNAME	NOVOUZENSKY DISTRICT
NOVOBURASSKY DISTRICT	ENNAME	NOVOBURASSKY DISTRICT
LYSOGORSKY DISTRICT	ENNAME	LYSOGORSKY DISTRICT
KRASNOPARTIZANSKY DISTRICT	ENNAME	KRASNOPARTIZANSKY DISTRICT
PETROVSKY DISTRICT, SARATOV OBLAST	ENNAME	PETROVSKY DISTRICT
PITERSKY DISTRICT	ENNAME	PITERSKY DISTRICT
PUGACHYOVSKY DISTRICT	ENNAME	PUGACHYOVSKY DISTRICT
PERELYUBSKY DISTRICT	ENNAME	PERELYUBSKY DISTRICT
RTISHCHEVSKY DISTRICT	ENNAME	RTISHCHEVSKY DISTRICT
ROVENSKY DISTRICT, SARATOV OBLAST	ENNAME	ROVENSKY DISTRICT
ROMANOVSKY DISTRICT, SARATOV OBLAST	ENNAME	ROMANOVSKY DISTRICT
SARATOVSKY DISTRICT	ENNAME	SARATOVSKY DISTRICT
SAMOYLOVSKY DISTRICT	ENNAME	SAMOYLOVSKY DISTRICT
VOSKRESENSKY DISTRICT, SARATOV OBLAST	ENNAME	VOSKRESENSKY DISTRICT
SOVETSKY DISTRICT, SARATOV OBLAST	ENNAME	SOVETSKY DISTRICT
VOLSKY DISTRICT	ENNAME	VOLSKY DISTRICT
YEKATERINOVSKY DISTRICT	ENNAME	YEKATERINOVSKY DISTRICT
TURKOVSKY DISTRICT	ENNAME	TURKOVSKY DISTRICT
YERSHOVSKY DISTRICT	ENNAME	YERSHOVSKY DISTRICT
GLINKOVSKY DISTRICT	ENNAME	GLINKOVSKY DISTRICT
GAGARINSKY DISTRICT, SMOLENSK OBLAST	ENNAME	GAGARINSKY DISTRICT
DOROGOBUZHSKY DISTRICT	ENNAME	DOROGOBUZHSKY DISTRICT
KHISLAVICHSKY DISTRICT	ENNAME	KHISLAVICHSKY DISTRICT
DUKHOVSHCHINSKY DISTRICT	ENNAME	DUKHOVSHCHINSKY DISTRICT
DEMIDOVSKY DISTRICT	ENNAME	DEMIDOVSKY DISTRICT
KARDYMOVSKY DISTRICT	ENNAME	KARDYMOVSKY DISTRICT
NOVODUGINSKY DISTRICT	ENNAME	NOVODUGINSKY DISTRICT
ROSLAVLSKY DISTRICT	ENNAME	ROSLAVLSKY DISTRICT
POCHINKOVSKY DISTRICT, SMOLENSK OBLAST	ENNAME	POCHINKOVSKY DISTRICT
SHUMYACHSKY DISTRICT	ENNAME	SHUMYACHSKY DISTRICT
SAFONOVSKY DISTRICT	ENNAME	SAFONOVSKY DISTRICT
MONASTYRSHCHINSKY DISTRICT	ENNAME	MONASTYRSHCHINSKY DISTRICT
RUDNYANSKY DISTRICT, SMOLENSK OBLAST	ENNAME	RUDNYANSKY DISTRICT
TYOMKINSKY DISTRICT	ENNAME	TYOMKINSKY DISTRICT
UGRANSKY DISTRICT	ENNAME	UGRANSKY DISTRICT
KHOLM-ZHIRKOVSKY DISTRICT	ENNAME	KHOLM-ZHIRKOVSKY DISTRICT
YARTSEVSKY DISTRICT	ENNAME	YARTSEVSKY DISTRICT
SYCHYOVSKY DISTRICT	ENNAME	SYCHYOVSKY DISTRICT
VELIZHSKY DISTRICT	ENNAME	VELIZHSKY DISTRICT
SMOLENSKY DISTRICT, SMOLENSK OBLAST	ENNAME	SMOLENSKY DISTRICT
VYAZEMSKY DISTRICT, SMOLENSK OBLAST	ENNAME	VYAZEMSKY DISTRICT
YERSHICHSKY DISTRICT	ENNAME	YERSHICHSKY DISTRICT
YELNINSKY DISTRICT	ENNAME	YELNINSKY DISTRICT
ARTYOMOVSKY DISTRICT	ENNAME	ARTYOMOVSKY DISTRICT
BOGDANOVICHSKY DISTRICT	ENNAME	BOGDANOVICHSKY DISTRICT
GARINSKY DISTRICT	ENNAME	GARINSKY DISTRICT
BAYKALOVSKY DISTRICT	ENNAME	BAYKALOVSKY DISTRICT
ALAPAYEVSKY DISTRICT	ENNAME	ALAPAYEVSKY DISTRICT
ACHITSKY DISTRICT	ENNAME	ACHITSKY DISTRICT
KAMENSKY DISTRICT, SVERDLOVSK OBLAST	ENNAME	KAMENSKY DISTRICT
IRBITSKY DISTRICT	ENNAME	IRBITSKY DISTRICT
BELOYARSKY DISTRICT, SVERDLOVSK OBLAST	ENNAME	BELOYARSKY DISTRICT
ARTINSKY DISTRICT	ENNAME	ARTINSKY DISTRICT
KRASNOUFIMSKY DISTRICT	ENNAME	KRASNOUFIMSKY DISTRICT
KAMYSHLOVSKY DISTRICT	ENNAME	KAMYSHLOVSKY DISTRICT
NOVOLYALINSKY DISTRICT	ENNAME	NOVOLYALINSKY DISTRICT
NIZHNESERGINSKY DISTRICT	ENNAME	NIZHNESERGINSKY DISTRICT
NEVYANSKY DISTRICT	ENNAME	NEVYANSKY DISTRICT
SEROVSKY DISTRICT	ENNAME	SEROVSKY DISTRICT
REZHEVSKY DISTRICT	ENNAME	REZHEVSKY DISTRICT
PYSHMINSKY DISTRICT	ENNAME	PYSHMINSKY DISTRICT
SUKHOLOZHSKY DISTRICT	ENNAME	SUKHOLOZHSKY DISTRICT
PRIGORODNY DISTRICT, SVERDLOVSK OBLAST	ENNAME	PRIGORODNY DISTRICT
TAVDINSKY DISTRICT	ENNAME	TAVDINSKY DISTRICT
TABORINSKY DISTRICT	ENNAME	TABORINSKY DISTRICT
TURINSKY DISTRICT	ENNAME	TURINSKY DISTRICT
SLOBODO-TURINSKY DISTRICT	ENNAME	SLOBODO-TURINSKY DISTRICT
SYSERTSKY DISTRICT	ENNAME	SYSERTSKY DISTRICT
SHALINSKY DISTRICT, SVERDLOVSK OBLAST	ENNAME	SHALINSKY DISTRICT
VERKHOTURSKY DISTRICT	ENNAME	VERKHOTURSKY DISTRICT
TUGULYMSKY DISTRICT	ENNAME	TUGULYMSKY DISTRICT
BONDARSKY DISTRICT	ENNAME	BONDARSKY DISTRICT
GAVRILOVSKY DISTRICT	ENNAME	GAVRILOVSKY DISTRICT
VERKHNESALDINSKY DISTRICT	ENNAME	VERKHNESALDINSKY DISTRICT
INZHAVINSKY DISTRICT	ENNAME	INZHAVINSKY DISTRICT
TALITSKY DISTRICT	ENNAME	TALITSKY DISTRICT
MICHURINSKY DISTRICT	ENNAME	MICHURINSKY DISTRICT
KIRSANOVSKY DISTRICT	ENNAME	KIRSANOVSKY DISTRICT
MORDOVSKY DISTRICT	ENNAME	MORDOVSKY DISTRICT
PICHAYEVSKY DISTRICT	ENNAME	PICHAYEVSKY DISTRICT
PERVOMAYSKY DISTRICT, TAMBOV OBLAST	ENNAME	PERVOMAYSKY DISTRICT
PETROVSKY DISTRICT, TAMBOV OBLAST	ENNAME	PETROVSKY DISTRICT
MORSHANSKY DISTRICT	ENNAME	MORSHANSKY DISTRICT
MUCHKAPSKY DISTRICT	ENNAME	MUCHKAPSKY DISTRICT
RZHAKSINSKY DISTRICT	ENNAME	RZHAKSINSKY DISTRICT
SAMPURSKY DISTRICT	ENNAME	SAMPURSKY DISTRICT
RASSKAZOVSKY DISTRICT	ENNAME	RASSKAZOVSKY DISTRICT
TOKARYOVSKY DISTRICT	ENNAME	TOKARYOVSKY DISTRICT
UVAROVSKY DISTRICT	ENNAME	UVAROVSKY DISTRICT
UMYOTSKY DISTRICT	ENNAME	UMYOTSKY DISTRICT
TAMBOVSKY DISTRICT, TAMBOV OBLAST	ENNAME	TAMBOVSKY DISTRICT
BAKCHARSKY DISTRICT	ENNAME	BAKCHARSKY DISTRICT
KOLPASHEVSKY DISTRICT	ENNAME	KOLPASHEVSKY DISTRICT
SOSNOVSKY DISTRICT, TAMBOV OBLAST	ENNAME	SOSNOVSKY DISTRICT
ASINOVSKY DISTRICT	ENNAME	ASINOVSKY DISTRICT
STAROYURYEVSKY DISTRICT	ENNAME	STAROYURYEVSKY DISTRICT
CHAINSKY DISTRICT	ENNAME	CHAINSKY DISTRICT
ZHERDEVSKY DISTRICT	ENNAME	ZHERDEVSKY DISTRICT
NIKIFOROVSKY DISTRICT	ENNAME	NIKIFOROVSKY DISTRICT
KRIVOSHEINSKY DISTRICT	ENNAME	KRIVOSHEINSKY DISTRICT
PARABELSKY DISTRICT	ENNAME	PARABELSKY DISTRICT
SHEGARSKY DISTRICT	ENNAME	SHEGARSKY DISTRICT
TEGULDETSKY DISTRICT	ENNAME	TEGULDETSKY DISTRICT
VERKHNEKETSKY DISTRICT	ENNAME	VERKHNEKETSKY DISTRICT
ZYRYANSKY DISTRICT	ENNAME	ZYRYANSKY DISTRICT
TOMSKY DISTRICT	ENNAME	TOMSKY DISTRICT
KAMENSKY DISTRICT, TULA OBLAST	ENNAME	KAMENSKY DISTRICT
PERVOMAYSKY DISTRICT, TOMSK OBLAST	ENNAME	PERVOMAYSKY DISTRICT
BOGORODITSKY DISTRICT	ENNAME	BOGORODITSKY DISTRICT
CHERNSKY DISTRICT	ENNAME	CHERNSKY DISTRICT
DUBENSKY DISTRICT, TULA OBLAST	ENNAME	DUBENSKY DISTRICT
KIMOVSKY DISTRICT	ENNAME	KIMOVSKY DISTRICT
KURKINSKY DISTRICT	ENNAME	KURKINSKY DISTRICT
KOZHEVNIKOVSKY DISTRICT	ENNAME	KOZHEVNIKOVSKY DISTRICT
ALEKSINSKY DISTRICT	ENNAME	ALEKSINSKY DISTRICT
BELYOVSKY DISTRICT	ENNAME	BELYOVSKY DISTRICT
PLAVSKY DISTRICT	ENNAME	PLAVSKY DISTRICT
KIREYEVSKY DISTRICT	ENNAME	KIREYEVSKY DISTRICT
ODOYEVSKY DISTRICT	ENNAME	ODOYEVSKY DISTRICT
LENINSKY DISTRICT, TULA OBLAST	ENNAME	LENINSKY DISTRICT
MOLCHANOVSKY DISTRICT	ENNAME	MOLCHANOVSKY DISTRICT
TYOPLO-OGARYOVSKY DISTRICT	ENNAME	TYOPLO-OGARYOVSKY DISTRICT
UZLOVSKY DISTRICT	ENNAME	UZLOVSKY DISTRICT
NOVOMOSKOVSKY DISTRICT	ENNAME	NOVOMOSKOVSKY DISTRICT
SHCHYOKINSKY DISTRICT	ENNAME	SHCHYOKINSKY DISTRICT
YASNOGORSKY DISTRICT	ENNAME	YASNOGORSKY DISTRICT
SUVOROVSKY DISTRICT	ENNAME	SUVOROVSKY DISTRICT
BELSKY DISTRICT, TVER OBLAST	ENNAME	BELSKY DISTRICT
YEFREMOVSKY DISTRICT	ENNAME	YEFREMOVSKY DISTRICT
ZAOKSKY DISTRICT	ENNAME	ZAOKSKY DISTRICT
VOLOVSKY DISTRICT, TULA OBLAST	ENNAME	VOLOVSKY DISTRICT
ARSENYEVSKY DISTRICT	ENNAME	ARSENYEVSKY DISTRICT
VENYOVSKY DISTRICT	ENNAME	VENYOVSKY DISTRICT
BEZHETSKY DISTRICT	ENNAME	BEZHETSKY DISTRICT
BOLOGOVSKY DISTRICT	ENNAME	BOLOGOVSKY DISTRICT
KALYAZINSKY DISTRICT	ENNAME	KALYAZINSKY DISTRICT
FIROVSKY DISTRICT	ENNAME	FIROVSKY DISTRICT
LESNOY DISTRICT	ENNAME	LESNOY DISTRICT
KUVSHINOVSKY DISTRICT	ENNAME	KUVSHINOVSKY DISTRICT
KALININSKY DISTRICT, TVER OBLAST	ENNAME	KALININSKY DISTRICT
KIMRSKY DISTRICT	ENNAME	KIMRSKY DISTRICT
MOLOKOVSKY DISTRICT	ENNAME	MOLOKOVSKY DISTRICT
KESOVOGORSKY DISTRICT	ENNAME	KESOVOGORSKY DISTRICT
KRASNOKHOLMSKY DISTRICT	ENNAME	KRASNOKHOLMSKY DISTRICT
KONAKOVSKY DISTRICT	ENNAME	KONAKOVSKY DISTRICT
MAKSATIKHINSKY DISTRICT	ENNAME	MAKSATIKHINSKY DISTRICT
NELIDOVSKY DISTRICT	ENNAME	NELIDOVSKY DISTRICT
OLENINSKY DISTRICT	ENNAME	OLENINSKY DISTRICT
LIKHOSLAVLSKY DISTRICT	ENNAME	LIKHOSLAVLSKY DISTRICT
RZHEVSKY DISTRICT	ENNAME	RZHEVSKY DISTRICT
RAMESHKOVSKY DISTRICT	ENNAME	RAMESHKOVSKY DISTRICT
OSTASHKOVSKY DISTRICT	ENNAME	OSTASHKOVSKY DISTRICT
SELIZHAROVSKY DISTRICT	ENNAME	SELIZHAROVSKY DISTRICT
PENOVSKY DISTRICT	ENNAME	PENOVSKY DISTRICT
SANDOVSKY DISTRICT	ENNAME	SANDOVSKY DISTRICT
SONKOVSKY DISTRICT	ENNAME	SONKOVSKY DISTRICT
TOROPETSKY DISTRICT	ENNAME	TOROPETSKY DISTRICT
SPIROVSKY DISTRICT	ENNAME	SPIROVSKY DISTRICT
STARITSKY DISTRICT	ENNAME	STARITSKY DISTRICT
TORZHOKSKY DISTRICT	ENNAME	TORZHOKSKY DISTRICT
UDOMELSKY DISTRICT	ENNAME	UDOMELSKY DISTRICT
ABATSKY DISTRICT	ENNAME	ABATSKY DISTRICT
ZHARKOVSKY DISTRICT	ENNAME	ZHARKOVSKY DISTRICT
ZUBTSOVSKY DISTRICT	ENNAME	ZUBTSOVSKY DISTRICT
ZAPADNODVINSKY DISTRICT	ENNAME	ZAPADNODVINSKY DISTRICT
AROMASHEVSKY DISTRICT	ENNAME	AROMASHEVSKY DISTRICT
VESYEGONSKY DISTRICT	ENNAME	VESYEGONSKY DISTRICT
ARMIZONSKY DISTRICT	ENNAME	ARMIZONSKY DISTRICT
VYSHNEVOLOTSKY DISTRICT	ENNAME	VYSHNEVOLOTSKY DISTRICT
GOLYSHMANOVSKY DISTRICT	ENNAME	GOLYSHMANOVSKY DISTRICT
BERDYUZHSKY DISTRICT	ENNAME	BERDYUZHSKY DISTRICT
ISETSKY DISTRICT	ENNAME	ISETSKY DISTRICT
NIZHNETAVDINSKY DISTRICT	ENNAME	NIZHNETAVDINSKY DISTRICT
ISHIMSKY DISTRICT	ENNAME	ISHIMSKY DISTRICT
KAZANSKY DISTRICT	ENNAME	KAZANSKY DISTRICT
UPOROVSKY DISTRICT	ENNAME	UPOROVSKY DISTRICT
YALUTOROVSKY DISTRICT	ENNAME	YALUTOROVSKY DISTRICT
TOBOLSKY DISTRICT	ENNAME	TOBOLSKY DISTRICT
OMUTINSKY DISTRICT	ENNAME	OMUTINSKY  DISTRICT
VIKULOVSKY DISTRICT	ENNAME	VIKULOVSKY DISTRICT
TYUMENSKY DISTRICT	ENNAME	TYUMENSKY DISTRICT
UVATSKY DISTRICT	ENNAME	UVATSKY DISTRICT
SOROKINSKY DISTRICT	ENNAME	SOROKINSKY DISTRICT
VAGAYSKY DISTRICT	ENNAME	VAGAYSKY DISTRICT
ZAVODOUKOVSKY DISTRICT	ENNAME	ZAVODOUKOVSKY DISTRICT
YARKOVSKY DISTRICT	ENNAME	YARKOVSKY DISTRICT
YURGINSKY DISTRICT, TYUMEN OBLAST	ENNAME	YURGINSKY DISTRICT
CHERDAKLINSKY DISTRICT	ENNAME	CHERDAKLINSKY DISTRICT
BARYSHSKY DISTRICT	ENNAME	BARYSHSKY DISTRICT
INZENSKY DISTRICT	ENNAME	INZENSKY DISTRICT
MAYNSKY DISTRICT	ENNAME	MAYNSKY DISTRICT
MELEKESSKY DISTRICT	ENNAME	MELEKESSKY DISTRICT
KUZOVATOVSKY DISTRICT	ENNAME	KUZOVATOVSKY DISTRICT
NOVOMALYKLINSKY DISTRICT	ENNAME	NOVOMALYKLINSKY DISTRICT
BAZARNOSYZGANSKY DISTRICT	ENNAME	BAZARNOSYZGANSKY DISTRICT
KARSUNSKY DISTRICT	ENNAME	KARSUNSKY DISTRICT
RADISHCHEVSKY DISTRICT	ENNAME	RADISHCHEVSKY DISTRICT
NIKOLAYEVSKY DISTRICT, ULYANOVSK OBLAST	ENNAME	NIKOLAYEVSKY DISTRICT
NOVOSPASSKY DISTRICT	ENNAME	NOVOSPASSKY DISTRICT
PAVLOVSKY DISTRICT, ULYANOVSK OBLAST	ENNAME	PAVLOVSKY DISTRICT
SENGILEYEVSKY DISTRICT	ENNAME	SENGILEYVSKY DISTRICT
TSILNINSKY DISTRICT	ENNAME	TSILNINSKY DISTRICT
STAROKULATKINSKY DISTRICT	ENNAME	STAROKULATKINSKY DISTRICT
SURSKY DISTRICT	ENNAME	SURSKY DISTRICT
TERENGULSKY DISTRICT	ENNAME	TERENGULSKY DISTRICT
STAROMAYNSKY DISTRICT	ENNAME	STAROMAYNSKY DISTRICT
VESHKAYMSKY DISTRICT	ENNAME	VESHKAYMSKY DISTRICT
ULYANOVSKY DISTRICT, ULYANOVSK OBLAST	ENNAME	ULYANOVSKY DISTRICT
MUROMSKY DISTRICT	ENNAME	MUROMSKY DISTRICT
KOLCHUGINSKY DISTRICT	ENNAME	KOLCHUGINSKY DISTRICT
MELENKOVSKY DISTRICT	ENNAME	MELENKOVSKY DISTRICT
KUMYLZHENSKY DISTRICT	ENNAME	KUMYLZHENSKY DISTRICT
KALACHYOVSKY DISTRICT	ENNAME	KALACHYOVSKY DISTRICT
KOTELNIKOVSKY DISTRICT	ENNAME	KOTELNIKOVSKY DISTRICT
KOTOVSKY DISTRICT	ENNAME	KOTOVSKY DISTRICT
DUBOVSKY DISTRICT, VOLGOGRAD OBLAST	ENNAME	DUBOVSKY DISTRICT
ILOVLINSKY DISTRICT	ENNAME	ILOVLINSKY DISTRICT
KLETSKY DISTRICT	ENNAME	KLETSKY DISTRICT
CHERNYSHKOVSKY DISTRICT	ENNAME	CHERNYSHKOVSKY DISTRICT
DANILOVSKY DISTRICT, VOLGOGRAD OBLAST	ENNAME	DANILOVSKY DISTRICT
KIKVIDZENSKY DISTRICT	ENNAME	KIKVIDZENSKY DISTRICT
FROLOVSKY DISTRICT	ENNAME	FROLOVSKY DISTRICT
BYKOVSKY DISTRICT	ENNAME	BYKOVSKY DISTRICT
ALEXEYEVSKY DISTRICT, VOLGOGRAD OBLAST	ENNAME	ALEXEYEVSKY DISTRICT
VYAZNIKOVSKY DISTRICT	ENNAME	VYAZNIKOVSKY DISTRICT
SUZDALSKY DISTRICT	ENNAME	SUZDALSKY DISTRICT
SELIVANOVSKY DISTRICT	ENNAME	SELIVANOVSKY DISTRICT
SOBINSKY DISTRICT	ENNAME	SOBINSKY DISTRICT
SUDOGODSKY DISTRICT	ENNAME	SUDOGODSKY DISTRICT
GUS-KHRUSTALNY DISTRICT	ENNAME	GUS-KHRUSTALNY DISTRICT
PETUSHINSKY DISTRICT	ENNAME	PETUSHINSKY DISTRICT
KAMESHKOVSKY DISTRICT	ENNAME	KAMESHKOVSKY DISTRICT
KIRZHACHSKY DISTRICT	ENNAME	KIRZHACHSKY DISTRICT
LENINSKY DISTRICT, VOLGOGRAD OBLAST	ENNAME	LENINSKY DISTRICT
OLKHOVSKY DISTRICT	ENNAME	OLKHOVSKY DISTRICT
MIKHAYLOVSKY DISTRICT, VOLGOGRAD OBLAST	ENNAME	MIKHAYLOVSKY DISTRICT
NOVOANNINSKY DISTRICT	ENNAME	NOVOANNINSKY DISTRICT
RUDNYANSKY DISTRICT, VOLGOGRAD OBLAST	ENNAME	RUDNYANSKY DISTRICT
NIKOLAYEVSKY DISTRICT, VOLGOGRAD OBLAST	ENNAME	NIKOLAYEVSKY DISTRICT
SERAFIMOVICHSKY DISTRICT	ENNAME	SERAFIMOVICHSKY DISTRICT
NEKHAYEVSKY DISTRICT	ENNAME	NEKHAYEVSKY DISTRICT
STAROPOLTAVSKY DISTRICT	ENNAME	STAROPOLTAVSKY DISTRICT
PALLASOVSKY DISTRICT	ENNAME	PALLASOVSKY DISTRICT
SREDNEAKHTUBINSKY DISTRICT	ENNAME	SREDNEAKHTUBINSKY DISTRICT
SUROVIKINSKY DISTRICT	ENNAME	SUROVIKINSKY DISTRICT
SVETLOYARSKY DISTRICT	ENNAME	SVETLOYARSKY DISTRICT
URYUPINSKY DISTRICT	ENNAME	URYUPINSKY DISTRICT
YELANSKY DISTRICT	ENNAME	YELANSKY DISTRICT
ZHIRNOVSKY DISTRICT	ENNAME	ZHIRNOVSKY DISTRICT
ANNINSKY DISTRICT	ENNAME	ANNINSKY DISTRICT
KALACHEYEVSKY DISTRICT	ENNAME	KALACHEYEVSKY DISTRICT
BOBROVSKY DISTRICT	ENNAME	BOBROVSKY DISTRICT
ERTILSKY DISTRICT	ENNAME	ERTILSKY DISTRICT
KASHIRSKY DISTRICT, VORONEZH OBLAST	ENNAME	KASHIRSKY DISTRICT
KAMENSKY DISTRICT, VORONEZH OBLAST	ENNAME	KAMENSKY DISTRICT
KANTEMIROVSKY DISTRICT	ENNAME	KANTEMIROVSKY DISTRICT
BOGUCHARSKY DISTRICT	ENNAME	BOGUCHARSKY DISTRICT
KHOKHOLSKY DISTRICT	ENNAME	KHOKHOLSKY DISTRICT
BUTURLINOVSKY DISTRICT	ENNAME	BUTURLINOVSKY DISTRICT
NIZHNEDEVITSKY DISTRICT	ENNAME	NIZHNEDEVITSKY DISTRICT
NOVOKHOPYORSKY DISTRICT	ENNAME	NOVOKHOPYORSKY DISTRICT
NOVOUSMANSKY DISTRICT	ENNAME	NOVOUSMANSKY DISTRICT
OSTROGOZHSKY DISTRICT	ENNAME	OSTROGOZHSKY DISTRICT
TALOVSKY DISTRICT	ENNAME	TALOVSKY DISTRICT
OLKHOVATSKY DISTRICT	ENNAME	OLKHOVATSKY DISTRICT
POVORINSKY DISTRICT	ENNAME	POVORINSKY DISTRICT
REPYOVSKY DISTRICT	ENNAME	REPYOVSKY DISTRICT
GRIBANOVSKY DISTRICT	ENNAME	GRIBANOVSKY DISTRICT
PETROPAVLOVSKY DISTRICT, VORONEZH OBLAST	ENNAME	PETROPAVLOVSKY DISTRICT
ROSSOSHANSKY DISTRICT	ENNAME	ROSSOSHANSKY DISTRICT
KALININSKY DISTRICT, SAINT PETERSBURG	ENNAME	KALININSKY DISTRICT
RAMONSKY DISTRICT	ENNAME	RAMONSKY DISTRICT
VOROBYOVSKY DISTRICT	ENNAME	VOROBYOVSKY DISTRICT
SEMILUKSKY DISTRICT	ENNAME	SEMILUKSKY DISTRICT
TERNOVSKY DISTRICT	ENNAME	TERNOVSKY DISTRICT
PRIMORSKY DISTRICT, SAINT PETERSBURG	ENNAME	PRIMORSKY DISTRICT
VERKHNEKHAVSKY DISTRICT	ENNAME	VERKHNEKHAVSKY DISTRICT
VERKHNEMAMONSKY DISTRICT	ENNAME	VERKHNEMAMONSKY DISTRICT
PANINSKY DISTRICT	ENNAME	PANINSKY DISTRICT
PODGORENSKY DISTRICT	ENNAME	PODGORENSKY DISTRICT
PAVLOVSKY DISTRICT, VORONEZH OBLAST	ENNAME	PAVLOVSKY DISTRICT
BIBIREVO DISTRICT	ENNAME	BIBIREVO DISTRICT
OTRADNOYE DISTRICT	ENNAME	OTRADNOYE DISTRICT
MITINO DISTRICT	ENNAME	MITINO
DANILOVSKY DISTRICT, MOSCOW	ENNAME	DANILOVSKY DISTRICT, MOSCOW
DONSKOY DISTRICT	ENNAME	DONSKOY DISTRICT
BIRYULYOVO VOSTOCHNOYE DISTRICT	ENNAME	BIRYULYOVO VOSTOCHNOYE DISTRICT
CHERTANOVO SEVERNOYE DISTRICT	ENNAME	CHERTANOVO SEVERNOYE DISTRICT
NAGORNY DISTRICT	ENNAME	NAGORNY DISTRICT
YUZHNOPORTOVY DISTRICT	ENNAME	YUZHNOPORTOVY DISTRICT
NAGATINO-SADOVNIKI DISTRICT	ENNAME	NAGATINO-SADOVNIKI DISTRICT
KAPOTNYA DISTRICT	ENNAME	KAPOTNYA DISTRICT
KRASNOSELKUPSKY DISTRICT	ENNAME	KRASNOSELKUPSKY DISTRICT
TAZOVSKY DISTRICT	ENNAME	TAZOVSKY DISTRICT
PRIURALSKY DISTRICT	ENNAME	PRIURALSKY DISTRICT
YAMALSKY DISTRICT	ENNAME	YAMALSKY DISTRICT
BELOYARSKY DISTRICT, KHANTY-MANSI AUTONOMOUS OKRUG	ENNAME	BELOYARSKY DISTRICT
PUROVSKY DISTRICT	ENNAME	PUROVSKY DISTRICT
OKTYABRSKY DISTRICT, KHANTY-MANSI AUTONOMOUS OKRUG	ENNAME	OKTYABRSKY DISTRICT
SURGUTSKY DISTRICT	ENNAME	SURGUTSKY DISTRICT
KONDINSKY DISTRICT	ENNAME	KONDINSKY DISTRICT
NEFTEYUGANSKY DISTRICT	ENNAME	NEFTEYUGANSKY DISTRICT
SOVETSKY DISTRICT, KHANTY-MANSI AUTONOMOUS OKRUG	ENNAME	SOVETSKY DISTRICT
KHANTY-MANSIYSKY DISTRICT	ENNAME	KHANTY-MANSIYSKY DISTRICT
NIZHNEVARTOVSKY DISTRICT	ENNAME	NIZHNEVARTOVSKY DISTRICT
SHURYSHKARSKY DISTRICT	ENNAME	SHURYSHKARSKY DISTRICT
ALARSKY DISTRICT	ENNAME	ALARSKY DISTRICT
BAYANDAYEVSKY DISTRICT	ENNAME	BAYANDAYEVSKY DISTRICT
NUKUTSKY DISTRICT	ENNAME	NUKUTSKY DISTRICT
OSINSKY DISTRICT, IRKUTSK OBLAST	ENNAME	OSINSKY DISTRICT
EKHIRIT-BULAGATSKY DISTRICT	ENNAME	EKHIRIT-BULAGATSKY DISTRICT
KANDALAKSHSKY DISTRICT	ENNAME	KANDALAKSHSKY DISTRICT
BALTIYSKY DISTRICT, KALININGRAD OBLAST	ENNAME	BALTIYSKY DISTRICT
SVETLOGORSKY DISTRICT	ENNAME	SVETLOGORSKY DISTRICT
NOVONIKOLAYEVSKY DISTRICT	ENNAME	NOVONIKOLAYEVSKY DISTRICT
KHOSTINSKY CITY DISTRICT	ENNAME	KHOSTINSKY CITY DISTRICT
LAZAREVSKY CITY DISTRICT	ENNAME	LAZAREVSKY CITY DISTRICT
