Azores	highestRegion	Pico Island
Lisbon	highestRegion	Benfica (Lisbon)
Madeira	highestRegion	Santana, Madeira
Great Dividing Range	highestRegion	Snowy Mountains
Peak District	highestRegion	Derbyshire
Scandinavian Mountains	highestRegion	Oppland
Corvo Island	highestRegion	Vila do Corvo (Azores)
Flores Island (Azores)	highestRegion	Santa Cruz das Flores (parish)
Eastern Ghats	highestRegion	Araku Valley
Adirondack Park	highestRegion	Essex County, New York
Camarate	highestRegion	Camarate (Loures)
Terceira Island	highestRegion	Santa Bárbara (Angra do Heroísmo)
Porto Santo Island	highestRegion	Porto Santo (Madeira)
Almada Municipality	highestRegion	Almada (parish)
Kikai Caldera	highestRegion	Ōsumi Islands
Babe (Bragança)	highestRegion	Babe (Bragança)
Praia da Vitória	highestRegion	Agualva (Praia da Vitória)
Vila do Porto (Azores)	highestRegion	Santa Bárbara (Vila do Porto)
Angra do Heroísmo	highestRegion	Santa Bárbara (Angra do Heroísmo)
Guadalupe (Santa Cruz da Graciosa)	highestRegion	Santa Cruz da Graciosa (Azores)
Velas (Azores)	highestRegion	Manadas
São Mateus (Madalena)	highestRegion	São Mateus (Madalena)
São Jorge Island	highestRegion	Norte Grande (Azores)
Calheta (Azores)	highestRegion	Ribeira Seca (Calheta)
Ribeira Seca (Calheta)	highestRegion	Ribeira Seca (Calheta)
Santo Antão (Calheta)	highestRegion	Santo Antão (Calheta)
Topo (Calheta)	highestRegion	Topo (Calheta)
Nossa Senhora do Rosário	highestRegion	Nossa Senhora do Rosário
Calheta, Madeira	highestRegion	Arco da Calheta
Santa Cruz das Flores (Azores)	highestRegion	Santa Cruz das Flores (parish)
Lajes das Flores (Azores)	highestRegion	Lajes das Flores (parish)
Lajedo (Lajes das Flores)	highestRegion	Lajedo (village)
Mosteiro (Lajes das Flores)	highestRegion	Lomba (Lajes das Flores)
Horta (Azores)	highestRegion	Flamengos
Faial Island	highestRegion	Flamengos
Flamengos	highestRegion	Horta (Azores)
Madalena (Azores)	highestRegion	Madalena (parish)
Candelária (Ponta Delgada)	highestRegion	Candelária (Ponta Delgada)
Candelária (Madalena)	highestRegion	Candelária (Madalena)
São Caetano (Madalena)	highestRegion	São Caetano (Madalena)
São Roque do Pico (Azores)	highestRegion	Santa Luzia (São Roque do Pico)
Prainha (São Roque do Pico)	highestRegion	Prainha (São Roque do Pico)
Santa Luzia (São Roque do Pico)	highestRegion	Santa Luzia (São Roque do Pico)
Santo Amaro (São Roque do Pico)	highestRegion	Santo Amaro (São Roque do Pico)
Santo António (São Roque do Pico)	highestRegion	Santa Luzia (São Roque do Pico)
Lajes do Pico (Azores)	highestRegion	São João (Lajes do Pico)
Ribeirinha (Lajes do Pico)	highestRegion	Ribeirinha (Lajes do Pico)
São João (Lajes do Pico)	highestRegion	São João (Lajes do Pico)
Feteira (Angra do Heroísmo)	highestRegion	Feteira (Angra do Heroísmo)
Nossa Senhora da Conceição	highestRegion	Blessed Virgin Mary (Roman Catholic)
Ribeirinha (Angra do Heroísmo)	highestRegion	Ribeirinha (Angra do Heroísmo)
Santa Bárbara (Angra do Heroísmo)	highestRegion	Santa Bárbara (Angra do Heroísmo)
Santa Luzia (Angra do Heroísmo)	highestRegion	Saint Lucy
São Bento (Angra do Heroísmo)	highestRegion	São Bento (Angra do Heroísmo)
São Pedro (Angra do Heroísmo)	highestRegion	Saint Peter
Sé (Angra do Heroísmo)	highestRegion	Sé (Angra do Heroísmo)
Serreta (Azores)	highestRegion	Serreta (Azores)
Agualva (Praia da Vitória)	highestRegion	Agualva (Praia da Vitória)
São Brás (Praia da Vitória)	highestRegion	São Brás (Praia da Vitória)
Vila Nova (Praia da Vitória)	highestRegion	Vila Nova (Praia da Vitória)
Capelas	highestRegion	Candelária (Ponta Delgada)
Ginetes	highestRegion	São Sebastião (Ginetes)
Livramento (Ponta Delgada)	highestRegion	Livramento (Ponta Delgada)
Santa Bárbara (Ponta Delgada)	highestRegion	Santa Bárbara (Ponta Delgada)
Santa Clara (Ponta Delgada)	highestRegion	Santa Clara (Ponta Delgada)
Santo António (Ponta Delgada)	highestRegion	Santo António (Ponta Delgada)
São José (Ponta Delgada)	highestRegion	São José (Ponta Delgada)
São Roque, Ponta Delgada	highestRegion	São Roque, Ponta Delgada
São Pedro (Ponta Delgada)	highestRegion	Saint Peter
São Sebastião (Ponta Delgada)	highestRegion	São Sebastião (Ponta Delgada)
Lagoa (Azores)	highestRegion	Água de Pau
Santa Cruz (Lagoa)	highestRegion	Santa Cruz (Lagoa)
Ribeira Grande (Azores)	highestRegion	Ribeira Seca (Ribeira Grande)
Conceição (Ribeira Grande)	highestRegion	Conceição (Ribeira Grande)
Matriz (Ribeira Grande)	highestRegion	Matriz (Ribeira Grande)
Ribeirinha (Ribeira Grande)	highestRegion	Ribeirinha (Ribeira Grande)
Mosteiros (Ponta Delgada)	highestRegion	Mosteiros (Ponta Delgada)
Vila Franca do Campo (Azores)	highestRegion	Água de Alto
São Miguel (Vila Franca do Campo)	highestRegion	São Miguel (Vila Franca do Campo)
São Pedro (Vila Franca do Campo)	highestRegion	São Pedro (Vila Franca do Campo)
Povoação (Azores)	highestRegion	Nossa Senhora dos Remédios (Povoação)
Nossa Senhora dos Remédios (Povoação)	highestRegion	Nossa Senhora dos Remédios (Povoação)
Nordeste (Azores)	highestRegion	Nordeste (parish)
Graciosa	highestRegion	Santa Cruz da Graciosa (Azores)
São Pedro de Nordestinho	highestRegion	Santo António de Nordestinho
Santa Maria Island	highestRegion	Santa Bárbara (Vila do Porto)
Almagreira (Vila do Porto)	highestRegion	Almagreira (Vila do Porto)
São Pedro (Vila do Porto)	highestRegion	São Pedro (Vila do Porto)
Santa Bárbara (Vila do Porto)	highestRegion	Almagreira (Vila do Porto)
Porto Santo (Madeira)	highestRegion	Porto Santo (parish)
Machico	highestRegion	Machico (parish)
Santana, Madeira	highestRegion	Madeira
Santa Maria de Belém	highestRegion	Blessed Virgin Mary (Roman Catholic)
Seixal (Porto Moniz)	highestRegion	Seixal (Porto Moniz)
Campanário, Madeira	highestRegion	Campanário, Madeira
Cabo Girão	highestRegion	Câmara de Lobos (parish)
São Roque (Funchal)	highestRegion	São Roque (Funchal)
Albergaria-a-Velha Municipality	highestRegion	Albergaria-a-Velha Municipality
Bragança District	highestRegion	França (Bragança)
Sé (Funchal)	highestRegion	Sé (Funchal)
Ponta do Sol, Madeira	highestRegion	Ponta do Sol (parish)
Shiretoko Peninsula	highestRegion	Hokkaido
Desertas Islands	highestRegion	Santa Cruz, Madeira (parish)
Felgueiras (Resende)	highestRegion	Felgueiras (Resende)
Portela (Loures)	highestRegion	Portela (Loures)
Teshio Mountains	highestRegion	Hokkaido
Vila do Porto (parish)	highestRegion	Vila do Porto (Azores)
Favaios (Alijó)	highestRegion	Favaios (Alijó)
Horta (district)	highestRegion	Madalena (Azores)
Sierra de las Minas	highestRegion	Alta Verapaz Department
Chūgoku Mountains	highestRegion	Tottori Prefecture
Breheimen	highestRegion	Oppland
Ponta Delgada (Azores)	highestRegion	Sete Cidades (Ponta Delgada)
Pena (Lisbon)	highestRegion	Pena (Lisbon)
Kitami Mountains	highestRegion	Hokkaido
Santa Cruz da Graciosa (parish)	highestRegion	Santa Cruz da Graciosa (parish)
Mashike Mountains	highestRegion	Rumoi Subprefecture
Mashike Mountains	highestRegion	Sorachi Subprefecture
Shokanbetsudake Mountains	highestRegion	Rumoi Subprefecture
Shokanbetsudake Mountains	highestRegion	Sorachi Subprefecture
Faial Nature Park	highestRegion	Flamengos
Faial Botanical Garden	highestRegion	Flamengos
