LAKE ONTARIO	IMAGEBATHYMETRY	LAKE-ONTARIO.SVG
LAKE ERIE	IMAGEBATHYMETRY	LAKE-ERIE.SVG
LAKE MICHIGAN	IMAGEBATHYMETRY	LAKE-MICHIGAN.SVG
LAKE SUPERIOR	IMAGEBATHYMETRY	LAKE-SUPERIOR.SVG
ANDAMAN SEA	IMAGEBATHYMETRY	LOCATIONANDAMANSEA.PNG
LAKE HURON	IMAGEBATHYMETRY	LAKE-HURON.SVG
LAKE ZURICH	IMAGEBATHYMETRY	KARTE_ZüRICHSEE.PNG
LAKE PONTCHARTRAIN	IMAGEBATHYMETRY	LAKE_PONTCHARTRAIN.PNG
LAKE LUCERNE	IMAGEBATHYMETRY	KARTE_VIERWALDSTäTTERSEE.PNG
LAKE OF THE WOODS	IMAGEBATHYMETRY	LAKE-OF-THE-WOODS.PNG
PORT PHILLIP	IMAGEBATHYMETRY	PORTPHILLIP.GIF
SETO INLAND SEA	IMAGEBATHYMETRY	INLANDSEA.JPG
LAKE NASSER	IMAGEBATHYMETRY	EGYPT-REGION-MAP-CITIES-OASES.GIF
ACTON, ONTARIO	IMAGEBATHYMETRY	FAIRYLAKE_BATHYMETRY.PNG
LAKE MINNETONKA	IMAGEBATHYMETRY	LAKEMINNETONKABLUE.JPG
HOBSONS BAY	IMAGEBATHYMETRY	PORTPHILLIP.GIF
LAKE BALKHASH	IMAGEBATHYMETRY	LAKEBALKHASHBASINMAP.PNG
LAKE HéVíZ	IMAGEBATHYMETRY	HéVíZ.JPG
BAFFIN BAY	IMAGEBATHYMETRY	BAFFIN BAY, CANADA.SVG
LAKE ABAYA	IMAGEBATHYMETRY	CHAMOMAP.JPG
JERVIS BAY	IMAGEBATHYMETRY	JERVISBAYABOVE.JPG
LAKE VIDA	IMAGEBATHYMETRY	LAKE_VIDA.PNG
LAKE INARI	IMAGEBATHYMETRY	INARIJäRVI.PNG
LABRADOR SEA	IMAGEBATHYMETRY	LABRADORSEAMAP.PNG
MEDICINE LAKE VOLCANO	IMAGEBATHYMETRY	MEDICINELAKEBATHYMETRICMETERS20080926.PNG
BUTTERMERE	IMAGEBATHYMETRY	BUTTERMEREMAP.JPG
BEAR LAKE	IMAGEBATHYMETRY	BATHYMETRY.JPG
LAKE BODOM	IMAGEBATHYMETRY	BODOMINJäRVI.PNG
DELLEN	IMAGEBATHYMETRY	DELLEN.PNG
STORSJöN	IMAGEBATHYMETRY	STORSJöN IN SWEDEN.PNG
LOUGH ENNELL	IMAGEBATHYMETRY	CASTLETOWN_GEOGHEGAN_DETAIL_MAP_01.JPG
LAKE PäIJäNNE	IMAGEBATHYMETRY	PäIJäNNE.PNG
LOUGH FOYLE	IMAGEBATHYMETRY	LOUGHFOYLELOCATION.PNG
LAKE OHRID	IMAGEBATHYMETRY	FILE:OHRID AND PRESPA LAKES TOPOGRAPHIC MAP.SVG
MEDINA LAKE	IMAGEBATHYMETRY	US-TX-MEDINALAKE.PNG
DINOSAUR COVE	IMAGEBATHYMETRY	DINOSAURCOVE.PNG
LAKE CONROE	IMAGEBATHYMETRY	TXLAKECONROEMAP.JPG
LAKE SONOMA	IMAGEBATHYMETRY	LAKE_SONOMA_MAP.GIF
SCORESBY SOUND	IMAGEBATHYMETRY	GREENLAND.A2003233.1340.250M.JPG
SHUSWAP LAKE	IMAGEBATHYMETRY	SHUSWAPARMS.PNG
OULUJäRVI	IMAGEBATHYMETRY	OULUJARVIMAP.PNG
LAKE ZWAY	IMAGEBATHYMETRY	ETHIOPIA_CENTRAL_LAKES.JPG
HJäLMAREN	IMAGEBATHYMETRY	LA2-DEMIS-HJALMAREN.PNG
LAKE SHALA	IMAGEBATHYMETRY	ETHIOPIA_CENTRAL_LAKES.JPG
MESSALONSKEE LAKE	IMAGEBATHYMETRY	MESSALONSKEE_LAKE.SVG
SOMMEN	IMAGEBATHYMETRY	LA2-DEMIS-SOMMEN.PNG
BOREN	IMAGEBATHYMETRY	LA2-DEMIS-BOREN.PNG
PINK LAKE	IMAGEBATHYMETRY	PINK-LAKE-IN-FALL.JPG
HORNAVAN	IMAGEBATHYMETRY	SKELLEFTEALVEN_RIVER_MAP_CLOSER.GIF
LIMEBURNERS BAY	IMAGEBATHYMETRY	PORTPHILLIP.GIF
SETON LAKE	IMAGEBATHYMETRY	SETON-LAKE-OUTLINE.PNG
LAKE AFTON	IMAGEBATHYMETRY	MAP OF SEDGWICK CO, KS, USA.PNG
OFOTFJORD	IMAGEBATHYMETRY	UK-NWE-NORWAY-2.JPG
BEAUMARIS BAY	IMAGEBATHYMETRY	PORTPHILLIP.GIF
LAKE ABIJATTA	IMAGEBATHYMETRY	ETHIOPIA_CENTRAL_LAKES.JPG
STORAVAN	IMAGEBATHYMETRY	SKELLEFTEALVEN_RIVER_MAP_CLOSER.GIF
LAKE JACKSON	IMAGEBATHYMETRY	LAKE_JACKSON_TLH_FLORIDA.GIF
LAKE TALQUIN	IMAGEBATHYMETRY	LAKE_TALQUIN.GIF
YANGCHENG LAKE	IMAGEBATHYMETRY	YANGCHENGLAKEMAP.PNG
LAKE IAMONIA	IMAGEBATHYMETRY	LAKE_IAMONIA_FLORIDA.GIF
ELK CITY LAKE	IMAGEBATHYMETRY	MAP OF MONTGOMERY CO, KS, USA.PNG
ØYEREN	IMAGEBATHYMETRY	OYEREN.PNG
TUTTLE CREEK LAKE	IMAGEBATHYMETRY	MAP OF POTTAWATOMIE CO, KS, USA.PNG
LAKE SALTONSTALL	IMAGEBATHYMETRY	SALTONSTALL.GIF
MøSVATN	IMAGEBATHYMETRY	MOSVATN.PNG
ALSVåGVATNET	IMAGEBATHYMETRY	ALSVåGVATNET.PNG
CLINTON LAKE	IMAGEBATHYMETRY	MAP OF DOUGLAS CO, KS, USA.PNG
TYIN	IMAGEBATHYMETRY	LA2-DEMIS-BYGDIN-ANNOTATED.PNG
VINSTRE	IMAGEBATHYMETRY	LA2-DEMIS-BYGDIN-ANNOTATED.PNG
SELBUSJø	IMAGEBATHYMETRY	LA2-DEMIS-SELBUSJOEN.PNG
WILSON LAKE	IMAGEBATHYMETRY	MAP OF RUSSELL CO, KS, USA.PNG
LAKE LAFAYETTE	IMAGEBATHYMETRY	LAKE_LAFAYETTE_TLH.GIF
CHOKE CANYON RESERVOIR	IMAGEBATHYMETRY	CHOKECANYON.PNG
PERRY LAKE	IMAGEBATHYMETRY	MAP OF JEFFERSON CO, KS, USA.PNG
BIG HILL LAKE	IMAGEBATHYMETRY	MAP OF LABETTE CO, KS, USA.PNG
LOON LAKE	IMAGEBATHYMETRY	MAP_OF_NEW_YORK_HIGHLIGHTING_LOONLAKE.PNG
WRIGHT PATMAN LAKE	IMAGEBATHYMETRY	US-TX-WRIGHTPATMANLAKE.PNG
PUULA	IMAGEBATHYMETRY	PUULA.PNG
LAKE LANGANO	IMAGEBATHYMETRY	ETHIOPIA_CENTRAL_LAKES.JPG
LAKE CHAMO	IMAGEBATHYMETRY	CHAMOMAP.JPG
D'ENTRECASTEAUX CHANNEL	IMAGEBATHYMETRY	D'ENTRECASTEAUX.JPG
ZERVREILASEE	IMAGEBATHYMETRY	KARTE_ZERVREILASEE.PNG
BURGUMER MAR	IMAGEBATHYMETRY	BERGUMERMEER.PNG
EL DORADO LAKE	IMAGEBATHYMETRY	MAP OF BUTLER CO, KS, USA.PNG
DUCK LAKE	IMAGEBATHYMETRY	DUCK_LAKE_ALLAMAKEE_CTY.GIF
BIG LAKE	IMAGEBATHYMETRY	BIG_LAKE_IOWA.GIF
LAKE YALCHIK	IMAGEBATHYMETRY	YALCHIK.SVG
LAKE SEPPINGS	IMAGEBATHYMETRY	LAKE_SEPPINGS_DRAWING.JPG
LAKE LETAS	IMAGEBATHYMETRY	MAP-GAUA-VANUATU.PNG
HILLSDALE LAKE	IMAGEBATHYMETRY	MAP OF MIAMI CO, KS, USA.PNG
BUDD LAKE	IMAGEBATHYMETRY	BUDD_LAKE,_MICHIGAN.PNG
HARRIS LAKE	IMAGEBATHYMETRY	NCMAP-DOTON-HIGHLANDS.PNG
COTACOTANI LAKE	IMAGEBATHYMETRY	RíO-LAUCA.SVG
KALLAVESI	IMAGEBATHYMETRY	KALLAVESI.PNG
YLI-KITKA	IMAGEBATHYMETRY	YLI-KITKA.PNG
LAKE KIVIJäRVI	IMAGEBATHYMETRY	MAP-KIVIJARVI.SVG
MIR ALAM TANK	IMAGEBATHYMETRY	MIR-ALAM-TANK-2.JPG
LANALHUE LAKE	IMAGEBATHYMETRY	TXU-OCLC-224571178-SJ18-08.JPG
ENDEAVOUR STRAIT	IMAGEBATHYMETRY	TORRESSTRAITISLANDSMAP.PNG
TORONTO LAKE	IMAGEBATHYMETRY	MAP OF WOODSON CO, KS, USA.PNG
BONNY LAKES	IMAGEBATHYMETRY	BONNY_LAKE_WEST.JPG
MILFORD LAKE	IMAGEBATHYMETRY	MAP OF CLAY CO, KS, USA.PNG
CHEYENNE BOTTOMS	IMAGEBATHYMETRY	MAP OF BARTON CO, KS, USA.PNG
GRöSSINSEE	IMAGEBATHYMETRY	NUTHE_NIEPLITZ_SEEN_KERN.JPG
ARLESHEIMER SEE	IMAGEBATHYMETRY	FREIBURGERSEEN.PNG
WUHLEBECKEN	IMAGEBATHYMETRY	WUHLEBECKEN.JPG
DäMERITZSEE	IMAGEBATHYMETRY	SEEN-SUEDOST-BERLIN.PNG
RUPPINER SEE	IMAGEBATHYMETRY	RUPPINERSEE.GIF
MECHOWER SEE	IMAGEBATHYMETRY	WIEBEKINGRZ.JPG
LA ANGOSTURA LAKE	IMAGEBATHYMETRY	VISTA_DE_LA_POBLACIóN_DE_ARANI.JPG
JOHN REDMOND RESERVOIR	IMAGEBATHYMETRY	MAP OF COFFEY CO, KS, USA.PNG
WEBSTER LAKE	IMAGEBATHYMETRY	WEBSTER LAKE, INDIANA.PNG
IRISH SEA	IMAGEBATHYMETRY	IRISH SEA – RELIEF, PORTS, LIMITS.TIF
KHYARGAS NUUR	IMAGEBATHYMETRY	KHYARGAS NUUR AND AIRAG NUUR LAKES, MONGOLIA, LANDSAT IMAGE, 07-28-2015.JPG
CHURCHILL LAKE	IMAGEBATHYMETRY	CANADA.A2002236.1810.721.250M.JPG
KEITH SEBELIUS LAKE	IMAGEBATHYMETRY	MAP OF NORTON CO, KS, USA.PNG
WACONDA LAKE	IMAGEBATHYMETRY	MAP OF MITCHELL CO, KS, USA.PNG
KALHOVDFJORDEN	IMAGEBATHYMETRY	MOSVATN.PNG
WATER RESOURCES MANAGEMENT IN NICARAGUA	IMAGEBATHYMETRY	OMETEPEMAP.PNG
LAKE MUHAZI	IMAGEBATHYMETRY	SEEDSOFPEACE2.JPG
INDIAN LAKE	IMAGEBATHYMETRY	INDIAN_LAKE_SCENE,_NOBLES_COUNTY,_MN.JPG
RANCHO SECO RECREATIONAL PARK	IMAGEBATHYMETRY	RANCHOSECORECPARKWORLDWINDMAP.JPG
LAKE ZABUYE	IMAGEBATHYMETRY	ZABUYELAKE2.JPG
MARION RESERVOIR	IMAGEBATHYMETRY	MAP OF MARION CO, KS, USA.PNG
ADOLPHUS CHANNEL	IMAGEBATHYMETRY	TORRESSTRAITISLANDSMAP.PNG
SCHWIELOWSEE	IMAGEBATHYMETRY	SCHWIELOWSEE.PNG
MARION COUNTY LAKE	IMAGEBATHYMETRY	MAP OF MARION CO, KS, USA.PNG
SMALL PRESPA LAKE	IMAGEBATHYMETRY	OHRID AND PRESPA LAKES TOPOGRAPHIC MAP.SVG
JYVäSJäRVI	IMAGEBATHYMETRY	LOCATION OF JYVäSKYLä IN FINLAND.PNG
LOVEWELL RESERVOIR	IMAGEBATHYMETRY	MAP OF JEWELL CO, KS, USA.PNG
LAKE INMAN	IMAGEBATHYMETRY	MAP OF MCPHERSON CO, KS, USA.PNG
CEDAR BLUFF RESERVOIR	IMAGEBATHYMETRY	MAP OF TREGO CO, KS, USA.PNG
DöRGöN LAKE	IMAGEBATHYMETRY	DORGON LAKE, MONGOLIA, LANDSAT.JPG
KIRWIN RESERVOIR	IMAGEBATHYMETRY	MAP OF PHILLIPS CO, KS, USA.PNG
WEBSTER RESERVOIR	IMAGEBATHYMETRY	MAP OF ROOKS CO, KS, USA.PNG
KANOPOLIS LAKE	IMAGEBATHYMETRY	MAP OF ELLSWORTH CO, KS, USA.PNG
CHENEY RESERVOIR	IMAGEBATHYMETRY	MAP OF RENO CO, KS, USA.PNG
COUNCIL GROVE LAKE	IMAGEBATHYMETRY	MAP OF MORRIS CO, KS, USA.PNG
MELVERN LAKE	IMAGEBATHYMETRY	MAP OF OSAGE CO, KS, USA.PNG
NøKLEVANN	IMAGEBATHYMETRY	NøKLEVANN.SVG
OLDAMBTMEER	IMAGEBATHYMETRY	WINSCHOTEN-TOPOGRAFIE.JPG
FALL RIVER LAKE	IMAGEBATHYMETRY	MAP OF GREENWOOD CO, KS, USA.PNG
