BELFAST	IRISHNAME	BéAL FEIRSTE
DERRY	IRISHNAME	DOIRE/DOIRE CHOLMCILLE
ENNISKILLEN	IRISHNAME	INIS CEITHLEANN
LISNASKEA	IRISHNAME	LIOS NA SCéITHE
CARRICKFERGUS	IRISHNAME	CARRAIG ḞEARġAIS
CARRICKFERGUS	IRISHNAME	CARRAIG FHEARGHAIS
OMAGH	IRISHNAME	AN ÓMAIGH
BALLYCASTLE, COUNTY ANTRIM	IRISHNAME	BAILE AN CHAISTIL
RATHLIN ISLAND	IRISHNAME	REACHLAINN
DOWNPATRICK	IRISHNAME	DúN PHáDRAIG
COOKSTOWN	IRISHNAME	AN CHORR CHRíOCHACH
LIMAVADY	IRISHNAME	LéIM A' MHADAIDH
NEWCASTLE, COUNTY DOWN	IRISHNAME	AN CAISLEáN NUA
NEWTOWNARDS	IRISHNAME	BAILE NUA NA HARDA
STRABANE	IRISHNAME	AN SRATH BáN
CASTLEREAGH	IRISHNAME	AN CAISLEáN RIABHACH
GLENGORMLEY	IRISHNAME	GLEANN GHORMLAITHE
LURGAN	IRISHNAME	AN LORGAIN
NEWRY	IRISHNAME	IúR CINN TRá OR AN TIúR
PORTADOWN	IRISHNAME	PORT A' DúNáIN
LISBURN	IRISHNAME	LIOS NA GCEARRBHACH
CRAIGAVON	IRISHNAME	CREAG ABHANN
LARNE	IRISHNAME	LATHARNA
BALLYCLARE	IRISHNAME	BEALACH CLáIR
DUNGIVEN	IRISHNAME	DúN GEIMHIN
BUSHMILLS	IRISHNAME	MUILEANN NA BUAISE
COLERAINE	IRISHNAME	CúIL RATHAIN
BANGOR, COUNTY DOWN	IRISHNAME	BEANNCHAR
DUNDRUM, COUNTY DOWN	IRISHNAME	DúN DROMA
PORTRUSH	IRISHNAME	PORT ROIS
PORTSTEWART	IRISHNAME	PORT STíOBHAIRD
CASTLEDERG	IRISHNAME	CAISLEáN NA DEIRGE
ARDGLASS	IRISHNAME	ARD GHLAIS
PORTAFERRY	IRISHNAME	PORT AN PHEIRE
WARRENPOINT	IRISHNAME	RINN MHIC GIOLLA RUA  OR
WARRENPOINT	IRISHNAME	AN PHOINTE
KILKEEL	IRISHNAME	CILL CHAOIL
COALISLAND	IRISHNAME	OILEáN AN GHUAIL
MONEYMORE	IRISHNAME	MUINE MóR
COMBER	IRISHNAME	AN COMAR
IRVINESTOWN	IRISHNAME	BAILE AN IRBHINIGH
ROSTREVOR	IRISHNAME	CAISLEAN RUAIRI
CARNMONEY	IRISHNAME	CARN MONAIDH
DRAPERSTOWN	IRISHNAME	BAILE NA CROISE
ARMAGH	IRISHNAME	ARD MHACHA
DUNGANNON	IRISHNAME	DúN GEANAINN
HILLSBOROUGH, COUNTY DOWN	IRISHNAME	CROMGHLINN
CROSSMAGLEN	IRISHNAME	CROIS MHIC LIONNáIN
MAGHERA	IRISHNAME	MACHAIRE RáTHA
BESSBROOK	IRISHNAME	AN SRUTHáN
HOLYWOOD	IRISHNAME	ARD MHIC NASCA
BALLYNAHINCH, COUNTY DOWN	IRISHNAME	BAILE NA HINSE
TULLYHOGUE	IRISHNAME	TULAIGH ÓG
MAGILLIGAN	IRISHNAME	ARD MHIC GIOLLAGáIN
CROSSGAR	IRISHNAME	AN CHROIS GHEARR
CASTLEWELLAN	IRISHNAME	CAISLEáN UIDHILíN
CLOGHER	IRISHNAME	CLOCHAR
CRUMLIN, COUNTY ANTRIM	IRISHNAME	CROMGHLINN
DROMORE, COUNTY TYRONE	IRISHNAME	DROIM MóR
FIVEMILETOWN	IRISHNAME	BAILE NA LORGAN
BROUGHSHANE	IRISHNAME	BRUACH SHEáIN
SAINTFIELD	IRISHNAME	TAMHNAIGH NAOMH
BALLINTOY	IRISHNAME	BAILE AN TUAIGH
NEWTOWNABBEY	IRISHNAME	BAILE NUA NA MAINISTREACH
ANTRIM, COUNTY ANTRIM	IRISHNAME	AONTROIM
BALLYMENA	IRISHNAME	AN BAILE MEáNACH
BALLYMONEY	IRISHNAME	BAILE MONAIDH
MAGHERAFELT	IRISHNAME	MACHAIRE FíOLTA
ISLANDMAGEE	IRISHNAME	OILEáN MHIC AODHA
DONEMANA	IRISHNAME	DúN NA MANACH
TOBERGILL	IRISHNAME	AN TOBAR GEAL
TEMPLEPATRICK	IRISHNAME	TEAMPALL PHáDRAIG
DUNADRY	IRISHNAME	DúN EADRADH
DUNAMUGGY	IRISHNAME	DúN NA MBOGACH
BENBURB	IRISHNAME	BEANN BHORB
DERRYGONNELLY	IRISHNAME	DOIRE Ó GCONAíLE
FINTONA	IRISHNAME	FIONNTAMHNACH
DROMORE, COUNTY DOWN	IRISHNAME	DROIM MóR
MAYOBRIDGE	IRISHNAME	DROICHEAD MHAIGH EO
DERRYLIN	IRISHNAME	DOIRE LOINN
GREENISLAND	IRISHNAME	INIS GLAS
MOY, COUNTY TYRONE	IRISHNAME	AN MHAIGH
MAZETOWN	IRISHNAME	AN MHAIGH
HILLTOWN, COUNTY DOWN	IRISHNAME	BAILE HILL
BELLEEK, COUNTY FERMANAGH	IRISHNAME	BéAL LEICE
WHITEHEAD, COUNTY ANTRIM	IRISHNAME	AN CIONN BáN
BROOKEBOROUGH	IRISHNAME	ACHADH LON
PORTGLENONE	IRISHNAME	PORT CHLUAIN EOGHAIN
CASTLE COOLE	IRISHNAME	CAISLEáN NA CúILE
LETTERBREEN	IRISHNAME	LEITIR BHRUíN
CASTLEDAWSON	IRISHNAME	AN SEANMHULLACH
MILLISLE	IRISHNAME	OILEáN AN MHUILINN
GLENARM	IRISHNAME	GLEANN ARMA
DUNDONALD	IRISHNAME	DúN DóNAILL
BALLYKELLY, COUNTY LONDONDERRY	IRISHNAME	BAILE Uí CHEALLAIGH
SWATRAGH	IRISHNAME	AN SUAITREACH
GROOMSPORT	IRISHNAME	PORT AN GHIOLLA GHRUAMA
CASTLEROCK	IRISHNAME	CARRAIG CEASAIL
BALLELA	IRISHNAME	BAILE AILIGH
KINALLEN	IRISHNAME	CIONN ÁLAINN
PORTAVOGIE	IRISHNAME	PORT A' BHOGAIGH
BLEARY	IRISHNAME	BLADHRAIGH
NEWBUILDINGS	IRISHNAME	AN BAILE NUA
SESKINORE	IRISHNAME	SEISCEANN MHóR
BERAGH	IRISHNAME	BEARACH
DRUMQUIN	IRISHNAME	DROIM CAOIN
GORTIN	IRISHNAME	AN GOIRTíN
SIXMILECROSS	IRISHNAME	NA CORRACHA MORA
TULLYWIGGAN	IRISHNAME	TULACH AN BHOGAIN
LOUGHINISLAND	IRISHNAME	LOCH AN OILEáIN
STRANGFORD	IRISHNAME	BAILE LOCH CUAN
ARNEY	IRISHNAME	AN ARNA
ESKRA	IRISHNAME	EISCREACH
RASHARKIN	IRISHNAME	ROS EARCáIN
DUNLOY	IRISHNAME	DúN LATHAI
FORKHILL	IRISHNAME	FOIRCEAL
KEADY	IRISHNAME	AN CéIDE
HELEN'S BAY	IRISHNAME	CUAN HéILIN
LOUGHGALL	IRISHNAME	LOCH GCáL
COAGH	IRISHNAME	AN CUACH
POLEGLASS	IRISHNAME	POLL GLAS
BOHO, COUNTY FERMANAGH	IRISHNAME	BOTHA
RATHFRILAND	IRISHNAME	RáTH FRAOILEANN
SHANTALLOW	IRISHNAME	SEANTALAMH
TATTYREAGH	IRISHNAME	AN TáITE RIABHACH MEANING THE STRIPED/TABBY FIELD
EGLINTON, COUNTY LONDONDERRY	IRISHNAME	AN MHAGH
BALLINAMALLARD	IRISHNAME	BéAL ÁTHA NA MALLACHT
CLAUDY	IRISHNAME	CLóIDIGH
AGHAGALLON	IRISHNAME	ACHADH GALLAN
BALLYGOWAN	IRISHNAME	BAILE MHIC GABHANN
AGHALEE	IRISHNAME	ACHADH Lí
ANNAHILT	IRISHNAME	EANACH EILTE
AUGHNACLOY, COUNTY TYRONE	IRISHNAME	ACHADH NA CLOICHE
BALLYCARRY	IRISHNAME	BAILE CARAIDH
DERRYMACASH	IRISHNAME	DOIRE MHIC CAIS
BALLYGAWLEY, COUNTY TYRONE	IRISHNAME	BAILE Uí DHáLAIGH
BALLYHALBERT	IRISHNAME	BAILE THALBóID
BALLYSTRUDDER	IRISHNAME	BAILE STRUDAIR
BALLYWALTER	IRISHNAME	BAILE BHáLTAIR
BELLAGHY	IRISHNAME	BAILE EACHAIDH
BELCOO	IRISHNAME	BéAL Cú
BELLANALECK	IRISHNAME	BEALACH NA LEICE
CAMLOUGH	IRISHNAME	CAMLOCH
CARNLOUGH	IRISHNAME	CARNLACH
CLOUGHMILLS	IRISHNAME	MUILEANN NA CLOICHE
KELLS, COUNTY ANTRIM	IRISHNAME	NA CEALLA
CRAWFORDSBURN	IRISHNAME	SRUTH CHRáFARD
CUSHENDALL	IRISHNAME	COIS ABHANN DALLA OR
CUSHENDALL	IRISHNAME	BUN ABHANN DALLA
GREYABBEY	IRISHNAME	MAINISTIR LIATH
CUSHENDUN	IRISHNAME	COIS ABHANN DUINNE OR
CUSHENDUN	IRISHNAME	BUN ABHANN DUINNE
DERVOCK	IRISHNAME	DEARBHóG/DAIRBHEOG
DARKLEY	IRISHNAME	DEARCLAIGH
DONAGHCLONEY	IRISHNAME	DOMHNACH CLUANA
DROMARA	IRISHNAME	DROIM MBEARACH
DRUMBEG	IRISHNAME	AN DROIM BEAG
EDERNY	IRISHNAME	EADARNAIDH
FEENY	IRISHNAME	NA FíNEADHA
FLORENCECOURT	IRISHNAME	MULLACH NA SEANGáN
GARRISON, COUNTY FERMANAGH	IRISHNAME	AN GARASTúN
GARVAGH	IRISHNAME	GARBHACHADH
GLENAVY	IRISHNAME	LANN ABHAIGH
GREYSTEEL	IRISHNAME	GLAS-STIALL
HAMILTONSBAWN	IRISHNAME	BáBHúN HAMALTúN
BALLYMOYER	IRISHNAME	BAILE AN MHAOIR
KESH, COUNTY FERMANAGH	IRISHNAME	AN CHEIS
KILLOUGH	IRISHNAME	CILL LOCHA
KILREA	IRISHNAME	CILL RIA
LAURELVALE	IRISHNAME	TAMHNAIGH BHEALTAINE
LETTERSHANDONEY	IRISHNAME	LEITIR SEANDUINE
LISBELLAW	IRISHNAME	LIOS BéAL ÁTHA
LISNARICK, COUNTY FERMANAGH	IRISHNAME	LIOS NA NDARóG
LOUGHBRICKLAND	IRISHNAME	LOCH BRICLEANN
MACOSQUIN	IRISHNAME	MAIGH CHOSCáIN
MAGUIRESBRIDGE	IRISHNAME	DROICHEAD MHIG UIDHIR
MARKETHILL	IRISHNAME	CNOC AN MHARGAIDH
MOIRA, COUNTY DOWN	IRISHNAME	MAIGH RATH
MOYGASHEL	IRISHNAME	MAIGH GCAISIL
NEWTOWNBUTLER	IRISHNAME	AN BAILE NUA
NEWTOWNHAMILTON	IRISHNAME	AN BAILE ÚR
POMEROY, COUNTY TYRONE	IRISHNAME	CABHáN A' CHAORTHAINN
PORTBALLINTRAE	IRISHNAME	PORT BHAILE AN TRá
RICHHILL, COUNTY ARMAGH	IRISHNAME	LOG A' CHOIRE
ROSSLEA	IRISHNAME	ROS LIATH
SEAHILL	IRISHNAME	CNOC MUIR
SION MILLS	IRISHNAME	MUILEANN AN TSIáIN
SCARVA	IRISHNAME	SCARBHACH
STEWARTSTOWN, COUNTY TYRONE	IRISHNAME	AN CHRAOBH
STRATHFOYLE	IRISHNAME	SRATH NA FEABHAIL
TEMPO, COUNTY FERMANAGH	IRISHNAME	AN TIOMPú DEISEAL
TOBERMORE	IRISHNAME	AN TOBAR MóR
TOOME	IRISHNAME	TUAIM
AUGHEY	IRISHNAME	ACHADH AODHA
TYNAN	IRISHNAME	TUíNEáN
ANDERSONSTOWN	IRISHNAME	BAILE ANDARSAN OR
ANDERSONSTOWN	IRISHNAME	BAILE MHIC AINDRéIS
MIDDLETOWN, COUNTY ARMAGH	IRISHNAME	COILLIDH CHANANNáIN
UPPERLANDS	IRISHNAME	ÁTH AN PHORTáIN
LOUGHGUILE	IRISHNAME	LOCH GCAOL
TULLYLISH	IRISHNAME	TULAIGH LIS
WARINGSFORD	IRISHNAME	ÁTH AN BHAIRíNIGH
MAYDOWN	IRISHNAME	MAGH DúIN
ACTON, COUNTY ARMAGH	IRISHNAME	AN CHORA UACHTARACH
KILLEAD	IRISHNAME	CILL ÉAD
BALLOO, COUNTY DOWN	IRISHNAME	BAILE AODHA
DERRYHALE	IRISHNAME	DOIRE CHAOL
MOUNTNORRIS	IRISHNAME	ACHADH NA CRANNCHA
LEITRIM, COUNTY DOWN	IRISHNAME	LIATROIM
CORBET	IRISHNAME	AN CARBAD
TAMNAHERIN	IRISHNAME	TAMHNACH CAORTHAINN
STRAIDARRAN	IRISHNAME	SRáID Uí ÁRáIN
PARK, COUNTY LONDONDERRY	IRISHNAME	AN PHáIRC
SCOTCH STREET	IRISHNAME	SRáID NA NALBANACH
BALLYKINLER	IRISHNAME	BAILE COINNLEORA
AUGHER	IRISHNAME	EOCHAIR
CALEDON, COUNTY TYRONE	IRISHNAME	CIONN AIRD
BALLYCASSIDY	IRISHNAME	BAILE Uí CHAISIDE
LARAGH	IRISHNAME	LATHRACH
TRORY	IRISHNAME	TREABHRAIGH
HOLYWELL, COUNTY FERMANAGH	IRISHNAME	DABHACH PHáDRAIG
CLABBY	IRISHNAME	CLABAIGH
DONAGH	IRISHNAME	DOMHNACH
KILLADEAS	IRISHNAME	CILL CHéILE Dé
KINAWLEY	IRISHNAME	CILL NáILE
LACK, COUNTY FERMANAGH	IRISHNAME	AN LEAC
MONEA	IRISHNAME	MAIGH NIADH
TAMLAGHT, COUNTY FERMANAGH	IRISHNAME	TAMHLACHT
TEEMORE	IRISHNAME	AN TIGH MóR
MULLAGHBOY	IRISHNAME	MULLACH BUIDHE
DRUMBO	IRISHNAME	DRUIM Bó
EDENDERRY, COUNTY DOWN	IRISHNAME	ÉADAN DOIRE
TULLYNACROSS	IRISHNAME	TULAIGH NA CROISE
KNOCKLOUGHRIM	IRISHNAME	CNOC CLOCHDROMA
MONEYNEANY	IRISHNAME	MóIN NA NIONADH
ARMOY, COUNTY ANTRIM	IRISHNAME	OIRTHEAR MAí
ATTICALL	IRISHNAME	ÁIT Tí CHATHAIL
BELLEEKS	IRISHNAME	BéAL LEICE
CULLAVILLE	IRISHNAME	BAILE MHIC CULLACH
JONESBOROUGH, COUNTY ARMAGH	IRISHNAME	BAILE AN CHLáIR
WHITECROSS, COUNTY ARMAGH	IRISHNAME	CORR LEACHT
SILVERBRIDGE, COUNTY ARMAGH	IRISHNAME	BéAL ÁTHA AN AIRGID
DOOISH	IRISHNAME	DUBHAIS
ARDSTRAW	IRISHNAME	ARD SRATHA
KILLEN, COUNTY TYRONE	IRISHNAME	CILLíN
KILLETER	IRISHNAME	COILL ÍOCHTAIR
VICTORIA BRIDGE, COUNTY TYRONE	IRISHNAME	DROICHEAD VICTORIA
BURREN, COUNTY DOWN	IRISHNAME	AN BHOIRINN
BLANEY	IRISHNAME	BLéINIGH
FINAGHY	IRISHNAME	AN FIONNACHADH
AGHADRUMSEE	IRISHNAME	ACHADH DHRUIM SAILEACH
DERRYNOOSE	IRISHNAME	DOIRE NúIS
DUNMURRY	IRISHNAME	DúN MUIRíGH
BALLYMAGUIGAN	IRISHNAME	BAILE MHIC UIGINN
BALLYRONAN	IRISHNAME	BAILE Uí RóNáIN
ARDBOE	IRISHNAME	ARD Bó
DRUMKEE	IRISHNAME	DRUIM CEATH
AUGHNACLOY, COUNTY DOWN	IRISHNAME	ÁTH NA CLOICHE
BALLERIN	IRISHNAME	BAILE Uí SHíRíN / BAILE IARAINN
CREEVEROE	IRISHNAME	AN CHRAOBH RUA
BENRAW	IRISHNAME	BEANN RáTHA
KILLYMAN	IRISHNAME	CILL NA MBAN
CARNTEEL	IRISHNAME	CARN TSIADHAIL
TAMNAMORE	IRISHNAME	AN TAMHNACH MHóR
DERRYNEILL	IRISHNAME	DOIRE NéILL
MULLAGHBAWN	IRISHNAME	AN MULLACH BáN
CARNALEA	IRISHNAME	CARNAN LAO
GRANEMORE	IRISHNAME	GRAINSEACH MOR
BRYANSFORD	IRISHNAME	ÁTH BHRIAIN
BANBRIDGE	IRISHNAME	DROICHEAD NA BANNA
KNOCKMOYLE	IRISHNAME	CNOC MAOL
KILLEAN, COUNTY ARMAGH	IRISHNAME	CILLíN
KILCOO, COUNTY DOWN	IRISHNAME	CILL CHUA
DRUMMULLAN	IRISHNAME	DRUIM MAOLáIN
BUCKNA	IRISHNAME	BOCHNACH
PREHEN	IRISHNAME	PREACHAN
RANDALSTOWN	IRISHNAME	BAILE RAGHNAIL
SHANVEY	IRISHNAME	SEAN-BHEITH
TRILLICK	IRISHNAME	TRILEAC
ANNACLONE	IRISHNAME	EANACH LUAIN
RINGSEND, COUNTY LONDONDERRY	IRISHNAME	AN RINN
CABRA, COUNTY DOWN	IRISHNAME	CABRACH
DERRYCREW	IRISHNAME	DOIRE CRAOBH
TIEVENADARRAGH	IRISHNAME	TAOBH NA DARACH
BALLYHORNAN	IRISHNAME	BAILE AN EOIRNA THE TOWN LAND OF THE BARLEY
BALLYHARRY	IRISHNAME	BAILE H-ARAIDH
RINGHADDY	IRISHNAME	RINN AN CHADAIGH
LISTOODER	IRISHNAME	LIOS AN TSúDAIRE
GLENULLIN	IRISHNAME	GLEANN AN IOLAR
ACRAVALLY	IRISHNAME	ACRA BHILE
AGHACARNAGHAN	IRISHNAME	ACHADH CARNáNACH
AGHACULLY	IRISHNAME	ACHADH COILLE
AGHALOUGHAN	IRISHNAME	ACHADH AN LOCHáIN
AGHALISLONE	IRISHNAME	ACHADH LIS LUAIN
ANNAGHMORE, COUNTY ANTRIM	IRISHNAME	EANACH MóR
ANTIVILLE, COUNTY ANTRIM	IRISHNAME	AN TIGH BHILE
AGHANCROSSY	IRISHNAME	ACHADH NA CROISE
ARTNAGROSS	IRISHNAME	ARD NA GCROS
AGHNAHOUGH	IRISHNAME	ACHADH NA GCLOCH
AUGHAREAMLAGH	IRISHNAME	ACHADH RAMALACH
AUGHABOY	IRISHNAME	ACHADH BUí
BALLAGHBEDDY	IRISHNAME	BEALACH BEADAIDHE
BALLAGHMORE	IRISHNAME	BEALACH MóR
AULT, NORTHERN IRELAND	IRISHNAME	ALLT
UNSHINAGH MOUNTAIN	IRISHNAME	SLIABH UINSEANNACH
BALLYBOLEY	IRISHNAME	BAILE NA BUAILE
BALLYBENTRAGH	IRISHNAME	BAILE BEANNTRACH
BALLYCLOGHAN	IRISHNAME	BAILE CLOCHáN
BALLYCOLLIN	IRISHNAME	BAILE UI COILEIN
BALLYCLAVERTY	IRISHNAME	BAILE MHIC LAIBHEARTAIGH
BALLYCUSHAN	IRISHNAME	BAILI CUISIN
BALLYDIVITY	IRISHNAME	BAILE MHIC DUIBHIDIGHE
BALLYDOWN, COUNTY DOWN	IRISHNAME	BAILE AN DúIN
BALLYCONAGAN	IRISHNAME	BAILE COINNEAGAIN
BALLYGOBBIN	IRISHNAME	BAILE GHOBAIN
AGHACOMMON	IRISHNAME	ACHADH CAMáN
BRANIEL	IRISHNAME	AN BRAINEAL
KILLEATON	IRISHNAME	COILL EATAIN
CORKEY	IRISHNAME	CORCAIGH
TATTYKEERAN, COUNTY FERMANAGH	IRISHNAME	TAITE AN CHAORTHAINN
BRANNY	IRISHNAME	BRANNAIDH
TULLYNAKILL	IRISHNAME	TULAIGH NA CILLE
LEITRIM, COUNTY ANTRIM	IRISHNAME	LIATROIM
HANNAHSTOWN	IRISHNAME	BAILE HAINE
KILMORE, COUNTY DOWN	IRISHNAME	AN CHILL MHóR
CHURCHTOWN, COUNTY TYRONE	IRISHNAME	BAILE AN TEAMPAILL
ARDTOLE	IRISHNAME	ARD TUATHAIL
RINGFAD	IRISHNAME	AN RINN FHADA
BALLYNAFERN	IRISHNAME	BAILE NA FEARNA
BALLYNAFOY	IRISHNAME	BAILE NA FAICHE
BALLYNAGROSS	IRISHNAME	BAILE NA GCROS
LISNASLIGGAN	IRISHNAME	LIOS NA SLIOGáN
DERRYLOUGH, COUNTY DOWN	IRISHNAME	DOIRE LOCHA
BALLYNANNY	IRISHNAME	BEALACH AN EANAIGH
BALLYSHEIL, COUNTY DOWN	IRISHNAME	BAILE Uí SHIAIL
ARDBRIN	IRISHNAME	ÁRD BRAIN
DERRYBRUSK	IRISHNAME	DOIRE BROSCAIDH
LISONEILL	IRISHNAME	LIOS Uí NéILL
LISNARICK, COUNTY ANTRIM	IRISHNAME	LIOS NA REACH
DERRYVULLAN	IRISHNAME	DOIRE MHAOLáIN
BALLYBOLEY	IRISHNAME	BAILE NA BUAILE
BALLYBOLEY, COUNTY DOWN	IRISHNAME	BAILE NA BUAILE
DERRIAGHY	IRISHNAME	DOIRE ACHAIDH
MAGHERALLY	IRISHNAME	AN MHACHAIRE ABHLAí
ISLANDREAGH, COUNTY ANTRIM	IRISHNAME	AN TOILEáN RIABHACH
LOUGHERMORE, COUNTY ANTRIM	IRISHNAME	AN LUACHAIR MHóR
MOYADAM	IRISHNAME	MAIGH DOINN
RATHBEG, COUNTY ANTRIM	IRISHNAME	AN RáTH BEAG
BALLYDOWN, COUNTY ANTRIM	IRISHNAME	BAILE AN DúN
CARNSPINDLE	IRISHNAME	CARN SPINNIL
DUNDRESSAN	IRISHNAME	DUN DREASáN
PORTMUCK	IRISHNAME	PORT MUC
MAGHERACULMONEY	IRISHNAME	MACHAIRE CUL MUINE
AGHAVEA	IRISHNAME	ACHADH BHEITHE
BALLAGHGEE GLEBE	IRISHNAME	BEALACH GAOíTHE
DERRYNACRANNOG GLEBE	IRISHNAME	DOIRE NA CRANNóG
OUGHTERDRUM	IRISHNAME	UACHTAR-DRUIM
TULLYCHURRY	IRISHNAME	TULAIGH CHURRAIGH
MALLYBREEN	IRISHNAME	MALAIDHE BHRAOIN
TAWNAGHGORM, COUNTY FERMANAGH	IRISHNAME	TAMHNACH GORM
LOWERYBANE	IRISHNAME	LEAMHRAIDHE
DERRYKEIGHAN	IRISHNAME	DOIRE CHAOCHáIN
ISLANDAHOE	IRISHNAME	OILEáN Dá EO
MOSTRAGEE	IRISHNAME	MAIGHISTIR GAOITHE
LISBUNNY, COUNTY LONDONDERRY	IRISHNAME	LIOS BUINIGHE
BALLYRORY, COUNTY LONDONDERRY	IRISHNAME	BAILE-RUDHRAIGHE
ALTAGHONEY	IRISHNAME	ALT A CHONNAIDH
GORTNARAN	IRISHNAME	GORT NA RANN
BROUGHDERG, COUNTY TYRONE	IRISHNAME	BRUACH DEARG
BOCKETS	IRISHNAME	BUACAIDE
CRANLOME	IRISHNAME	CRANN LOM
FARRITER	IRISHNAME	FEARAN IOCHTRACH
TULLYVANNON	IRISHNAME	TUL AN BHEANNAIN
LURGACULLION	IRISHNAME	LURG A CHUILINN
MULLYRODDAN	IRISHNAME	MULLAGH RODAIN
DERGENAGH	IRISHNAME	DEARGANACH
AGHAGINDUFF	IRISHNAME	ACHADH CINN DUIBH
CABRAGH	IRISHNAME	AN CHABRACH
GLENCULL	IRISHNAME	GLEANN CHOILL
BALLYMORE, COUNTY ARMAGH	IRISHNAME	AN BAILE MóR
LEVALLEGLISH	IRISHNAME	LEATH-BAILE EAGLAISE
TURCARRA	IRISHNAME	TOR CARRACH
CLONMAIN	IRISHNAME	CLUAIN MEADHOIN
FERNAGREEVAGH	IRISHNAME	FEARANN NA GCRAOBHACH
ANNAGHMORE, COUNTY ARMAGH	IRISHNAME	EANACH MóR
AGHINLIG	IRISHNAME	ACHADH AN LUIG
BALLYTYRONE	IRISHNAME	BAILE TíRE EOGHAIN
CAUSANAGH	IRISHNAME	COIS-EANACH
KISHABOY	IRISHNAME	CEASACH BUIDHE
RATHDRUMGRAN	IRISHNAME	RATH DRUIM GRáINE
MULLANASILLA	IRISHNAME	MULLACH NA SAILEACH
TIRMACRANNON	IRISHNAME	TíR MIC RANNáIN
LISLASLY	IRISHNAME	LIOS LASLY
BALLYGASEY	IRISHNAME	BAILE UA GCATHASAIGH
ANNAGHMACMANUS	IRISHNAME	EANACH MIC MAGHNUSA
ALTATURK	IRISHNAME	ALT A TUIRC
EAGRALOUGHER	IRISHNAME	EAGAR A LOCHAIN
LISNEANY	IRISHNAME	LIOS AN AONAIGH
DERRYCOOSE	IRISHNAME	DOIRE CUAIS
BALLYARGAN	IRISHNAME	BAILE ARGAIN
DEMOAN	IRISHNAME	DéAGH-MóIN
FEDERNAGH	IRISHNAME	AN FHEADARNACH
MONCLONE	IRISHNAME	MION-CLUAIN
SHANEGLISH	IRISHNAME	SEAN-EGLIS
TULLYLINN	IRISHNAME	TULAIGH LINNE
LISNAGREE, COUNTY ARMAGH	IRISHNAME	LIOS NA GCROIDHE
DRUMINARGAL, COUNTY ARMAGH	IRISHNAME	DRUIM ARGAIN
TANNYOKY	IRISHNAME	TAMNACH O'CIAIDH
CARRICKBRACK, COUNTY ARMAGH	IRISHNAME	CARRAIG BHREAC
CAVANAKILL	IRISHNAME	CABHAN NA CILLE
BALLYNALECK, COUNTY ARMAGH	IRISHNAME	BAILE NA LEAC
SKEGATILLIDA	IRISHNAME	SCEITHEOG AN TSEILIDE
DRUMNAGLONTAGH	IRISHNAME	DROMANN NA GCLUAINTE
KILLANEY	IRISHNAME	CILL EANAIGH
BLARIS	IRISHNAME	BLáRAS
LEGACURRY, COUNTY DOWN	IRISHNAME	LAG AN CHOIRE
LEGACURRY, COUNTY ANTRIM	IRISHNAME	LAG AN CHOIRE
MAGHERA, COUNTY DOWN	IRISHNAME	MACHAIRE RáTHA
KILCLIEF	IRISHNAME	CILL CLEITHE
BRANNOCK, COUNTY ARMAGH	IRISHNAME	BRAN CNOC
