JACK LYNCH	IRISH	SEáN Ó LOINGSIGH
CHRISTY RING	IRISH	CRíOSTóIR Ó RINN
NICKY RACKARD	IRISH	NIOCLáS MAC RIOCAIRD
STEPHEN O'NEILL	IRISH	STIOFáN Ó NéILL
D. J. CAREY	IRISH	DONNCHA SEOSAMH Ó CIARA
RICHIE FOLEY	IRISH	RISTEARD Ó FOGHLú
PáIDí Ó Sé	IRISH	PáIDí Ó Sé
DAN O'KEEFFE	IRISH	DóNALL Ó CAOIMH
JOHN JOE O'REILLY	IRISH	SEáN SEOSAMH Ó RAGHALLAIGH
SEáN O'NEILL	IRISH	SEáN Ó NéILL
MARTIN O'CONNELL	IRISH	MáIRTíN Ó CONAILL
MICK O'CONNELL	IRISH	MíCHEáL Ó CONAILL
PAT SPILLANE	IRISH	PáDRAIG Ó SPEALáIN
MIKEY SHEEHY	IRISH	MíCHEáL Ó SíTHIGH
KEVIN MORAN	IRISH	CAOIMHíN BEARNARD Ó MóRáIN
BILLY RACKARD	IRISH	LIAM MAC RIOCAIRD
BOBBY RACKARD	IRISH	RIOBAIRD MAC RIOCAIRD
KEVIN HEFFERNAN	IRISH	CAOIMHíN Ó HIFEARNáIN
MICK MACKEY	IRISH	MíCHEáL MAC AODHA
JOHN DOYLE	IRISH	SEáN Ó DúILL
GER LOUGHNANE	IRISH	GEARóID Ó LACHTNáIN
MATTIE MCDONAGH	IRISH	MAITIú MAC DONNCHADHA
EDDIE KEHER	IRISH	ÉAMONN Ó CATHAOIR
PAUL FLYNN	IRISH	PóL Ó FLOINN
EOIN LISTON	IRISH	EOIN LIOSTúN
RYAN MCMENAMIN	IRISH	RIAN MAC MEANMáN
JOHN KEANE	IRISH	SEáN Ó CATHáIN
MICHAEL HOGAN	IRISH	MíCHEáL Ó HÓGáIN
SEáN PURCELL	IRISH	SEáN PUIRCELL
PHIL GRIMES	IRISH	PILIB Ó GORMSHúIL
PADDY CHRISTIE	IRISH	PáDRAIG MAC CRíOSTA
TOMMY MURPHY	IRISH	TOMAS Ó MURCHú
TADHG KENNELLY	IRISH	TADHG MAC AN FHAILí
DERMOT EARLEY, SNR	IRISH	DIARMUID Ó MOCHóIR
JIMMY DOYLE	IRISH	SéAMUS Ó DúIL
TONY REDDIN	IRISH	MáIRTíN CATHAL Ó ROIDEACHáIN
NICK O'DONNELL	IRISH	NIOCLáS Ó DóNAILL
PADDY PHELAN	IRISH	PáDRAIG Ó FAOLáIN
LORY MEAGHER	IRISH	LABHRAí Ó MEACHAIR
RAY CUMMINS	IRISH	REAMONN Ó COIMíN
ENDA COLLERAN	IRISH	ÉINDE Ó CALLARáIN
HUMPHREY KELLEHER	IRISH	AMHLAOIBH O CéILEACHAIR
JIM LANGTON	IRISH	SéAMUS LANGTúN
PADDY BUGGY	IRISH	PáIDí Ó BOGAIGH
CON MURPHY	IRISH	CONCHUR Ó MURCHú
CORMAC MCANALLEN	IRISH	CORMAC MAC AN AILíN
JOE BROLLY	IRISH	SEOSAMH Ó BROLLAIGH
TIM KENNELLY	IRISH	TADHG MAC AN FHAILí
SEAN FALLON	IRISH	SEáN Ó FALLúIN
ÉAMONN BURNS	IRISH	ÉAMONN Ó BROIN
JOHN MULLANE	IRISH	SEáN Ó MAOLáIN
TONY BROWNE	IRISH	TóNAí DE BRúN
FERGAL HARTLEY	IRISH	FERGAL Ó HARTAILE
DAN SHANAHAN	IRISH	DóNAL Ó SEANACHáIN
SYLVIE LINNANE	IRISH	SAILBHEASTAR Ó LíONNáIN
JIMMY KEAVENEY	IRISH	SéAMAS Ó GéIBHEANNAIGH
MARK VAUGHAN	IRISH	MARCAS MAC UACHAN
RAY COSGROVE	IRISH	RéAMANN MAC OSCAIR
BRYAN CULLEN	IRISH	BRíAN Ó CUILINN
ALAN BROGAN	IRISH	AILéIN Ó BRóGáIN
JASON SHERLOCK	IRISH	IASAN SCORLóG
BARNEY ROCK	IRISH	BRIAN MAC CONCHARRAIGE
JOHN HAYES	IRISH	SEáN Ó HAODHA
STEPHEN CLUXTON	IRISH	STIOFáIN CLUXTON
CONAL KEANEY	IRISH	CONAL Ó CIANAIGH
JOHNNY MAGEE	IRISH	SEáN MAG AOIDH
COLIN MORAN	IRISH	COILíN Ó MóRáIN
BARRY CAHILL	IRISH	BARRA Ó CATHAIL
DARREN MAGEE	IRISH	DARREN MAG AOIDH
PEADAR ANDREWS	IRISH	PEADAR MAC AINDRIú
TOMáS QUINN	IRISH	TOMáS Ó CUINN
DESSIE FARRELL	IRISH	DEASúN Ó FEARGHAIL
JOHN DONNELLAN	IRISH	SEáN Ó DOMHNALLáIN
CIARáN WHELAN	IRISH	CIARáN Ó FAOLáIN
PETER CANAVAN	IRISH	PEADAR Ó CEANNABHáIN
SHANE RYAN	IRISH	SHANE Ó RIAíN
BRIAN DOOHER	IRISH	BRIAN Ó DúICHAR
DARA Ó CINNéIDE	IRISH	DARA Ó CINNéIDE
COLM O'ROURKE	IRISH	COLM Ó RUAIRC
STEPHEN O'SHAUGHNESSY	IRISH	STIOFáN Ó SEACHNASAIGH
HENRY SHEFFLIN	IRISH	ANRAí Ó SIBHLEáIN
ART FOLEY	IRISH	AIRT Ó FOGHLú
KARL MCKEEGAN	IRISH	CAIREALL MAC AOGáIN
ANTHONY TOHILL	IRISH	ANTóIN Ó TUATHAIL
JOE DEANE	IRISH	SEOSAMH Ó DéIN
DIARMUID O'SULLIVAN	IRISH	DIARMUID Ó SúILLEABHáIN
J. J. DELANEY	IRISH	S. S. Ó DúLáINNE
COMAN GOGGINS	IRISH	COMáN Ó GóGáIN
MICK O'DWYER	IRISH	MíCHEáL Ó DUIBHIR
JERRY O'CONNOR	IRISH	GEARóID Ó CONCHUBHAIR
BRIAN CORCORAN	IRISH	BRIAN Ó CORCRáIN
JOHN GARDINER	IRISH	SEáN Ó GAIRNéIR
TOMMY DUNNE	IRISH	TOMáS Ó DOINN
PAT FOX	IRISH	PáDRAIG Ó SIONNAIGH
NICKY ENGLISH	IRISH	NIOCLáS INGLIS
GER CUNNINGHAM	IRISH	GEARóID MAC CUINNEAGAIN
JACK O'SHEA	IRISH	SEáN Ó Sé
NOEL SKEHAN	IRISH	NOLLAIG Ó SCEACHáIN
PAT MULCAHY	IRISH	PáDRAIG Ó MAOLCATHAIGH
SENAN CONNELL	IRISH	SEANáN Ó CONAILL
JOE KEOHANE	IRISH	SEOSAMH Ó CEOCHáIN
SEáN MURPHY	IRISH	SEáN Ó MURCHú
JOHN EGAN	IRISH	SEáN MAC AOGáIN
JAMESIE O'CONNOR	IRISH	SéAMUS Ó CONCHUBHAIR
TOMMY WALSH	IRISH	TOMáS BREATHNACH
MARTIN COMERFORD	IRISH	MáIRTíN MAC CUMASCAIGH
EDDIE BRENNAN	IRISH	ÉAMONN Ó BRAONáIN
DEREK LYNG	IRISH	D. Ó LOINN
BEN O'CONNOR	IRISH	BEIRCHEART Ó CONCHUBHAIR
PETER BARRY	IRISH	PEADAR DE BARRA
NOEL HICKEY	IRISH	NOLLAIG Ó HÍCí
RONAN CURRAN	IRISH	RONáN Ó CORRáIN
PAUL CURRAN	IRISH	PóL Ó CURRAOíN
TONY DORAN	IRISH	TóNAí Ó DEORáIN
JIMMY BARRY-MURPHY	IRISH	SéAMUS DE BARRA-Ó MURCHú
JAMES MCGARRY	IRISH	SéAMUS MAG FHEARAIGH
BRIAN CODY	IRISH	BRIAIN MAC ÓDA
MAURICE FITZGERALD	IRISH	MUIRIS MAC GEARAILT
DECLAN BROWNE	IRISH	DéAGLAN DE BRUN
KEVIN BONNER	IRISH	CAOIMHíN Ó CNáIMHSí
EOIN KELLY	IRISH	EOIN Ó CEALLAIGH
PAUL KELLY	IRISH	PóL Ó CEALLAIGH
JOHN CARROLL	IRISH	SEáN Ó CEARRBHALL
GER O'GRADY	IRISH	GEARóID Ó GRáDA
LAR CORBETT	IRISH	LABHRAS Ó COIRBíN
PAUL GRIFFIN	IRISH	PóL Ó GRíOFA
PAUL CURRAN	IRISH	PóL Ó CORRáIN
PAUL ORMOND	IRISH	PóL Ó RUA
DIARMAID FITZGERALD	IRISH	DIARMAID MAC GEARAILT
DAVY FITZGERALD	IRISH	DAITHí MAC GEARAILT
ANTHONY DALY	IRISH	ANTóIN Ó DáLAIGH
DAMIEN HAYES	IRISH	DAMIEN Ó HAODHA
KEITH ROSSITER	IRISH	CEITEACH Ó ROISETEIR
TOMMY LANGAN	IRISH	TOMáS
JOHN O'LEARY	IRISH	SEáN Ó LAOIRE
OLLIE CANNING	IRISH	OLIBHéAR Ó CAINíN
TIMMY MCCARTHY	IRISH	TADHG MAC CáRTHAIGH
TOM KENNY	IRISH	TOMáS Ó CIONNAITH
NIALL MCCARTHY	IRISH	NIALL MAC CáRTHAIGH
DAVID COLLINS	IRISH	DAITHí Ó COILEáIN
GER O'MEARA	IRISH	GEARóID Ó MEáRA
BRIAN MURPHY	IRISH	BRIAIN Ó MURCHú
RICHIE MULLALLY	IRISH	RISTéARD Ó MAOLALAIDH
DAMIEN FITZHENRY	IRISH	DAMIEN MAC EINRí
BRIAN LOHAN	IRISH	BRíAN Ó LEOCHáIN
DONNACHA CODY	IRISH	DONNACHA MAC ÓDA
FERGAL BYRON	IRISH	FERGAL Ó BEIRN
TOM KELLY	IRISH	TOMáS Ó CEALLAIGH
GEORGE O'CONNOR	IRISH	SEOIRSE Ó CONCHUBHAIR
OISíN MCCONVILLE	IRISH	OISíN MAC CONMHAOIL
KEVIN ARMSTRONG	IRISH	CAOIMHíN Ó LABHRAí TRéAN
JUSTIN MCCARTHY	IRISH	JUSTIN MAC CARTHAIGH
LAR FOLEY	IRISH	LIAM Ó FOGHLú
SHANE O'SULLIVAN	IRISH	SEáN Ó SúILLEABHáIN
PHILLY LARKIN	IRISH	PILIB Ó LORCáIN
KIERAN MCGEENEY	IRISH	CIARáN MAC GéIBHEANNAIGH
NEIL RONAN	IRISH	NIALL Ó RóNáIN
CATHAL NAUGHTON	IRISH	CATHAL MAC NEACHTáIN
JOHN FENTON	IRISH	SEáN Ó FIONNACHTA
JIM CASHMAN	IRISH	SéAMUS Ó CíOSáIN
JOHN LEONARD	IRISH	SEáN Ó LOINíN
MARTIN O'DOHERTY	IRISH	MáIRTIN Ó DOCHARTAIGH
CHARLIE MCCARTHY	IRISH	CATHAL MAC CáRTHAIGH
DENIS MULCAHY	IRISH	DONNCHA Ó MAOLCATHA
KEVIN HENNESSY	IRISH	CAOIMHGHíN Ó HAONGHUSA
TOM CASHMAN	IRISH	TOMáS Ó CíOSáIN
JOHN HORGAN	IRISH	SEáN Ó HORGáIN
JOE COONEY	IRISH	SEOSAMH Ó CUANA
SEáNIE MCMAHON	IRISH	SEáN MAC MATHúNA
TONY O'SULLIVAN	IRISH	TóNAí Ó SúILLEABHáIN
OLLIE WALSH	IRISH	PáDRAIG OILIBHéAR BREATHNACH
JOE CONNOLLY	IRISH	SEOSAMH Ó CONGHAILE
MICHAEL JACOB	IRISH	MICHéAL IáCóB
TONY KEADY	IRISH	TóNAí MAC CéADAIGH
EUGENE COUGHLAN	IRISH	EOGHAN Ó COCHLáIN
FRANK CUMMINS	IRISH	PRIONSIAS Ó COIMíN
PAT MCDONNELL	IRISH	PáDRAIG MAC DOMHNAILL
LIAM O'BRIEN	IRISH	LIAM Ó BRIAIN
JOE DOOLEY	IRISH	SEOSAMH Ó DULAOíCH
BILLY DOOLEY	IRISH	LIAM Ó DULAOíCH
COLM COOPER	IRISH	COLM Ó CúIPéIR
JIMMY SMYTH	IRISH	SéAMUS MAC GABHANN
TOM CHEASTY	IRISH	TOMáS Ó SíOSTA
JOHN POWER	IRISH	SEáN DE PAOR
LIAM DEVANEY	IRISH	LIAM Ó DUBHáIN
TONY WALL	IRISH	TONAí DE LAVAL
DONIE NEALON	IRISH	DóNAL Ó NIALLáIN
GERALD MCCARTHY	IRISH	GEARóID MAC CáRTHAIGH
PAUL CASEY	IRISH	PóL Ó CATHASAIGH
DAVID HENRY	IRISH	DAITHí MAC ÉINRí
TOMáS MULCAHY	IRISH	TOMáS Ó MAOLCATHA
DAMIEN MARTIN	IRISH	DAMIEN Ó MáIRTíN
MARTIN COLEMAN	IRISH	MáIRTíN Ó COLMáIN
BRIAN MURPHY	IRISH	BRIAIN Ó MURCHú
PAT HARTIGAN	IRISH	PáDRAIG Ó HARTAGáIN
TEDDY MCCARTHY	IRISH	TADHG MAC CáRTHAIGH
MARTIN COLEMAN, JNR	IRISH	MáIRTíN Ó COLMáIN
CIAN O'CONNOR	IRISH	CIAN Ó CONCHUBHAIR
KIERAN MURPHY	IRISH	CIARáN Ó MURCHú
CHARLIE REDMOND	IRISH	CATHAL MAC RéAMAINN
JOHNNY CROWLEY	IRISH	SEáN Ó CRUALAOICH
MARK LANDERS	IRISH	MARC DE LONDRAS
JOHN CONNOLLY	IRISH	SEáN Ó CONGHAILE
KIERAN DONAGHY	IRISH	CIARáN Ó DUINNEACHA
BILL DELANEY	IRISH	LIAM Ó DUBHSHLáINE
BRIAN MCDONALD	IRISH	BRIAN MACDóNAILL
JAMES RYALL	IRISH	SéAMAS Ó RAGHAILL
CONOR CUSACK	IRISH	CONCHUIR Ó CíOSóG
JOHN TENNYSON	IRISH	SEáN TENNYSON
AIDAN FOGARTY	IRISH	AODáN Ó FóGARTAIGH
FRANK KEENAN	IRISH	PRIONSIAS Ó CIANáIN
FERGAL RYAN	IRISH	FERGAL Ó RIAIN
FERGAL MCCORMACK	IRISH	FEARGHALL MAC CORMAIC
RóNáN CLARKE	IRISH	RóNáN Ó CLéIRIGH
DECLAN LALLY	IRISH	DéAGLáN Ó MAOLALAIDH
ANDY MALLON	IRISH	AINDRIU Ó MEALLáIN
KEITH BARR	IRISH	CEITEACH Ó BAIRR
JIM STAPLETON	IRISH	SéAMUS MAC AN GHAILL
PADDY BRADLEY	IRISH	PáDRAIG Ó BROLCHáIN
PAUL BEALIN	IRISH	PóL Ó BAIRR
EOIN BRADLEY	IRISH	EOIN Ó BROLCHáIN
ENDA MULDOON	IRISH	ÉANNA Ó MAOLDúIN
PAT DELANEY	IRISH	PáDRAIG Ó DúLáINNE
GER FENNELLY	IRISH	GEARóID Ó FIONNALAIGH
DENIS COUGHLAN	IRISH	DONNACHA Ó COCHLAINN
MICHAEL FENNELLY	IRISH	MICHEáL Ó FIONNALAIGH
AIDAN O'MAHONY	IRISH	AODáN Ó MATHúNA
DIARMUID MURPHY	IRISH	DIARMUID Ó MURCHú
DARRAGH Ó Sé	IRISH	DARRAGH Ó Sé
MIKE FRANK RUSSELL	IRISH	MíCHEáL PRIONSIAS RUISéAL
MARC Ó Sé	IRISH	MARC Ó Sé
CIARáN MCDONALD	IRISH	CIARáN MAC DóMHNAILL
BRENDAN CUMMINS	IRISH	BREANDáN Ó CUIMIN
EOIN BROSNAN	IRISH	EOIN Ó BROSNACHáIN
ANTHONY NASH	IRISH	ANTóIN DE NAIS
PAUL GALVIN	IRISH	PóL Ó GALBHáIN
TOM O'SULLIVAN	IRISH	TOMáS Ó SúILLEABHáIN
SEáN O'SULLIVAN	IRISH	SEáN Ó SúILLEABHáIN
TOMMY GRIFFIN	IRISH	TOMáS Ó GRIFíN
TOMáS Ó Sé	IRISH	TOMáS Ó Sé
BARRY EGAN	IRISH	BARRA MAC AOGáIN
DAVID O'CALLAGHAN	IRISH	DAITHí Ó CEALLACHáIN
IAN ROBERTSON	IRISH	IAN MAC ROIBEAIRD
EUGENE CLOONAN	IRISH	EOGHAN Ó CLUANáIN
BERNARD BROGAN	IRISH	BEARNARD Ó BRóGáIN
DINNY ALLEN	IRISH	DONNACHA Ó HAILíN
BRIAN MULLINS	IRISH	BRIAN Ó MAOLáIN
CONOR HAYES	IRISH	CONCHUR Ó HAODHA
PAT FLEURY	IRISH	PáDRAIG Ó FíOBHRA
BERNARD BROGAN	IRISH	BEARNARD Ó BRóGáIN
VINNIE MURPHY	IRISH	UINSEANN Ó MURCHú
CIARáN WALSH	IRISH	CIARáN BREATHNACH
NIALL O'SHEA	IRISH	NíALL Ó Sé
DECLAN O'MAHONY	IRISH	DéAGLáN Ó MATHúNA
DENIS BASTICK	IRISH	DONNACHA BASTIC
GRAHAM NORTON	IRISH	GRAHAM Ó NEACHTAIN
PAT BURKE	IRISH	PáDRAIG DE BúRCA
SEáN CAVANAGH	IRISH	SEáN Ó CAOMHáNACH
JOHN MEYLER	IRISH	SEáN MAC MAOILIR
DIARMUID CONNOLLY	IRISH	DIARMUID Ó CONGHAILE
TOMMY DRUMM	IRISH	TOMáS Ó DROMA
JOE MCMAHON	IRISH	SEOSAMH MAC MATHúNA
CONOR GORMLEY	IRISH	CONCHúR Ó GARMAILE
BRIAN MCGUIGAN	IRISH	BRIAN MAG UIGINN
SEAN DALY	IRISH	SéAN Ó DáLAIGH
PADDY CULLEN	IRISH	PáDRAIG Ó CUILINN
MICHAEL MCGEE	IRISH	MICHáEL MAC AOIDH
PASCAL MCCONNELL	IRISH	PASCAL MAC DHóNAILL
MICHAEL DONNELLAN	IRISH	MíCHEáL Ó DOMHNALLáIN
MICK DEEGAN	IRISH	MíCHEáL Ó DUíGINN
DAVID HARTE	IRISH	DAITHí Ó HAIRT
GER POWER	IRISH	GEARóID DE PAOR
JOHN O'KEEFFE	IRISH	SEáN Ó CAOIMH
CHRIS LAWN	IRISH	CRIOSRóIR Ó LIATHáIN
TONY MAHER	IRISH	ANTOIN Ó MEACHAIR
NOEL LANE	IRISH	NOLLAIG Ó LAIGHIN
JOHN DEVINE	IRISH	SEáN Ó DAIMHíN
RYAN MELLON	IRISH	RíAN Ó MEALLáIN
NIALL CAHALANE	IRISH	NIALL Ó CATHALáIN
MICK BERMINGHAM	IRISH	MíCHEáL BERMINGHAM
BRENDAN COULTER	IRISH	BREANDáN Ó COITáIR
TOMMY CARR	IRISH	TOMáS Ó CARRA
GEORGE DOYLE	IRISH	SEOIRSE Ó DúGHAILL
PADDY BARRY	IRISH	PáDRAIG DE BARRA
CHRISTY O'BRIEN	IRISH	CRIOSTóIR Ó BRIAIN
DANNY CULLOTY	IRISH	DONAL O'COLLáTA
BRIAN O'DONOGHUE	IRISH	BRíAN Ó DONNCHú
ALAN KEANE	IRISH	ALAN Ó CATHAIN
MICK FALVEY	IRISH	MíCHEáL Ó FáILBHE
KEITH GALVIN	IRISH	CEITEACH Ó GEALBHáIN
PADDY MORAN	IRISH	PáDRAIG Ó MóRáIN
PAT GILROY	IRISH	PáDRAIG MAC GIOLLA RUA
PAT O'NEILL	IRISH	PáDRAIG Ó NéILL
ROBBIE BOYLE	IRISH	ROIBEARD Ó BAOILL
MICK GALVIN	IRISH	MíCHEáL Ó GEALBHáIN
SEáN DOHERTY	IRISH	SEáN Ó DOCHARTAIGH
ANTON O'TOOLE	IRISH	ANTóIN Ó TUATHAIL
GRAHAM GERAGHTY	IRISH	GRAHAM MAG OIREACHTAIGH
TONY SCULLION	IRISH	ANTóIN Ó SCOLLáIN
JACK SHEEDY	IRISH	SEáN Ó SíODA
SIM WALTON	IRISH	SIMóIN DE BHáLTúN
DICK WALSH	IRISH	RISTEáRD BREATHNACH
AIDAN FENNELLY	IRISH	AODHáN Ó FIONNAILE
CHRIS CONWAY	IRISH	CRIOSTóIR Ó CONBHUí
AMBY POWER	IRISH	AMBRóS DE PAOR
JACK FINLAY	IRISH	LAOIS
CATHAL CASEY	IRISH	CATHAL Ó CATHASAIGH
ROSS MUNNELLY	IRISH	ROSS Ó MAONAILE
PADRAIG CLANCY	IRISH	PáDRAIG MAC FHLANNCHAIDH
DARREN ROONEY	IRISH	DARREN Ó RUANAIDH
COLM MCFADDEN	IRISH	COLM MAC PHáIDíN
GARY KAVANAGH	IRISH	GARY Ó CAOMHáNACH
PETER O'LEARY	IRISH	PEADAR Ó LAOIRE
GER SPILLANE	IRISH	GEARóID Ó SPEALáIN
PáDRAIG MCMAHON	IRISH	PADRAIG MACMATHúNA
NIALL DONOHER	IRISH	NíALL Ó DANACHAIR
CONOR GORMAN	IRISH	CONOR Ó GORMáIN
CATHAL RYAN	IRISH	CATHAL Ó RIAIN
BILLY SHEEHAN	IRISH	LIAM Ó SíOCHáIN
GERRY MCELHINNEY	IRISH	GEARóID MAC GIOLLA CHAINNIGH
MICHAEL TIERNEY	IRISH	MICHEáL SEáN Ó TIARNAIGH
ROBBIE KELLEHER	IRISH	ROIBEARD O CéILEACHAIR
PAUL LAWLOR	IRISH	PóL Ó LEATHLOBHAIR
HENRY DOWNEY	IRISH	ANRAí Ó DOMHNAIGH
COLM KELLY	IRISH	COLM Ó CEALLAIGH
PAUL MCDONALD	IRISH	PóL MACDóNAILL
TEU Ó HAILPíN	IRISH	TEU Ó HAILPíN
DINNY BARRY-MURPHY	IRISH	DONNACHA DE BARRA-MURCHU
MICK CASHMAN	IRISH	MíCHEáL Ó CíOSáIN
EUDIE COUGHLAN	IRISH	EOGHAN Ó COCHLáIN
DEREK MURRAY	IRISH	DEREK Ó MUIRí
GER BRENNAN	IRISH	GEARóID Ó BRAONáIN
COLIN PRENDERVILLE	IRISH	COILíN DE PRIONNBHíOL
BRIAN MCCORMACK	IRISH	BRIAN MACCORMAIC
JOHN MADIGAN	IRISH	SEáN Ó MADAGAIN
BARRY BRENNAN	IRISH	BARRA Ó BRAONáIN
DENIS MURPHY	IRISH	DONNCHA Ó MURCHú
JACKIE POWER	IRISH	SEáN DE PAOR
PADDY BARRY	IRISH	PáDRAIG DE BARRA
KEVIN MEANEY	IRISH	CAOIMHIN Ó MAONAí
MICK NOLAN	IRISH	MICHEáL Ó NUALLáIN
KIERAN MURPHY	IRISH	CIARáN Ó MURCHú
ANDY COMERFORD	IRISH	ANDRIAS COMARTúN
MICK GILL	IRISH	MíCHEáL MAC AN GHAILL
MICK KENNY	IRISH	MíCHEáL Ó CIONNAITH
SEáN ÓG MURPHY	IRISH	SEáN Ó MURCHú
LIAM KEARNS	IRISH	LIAM Ó CIARáN
JIM HURLEY	IRISH	SéAMUS Ó MUIRTHILE
WILLIE MURPHY	IRISH	LIAM Ó MURCHú
TONY HANAHOE	IRISH	ANTóIN Ó HEANCHAí
JIMMY MURRAY	IRISH	SéAMUS Ó MUIRí
JOHN BROWNE	IRISH	SEáN DE BRúN
MICKEY O'CONNELL	IRISH	MICHEAL Ó CONAILL
BOBBY RYAN	IRISH	ROIBEARD Ó RIAIN
HUBERT RIGNEY	IRISH	AODH Ó ROIGNE
WILLIE O'CONNOR	IRISH	LIAM Ó CONCHUBHAIR
JOHN BENNETT	IRISH	SEáN BINéID
TIM CROWLEY	IRISH	TADHG Ó CRUALAOI
SéAMUS CLEERE	IRISH	SéAMUS DE CLéIR
JIMMY O'BRIEN	IRISH	SéAMUS Ó BRIAIN
TED CARROLL	IRISH	ÉAMON Ó CEARRBHAILL
ÉAMONN CREGAN	IRISH	ÉAMONN Ó CRíAGáIN
JACKIE TYRRELL	IRISH	SEáNIE Ó TIRIAL
DONAL ÓG CUSACK	IRISH	DóNALL ÓG Ó CíOSóG
DóNAL O'GRADY	IRISH	DóNALL Ó GRáDA
MICK LYONS	IRISH	MíCHEáL Ó LAIGHIN
JOE BARRETT	IRISH	SEOSAMH BAIRéID
EDDIE O'BRIEN	IRISH	ÉAMONN Ó BRIAIN
JACKIE GILROY	IRISH	SEáN MAC GIOLLA RUA
LIAM CURRAMS	IRISH	LIAM Ó CORRáIM
MARTIN HANAMY	IRISH	MáIRTíN Ó HAINMIDH
TREVOR GILES	IRISH	TREVOR MAC GOILL
PAT HARTE	IRISH	PáDRAIG
ANGELA DOWNEY	IRISH	AINGEAL NIC GIOLLA DOMHNAIGH-DE BRúN
KEN HOGAN	IRISH	SéAMUS CIONNAITH Ó HÓGAIN
JOHN MAHONY	IRISH	SEáN Ó MATHúNA
GER BRADY	IRISH	GEARóID Ó BRáDAIGH
EILEEN DUFFY	IRISH	ÉIBHLíN Ní DHUBHTHAIGH
ÚNA O'CONNOR	IRISH	ÚNA Ní CONCHOBHAIR
JOVITA DELANEY	IRISH	SIOBHáN Ní DHUBHSHLáINE
TOMáS BRADY	IRISH	TOMáS Ó BRáDAIGH
NIALL PATTERSON	IRISH	NIALL MAC PHáIDíN
MICHAEL CARTON	IRISH	MICHEáL MAC ARTáIN
PHILIP BRENNAN	IRISH	PILIB Ó BRAONáIN
KEVIN FLYNN	IRISH	CAOIMHíN Ó FLOINN
RóNáN FALLON	IRISH	RóNáN Ó FALLúIN
MICHAEL KAVANAGH	IRISH	MíCHEáL CAOMHáNACH
JOHN MCCAFFREY	IRISH	SEáN MAC GAFRAIDH
GERRY MCENTEE	IRISH	GEARóID MAC AN TSAOI
ÉAMONN GRIMES	IRISH	ÉAMONN Ó GREACHáIN
TONY DAVIS	IRISH	ANTOINE DáIBHIS
JOEY BOLAND	IRISH	SEOSAMH Ó BEóLLáIN
BILLY FITZPATRICK	IRISH	LIAM MAC GIOLLA PHáDRAIG
JOHN CAFFREY	IRISH	SEáN MAC GAFRAIDH
ROBBIE O'MALLEY	IRISH	ROIBEARD Ó MáILLE
BRIAN STAFFORD	IRISH	BRIAN STAFORT
COLM CAVANAGH	IRISH	COLM CAOMHáNACH
JOHN COMMINS	IRISH	SEáN Ó COIMíN
PETE FINNERTY	IRISH	PEADAR Ó FIANNACHTA
MICK MURPHY	IRISH	MíCHEáL Ó MURCHú
JACK QUINN	IRISH	SEáN Ó CUINN
PAT REYNOLDS	IRISH	PáDRAIG MAC RáNAILL
DAVID HICKEY	IRISH	DAITHí Ó HÍCí
LIAM DUNNE	IRISH	LIAM Ó DúINN
MARTIN STOREY	IRISH	MáIRTíN Ó STOIRíN
CHRIS BERGIN	IRISH	CRIOSTOIR Ó BEIRGIN
KEVIN O'REILLY	IRISH	CAOIMHíN Ó RATHAILLE
RORY MCCARTHY	IRISH	RUAIRI MAC CáRTHAIGH
ALAN MCCRABBE	IRISH	AILéIN MAC CRABBE
GER CUSHE	IRISH	GEARóID MAC COISE
DICK FITZGERALD	IRISH	RISTéARD MAC GEARAILT
TOMMY DOWD	IRISH	TOMáS Ó DúDA
DARREN FAY	IRISH	DARREN Ó FéICH
JOHN O'BRIEN	IRISH	SEáN Ó BRIAIN
DAVE CREEDON	IRISH	DAITHí Ó CRíODáIN
GARY MAGUIRE	IRISH	GARRAí MAG UIDHIR
DEREK O'REILLY	IRISH	DEREK Ó RATHAILLE
LIAM RYAN	IRISH	LIAM Ó RIAIN
PáDRAIG O'DRISCOLL	IRISH	PáDRAIG Ó DRISCEOIL
TOMMY QUAID	IRISH	TOMáS MAC UAID
JOE QUAID	IRISH	SEOSAMH MAC UAID
JOHN MCDERMOTT	IRISH	SEáN MAC DIARMADA
PAT ROE	IRISH	PáDRAIG Ó RUADH
MICK LAWLOR	IRISH	MICHEáL Ó LEATHLOBHAIR
TONY MAHER	IRISH	ANTóIN Ó MEACHEAIR
JOHN MCANDREW	IRISH	SEáN MAC AINDRIú
OLLIE MURPHY	IRISH	OILIBHéAR Ó MURCHú
CIARáN CAREY	IRISH	CIARáN Ó CIARA
T. J. RYAN	IRISH	T. S. Ó RIAIN
OLLIE MORAN	IRISH	OLIBHéAR Ó MORáIN
DECLAN FANNING	IRISH	DéAGLáN Ó FAINíN
ÉAMONN CORCORAN	IRISH	ÉAMONN Ó CORCRáIN
PADDY O'BRIEN	IRISH	PáDRAIG Ó BRIAN
LIAM DONOGHUE	IRISH	LIAM Ó DONNCHU
BARRY FOLEY	IRISH	BARRA Ó FOGHLú
MICHAEL WALSH	IRISH	MíCHEáL BREATHNACH
MICHAEL WALSH	IRISH	MíCHEáL BREATHNACH
KIERAN DUFF	IRISH	CIARáN Ó DUIBH
BENNY DUNNE	IRISH	BREANDáN Ó DOINN
PAT CANAVAN	IRISH	PáDRAIG Ó CEANNUBHáIN
GAY O'DRISCOLL	IRISH	GAIBRIéL Ó DRISCEOIL
PEADAR CARTON	IRISH	PEADAR MAC ARTáIN
TOMMY MOORE	IRISH	TOMáS Ó MóRDHA
CONOR O'MAHONY	IRISH	CONCHúR Ó MATHúNA
AODáN DE PAOR	IRISH	AODáN DE PAOR
PADDY GOGARTY	IRISH	PáDRAIG MAG FHóGARTAIGH
JOHN LEAHY	IRISH	SEáN Ó LAOCHDA
PAT COLLIER	IRISH	PáDRAIG COILéIR
DECLAN RYAN	IRISH	DéAGLáN Ó RIAIN
COLM BONNAR	IRISH	COLM Ó CNáIMHSí
BERNARD FLYNN	IRISH	BEARNARD Ó FLOINN
BERTIE CUNNINGHAM	IRISH	AILBHE MAC CUINNEAGáIN
PETER MCDERMOTT	IRISH	PEADAR MAC DIARMADA
DECLAN CARR	IRISH	DéAGLáN Ó CARRA
JOHNNY PILKINGTON	IRISH	SEáN PILINEACH
MICHAEL DUIGNAN	IRISH	MíCHEáL Ó DUIGEANáIN
PHIL LARKIN	IRISH	PILIB Ó LORCáIN
RICHIE CONNOR	IRISH	RISTEARD Ó CONCHUBHAIR
DENIS GRIMES	IRISH	DONNCHADHA Ó GREACHáIN
DICK DOYLE	IRISH	RISTéARD Ó DúIL
MIKEY MAHER	IRISH	MíCHEáL Ó MEAGHER
PADDY DUNNE	IRISH	PáDRAIG O DUINN
MICK KENNEFICK	IRISH	MICHEáL CINIFéIC
MATT HASSETT	IRISH	MAITIú Ó HAISEADHA
SEáNIE MCGRATH	IRISH	SEáNIE MAC CRAITH
ALAN BROWNE	IRISH	ALAIN DE BRúN
MICHAEL DOYLE	IRISH	MíCHEáL Ó DúIL
DAVID BRENNAN	IRISH	DAIBHéID Ó BRAONáIN
TOMMY MCGUINNESS	IRISH	TOMáS MAG AONASA
DAMIEN DELANEY	IRISH	DAMIEN Ó DUBHSHLáINE
TOMMY CONROY	IRISH	TOMáS Ó CONAIRE
PADDY REILLY	IRISH	PáDRAIG Ó RAGHALLAIGH
JOE MCNALLY	IRISH	SEOSAMH MAC AN FHAILí
BOBBY DOYLE	IRISH	ROIBEARD Ó DúGHAILL
PAUL JOHN BUCKLEY	IRISH	PóL SEáN Ó BUACHALLA
SéAMUS DURACK	IRISH	SéAMUS Ó DúRAIC
STEPHEN BYRNE	IRISH	STIOFáN Ó BROIN
GER HENDERSON	IRISH	GEARóID MAC ÉINRí
PAT HENDERSON	IRISH	PáDRAIG MAC ÉINRí
JOHN HENDERSON	IRISH	SEáN MAC ÉINRí
SEáN FOLEY	IRISH	SEáN Ó FOGHLú
RORY KAVANAGH	IRISH	RUAIDHRí Ó CAOMHáNACH
BRENDAN DEVENNEY	IRISH	BREANDáN Ó DUIBHEANNAIGH
BILLY MORGAN	IRISH	LIAM Ó MORGáIN
MICKEY O'SULLIVAN	IRISH	MICHEáL Ó SUILLEABHáIN
DENIS MORAN	IRISH	DONNCHA Ó MORáIN
LIAM FENNELLY	IRISH	LIAM Ó FIONNALAIGH
RICHIE BENNIS	IRISH	RISTEáRD Ó BINéID
PáDRAIG HORAN	IRISH	PáDRAIG Ó HÓRáIN
JOE HENNESSY	IRISH	SEOSAMH Ó HAONASA
CLINTON HENNESSY	IRISH	CLINTON Ó HAONGHUSA
DECLAN PRENDERGAST	IRISH	DéAGLáN DE PRIONDRAGáS
TOM FEENEY	IRISH	TOMáS Ó FIANNAí
JOHN MACKEY	IRISH	SEáN MAC AODHA
DERRY BECKETT	IRISH	DOIRE BEICéID
DERMOT MAC CURTAIN	IRISH	DIARMUID MAC CURTAIN
JOHN ALLEN	IRISH	SEáN Ó HAILíN
MICK ROCHE	IRISH	MíCHEáL DE RóISTE
JIM ENGLISH	IRISH	SéAMUS INGLIS
PHIL BENNIS	IRISH	PILIB Ó BINéID
FRANCIS LOUGHNANE	IRISH	PRIONSIAS Ó LACHTNáIN
KEVIN CASSIDY	IRISH	CAOIMHíN Ó CASAIDE
EOIN MCGRATH	IRISH	EOIN MAC CRAITH
JACK KENNEDY	IRISH	SEáN Ó CINNéIDE
JARLATH FALLON	IRISH	IARLAITH Ó FALLúIN
EOIN KELLY	IRISH	EOIN Ó CEALLAIGH
BILLY O'SULLIVAN	IRISH	LIAM Ó SúILLEABHáIN
BERTIE ÓG MURPHY	IRISH	PARTHALAN ÓG Ó MURCHú
PAT MOYLAN	IRISH	PáDRAIG Ó MAOILEáIN
BRENDAN CUMMINS	IRISH	BREANDáN Ó COIMíN
KIERAN MCGUCKIN	IRISH	CIARáN MAC EOCHáIN
DENIS BYRNE	IRISH	DONNCHA Ó BROIN
TADHG O'CONNOR	IRISH	TADHG Ó CONCHUBHAIR
WILLIE JOHN DALY	IRISH	LIAM SEáN Ó DáLAIGH
PAUL FLYNN	IRISH	PóL Ó FLOINN
KEVIN LEAHY	IRISH	CAOIMHíN Ó LAOCHA
KIERAN CAREY	IRISH	CIARáN Ó CIARDHA
ROSS O'CARROLL	IRISH	ROSSA Ó CEARúIL
KEN MCGRATH	IRISH	CIONNAITH MAC CRAITH
GER HOULAHAN	IRISH	GEARóID Ó HUALLACHáIN
EAMONN COLEMAN	IRISH	ÉAMONN Ó COLMáIN
KEVIN HARTNETT	IRISH	CAOIMHGHIN Ó HAIRTNEADA
SHANE O'NEILL	IRISH	SEáN Ó NéILL
GRAHAM CALLINAN	IRISH	GRAHAM Ó CALLANáIN
ÉAMONN O'DONOGHUE	IRISH	ÉAMONN Ó DONNCHú
DAN QUIGLEY	IRISH	DóNALL Ó COIGLIGH
SEáN CONDON	IRISH	SEáN CONDúN
KEITH HIGGINS	IRISH	CEITEACH Ó H-UIGINN
JIM BROGAN	IRISH	SéAMUS Ó BRóGáIN
JIMMY BROHAN	IRISH	SéAMUS Ó BRUACHáIN
CONNIE BUCKLEY	IRISH	CONCHUIR Ó BUACHALLA
DóNAL CLIFFORD	IRISH	DóNALL Ó CLúMHáIN
FRANK NORBERG	IRISH	PRIONSIAS \
MICK MALONE	IRISH	MíCHEáL Ó MAOILEOIN
PAT BARRY	IRISH	PáDRAIG DE BARRA
SéAMUS LOONEY	IRISH	SéAMUS Ó LUANAIGH
CON ROCHE	IRISH	CONCHUR DE RóISTE
PAT HEGARTY	IRISH	PáDRAIG Ó HÉIGEARTAIGH
TOMáS RYAN	IRISH	TOMáS Ó RIAIN
CHARLIE CULLINANE	IRISH	CATHAL Ó CUILEANNáIN
PáDRAIC JOYCE	IRISH	PáDRAIC SEOIGHE
DECLAN O'DWYER	IRISH	DéAGLáN Ó DUIBHIR
BARRY O'RORKE	IRISH	BARRA Ó RúAIRC
WILLIE WALSH	IRISH	LIAM BREATHNACH
TOM O'DONOGHUE	IRISH	TOMáS Ó DONNCHú
TONY CONNOLLY	IRISH	ANTOIN Ó CONGHAILE
PETER DOOLAN	IRISH	PEADAR Ó DúLAINN
MICK WATERS	IRISH	MíCHEáL UíTEAR
JERRY O'SULLIVAN	IRISH	GEARóID Ó SúILLEABHáIN
COLM SHEEHAN	IRISH	COLM Ó SíOCHáIN
JOHN O'HALLORAN	IRISH	SEáN Ó HALLúRáIN
SEáNIE BARRY	IRISH	SEáN DE BARRA
PADDY FITZGERALD	IRISH	PáIDí MAC GEARAILT
DENIS WALSH	IRISH	DONNCHA BREATHNACH
JOHN BUCKLEY	IRISH	SEáN Ó BUACHALLA
ALAN LARKIN	IRISH	AILéIN Ó LORCáIN
STEPHEN HAYES	IRISH	STíOFáN Ó HAODHA
DAN LANE	IRISH	DóNALL Ó LAIGHIN
BILL O'CALLAGHAN	IRISH	LIAM Ó CEALLEACHáIN
STEVA RIORDAN	IRISH	STIOFáN Ó RIORDáIN
JAMESY KELLEHER	IRISH	SéAMUS Ó CéILEACHAIR
JOHN MURPHY	IRISH	SEáN Ó MURCHú
EDWARD O'CONNELL	IRISH	ÉAMONN Ó CONAILL
BATT THORNHILL	IRISH	PARTHALAN Ó DROIGHNEáN
VINCY TWOMEY	IRISH	UINSEANN Ó TUAMA
JOE TWOMEY	IRISH	SEOSAMH Ó TUAMA
KIERAN KELLY	IRISH	CIARáN Ó CEALLAIGH
PADDY COLLINS	IRISH	PáDRAIG Ó COILEáIN
JIM BUTTIMER	IRISH	SéAMUS BUITIMéAR
TONY O'SHAUGHNESSY	IRISH	TóNAí Ó SEACNASAIGH
GERRY O'RIORDAN	IRISH	GEARóID Ó RIORDáIN
LIAM DOWLING	IRISH	LIAM Ó DUALAING
JOHN LYONS	IRISH	SEáN Ó LIATHáIN
WILLIE MOORE	IRISH	LIAM Ó MORDHA
ÉAMONN GOULDING	IRISH	ÉAMONN DE GúL
JER DOHENY	IRISH	JER Ó DúCHONNA
GERALD MURPHY	IRISH	GEARóID Ó MURCHU
MOSSY O'RIORDAN	IRISH	MUIRIS Ó RIORDáIN
TOM SEMPLE	IRISH	TOMáS SIOMPAL
BRIAN WHELAHAN	IRISH	BRIAN Ó FAOILEACHáIN
ALAN LOTTY	IRISH	AILéIN Ó LOTAIGH
DIN JOE BUCKLEY	IRISH	D. S. Ó BUACHALLA
TOM MULCAHY	IRISH	TOMáS Ó MAOLCATHA
JIMMY KENNEDY	IRISH	SéAMUS Ó CINNéIDE
WILLIE HOUGH	IRISH	LIAM Ó HEOCHAIDH
AMBROSE O'DONOVAN	IRISH	AMBRóS Ó DONNABHáIN
JOHN MCCARTHY	IRISH	SEáN MAC CáRTHAIGH
MARK TIMMONS	IRISH	MARC MAC TOIMíN
ALAN NOLAN	IRISH	ALAN Ó NUALLáIN
JOHNNY LEAHY	IRISH	SEáN Ó LIATHAIGH
NED HAYES	IRISH	ÉAMONN Ó HAODHA
NICHOLAS O'SHEA	IRISH	NIOCLáS Ó Sé
GARY KIRBY	IRISH	GEARóID Ó CIARBA
PA DILLON	IRISH	PáDRAIG DIOLúN
DICK O'HARA	IRISH	RISTEARD Ó HEáRA
CHRISTY HEFFERNAN	IRISH	CRíOSTóIR Ó HIFEARNáIN
JIMMY FINN	IRISH	SéAMUS Ó FINN
SEáN KENNY	IRISH	SEáN Ó CIONNAITH
PAT DELANEY	IRISH	PáDRAIG Ó DúLáINNE
KIERAN BRENNAN	IRISH	CIARáN Ó BRAONáN
KEVIN FENNELLY	IRISH	CAOIMHíN Ó FIONNALAIGH
MICK CROTTY	IRISH	MíCHEáL Ó CROTAIGH
JIMMY WALSH	IRISH	SéAMUS BREATHNACH
CON COTTRELL	IRISH	CONN MAC OITIRIL
MICHAEL CLEARY	IRISH	MíCHEáL Ó CLéIRIGH
GERRY KENNEDY	IRISH	GEAROID Ó CINNEIDE
MICKA BRENNAN	IRISH	MICHEáL Ó BRAONáIN
MICK AHERN	IRISH	MíCHEáL Ó HEACHTAIRN
PADDY AHERN	IRISH	PáIDí Ó HEACHTAIRN
NEIL GALLAGHER	IRISH	NIALL Ó GALLCHOBHAIR
BRENDAN MURPHY	IRISH	BREANDáN Ó MURCHú
SHANE O'ROURKE	IRISH	SEáN Ó RUAIRC
EAMON HEERY	IRISH	ÉAMON Ó HÍORUA
PATRICK CRONIN	IRISH	PáDRAIG Ó CRóINíN
JIM TREACY	IRISH	SéAMUS Ó TREASAIGH
STEPHEN BRAY	IRISH	STIOFáN Ó BRé
TOMMY DOYLE	IRISH	TOMáS Ó DUIL
STEPHEN MOLUMPHY	IRISH	STIOFáIN Ó MAOLANFAIDH
AIDAN KEARNEY	IRISH	AODáN Ó CEARNAIGH
NICHOLAS MURPHY	IRISH	NIOCLáS Ó MURCHú
NED POWER	IRISH	ÉAMONN DE PAOR
MARTIN NAUGHTON	IRISH	MAIRTíN MAC NEACHTáIN
PADDY PRENDERGAST	IRISH	PáDRAIG DE PRIONDRAGáS
EDDIE O'CONNOR	IRISH	ÉAMONN Ó CONCHúIR
LIAM WALSH	IRISH	LIAM BREATHNACH
GERRY MCCAUL	IRISH	GEARóID MAC CAMHAOIL
CHARLIE VERNON	IRISH	CATHAL DE BHEARNúIN
SEáN MCCARTHY	IRISH	SEáN MAC CARTHAIGH
MARK FOLEY	IRISH	MARCUS Ó FOGHLú
JOHN FITZGIBBON	IRISH	SEáN MAC GIOBUIN
GER FITZGERALD	IRISH	GEAROID MAC GEARAILT
WILLIE O'DWYER	IRISH	LIAM Ó DUBHUIR
DERMOT DEASY	IRISH	DIARMAID MAC AN DéISIGH
FRANKIE WALSH	IRISH	PRIONSIAS BREATHNACH
JIM WARE	IRISH	SéAMUS MAC AN MHAOIR
JOHN KIELY	IRISH	SEáN Ó CADHLA
JOHN HOYNE	IRISH	SEáN Ó HEOGHAIN
BRIAN MURRAY	IRISH	BRIAIN Ó MUIRí
EOIN MURPHY	IRISH	EOIN Ó MURCHú
MIKE O'BRIEN	IRISH	MíCHEáL Ó BRIAIN
ANDREW O'SHAUGHNESSY	IRISH	AINDRIAS Ó SEACHNASAIGH
STEPHEN LUCEY	IRISH	STIOFáN Ó LUASAIGH
BRIAN BEGLEY	IRISH	BRIAIN Ó BEAGLAOICH
BRIAN GEARY	IRISH	BRIAIN Ó GADHRA
MARK O'RIORDAN	IRISH	MARC Ó RíORDáN
SéAMUS HICKEY	IRISH	SéAMUS Ó HÍCí
MARK FOLEY	IRISH	MARC Ó FOGHLú
MIKE FITZGERALD	IRISH	MíCHEáL MAC GEARAILT
DONIE RYAN	IRISH	DóNAL Ó RIAIN
P. J. RYAN	IRISH	P. S. Ó RIAIN
BRIAN HOGAN	IRISH	BRIAIN Ó HÓGáIN
DONAL O'GRADY	IRISH	DONAL Ó GRáDA
SEáN O'CONNOR	IRISH	SEáN Ó CONCHUBHAIR
PETER LAWLOR	IRISH	PEADAR Ó LEATHLOBHAIR
JIMMY COOGAN	IRISH	SéAMUS Ó CUAGáIN
CHARLIE CARTER	IRISH	SéARLAS MAC ARTúIR
KEVIN MURRAY	IRISH	CAOIMHíN Ó MUIRí
LIAM SIMPSON	IRISH	LIAM MAC SHIM
NED BYRNE	IRISH	ÉAMONN Ó BROIN
PADDY MORAN	IRISH	PáDRAIG Ó MóRáIN
JOHN QUIGLEY	IRISH	SEáN Ó COIGLIGH
JAMES MASTERS	IRISH	SéAMUS MAC MáISTIR
KIERAN MCKEEVER	IRISH	CIARáN MAC ÍOMHAIR
ENDA GORMLEY	IRISH	ÉANNA Ó GARMAILE
JIMMY PHELAN	IRISH	SéAMAS Ó FAOLáIN
JOE CANNING	IRISH	SEOSAMH Ó CAINíN
PADGE KEHOE	IRISH	PáDRAIG MAC EOCHAIDH
TOM MULLIGAN	IRISH	TOMáS Ó MAOLAGáIN
SéAMUS HORGAN	IRISH	SéAMUS Ó HORGáIN
PAUDIE FITZMAURICE	IRISH	PáDRAIG MAC MUIRIS
EOIN LARKIN	IRISH	EOGHAN Ó LORCáIN
T. J. REID	IRISH	T. S. Ó MAOILDEIRG
ALAN QUIRKE	IRISH	AILéIN Ó CUIRC
MICHAEL SHIELDS	IRISH	MíCHEáL Ó SIAIL
GRAHAM CANTY	IRISH	GRAHAM Ó CáINTE
MICHAEL CUSSEN	IRISH	MíCHEáL CúISíN
ANTHONY LYNCH	IRISH	ANTóIN Ó LOINGSIGH
KIERAN O'CONNOR	IRISH	CIARáN Ó CONCHUBHAIR
NOEL O'LEARY	IRISH	NOLLAIG Ó LAOIRE
KEVIN MCMAHON	IRISH	CAOIMHíN MAC MATHúNA
PEARSE O'NEILL	IRISH	PIARSAS Ó NéILL
DECLAN O'SULLIVAN	IRISH	DéAGLáN Ó SúILLEABHáIN
DICK DOYLE	IRISH	RISTEARD Ó DúGHAILL
JACK ROCHFORD	IRISH	SEáN DE ROCHFORT
CHARLIE NELLIGAN	IRISH	CATHAL Ó NEILEAGáIN
JIMMY KENNEDY	IRISH	SéAMUS Ó CINNéIDE
DAN DREW	IRISH	DóNALL Ó DRAOI
PAT BUCKLEY	IRISH	PáDRAIG Ó BUACHALLA
THADY O'CONNOR	IRISH	TADHG Ó CONCHUBHAIR
PADDY DELEA	IRISH	PáDRAG Ó DUILé
PAT NOLAN	IRISH	PáDRAIG Ó NUALLáIN
JOE MCKENNA	IRISH	SEOSAMH MAC CIONNAITH
LIAM SHEEDY	IRISH	LIAM Ó SIODAIGH
JOHNNY DOOLEY	IRISH	SEáN Ó DULAOíCH
MICHAEL BOND	IRISH	MíCHEáL DE BOND
PAT CARROLL	IRISH	PáDRAIG Ó CEARBHALL
MARTIN COOGAN	IRISH	MáIRTíN Ó CUAGáIN
MARTIN CODD	IRISH	MáIRTíN MAC ODA
MARTIN CARNEY	IRISH	MáIRTíN Ó CEARNAIGH
JOHNNY MCGOVERN	IRISH	SEáN MAC GIOBHEANAIGH
BOB MOCKLER	IRISH	ROIBéARD MOCLéIR
JIM GAVIN	IRISH	SéAMUS Ó GáBHáIN
SEáN CLOHESSY	IRISH	SEáN Ó CLOCHASAIGH
MICHAEL MAHER	IRISH	MíCHEáL Ó MEACHAIR
GARRETT HOWARD	IRISH	GEARóID Ó HÍOMHAIR
PADDY O'DONOVAN	IRISH	PáIDí Ó DONNABHáIN
JOHN BARRON	IRISH	SEáN DE BARúN
JIM YOUNG	IRISH	SéAMUS DE SIúN
KEVIN MCCLOY	IRISH	CAOIMHíN MAC LUAIDH
JAMES %22CHA%22 FITZPATRICK	IRISH	SéAMUS MAC GIOLLA PHáDRAIG
JIM MCKEEVER	IRISH	SéAMAS MAC ÍOMHAIR
WILLIE MOORE	IRISH	LIAM Ó MORDHA
JIM O'BRIEN	IRISH	SéAMUS Ó BRIAIN
MOSSIE DOWLING	IRISH	MUIRIS Ó DUALAING
BERNIE HARTIGAN	IRISH	BEIRCHEART Ó HARTAGáIN
FRANKIE NOLAN	IRISH	PROINSIAS Ó NUALLáIN
LIAM O'DONOGHUE	IRISH	LIAM Ó DONNCHú
NED REA	IRISH	ÉAMONN Ó RIABHAIGH
TOM RYAN	IRISH	TOMáS Ó RIAIN
SIMON BEHAN	IRISH	SíOMóN Ó BEACHáIN
KIERAN PURCELL	IRISH	CIARáN PUIRSéIL
TOMMY MAHER	IRISH	TOMáS Ó MEACHAIR
JOHN HODGINS	IRISH	SEáN MAC HOISTICíN
RICHARD BROWNE	IRISH	RISTéARD DE BRUN
DARREN HOMAN	IRISH	DARRAN Ó HEOGHAMáIN
TEDDY HOLLAND	IRISH	TADHG Ó HAOLáIN
THEO ENGLISH	IRISH	TIOBóID INGLIS
JOACHIM KELLY	IRISH	JOACHIM Ó CEALLAIGH
PETER O'SULLIVAN	IRISH	PEADAR Ó SúILLEABHáIN
JOHN GLEESON	IRISH	SEáN Ó GLíASáIN
P. J. RYAN	IRISH	P.S. Ó RIAIN
CLAUS DUNNE	IRISH	NIOCLáS Ó DUINN
JIM BENNETT	IRISH	SéAMUS MAC BEINéID
JIM LYNCH	IRISH	SéAMUS Ó LOINGSIGH
TOM WALSH	IRISH	TOMáS BREATHNACH
RICHIE REID	IRISH	RISTEARD Ó MAOILDEIRG
PAT LAWLOR	IRISH	PáDRAIG Ó LEATHLOBHAIR
TOM MCCORMACK	IRISH	TOMáS MAC CORMAIC
MICK BRENNAN	IRISH	MíCHEáL Ó BRAONáIN
SHANE DURKIN	IRISH	SHANE MAC DHUARCáIN
WATTIE DUNPHY	IRISH	UALTAR Ó DONNCHAIDH
MARTIN WHITE	IRISH	MáIRTíN DE FAOITE
MICK RYAN	IRISH	MíCHEáL Ó RIAIN
EDDIE DOYLE	IRISH	ÉAMONN Ó DúGHAILL
SéAMUS PRENDERGAST	IRISH	SéAMUS DE PRIONDRAGáS
BRYAN PHELAN	IRISH	BRIAN Ó FAOLáIN
DAVE BENNETT	IRISH	DáITHí Ó BEINéID
PADDY KENNY	IRISH	PáDRAIG Ó CIONNAITH
TERRY LEAHY	IRISH	TOIREALAIGH Ó LAOCHA
SHANE WALSH	IRISH	SHANE BREATHNACH
PAT KELLY	IRISH	PáDRAIG Ó CEALLAIGH
DAN KENNEDY	IRISH	DóNALL Ó CINNéIDE
JIMMY LANIGAN	IRISH	SéAMUS Ó LONAGáIN
TERENCE MCNAUGHTON	IRISH	TOIREALACH MAC NEACHTAIN
DAMIEN REALE	IRISH	DAMIEN Ó ROGHAIL
PAT TOBIN	IRISH	PáDRAIG Ó TóIBíN
KEVIN TOBIN	IRISH	CAOIMHIN Ó TóIBíN
RICHIE POWER	IRISH	RISTEARD DE PAOR
AIDAN FOGARTY	IRISH	AODáN Ó FOGARTAIGH
NIALL MORAN	IRISH	NIALL Ó MORáIN
JOHNNY FLAHERTY	IRISH	SEáN O FLAHARTAIGH
FERGAL DOHERTY	IRISH	FEARGHáL Ó DOCHARTAIGH
JAMES O'BRIEN	IRISH	SéAMUS Ó BRIAIN
KEVIN MCGUCKIN	IRISH	CAOIMHíN MAG EOCHáIN
SEáN MARTY LOCKHART	IRISH	SEáN MáIRTíN LOCARD
CONLEITH GILLIGAN	IRISH	CONLáED MAC GIOLLAGáIN
MICHAEL MCGOLDRICK	IRISH	MíCHEáL MAC GUALRAIC
MARK LYNCH	IRISH	MARCAS Ó LOINGSIGH
GERARD O'KANE	IRISH	GEARóID Ó CATHáIN
BARRY GILLIS	IRISH	BARRA MAC GIOLLA ÍOSA
BRIAN MURPHY	IRISH	BRIAN Ó MURCHú
FRANCIS MCELDOWNEY	IRISH	PROINSIAS MAC GIOLLA DOMHNAIGH
PAUL BROGAN	IRISH	PóL Ó BRóGáIN
DERMOT MCBRIDE	IRISH	DIARMUID MAC GIOLLA BHRíDE
DAMIEN MCCUSKER	IRISH	D. MAC OSCAIR
FERGAL MCCUSKER	IRISH	FEáRGHAL MAC OSCAIR
JOHNNY MCGURK	IRISH	SEáN MAC UIRC
GARY COLEMAN	IRISH	GEARóID Ó COLMáIN
BRIAN MCGILLIGAN	IRISH	BRIAN MAC GIOLLAGáIN
JOHN O'BRIEN	IRISH	SEáN Ó BRIAIN
DESSIE DOLAN	IRISH	DEASúN Ó DúLáIN
GAVIN DEVLIN	IRISH	GáBHáIN Ó DOIBHILIN
PHILIP MCMAHON	IRISH	PILIB MAC MATHúNA
EAMONN FENNELL	IRISH	ÉAMONN Ó FIONNAIL
SIMON LAMBERT	IRISH	SIMON LAIMBEART
CONOR COUNIHAN	IRISH	CONCHUR Ó CUANACHáIN
SéAMUS SCANLON	IRISH	SéAMUS Ó SCANLáIN
BRYAN SHEEHAN	IRISH	BRIAN Ó SíOCHáIN
KILLIAN YOUNG	IRISH	CILLIAN DE SHIúN
DONNCHADH WALSH	IRISH	DONNCHADH BREATHNACH
KIERAN O'LEARY	IRISH	CIARáN Ó LAOIRE
DONNCHA O'CONNOR	IRISH	DONNCHA Ó CONCHUBHAIR
MICHEáL QUIRKE	IRISH	MíCHEáL Ó COIRC
DAVID MORAN	IRISH	DAITHí Ó MóRáIN
KEVIN MORAN	IRISH	CAOIMHíN Ó MóRáIN
TOMMY WALSH	IRISH	TOMáS BREATHNACH
JAMES CONWAY	IRISH	SéAMAS Ó CONBHUí
COILIN DEVLIN	IRISH	COILíN Ó DOIBHILIN
PAUL MURPHY	IRISH	PóL Ó MURCHú
LIAM HINPHEY	IRISH	LIAM ÓG Ó HANFAIDH
JOHN DEIGHAN	IRISH	SEáN Ó DUíGEANNáIN
MICHAEL MCBRIDE	IRISH	MíCHEáL MAC GIOLLA BHRíDE
FRANK LOHAN	IRISH	PRIONSIAS Ó LEOCHáIN
DERMOT MCNICHOLL	IRISH	DIARMUID MAC NIOCAIL
DERMOT HEANEY	IRISH	DIARMUID Ó HÉANNA
SHANE CASEY	IRISH	SEáN Ó CATHASAIGH
NIALL MCCUSKER	IRISH	NIALL MAC OSCAIR
ANTHONY MCGURK	IRISH	SEáN MAC UIRC
COLM COYLE	IRISH	COLM MAC GIOLLA CHOMHAILL
BARRY MCGOLDRICK	IRISH	BARRA MAC GUALRAIC
CIARáN MULLAN	IRISH	CIARáN Ó MAOLáIN
DENIS BURNS	IRISH	DONNCHA Ó BROIN
PAT HEFFERNAN	IRISH	PáDRAIG Ó HIFEARNáIN
BERNIE O'CONNOR	IRISH	BEIRCHEART Ó CONCHUBHAIR
PAD JOE WHELEHAN	IRISH	PáDRAIG SEOSAMH Ó FAOILEACHáIN
TONY ÓG REGAN	IRISH	ANTOINE Ó RIAGáIN
NIALL HEALY	IRISH	NIALL Ó HÉILí
DAMIEN JOYCE	IRISH	DAMIEN SEOIGE
KEVIN BRODERICK	IRISH	CAOIMHíN Ó BRUADAU
DAVID TIERNEY	IRISH	DAITHí Ó TIARNA
RICHIE MURRAY	IRISH	RISTEARD Ó MUIRí
JOHNNY QUIRKE	IRISH	SEáN Ó COIRC
CYRIL LYONS	IRISH	COIREALL Ó LAIGHIN
THOMAS COSTELLO	IRISH	TOMáS MAC COISTEALA
DARRAN O'SULLIVAN	IRISH	DARRAN Ó SúILLEABHáIN
AUSTIN O'MALLEY	IRISH	AUSTIN Ó MáILLE
BRIAN MCEVOY	IRISH	BRIAN MAC FHíOBHUí
JIMMY COFFEY	IRISH	SéAMUS Ó COFAIGH
SéAMUS MURPHY	IRISH	SéAMUS Ó MURCHú
TIM FLOOD	IRISH	TADHG Ó MAOLTUILE
OLIVER MCGRATH	IRISH	OLIBHéAR MAC CRAITH
TIMMY RYAN	IRISH	TADHG Ó RIAIN
D.J. STAPLETON	IRISH	D.J. MAC AN GHAILL
OLLIE BAKER	IRISH	OLIBHéAR BáICéIR
SEáN MCLOUGHLIN	IRISH	SEáN MAC LOCHLAINN
JOHN O'GRADY	IRISH	SEáN Ó GRáDA
LIAM CONNOLLY	IRISH	LIAM Ó CONGHAILE
TOM RYAN	IRISH	TOMáS Ó RIAIN
TOM RYAN	IRISH	TOMáS Ó RIAIN
PHIL SHANAHAN	IRISH	PILIB Ó SEANACHáIN
JOE MCDONAGH	IRISH	SEOSAMH MAC DONNCHADHA
NIALL CORCORAN	IRISH	NíALL Ó CORCRáIN
JAMES BURKE	IRISH	SEAMUS Dé BURCA
PAUDIE O'SULLIVAN	IRISH	PáDRAIG Ó SúILLEABHáIN
EOIN CADOGAN	IRISH	EOIN Ó CEADAGáIN
MARTIN ÓG MORRISSEY	IRISH	MáIRTíN ÓG Ó MUIRGHEASA
JOE HAYES	IRISH	SEOSAMH Ó HAODHA
JOHN KENNEDY	IRISH	SEáN Ó CINNéIDE
DONIE O'CONNELL	IRISH	DóNALL Ó CONAILL
AIDAN RYAN	IRISH	AODáN Ó RIAIN
CONOR STAKELUM	IRISH	CONCHUR STEACLúM
MICHAEL RYAN	IRISH	MíCHEáL Ó RIAIN
JOHN O'LOUGHLIN	IRISH	SEáN Ó LOCHLAINN
KEVIN CANTY	IRISH	CAOIMHíN Ó CAINTE
SEáN O'GORMAN	IRISH	SEáN Ó GORMáIN
RYAN O'DWYER	IRISH	RYAN Ó DUBHUIR
SHANE MCGRATH	IRISH	SEáN MAC CRAITH
WILLIE RYAN	IRISH	LIAM Ó RIAIN
CONOR O'BRIEN	IRISH	CONCHUR Ó BRIAIN
MICHAEL MCIVER	IRISH	MíCHEáL MAC ÍOMHAIR
PATSY BRADLEY	IRISH	PáDRAIG Ó BROLCHáIN
PAUL CARTIN	IRISH	PóL MAC ARTáIN
ÉAMONN BUCKLEY	IRISH	ÉAMON  Ó BUACHALLA
SHANE MAHER	IRISH	SEáN Ó MEAGHER
JAMES WOODLOCK	IRISH	SéAMUS UADLóG
SéAMUS BUTLER	IRISH	SéAMUS DE BUITLéIR
SéAMUS CALLANAN	IRISH	SéAMUS Ó CALLANáIN
PATRICK	IRISH	PáDRAIG DE BURCA
PATRICK HORGAN	IRISH	PáDRAIG Ó HORGáIN
BRIAN CORRY	IRISH	BRIAIN Ó CORRA
CATHAL PARLON	IRISH	CATHAL MAC PARTHALáIN
JOHN T. POWER	IRISH	SEáN T. DE PAOR
MATTY POWER	IRISH	MAITIú DE PAOR
JIM POWER	IRISH	SéAMUS DE PAOR
PADDY SCANLON	IRISH	PáDRAIG Ó SCANLáIN
PADDY GRACE	IRISH	PáDRAIG DE GRáS
PAT MAHER	IRISH	PáDRAIG Ó MEACHAIR
NED DOYLE	IRISH	ÉAMONN Ó DúGHAILL
PADDY LANIGAN	IRISH	PáDRAIG Ó LONAGáIN
MATT GARGAN	IRISH	MAITIú Ó GARGáIN
JACK HOYNE	IRISH	SEáN Ó HEOGHAIN
JIMMY KELLY	IRISH	SEAMUS Ó CEALLAIGH
DICK DOHERTY	IRISH	RISTEARD Ó DOCHARTAIGH
MICK DOYLE	IRISH	MíCHEáL Ó DúGHAILL
PADDY SAUNDERS	IRISH	PáDRAIG MAC SANDAIR
JIM LALOR	IRISH	SéAMUS Ó LEATHLOBHAIR
PAT FIELDING	IRISH	PáDRAIG AN MHACHAIRE
JACK ANTHONY	IRISH	SEAN ANTAINE
DICK GRACE	IRISH	RISTEARD GRáS
PADDY LARKIN	IRISH	PáDRAIG Ó LORCáIN
JACK BARRETT	IRISH	SEáN BAIRéID
JIM O'REGAN	IRISH	SéAMUS Ó RIAGáIN
WILLIE CAMPBELL	IRISH	LIAM MAC CATHMHAOIL
JAMES RYNG	IRISH	SéAMUS Ó RINN
PIERCE GRACE	IRISH	PIARAS GRáS
TOMMY DALY	IRISH	TOMáS Ó DáLAIGH
MICK DANIELS	IRISH	MíCHEáL Ó DóNAILL
SHEM DOWNEY	IRISH	SéAMUS Ó DúNAIGH
PETER BLANCHFIELD	IRISH	PEADAR DE BLUINSíN
JIM DERMODY	IRISH	SéAMAS Ó DIARMADA
MICKEY KELLY	IRISH	MíCHEáL Ó CEALLAIGH
PAT COUGHLAN	IRISH	PáDRAIG MAC COCHLáIN
TOM COUGHLAN	IRISH	TOMáS MAC COCHLáIN
JOHN COUGHLAN	IRISH	SEáN MAC COCHLáIN
MICHAEL JOHN FLAHERTY	IRISH	M. S. Ó FLAITHEARTA
JOHN JOE CALLANAN	IRISH	SEáN SEOASAMH Ó CALLANáIN
BOB MCCONKEY	IRISH	ROIBéARD MAC CONCAIGH
PADDY MCINERNEY	IRISH	PáDRAIG MAC AN AIRCHINNIGH
WILLIE CLANCY	IRISH	LIAM MAC LANNCHAIDH
MORGAN MADDEN	IRISH	MURCHA Ó MADáIN
PETER O'GRADY	IRISH	PEADAR Ó GRáDA
MICK O'CONNELL	IRISH	MíCHEáL Ó CONAILL
TOM BARRY	IRISH	TOMáS DE BARRA
JOHNNY WALSH	IRISH	SEáN BREATHNACH
GARY HURNEY	IRISH	GARRAí Ó HURNAí
JAMES MURRAY	IRISH	SEAMAS O MUIRITHE
CIARAN BARR	IRISH	CIARáN Ó BAIRR
JIMMY WALSH	IRISH	SéAMUS BREATHNACH
PHIL PURCELL	IRISH	PILIB PUIRSéIL
TOM SHINNY	IRISH	TOMáS Ó SIONNAIGH
PADDY GANTLY	IRISH	PáDRAIG MAG SHEANLAOICH
MICK KING	IRISH	MíCHEáL Ó CIONGA
MICK DERIVAN	IRISH	MíCHEáL Ó DOIRBHEáIN
IGNATIUS HARNEY	IRISH	EIGHNEACHáN Ó HATHAIRNE
IGGY CLARKE	IRISH	EIGHNEACHáN Ó CLéIREACHáIN
SEáN SILKE	IRISH	SEáN Ó SíODA
JOE SALMON	IRISH	SEOSAMH Ó BRADáIN
JOSIE GALLAGHER	IRISH	SEOSAMH Ó GALLCHóIR
P. J. MOLLOY	IRISH	P. S. Ó MAOLMHUAIDH
SEáN HERBERT	IRISH	SEáN HOIREABARD
TONY BRENNAN	IRISH	TóNAí Ó BRAONáIN
MARTIN KENNEDY	IRISH	MáIRTíN Ó CINNéIDE
NOEL DRUMGOOLE	IRISH	NOLLAIG DROMGúL
JOHN MAHER	IRISH	SEáN Ó MEACHAIR
BILLY MACKESY	IRISH	LIAM Ó MACASA
SEáN STACK	IRISH	SEáN DE STAIC
JOHN MCGRATH	IRISH	SEáN MAC CRAITH
JOHN JOE DOYLE	IRISH	SEáN SEOSAMH Ó DúIL
CHRISTY MOYLAN	IRISH	CRIOSTóIR Ó MAOILEáIN
COLM DORAN	IRISH	COLM Ó DóRáIN
JAMIE NAGLE	IRISH	SéAMUS DE NAGLE
ADRIAN POWER	IRISH	ADRIAN DE PAOR
MARTIN QUIGLEY	IRISH	MáIRTíN Ó COIGLIGH
NOEL CAMPBELL	IRISH	NOLLAIG MAC CATHMHAOIL
MICK JACOB	IRISH	MíCHEáL IáCóB
NED BUGGY	IRISH	ÉAMONN Ó BOGAIGH
PHIL WILSON	IRISH	PILIB MAC LIAM
KEVIN NOLAN	IRISH	CAOIMHíN Ó NUALLáIN
TOM DEMPSEY	IRISH	TOMáS Ó DíOMSAIGH
HARRY RYAN	IRISH	ANRAí Ó RIAIN
PADDY MACKEY	IRISH	PáDRAIG MAC AODHA
SEAMUS LEYDON	IRISH	SéAMUS Ó LOIDEáIN
SEáN ÓG DE PAOR	IRISH	SEáN ÓG DE PAOR
LIAM SAMMON	IRISH	LIAM Ó BRADáIN
GARY FAHEY	IRISH	GEARóID Ó FATHAIGH
LIAM MCCARTHY	IRISH	LIAM MAC CáRTHAIGH
MICHAEL MEEHAN	IRISH	MíCHEáL Ó MíOCHáIN
PAUL DOHERTY	IRISH	PóL Ó DOCHARTAIGH
GARETH BRADSHAW	IRISH	GEARóID BRADSEACH
RAY BARRY	IRISH	RéAMANN DE BARRA
ANTHONY KIRWAN	IRISH	ANTOINE Ó CIARUBHáIN
FINIAN HANLEY	IRISH	FINIAN Ó HAINLE
PAUDIE PRENDERGAST	IRISH	PáDRAIG DE PRIONDRAGáS
CHRISTY KEOGH	IRISH	CRIOSTóIR MAC EOCHAIDH
CHRISTY JACOB	IRISH	CRIOSTóIR IáCóB
MATTHEW CLANCY	IRISH	MAITIú MAC FHLANNCHAIDH
MARTIN MCNAMARA	IRISH	MáIRTíN MAC CON MARA
JOE BERGIN	IRISH	SEOSAMH Ó BEIRGIN
KIERAN O'GORMAN	IRISH	CIARáN Ó GORMáIN
JOHNNY BRENNER	IRISH	SéAN BRENNER
TOM MCINERNEY	IRISH	TOMáS MAC AN AIRCHINNIGH
SéAMUS SHINNORS	IRISH	SéAMUS SIONúIR
TOM FOGARTY	IRISH	TOMáS Ó FOGARTAIGH
PAT KENNEALLY	IRISH	PáDRAIG
GARY LAFFAN	IRISH	GARRAí LAFáN
TOM O'REILLY	IRISH	THOMAS Ó'RAGHALLAIGH
DICKIE MURPHY	IRISH	RISTEARD Ó MURCHú
JOHNNY O'CONNOR	IRISH	SEáN Ó CONCHUBHAIR
ANDY FLEMING	IRISH	AINDRIAS PLéAMEANN
LOCKY BYRNE	IRISH	LOCHLAINN Ó BROIN
SEáN DOWLING	IRISH	SEáN Ó DúLLAING
PADDY MULLALLY	IRISH	PáIDí Ó MAOLALAIDH
LIZ NEARY	IRISH	EIBHLíN Ní NáRAIGH
MICKEY MORAN	IRISH	MíCHEáL Ó MORáIN
SEáN FENNELLY	IRISH	SEáN Ó FIONNALAIGH
PETER QUEALLY	IRISH	PEADAR Ó CAOLLAí
TOM PARSONS	IRISH	TOMáS MAC AN PHEARSúIN
TEDDY O'BRIEN	IRISH	TADHG Ó BRIAIN
DONIE COLLINS	IRISH	DóNALL Ó COILEáIN
LEIGHTON GLYNN	IRISH	LACHTNáIN MAG FHLOINN
CHARLIE TOBIN	IRISH	CATHAL TóIBíN
JOHN KEANE	IRISH	SEáN Ó CATHáIN
BRIAN KAVANAGH	IRISH	BRíAN Ó CAOMHáNACH
ANTHONY MAHER	IRISH	ANTAINE MEAGHER
KEVIN ROBINSON	IRISH	CAOIMHíN MAC RóIBíN
PADDY ANDREWS	IRISH	PáDRAIG MAC AINDRIú
PAT KERWICK	IRISH	PáDRAIG Ó CIARMHAIC
JOHN MCINTYRE	IRISH	SEáN MAC AN TSAOIR
PADDY STAPLETON	IRISH	PáDRAIG MAC AN GHAILL
LEONARD ENRIGHT	IRISH	LIONAIRD MAC IONNRACHTAIGH
ÉAMONN TAAFFE	IRISH	ÉAMONN TáTH
LIAM DOYLE	IRISH	LIAM Ó DúIL
NIALL GILLIGAN	IRISH	NIALL MAC GIOLLAGáIN
COLIN LYNCH	IRISH	CóILíN Ó LOINGSIGH
PHILIP BRENNAN	IRISH	PILIB Ó BRAONáIN
PADDY KENNEDY	IRISH	PáDRAIC Ó CINNéIDE
TIMMY HOULIHAN	IRISH	TADGH Ó HUALLACHáIN
SHANE DOOLEY	IRISH	SEáN Ó DULAOíCH
FERGAL HEALY	IRISH	FEARGALL Ó HÉILí
SHANE KAVANAGH	IRISH	SEáN CAOMHáNACH
SEAN DEMPSEY	IRISH	SEAN Ó DIOMSAIGH
SIMON WHELEHAN	IRISH	SíOMóN Ó FAOILEACHáIN
KEVIN KINAHAN	IRISH	CAOIMHíN Ó COINNEACHáIN
DAITHí REGAN	IRISH	DAITHí Ó RIAGáIN
DECLAN PILKINGTON	IRISH	DéAGLáN PILINEACH
GARY HANNIFFY	IRISH	GEARóID Ó HAINFIDH
JOE RABBITTE	IRISH	SEOSAMH Ó COINíN
KEVIN MARTIN	IRISH	CAOIMHíN Ó MHAIRTíN
RORY HANNIFFY	IRISH	RUAIRí Ó HAINFIDH
PAUL CODD	IRISH	PóL MAC ÓDA
ADRIAN FENLON	IRISH	ANDRIAS Ó FIONNALáIN
JOHN O'CONNOR	IRISH	SEáN Ó CONCHUBHAIR
ÉAMONN SCALLAN	IRISH	ÉAMONN Ó SCALLAIN
DECLAN RUTH	IRISH	DéAGLáN RúT
RORY JACOB	IRISH	RUAIRí IáCóB
JOE BERGIN	IRISH	SEOSAMH Ó BEIRGIN
DAVID FRANKS	IRISH	DAITHí PRIONSéIS
BRENDAN MURPHY	IRISH	BREANDáN Ó MURCHú
NEILUS FLYNN	IRISH	NEILUS Ó FLOINN
STEPHEN MCDONAGH	IRISH	STíOFáN MAC DONNCHA
MIKE HOULIHAN	IRISH	MíCHEáL Ó HUALLACHáIN
MIKE GALLIGAN	IRISH	MíCHEáL Ó GEALAGáIN
ÉANNA RYAN	IRISH	ÉANNA Ó RIAIN
ANTHONY CUNNINGHAM	IRISH	ANTAINE Ó CUINNEAGáIN
VINNY STAPLES	IRISH	UINSEANN MAC AN GHAILL
JACK BERRY	IRISH	SEáN Ó BéARA
WILLIE MURPHY	IRISH	LIAM Ó MURCHú
DAVID KENNEDY	IRISH	DAITHí Ó CINNéIDE
DONNACHA FAHY	IRISH	DONNACHA Ó FATHAIGH
MATTY MAHER	IRISH	MAITIú Ó MEACHAIR
PADDY KIRWAN	IRISH	PáIDí Ó CIARUBHáIN
MARK CORRIGAN	IRISH	MARC Ó CORRAGáIN
NIALL MCINERNEY	IRISH	NIALL MAC AN AIRCHINNIGH
MICHAEL RICE	IRISH	MíCHEáL RíS
JOHNNY DUNNE	IRISH	SEáN Ó DUINN
JOHN KINSELLA	IRISH	SEáN CINSEALACH
WILLIE MURPHY	IRISH	LIAM Ó MURCHú
DENIS HEASLIP	IRISH	DONNCHA Ó HEISLIP
CHA WHELAN	IRISH	JARLATH Ó FAOILEáIN
JOE MILLEA	IRISH	SEOSAMH Ó MAOLAOIDH
PAT KAVANAGH	IRISH	PáDRAIG CAOMHáNACH
MICK LAWLER	IRISH	MíCHEáL Ó LEATHLOBHAIR
MOSSY MURPHY	IRISH	MUIRIS Ó MURCHú
JOHN SUTTON	IRISH	SEáN DE SUTúN
MICK BROPHY	IRISH	MíCHEáL Ó BRóITHE
JIM WALSH	IRISH	SéAMUS BREATHNACH
TOM WALSH	IRISH	TOMáS BREATHNACH
MICK WALSH	IRISH	MíCHEáL BREATHNACH
MICK KENNY	IRISH	MíCHEáL Ó CIONNAITH
RAMIE DOWLING	IRISH	RéAMANN Ó DúLLAING
JACK MULCAHY	IRISH	SEáN Ó MAOLCATHA
BOBBY HINKS	IRISH	RIOBEARD MAC AONAIS
JIMMY HEFFERNAN	IRISH	SéAMUS Ó HIFEARNáIN
LIAM REIDY	IRISH	LIAM Ó RIADA
TADHG FLYNN	IRISH	TADHG Ó FLOINN
MICHEáL WEBSTER	IRISH	MíCHEáL
EAMON MORRISSEY	IRISH	ÉAMONN Ó MUIREASA
PAT O'NEILL	IRISH	PáDRAIG Ó NéILL
ADRIAN RONAN	IRISH	ADRIAN Ó RONáIN
TERRY KELLY	IRISH	TOIRNEACH Ó CEALLAIGH
ÉAMONN FITZMAURICE	IRISH	ÉAMONN MAC MUIRIS
JOHN KERINS	IRISH	SEáN Ó CéIRíN
SEáN O'KENNEDY	IRISH	SEáN Ó CINNéIDE
TADHG ÓG MURPHY	IRISH	TADHG ÓG Ó MURCHú
CRAIG LEAHY	IRISH	CRAIG Ó LAOCHA
RAY RYAN	IRISH	RéAMONN Ó RIAIN
ALAN KENNEDY	IRISH	ALAN Ó CINNéIDE
CIAN MCCARTHY	IRISH	CIAN MAC CáRTHAIGH
AIDAN RYAN	IRISH	AODáN Ó RIAIN
GER O'DRISCOLL	IRISH	GEARóID Ó DRISCEOIL
BARRY JOHNSON	IRISH	BARRA MAC SHEáIN
CHRIS MURPHY	IRISH	CRIOSTóIR Ó MURCHú
PAT RYAN	IRISH	PáDRAIG Ó RIAIN
JOE KELLY	IRISH	SEOSAMH Ó CEALLAIGH
TOMMY PURCELL	IRISH	TOMáS PUIRSéIL
JOE MORAN	IRISH	SEOSAMH Ó MORáIN
SEáN O'BRIEN	IRISH	SEáN Ó BRIAIN
WILLIE GRIFFIN	IRISH	LIAM GRIOFAIN
MATTY FOUHY	IRISH	MAITIú Ó FUATHAIGH
WILLIE WALSH	IRISH	LIAM BREATHNACH
MAURICE SHANAHAN	IRISH	MUIRIS Ó SEANACHáIN
NOEL CONNORS	IRISH	NOLLAIG Ó CONCHUBHAIR
BLAINE KELLY	IRISH	BLAINE Ó CEALLAIGH
JOHN CASHMAN	IRISH	SEáN Ó CíOSáIN
JOHN O'CONNOR	IRISH	SEáN Ó CONCHUBHAIR
TOM IRWIN	IRISH	TOMáS Ó HEIREAMHóIN
JOHN CONSIDINE	IRISH	SEáN MAC CONSAIDíN
DAVE MCGRATH	IRISH	DAITHí MAC CRAITH
DENIS O'KEEFFE	IRISH	DONNACHA Ó CUíV
JIM RONAYNE	IRISH	SéAMUS Ó RóNáIN
MAURICE O'SHEA	IRISH	MUIRIS Ó Sé
JACKIE O'SHEA	IRISH	SEáN Ó Sé
DENIS COUGHLAN	IRISH	DONNACHA MAC COCHLáIN
DAN COUGHLAN	IRISH	DóNALL MAC COCHLáIN
NED GREY	IRISH	ÉAMONN DE GRAE
WILLIE JOHN O'CONNELL	IRISH	LIAM SEáN Ó CONAILL
DAVID HAYES	IRISH	DAITHí Ó HAODHA
JIM YOUNG	IRISH	SéAMUS DE SIúN
CONOR O'SULLIVAN	IRISH	CONCHUR Ó SúILLEABHáIN
DICK O'GORMAN	IRISH	RISTéARD Ó GORMAIN
DANNIX RING	IRISH	DóNALL Ó RINN
JOHN O'KEEFFE	IRISH	SEáN Ó CUíV
JOHN BARRY-MURPHY	IRISH	SEáN DE BARRA-MURCHU
FRANK KELLEHER	IRISH	PRIONSIAS Ó CéILLEACHAIR
CIAN O'SULLIVAN	IRISH	CIAN Ó SúILLEABHáIN
JOHN COLEMAN	IRISH	SEáN Ó COLMáIN
FRANK COGAN	IRISH	PRIONSIAS Ó CóGáIN
CON HARTNETT	IRISH	CONCHUR Ó HAIRTNéADA
DINNY LONG	IRISH	DONNCHA Ó LONGáIN
NED KIRBY	IRISH	ÉAMONN Ó CIARBA
JIMMY BARRETT	IRISH	SéAMUS DE BAIRéID
JOHN GRIFFIN	IRISH	SEáN Ó GRIFíN
TADHGO CROWLEY	IRISH	TADHG Ó CRUADHLAOICH
DONIE O'DONOVAN	IRISH	DóNALL Ó DONNABHáIN
MICK SPILLANE	IRISH	MíCHEáL Ó SPEALáIN
MICK HAYES	IRISH	MíCHEáL Ó HAODHA
MICK MCCARTHY	IRISH	MíCHEáL MAC CáRTHAIGH
STEPHEN O'BRIEN	IRISH	STIOFáN Ó BRIAIN
TONY NATION	IRISH	TóNAí Ó NáISIúIN
BARRY COFFEY	IRISH	BARRA Ó COFAIGH
JIMMY KERRIGAN	IRISH	SéAMUS Ó CIARAGáIN
CATHAL MOORE	IRISH	CATHAL Ó MóRDHA
TIM MURPHY	IRISH	TADHG Ó MURCHú
DAVE MCCARTHY	IRISH	DAITHI MAC CáRTHAIGH
COLMAN CORRIGAN	IRISH	COLMáN Ó CORRAGáIN
JOE KAVANAGH	IRISH	SEOSAMH CAOMHáNACH
KEVIN O'DWYER	IRISH	CAOIMHíN Ó DUIBHIR
MICHAEL QUINN	IRISH	MICHEáL Ó CUINN
JAMES SKEHILL	IRISH	SéAMUS Ó SCEACHáIL
CONOR MCCARTHY	IRISH	CONCHUR MAC CáRTHAIGH
DANIEL GOULDING	IRISH	DóNALL DE GúL
FINTAN GOOLD	IRISH	FIONTáN DE GúL
GABRIEL BRADLEY	IRISH	GABRIEL Ó BROLCHáIN
PAUL MORRISSEY	IRISH	PóL Ó MUIREASA
JOHN ANDERSON	IRISH	SEáN MAC AINDRIú
JONATHAN O'CALLAGHAN	IRISH	SEáN Ó CEALLACHáIN
JAMES BOWLES	IRISH	SéAMUS Ó BAOILL
JOHN PAUL KING	IRISH	SEáN PóL Ó CIONGA
GARVAN MCCARTHY	IRISH	GARBHáN MAC CáRTHAIGH
PAUL TIERNEY	IRISH	PóL Ó TIARNAIGH
MICHAEL BYRNE	IRISH	MíCHEáL Ó BROIN
PáDRAIG CROWLEY	IRISH	PáDRAIG Ó CRUALAíOCH
PAT HORGAN	IRISH	PáDRAIG Ó HORGáIN
JOHN HARTNETT	IRISH	SEáN Ó HAIRTNéADA
DONAL HUNT	IRISH	DóNALL Ó FIAICH
ROBERT WILMOT	IRISH	ROIBEáRD UILMIT
SéAMUS COUGHLAN	IRISH	SEáMUS Ó COCHLAINN
JOHN CLEARY	IRISH	SEáN Ó CLéIRIGH
JOHN O'DRISCOLL	IRISH	SEáN Ó DRISCEOIL
CHRISTY O'SHEA	IRISH	CRIOSTóIR Ó Sé
PAT DOWLING	IRISH	PáDRAIG Ó DúALAING
DONAL O'SULLIVAN	IRISH	DóNALL Ó SúILLEABHáIN
MORT O'SHEA	IRISH	MUIREARTACH Ó Sé
PAUL KERRIGAN	IRISH	PóL Ó CEARRAGáIN
GER MANLEY	IRISH	GEARóID Ó MANLAí
PAUL ROCHE	IRISH	PóL RóISTIGH
BOBBY DINEEN	IRISH	ROIBEáRD Ó DUINNíN
TED O'SULLIVAN	IRISH	TADHG Ó SúILLEABHáIN
NED PORTER	IRISH	ÉAMONN PóIRTéIR
CIARáN KENNY	IRISH	CIARáN Ó CIONNAITH
PAT HEALY	IRISH	PáDRAIG Ó HÉILí
PADDY PHILPOTT	IRISH	PáDRAIG MAC PHILIB
LIAM ABERNETHY	IRISH	LIAM
JIM MORRISON	IRISH	SéAMUS Ó MUIREASáIN
BRIAN CARROLL	IRISH	BRIAIN Ó CEARúILL
ROGER TUOHY	IRISH	RUAIRí Ó TUATHAIGH
SIMON MURPHY	IRISH	SIOMóN Ó MURCHú
PADDY RYAN	IRISH	PáDRAIG Ó RIAIN
DENIS O'GORMAN	IRISH	DONNCHA Ó GORMáIN
TOM BUTLER	IRISH	TOMáS DE BUITLéIR
GER CORNALLY	IRISH	GEARóID Ó CORNALAIGH
FLOR COFFEY	IRISH	FLAITHRí Ó COFAIGH
LARRY FLAHERTY	IRISH	LABHRáS Ó FLATHARTA
JOHNNY RYAN	IRISH	SEáNIE Ó RIAIN
LIAM KING	IRISH	LIAM Ó CIONGA
JOHN KELLY	IRISH	SEáN Ó CEALLAIGH
SéAMUS HOGAN	IRISH	SéAMUS Ó HÓGáIN
NOEL O'DWYER	IRISH	NOLLAIG Ó DUIBHIR
JOHN FLANAGAN	IRISH	SEáN Ó FLANNAGáIN
PAUL BYRNE	IRISH	PóL Ó BROIN
CONOR O'DONOVAN	IRISH	CONCHUR Ó DONNABHáIN
LESTER RYAN	IRISH	LESTER Ó RIAIN
BILL HENNESSY	IRISH	LIAM Ó HAONASA
JAMES KIELT	IRISH	SéAMUS Ó CAOILTE
MICHAEL PHELAN	IRISH	MíCHEáL Ó FAOLáIN
PAT DWYER	IRISH	PáDRAIG Ó DUIBHIR
CANICE BRENNAN	IRISH	CAINNEACH Ó BRAONáIN
LIAM KEOGHAN	IRISH	LIAM MAC EOCHAGáIN
KEVIN FENNELLY	IRISH	CAOIMHíN Ó FIONNALAIGH
RICHIE HOGAN	IRISH	RISTEARD Ó HÓGáIN
BRIAN MULLINS	IRISH	BRIAN Ó MAOLáIN
SEáNIE DUGGAN	IRISH	SEáN DUAGáIN
MARTIN MCGRATH	IRISH	MáIRTíN  MAC CRAITH
AIDAN O'SHEA	IRISH	AIDAN Ó Sé
HUGH MARTIN MCGURK	IRISH	AODH MAIRTíN MAC UIRC
PAUL EARLEY	IRISH	POL Ó MOCHóIR
NOEL MCGRATH	IRISH	NOLLAIG MAC CRAITH
COLM CALLANAN	IRISH	COLM Ó CALLANáIN
COLM O'NEILL	IRISH	COLM Ó NéILL
RAY CAREY	IRISH	RéAMONN Ó CIARDHA
SEAN LEO MCGOLDRICK	IRISH	SEáN LEON MAC GUALRAIC
CHRISSY MCKAIGUE	IRISH	CRíOSTóIR MAC THAIDHG
PAUL O'FLYNN	IRISH	PóL Ó FLOINN
TOM MCGUINNESS	IRISH	TOMáS MAG AONGHUSA
DON DAVIS	IRISH	DóNALL DáIBHíS
FACHTNA COLLINS	IRISH	FACHTNA Ó COILEáIN
FIONáN MURRAY	IRISH	FIONáN Ó MUIRí
PODSIE O'MAHONY	IRISH	PáDRAIG MAC MATHúNA
MARTIN CRONIN	IRISH	MáIRTíN Ó CRóINíN
RONAN MCCARTHY	IRISH	RóNáN MAC CáRTHAIGH
KEVIN O'SULLIVAN	IRISH	CAOIMHíN Ó SúILLEABHáIN
PAUDIE KISSANE	IRISH	PáIDí Ó CIOSáIN
OWEN SEXTON	IRISH	EOIN Ó SEASNáIN
GEOFFREY MCGONAGLE	IRISH	SEATHRúN MAC CONGáIL
EAMON O'SHEA	IRISH	ÉAMONN Ó Sé
BRENDAN MAHER	IRISH	BREANDáN Ó MEACHAIR
CATHAL ÓG GREENE	IRISH	CATHAL ÓG O HUAINE
PáDRAIC MAHER	IRISH	PáDRAIC Ó MEACHAIR
JOHN MURPHY	IRISH	SEáN Ó MURCHú
THOMAS STAPLETON	IRISH	TOMáS MAC AN GHAILL
JOHNNY CULLOTY	IRISH	SEáNAí Ó COLLATA
VINNY WHELAN	IRISH	UINSEAN Ó FAOLáIN
DECLAN O'KEEFFE	IRISH	DéAGLáN Ó CUíV
PAUDIE SHEEHY	IRISH	PáIDí Ó SíODA
GARRY MCMAHON	IRISH	GARRAí MAC MATHúNA
SEáN WALSH	IRISH	SEáN BREATHNACH
PAUDIE O'DONOGHUE	IRISH	PáIDí Ó DONNCHú
LIAM HIGGINS	IRISH	LIAM Ó HUIGINN
PAT GRIFFIN	IRISH	PáDRAIG Ó GRIOFAIN
LIAM RUSHE	IRISH	LIAM Ó LUACHRA
PATSY BREEN	IRISH	PáDRAIG Ó BRAOIN
JOHN JOE LANDERS	IRISH	SEáN SEOSAMH DE LONDRAS
STEPHEN WHITE	IRISH	STIOFáN DE FAOITE
BILL DILLON	IRISH	LIAM O DIOLúIN
TIM O'DONNELL	IRISH	TADHG Ó DOMHNAILL
OISIN GOUGH	IRISH	OISíN MAC EOCHAIDH
JAMES MCCARTAN, JUNIOR	IRISH	SéAMAS MAC ARTáIN
EDDIE WALSH	IRISH	ÉAMONN BREATHNACH
JOHN JOE SHEEHY	IRISH	SEáN SEOSAMH Ó SíODA
GER O'KEEFFE	IRISH	GEARóID Ó CUíV
DIN JOE CROWLEY	IRISH	DONNCHA SEOSAMH Ó CRUALAíOCH
JACK MANGAN	IRISH	SEáN Ó MANGáIN
PADDY DOHERTY	IRISH	PáIDí Ó DOCHARTAIGH
JARLATH CAREY	IRISH	IARLAITH Ó CIARDHA
TOM O'HARE	IRISH	TOMáS Ó HEITHIR
DAVID TREACY	IRISH	DAITHí Ó TREASAIGH
DERMOT O'BRIEN	IRISH	DIARMUID Ó BRIAIN
MAURICE O'BRIEN	IRISH	MUIRIS Ó BRIAIN
MOSSIE CARROLL	IRISH	MUIRIS Ó CEARúIL
KEVIN JER O'SULLIVAN	IRISH	CAOIMHíN DIARMUID Ó SúILLEABHáIN
JULIET MURPHY	IRISH	SíLE Ní MHURCHú
ANGELA WALSH	IRISH	ANGELA BREATHNACH
MARY O'CONNOR	IRISH	MAIRE Ní CHONCHúIR
MARY LEACY	IRISH	MáIRE Ní LéASAIGH
LARRY STANLEY	IRISH	LABHRáS DE STAINLéIGH
PADDY O'ROURKE	IRISH	PáDRAIG Ó RUAIRC
ANTHONY MOLLOY	IRISH	ANTóIN Ó MAOLMHUAIDH
D. J. KANE	IRISH	D.S. MAC CATHáIN
JOE CASSELLS	IRISH	SEOSAMH Ó CAISIL
MARTIN MCHUGH	IRISH	MáIRTíN MAC AODH
MARK WARD	IRISH	MARK NIC AN BHAIRD
DAMIEN FOX	IRISH	DAMIEN Ó SIONNAIGH
NIALL RIGNEY	IRISH	DAMIEN Ó ROIGNE
DINNY CAHILL	IRISH	DONNCHA MAC CATHAIL
PADDY BAWN BROSNAN	IRISH	PáDRAIG BáN Ó BROSNACHáIN
COLM O'NEILL	IRISH	COLM Ó NéILL
GER REIDY	IRISH	GEAROID Ó RIADA
MARK O'LEARY	IRISH	MARC Ó LAOIRE
PAUL BRADY	IRISH	PóL Ó BRáDAIGH
STEVE MAHON	IRISH	STIOFáN MATHúIN
GER O'LOUGHLIN	IRISH	GEARóID Ó LOCHLAINN
PADDY DOYLE	IRISH	PáDRAIG Ó DúIL
MICK BURNS	IRISH	MíCHEáL Ó BROIN
NOEL O'GORMAN	IRISH	NOLLAIG Ó GORMáIN
DONAL O'BRIEN	IRISH	DóNALL Ó BRIAIN
TERRY MOLONEY	IRISH	TOIRLEACH Ó MAOLDOMHNAIGH
SéAMUS MACKEY	IRISH	SéAMUS MAC AODHA
RAY REIDY	IRISH	RéAMONN Ó RIADA
PAT RYAN	IRISH	PáDRAIG Ó RIAIN
RORY GALLAGHER	IRISH	RUAIDHRí Ó GALLCHOBHAIR
RICHIE CUMMINS	IRISH	RISTEáRD Ó CUIMIN
JIM TROY	IRISH	SéAMUS Ó TROITHIGH
P. J. O'CONNELL	IRISH	P. S. Ó CONAILL
JOHN LEAMY	IRISH	SEáN Ó LéIME
PAT MCGRATH	IRISH	PáDRAIG MAC CRAITH
JOHNNY MCGRATH	IRISH	SEáNIE MAC CRAITH
KEVIN RYAN	IRISH	CAOIMHíN Ó RIAIN
NOEL KENNELLY	IRISH	NOLLAG
ANTHONY MOYLES	IRISH	ANTóIN MAOLMHUIRE
NIGEL CRAWFORD	IRISH	NIGEL Ō CRáBHAGáIN
LIAM RYAN	IRISH	LIAM Ó RIAIN
AODáN MAC GEARAILT	IRISH	AODáN MAC GEARAILT
AMANDA O'REGAN	IRISH	AMANDA Ní RIAGáIN
AOIFE MURRAY	IRISH	AOIFE Ní MUIRí
CATHRIONA FOLEY	IRISH	CAITRíONA Ní FHOGHLú
JOANNE O'CALLAGHAN	IRISH	SIOBHáN Ní CHEALLACHáIN
RENA BUCKLEY	IRISH	RíOGHNA Ní BHUACHALLA
JENNY DUFFY	IRISH	SEANNAFAIR Ní DHUFAIGH
SARA HAYES	IRISH	SORCHA Ní AODHA
BRIEGE CORKERY	IRISH	BRíD Ní CHORCORA
ORLA COTTER	IRISH	ORLAITH NIC COITIR
SíLE BURNS	IRISH	SíLE Ní BHROIN
EIMEAR O'SULLIVAN	IRISH	EIMEAR Ní SHUILLEABHáIN
EMER O'FARRELL	IRISH	EMER Ní FHEARAIL
GEMMA O'CONNOR	IRISH	GEMMA Ní CHONCHúIR
UNA O'DONOGHUE	IRISH	ÚNA Ní DHONNCHú
LYNDA O'CONNELL	IRISH	LIONN Ní CHONAILL
EMER DILLON	IRISH	EMER Ní DHIOLúN
KATRIONA MACKEY	IRISH	CAITRíONA Ní MHACA
ELAINE AYLWARD	IRISH	ELAINE Ní AIGHLEART
CATHERINE DOHERTY	IRISH	CAIT Ní DHOCHARTAIGH
AMY BUTLER	IRISH	ÉIMí DE BHUITLéIR
JACQUI FRISBY	IRISH	SEACAILíN Ní FHRIOSBAIGH
LIZZIE LYNG	IRISH	EíLíS Ní LONGáIN
LEANN FENNELLY	IRISH	LEANNáN Ní FHIONNALAIGH
RACHEL MOLONEY	IRISH	RACHEL Ní MHAOLOMHNAIGH
ANN DALTON	IRISH	ÁINE Ní DHALTúIN
THERESE MULDOWNEY	IRISH	TREASA Ní MHAOLDOMHNAIGH
KATIE POWER	IRISH	CáIT DE PAOR
AISLING DUNPHY	IRISH	AISLING Ní DHONNCHAIDH
MARIE O'CONNOR	IRISH	MáIRE Ní CHONCHúIR
EDWINA KEANE	IRISH	EDWINA Ní CHATHáIN
DENISE GAULE	IRISH	DENíS NIC AN GAILL
ÁINE LYNG	IRISH	ÁINE Ní LOINN
COLLETTE DORMER	IRISH	COLLETTE Ní DHUIDHíORMA
MICHELLE QUILTY	IRISH	MICHELLE Ní CHAOILTE
AUDREY KENNEDY	IRISH	AIDRí Ní CHINNéIDE
KEEVA FENNELLY	IRISH	CAOIMHE Ní FHIONNALAIGH
ARLENE WATKINS	IRISH	ARLENE WATKINS
KAREN BRADY	IRISH	CáIT Ní BHRáDAIGH
KAREN KELLY	IRISH	CáIT Ní CHEALLAIGH
MICHAELA MORKAN	IRISH	MICHEáILíN Ní MHURCHáIN
FIONA STEPHENS	IRISH	FIONA Ní STIOFáIN
ELAINE DERMODY	IRISH	ELAINE Ní DHIARMADA
SUSIE O'CARROLL	IRISH	SIúN Ní CEARBHALL
THERESE MAHER	IRISH	TREASA Ní MEACHAIR
AOIFE NEARY	IRISH	AOIFE Ní NáRAIGH
CAITRIONA RYAN	IRISH	CAITRíONA Ní RIAIN
REGINA GLYNN	IRISH	RIOGHNA Ní GLOINN
DEIRDRE DELANEY	IRISH	DEIRDRE Ní DHUBHSLáINE
ANN MARIE HAYES	IRISH	ÁINE Ní HAODHA
GRAINNE MCGOLDRICK	IRISH	GRáINNE Ní GOLDRIC
JESSICA GILL	IRISH	JESSICA Ní GIOLLA
SINéAD CAHALAN	IRISH	SINéAD CATHALAN
VERONICA CURTIN	IRISH	VERONICA NIC CHUIRTíN
GAVIN O'MAHONY	IRISH	GABHáN Ó MATHúNA
STEPHEN STACK	IRISH	STIOFáIN DE STAIC
PAUL BROWNE	IRISH	PóL DE BRúN
BRIAN O'SULLIVAN	IRISH	BRIAN Ó SúILLEABHáIN
RYAN MCCLUSKEY	IRISH	RIAN MAC BHIASCAIDH
GERRY QUINN	IRISH	GEARóID Ó CUINN
GERRY MCINERNEY	IRISH	GEARóID MAC AN OIRCHINNIGH
JOHN REDDAN	IRISH	SEáN Ó RODáIN
TONY CARMODY	IRISH	TóNAí Ó CEAMADA
KEVIN HAYES	IRISH	CAOIMHíN Ó HAODHA
DIARMUID LYNG	IRISH	DIARMUID Ó LOINN
JOHN MINOGUE	IRISH	SEáN Ó MUINEOG
DARACH HONAN	IRISH	DARACH Ó HEOGHANáIN
DAVID REDMOND	IRISH	DAITHí MAC RéAMOINN
AMY MURPHY	IRISH	AIMí Ní MURCHú
ANNE GRIFFIN	IRISH	AINE Ní GRIFFíN
ALISON MAGUIRE	IRISH	ALISON Ní DHUíBHIR
EIMEAR BRANNIGAN	IRISH	EIMHEAR Ní BHRANNIGáIN
CATRIONA POWER	IRISH	CAITRíONA DE PAOR
AISLING DIAMOND	IRISH	AISLIN Ní DIOMAIN
LIAM LAWLOR	IRISH	LIAM Ó LEATHLOBHAIR
GLENN RYAN	IRISH	GLENN Ó RIAIN
DERMOT EARLEY, JNR	IRISH	DIARMAID Ó MOCHóIR
FIACHRA BREATHNACH	IRISH	FIACHRA BREATHNACH
ELAINE O'MEARA	IRISH	LéAN Ní MHéARA
EMER LUCEY	IRISH	EIMEAR Ní LúASAIGH
JEAN MURPHY	IRISH	JEAN Ní MHURCHú
LAURA TWOMEY	IRISH	LAURA \
RACHEL COSTELLO	IRISH	RACHEL Ní CHOISDEALBHA
RACHEL RUDDY	IRISH	RACHEL Ní RODAIGH
SARAH RYAN	IRISH	IRISH NAME
SéAMUS KENNY	IRISH	SéAMAS Ó CIONNAITH
MARY GEANEY	IRISH	MáIRE NIC ÉANNA
MICHAEL SAVAGE	IRISH	MICHEáL MAC SABHAOIS
MICHAEL BURKE	IRISH	MICHEáL DE BúRCA
MICK HIGGINS	IRISH	MíCHEáL Ó HUIGINN
CLIODHNA O'CONNOR	IRISH	CLíODHNA Ní CONCHOBHAIR
BARRY JOHN WALSH	IRISH	BARRA SEáN BREATHNACH
DAVID FLYNN	IRISH	DAITHí Ó FLOINN
RORY O'CARROLL	IRISH	RUAIDHRí Ó CEARBHAIL
KARL LACEY	IRISH	CARL DE LéIS
PáDRAIG TYERS	IRISH	PáDRAIG TYERS
PAT FANNING	IRISH	PáDRAIG Ó FAINíN
DARREN GLEESON	IRISH	DARRIN Ó GLIASáIN
PHIL CULLEN	IRISH	PILIB Ó CUILINN
MATT RUTH	IRISH	MAITIú DE RúT
JOHN DALTON	IRISH	SEáN DáLTúN
EOIN REID	IRISH	EOIN Ó MAOILDEIRG
CANICE HICKEY	IRISH	CAINNEACH  Ó HÍCí
DAVID HERITY	IRISH	DAITHí Ó HAGHARTAIGH
PADDY MORIARTY	IRISH	PáDRAIG Ó MUIREARTAIGH
PAUDIE O'MAHONY	IRISH	PáIDí Ó MATHúNA
PAUDIE LYNCH	IRISH	PáIDí Ó LOINGSIGH
DONIE O'SULLIVAN	IRISH	DóNAL Ó SúILLEABHáIN
MIKE NASH	IRISH	MíCHEáL DE NAIS
DECLAN NASH	IRISH	DéAGLáN DE NAIS
JOE O'CONNOR	IRISH	SEOSAMH Ó CONCHUBHAIR
FRANKIE CARROLL	IRISH	PRONSIAS Ó CEARRúIL
GER POWER	IRISH	GEARóID DE PAOR
PAT HARTNETT	IRISH	PáDRAIG Ó HAIRTNéID
CYRIL DUNNE	IRISH	CYRIL Ó DúINN
PETER FORD	IRISH	PEADAR MAC GIOLLARNáTH
KEVIN WALSH	IRISH	CAOIMHíN BREATHNACH
PETER MOORE	IRISH	PEADAR Ó MORDHA
CHRISTY RYAN	IRISH	CRISOTóIR Ó RIAIN
GARY O'KANE	IRISH	GARRAí Ó CATHáIN
DOMINIC MCKINLEY	IRISH	DOMINIC MAC FHIONNLAOICH
TERENCE DONNELLY	IRISH	TOIREALACH Ó DONNAILE
DESSIE DONNELLY	IRISH	DEASúN Ó DONNAILE
BRIAN DONNELLY	IRISH	BRIAIN Ó DONNAILE
DANNY FITZGERALD	IRISH	DóNALL MAC GEARAILT
KEVIN MCSTAY	IRISH	CAOIMHíN Ó MAOILSTé
KEVIN KEHILLY	IRISH	CAOIMHíN MAC CAOCHLAOICH
MICHAEL COLLINS	IRISH	MíCHEáL Ó COILEáIN
NED COLFER	IRISH	ÉAMONN COILFéIR
TOM CUNNINGHAM	IRISH	TOMáS Ó CUINNEAGáIN
AUSTIN FLYNN	IRISH	ÁISTíN Ó FLOINN
MICK FLANNELLY	IRISH	MíCHEáL Ó FLANNAILE
JOE CONDON	IRISH	SEOSAMH CONDúN
LARRY GUINAN	IRISH	LABHRáS Ó COINNEáIN
SéAMUS POWER	IRISH	SéAMUS DE PAOR
JIM IRISH	IRISH	SéAMUS ÍRéIS
MICK DEMPSEY	IRISH	MíCHEáL Ó DíOMSAIGH
JIMMY BYRNE	IRISH	SéAMUS Ó BROIN
BRIAN MURPHY	IRISH	BRIAIN Ó MURCHú
BERNIE O'NEILL	IRISH	BEIRCHEART Ó NéILL
MICK O'LOUGHLIN	IRISH	MíCHEáL Ó LOCHLAINN
GENE MCCARTHY	IRISH	EOGHAN MAC CáRTHAIGH
FLOR HAYES	IRISH	FLOR Ó HAODHA
JERRY LUCEY	IRISH	DIARMUID Ó LUASAIGH
JOHN O'MAHONY	IRISH	SEáN Ó MATHúNA
BRENDAN CONSIDINE	IRISH	BREANDáN MAC CONSAIDíN
CON CLIFFORD	IRISH	CONN Ó CLúMHáIN
PAT O'SHEA	IRISH	PáDRAIG Ó Sé
DAVE MAGNIER	IRISH	DAITHí MAINGNéIR
KEVIN COFFEY	IRISH	CAOIMHíN Ó COFAIGH
JOE O'SULLIVAN	IRISH	SEOSAMH Ó SúILLEABHáIN
TOM NEVILLE	IRISH	TOMáS Ó NIA
MATT BROWNE	IRISH	MAITIú DE BRúN
TEDDY O'CONNOR	IRISH	TADHG Ó CONCHUBHAIR
MICK BUTLER	IRISH	MíCHEáL DE BUITLéIR
PAT QUIGLEY	IRISH	PáDRAIG Ó COIGLIGH
DAVE BERNIE	IRISH	DAITHí MAC BIORNA
SéAMUS WHELAN	IRISH	SéAMUS Ó FAOILEáIN
PAUL LYNCH	IRISH	PóL Ó LOINGSIGH
JIMMY PRENDERGAST	IRISH	SéAMUS DE PRIONDRAGáS
JOHN NOLAN	IRISH	SEáN Ó NUALáIN
JOHNNY MURPHY	IRISH	SEáN Ó MURCHú
VIN BASTON	IRISH	UINSEANN BEASTúN
GER OAKLEY	IRISH	GEARóID MAC DARACH
MICHAEL COLEMAN	IRISH	MíCHEáL COLMáN
JIMMY COONEY	IRISH	SéAMUS Ó CUANA
SéAMUS COEN	IRISH	SéAMUS Ó CADHAIN
MICHAEL CONNEELY	IRISH	MíCHEáL MAC CONGHAOLA
MICHAEL CONNOLLY	IRISH	MíCHEáL Ó CONGHAILE
BERNIE FORDE	IRISH	BEIRCHEART MAC GIOLLARNáTH
FINBARR GANTLEY	IRISH	FIONBARRA MAG SHEANLAOICH
FRANK BURKE	IRISH	PRIONSIAS DE BúRCA
BRENDAN LYNSKEY	IRISH	BREANDáN Ó LOINSCIGH
JOE CLARKE	IRISH	SEOSAMH Ó CLéIREACHáIN
GERRY COONE	IRISH	GEARóID Ó CUAN
P. J. QUALTER	IRISH	P. S. MAC UALTAIR
PáDRAIC FAHY	IRISH	PáDRAIC Ó FATHAIGH
SEáN MURPHY	IRISH	SEáN Ó MURCHú
ANDY FENTON	IRISH	AINDRIú Ó FIANNACHTA
PETER MURPHY	IRISH	PEADAR Ó MURCHú
TONY KILKENNY	IRISH	TóNAí MAC GILLA CHAINNIGH
MICHAEL MCGRATH	IRISH	MíCHEáL MAC CRAITH
TOM HICKEY	IRISH	TOMáS Ó HICí
JOE DERMODY	IRISH	SEOSAMH Ó DIARMADA
PAT O'CONNOR	IRISH	PáDRAIG O'CONNOR
DAVID HUGHES	IRISH	DAITHí Ó HAODHA
SHANE MCGUCKIN	IRISH	SEáN MAG EOCHAíN
BRENDAN BERMINGHAM	IRISH	BREANDáN MAC FHEORAIS
TOM DONOGHUE	IRISH	TOMáS Ó DONNCHú
GER COUGHLAN	IRISH	GEARóID Ó COCHLAINN
TOM CONNEELY	IRISH	TOMáS MAC CONGHAOLA
DECLAN FOGARTY	IRISH	DéAGLáN Ó FOGARTAIGH
PADDY CORRIGAN	IRISH	PáDRAIG Ó CORRAGáIN
LEO SMITH	IRISH	LEO MAC GABHANN
MíCHEáL Ó Sé	IRISH	MíCHEáL Ó Sé
BRENDAN LYNCH	IRISH	BREANDáN Ó LOINGSIGH
MARTIN FURLONG	IRISH	MáIRTíN FURLONG
TONY MCTAGUE	IRISH	TóNAí MAC TAIDHG
WILLIE BRYAN	IRISH	LIAM MAC BRAOIN
MATT CONNOR	IRISH	MAITIú Ó CONCHUBHAIR
JOE WALDRON	IRISH	SEOSAMH DE BHALDRAITHE
JACK COSGROVE	IRISH	SEáN MAC COSGAIR
T. J. GILMORE	IRISH	T. S. MAC GIOLLA MHIR
MICHAEL CRIMMINS	IRISH	MíCHEáL MAC CRUIMEIN
SEAN CAREY	IRISH	SEáN Ó CIARDHA
JOHN FORDE	IRISH	SEáN MAC GIOLLARNáTH
CHARLIE GALLAGHER	IRISH	CATHAL Ó GALLCHóIR
GABRIEL KELLY	IRISH	GAIBRIAL O CEALLAIGH
P. J. DUKE	IRISH	PILIB DIúC
ÉAMONN MONGEY	IRISH	ÉAMONN Ó MONGAIGH
PETER DARBY	IRISH	PEADAR MAC DAIRMADA
RAY CAROLAN	IRISH	RéAMANN Ó CEARBHALLáIN
PHIL 'THE GUNNER' BRADY	IRISH	PHILIB Ó BRáDAIGH
FRANK MCPHILLIPS	IRISH	PROINSIAS MACPHILIB
RICHIE KEHOE	IRISH	RISTEARD MAC EOCHAIDH
BRENDAN KEALY	IRISH	BREANDáN Ó CAOLAí
OLLIE BRADY	IRISH	OILIBHéAR Ó BRáDAIGH
OWEN ROE MCGOVERN	IRISH	EOIN RUA MAG SHAMHRAIN
COLUMBA MCDYER	IRISH	COLM MAC DUIBHIR
TIMMY FLEMING	IRISH	TADHG PLéIMEANN
SEáN BURKE	IRISH	SEáN DE BúRCA
MORGAN NIX	IRISH	MORGáIN MAC NIOCAIS
PADDY O'SHEA	IRISH	PáIDí Ó Sé
EDWIN CAROLAN	IRISH	EDWIN Ó CEARBHALLáIN
PADDY KELLY	IRISH	PáDRAIG Ó CEALLAIGH
BRIAN O'REGAN	IRISH	BRIAIN Ó RIAGáIN
AIDAN WALSH	IRISH	AODáN BREATHNACH
BRIAN O'MEARA	IRISH	BRIAIN Ó MEáRA
HUGHIE O'REILLY	IRISH	AODH Ó'RAGHALLAIGH
NOEL CARTON	IRISH	NOLLAIG MAC ARTáIN
LORCáN MCLOUGHLIN	IRISH	LORCáN MAC LOCHLAINN
VICTOR SHERLOCK	IRISH	BUADHACH Ó SCORLóG
MICHAEL CAHILL	IRISH	MíCHEáL Ó CATHAIL
NEIL MCMANUS	IRISH	NIALL MAC MáNAIS
SéAMUS HENNESSY	IRISH	SéAMUS Ó HAONASA
LIAM CAHILL	IRISH	LIAM Ó CATHAIL
P. J. SMYTH	IRISH	P. S. MAC GABHANN
BRENDAN COLLERAN	IRISH	BREANDáN Ó CALLARáIN
PADDY MCCORMACK	IRISH	PáIDí MAC CORMAIC
ÉAMONN O'DONOGHUE	IRISH	ÉAMONN Ó DONNCHú
TOM PRENDERGAST	IRISH	TOMáS  DE PRIONDRAGáS
SéAMUS MURPHY	IRISH	SéAMUS Ó MURCHú
DONAL KAVANAGH	IRISH	DóNALL CAOMHáNACH
ÉAMONN FITZGERALD	IRISH	ÉAMONN MAC GEARAILT
MICHAEL GLEESON	IRISH	MíCHEáL Ó GLIASáIN
EUGENE MULLIGAN	IRISH	EOGHAN Ó MAOLAGáIN
MARTIN HEAVEY	IRISH	MáIRTíN Ó HÉIMHIGH
MICK RYAN	IRISH	MíCHEáL Ó RIAIN
KEVIN KILMURRAY	IRISH	CAOIMHíN MAC GIOLLA MHUIRE
MICK O'ROURKE	IRISH	MíCHEáL Ó RUAIRC
SEáN COONEY	IRISH	SEáN Ó CUANAIGH
SEáN EVAN	IRISH	SEáN Ó HÉIMHíN
NICHOLAS CLAVIN	IRISH	NIOCLáS Ó CLAMHáIN
SEáN LOWRY	IRISH	SEáN MAC LABHRAí
BRENDAN LOWRY	IRISH	BREANDáN MAC LABHRAí
LIAM O'CONNOR	IRISH	LIAM Ó CONCHUBHAIR
TOMáS CONNOR	IRISH	TOMáS Ó CONCHUBHAIR
JOHN FLANAGAN	IRISH	SEáN Ó FLANAGáIN
JIMMY CARROLL	IRISH	SéAMUS Ó CEARRúIL
DONAL MURRAY	IRISH	DóNALL Ó MUIRí
NICKY O'CONNELL	IRISH	NIOCLáS Ó CONAILL
CIAN DILLON	IRISH	CIAN Ó DIOLúN
DONAL TUOHY	IRISH	DOMHNALL Ó TUATHAIGH
MICK MORRIS	IRISH	MíCHEáL Ó MUIRIS
GER LYNCH	IRISH	GEARóID Ó LOINGSIGH
PADDY FENNING	IRISH	PáIDí Ó FIONNáIN
MICHAEL MCQUILLAN	IRISH	MíCHéAL MAC UILíN
JOE LENNON	IRISH	SEOSAMH Ó LEANNáIN
ADRIAN FREEMAN	IRISH	ADRIAN ó SAOIRE
PAUL RUSSELL	IRISH	PóL RUISéIL
BILLY MYERS	IRISH	LIAM Ó MíR
NOEL TIERNEY	IRISH	NOLLAIG Ó TIARNAIGH
BOSCO MCDERMOTT	IRISH	SEáN BOSCó MAC DIARMADA
COLIE MCDONAGH	IRISH	CóILíN MAC DONNCHA
SEáN MEADE	IRISH	SEáN MIACH
MARTIN L. NEWELL	IRISH	MáIRTíN Ó TNúTHAIL
BRYAN O'SULLIVAN	IRISH	BRIAN Ó SúILLEABHáIN
DAVID BREEN	IRISH	DAITHí MAC BRAOIN
SEáN CLEARY	IRISH	SEáN MAC GIOLLA ARRAITH
PAT DONNELLAN	IRISH	PáDRAIG Ó DóNALLáIN
JOHN KEENAN	IRISH	SEáN Ó CIANáIN
MICK GARRETT	IRISH	MíCHEáL MAC GEARóID
CHRISTY TYRRELL	IRISH	CRIOSTóIR TIRIAL
JIMMY DUGGAN	IRISH	SéAMUS
NOEL COLLERAN	IRISH	NOLLAIG Ó CALLARáIN
GAY MITCHELL	IRISH	GAIBRIéL MISTéIL
GEARóID RYAN	IRISH	GEARóID Ó RIAIN
THOMAS RYAN	IRISH	TóMAS Ó RIAN
BERNARD ROCHFORD	IRISH	BEIRCHEART DE ROCHFORD
NICKIE QUAID	IRISH	NIOCLáS MAC UAID
JOHN MULHALL	IRISH	SEáN Ó MAOLCHATHAIL
FINBARR DELANEY	IRISH	FIONNBARRA  Ó DúLáINNE
SANDIE FITZGIBBON	IRISH	ALASTRíONA NI GIOBúIN
BRIDIE MCGARRY	IRISH	BRíD NIC FHEARRAIGH
MARY SINNOTT	IRISH	MáIRE Ní SIONOID
MARIE COSTINE	IRISH	MáIRE Ní COISTíN
LINDA MELLERICK	IRISH	LINDA Ní MHAOILGHEIRIC
MARGARET O'LEARY	IRISH	MAIREAD NI LAOIRE
PAT MOLONEY	IRISH	PADRAIGíN Ní MHAOLDOMHNAIGH
SOPHIE BRACK	IRISH	SOPHIE Ní BHREAC
DEIRDRE HUGHES	IRISH	DEIRDRE NíC AODHA
DAVID YOUNG	IRISH	DAITHí DE SIúN
CONOR GLEESON	IRISH	CONCHUR Ó GLIASáIN
JOHN GALVIN	IRISH	SEáN Ó GALBHáIN
MICHAEL DARRAGH MACAULEY	IRISH	MICHEáL DARRAGH MAC AMHALGHAIDH
BRIAN O'HALLORAN	IRISH	BRIAN Ó HALLURáIN
ROSE COLLINS	IRISH	RóISíN Ní COILEáN
UNA O'DWYER	IRISH	ÚNA Ní DHUIBHIR
CIARA GAYNOR	IRISH	CIARA NíC FIONNBAIRR
VERA SHEEHAN	IRISH	FíORA Ní SíOCHáIN
THERESE BROPHY	IRISH	TREASA Ní BHROITHE
EILEEN O'BRIEN	IRISH	EIBHLíN Ní BHRIAIN
CLAIRE GROGAN	IRISH	CLáR Ní GHRóGáIN
STEPHANIE DUNLEA	IRISH	STíOFáINíN Ní DHúNLIATH
FIONA O'DRISCOLL	IRISH	FIONA Ní DRISCEOIL
JANE ADAMS	IRISH	SíNE NíC ÁDHAIMH
SUZANNE KELLY	IRISH	SIúN Ní CHEALLAIGH
ÁINE CODD	IRISH	ÁINE Ní CHODA
JENNIFER O'LEARY	IRISH	MUIREANN Ní LAOIRE
ANNA GEARY	IRISH	ÁINE Ní GHADHRA
CATHERINE O'LOUGHLIN	IRISH	CAITRíONA Ní LOCHLAINN
JULIE KIRWAN	IRISH	IúILE Ní CHIARDUBHáIN
SINéAD MILLEA	IRISH	SINéAD NíC AMHALGAIDH
EIMEAR MCDONNELL	IRISH	EIMEAR Ní DHOMHNAILL
CATHERINE O'LOUGHLIN	IRISH	CAITRíONA Ní LOCHLAINN
JOANNE RYAN	IRISH	SIOBHáN Ní RIAIN
PHILLY FOGARTY	IRISH	PHILOMENA Ní FHOGARTAIGH
LOUISE O'HARA	IRISH	ALOISIA Ní HEADHRA
IMELDA KENNEDY	IRISH	IMELDA Ní CHINNéIDE
KATE KELLY	IRISH	CáIT Ní CHEALLAIGH
UNA LEACY	IRISH	ÚNA LéASAIGH
EIMEAR MOYNAN	IRISH	EIMEAR Ní MHUANáIN
MAGS DARCY	IRISH	MAIREAD NI DORCHAí
TRISH O'HALLORAN	IRISH	PáDRAIGíN Ní HALLMHURáIN
LOUISE DONOGHUE	IRISH	LABHAOISE Ní DHONNCHú
LOUISE MAHONY	IRISH	ALOISIA Ní MHATHúNA
NIAMH COYLE	IRISH	NIAMH NíC GIOLLA COMHGHAILL
CATHERINE MCGOURTY	IRISH	CáITRIONA NíC DHOBHARTAIGH
MAEVE GILROY	IRISH	MEADHBH NíC GIOLLA RUAIDH
MARY CONNERY	IRISH	MAIRE Ní CHONAIRE
BRIDGET DOYLE	IRISH	BRíD Ní DHUBHGHAILL
CLAIRE HANRAHAN	IRISH	SORCHA Ní HANRADHáIN
PATRICIA MORRISSEY	IRISH	PáIDRIGíN Ní MHUIRGHEASA
ANN DOWNEY	IRISH	ÁINE NIC GIOLLA DOMHNAIGH
MARY O'LEARY	IRISH	MáIRE Ní LAOIRE
HELENA O'NEILL	IRISH	LéANA Ní NéILL
MARION MCCARTHY	IRISH	MáIRíN NíC CHARTHAIGH
BREDA HOLMES	IRISH	BRíD NíC AN THOMáIS
BIDDY O'SULLIVAN	IRISH	BRíD Ní SúILLEABHáIN
CLAIRE CRONIN	IRISH	SORCHA Ní CHRONíN
YVONNE REDMOND	IRISH	ÚNA Ní RéAMOINN
STEPHANIE GANNON	IRISH	STíOFáINíN Ní GHEANIN
CARINA ROSEINGRAVE	IRISH	CAIRENN Ní ROSINGRáBH
COLETTE MCSORLEY	IRISH	NICOILíN NíC SOMHAIRLE
NIAMH MULCAHY	IRISH	NIAMH Ní MAOLCHATHA
MARIE DARGAN	IRISH	MáIRE Ní DHEARGAIN
STEPHEN DORMER	IRISH	STíOFáN DORMER
STELLAH SINNOTT	IRISH	STELLA Ní SIONóID
SUE CASHMAN	IRISH	Sú Ní CHIOSAIN
JOSEPHINE MCCLEMENTS	IRISH	SEOSAIMHíN NíC LIAMON
AISLINN CONNOLLY	IRISH	AISLINN Ní CHONGHAILE
KAREN TINELLY	IRISH	CAIRENN Ní THIONLANAIGH
CIARA LUCEY	IRISH	CIARA Ní LUíSEACH
BERNIE FARRELLY	IRISH	BEARNáIRDíN Ní FHEARGHAILE
ÉAMONN MORRISSEY	IRISH	ÉAMONN MAC MUIREASA
JOE BRADY	IRISH	SEOSAMH MAC BRADAIGH
LUKE O'FARRELL	IRISH	LúC Ó FEARGHAILL
PATRICK MAHER	IRISH	PáDRAIG Ó MEACHAIR
JIMMY BROWNE	IRISH	SéAMUS DE BRúN
GABRIEL IRWIN	IRISH	GAIBRIéL Ó HEIREAMHóIN
TOM MURPHY	IRISH	TOMáS Ó MURCHú
MARTIN BRENNAN	IRISH	MáIRTíN Ó BRAONáIN
SEáN BUCKLEY	IRISH	SEáN Ó BUACHALLA
JOE DUNPHY	IRISH	SEOSAMH Ó DONNCHAIDH
JOE MURPHY	IRISH	SEOSAMH Ó MURCHú
WILLIAM EGAN	IRISH	LIAM MAC AOGáIN
ANNE COLGAN	IRISH	ÁINE Ní CHOLGAN
NANCY O'DRISCOLL	IRISH	ÁINE Ní DHRISCEOIL
TERESA O'NEILL	IRISH	TREASA Uí NéILL
GERRY HUGHES	IRISH	GERAROIDíN NIC AODHA
BETTY SUGRUE	IRISH	EíLíS Ní SHIOCHRú
DOREEN BRENNAN	IRISH	DóIRíN Ní BHRAONáIN
HANNAH DINEEN	IRISH	ÁINE Ní DHUINNíN
MARIE O'GORMAN	IRISH	MáIRE Ní GHORMáIN
GRETTA KEHOE-QUIGLEY	IRISH	MAIRéAD Ní CHOIGLIGH
BRíD REID	IRISH	BRíD Ní RIADA
MARY WALSH	IRISH	MáIRE BHREATHNACH
CATHY LANDERS	IRISH	CAITLíN DE LONDRAS
PEGGY GRIFFIN	IRISH	MAIRéAD Ní GHRíOFA
PAT LENIHAN	IRISH	PáDRAIGíN Ní LEANNACHáIN
PAT RAFTERY	IRISH	PáDRAIGíN Ní REACHTAIRE
MARJORIE GRIFFIN	IRISH	MáILLE Ní GHRíOFA
CELIA QUINN	IRISH	SíLE NIC COINN
MADGE RAINEY	IRISH	MAIRéAD Ní RáINE
ANN COMERFORD	IRISH	ÁINE Ní CHUMASCAIGH
DOREEN ROGERS	IRISH	DóIRíN NIC RUAIRí
KATHLEEN RYDER	IRISH	CAITLíN Ní MHARCAIGH
KATHLEEN BUCKLEY	IRISH	CAITLíN Ní BHUACHALLA
RENEE FITZGERALD	IRISH	RíONA NIC GEARAILT
EMMY DELANEY	IRISH	ÉAMA Ní DHUBHSHLáINE
KATHLEEN COTTER	IRISH	CAITLíN NíC OITIR
KATHLEEN DELEA	IRISH	CAITLíN Ní DHUILé
JOSIE MCGRATH	IRISH	SEOSAIMHíN NíC CRAITH
MARY WALSH	IRISH	MáIRE BHREATHNACH
JUDY DOYLE	IRISH	IúIDíT Ní DHUBHGHáIL
URSULA GRACE	IRISH	URSULA Ní GHRáS
THERESA CAIRNS	IRISH	TREASA Ní CHIARáIN
ELAINE BURKE	IRISH	EIBHLíN DE BúRCA
EMILY HAYDEN	IRISH	EIMíLE Ní HEIDEáIN
MEADHBH STOKES	IRISH	MEADHBH Ní STóC
LYNN DUNLEA	IRISH	LINN Ní DHUINNSHLé
IRENE O'KEEFFE	IRISH	SíOMHA Ní CAOIMH
EITHNE DUGGAN	IRISH	EITHNE Ní DHUAGáIN
MARIAN KEARNS	IRISH	MáIRE Ní CHIARáIN
IMELDA HOBBINS	IRISH	IRISH NIC OIBICíN
DENISE CRONIN	IRISH	DENíS Ní CHRóINíN
LIZ GARVAN	IRISH	EILíS Ní GHARBHáIN
DENISE GILLIGAN	IRISH	DENíS NIC GHIOLLAGáIN
KATHLEEN CODY	IRISH	CAITLíN NíC ODA
PATRICIA FITZGIBBON	IRISH	PáDRAIGíN NIC GHIOBúIN
DEIRDRE COSTELLO	IRISH	DEIRDRE Ní CHOISTEALA
BIDDY PHILLIPS	IRISH	BRíD NIC PHILIB
MARIANNE JOHNSON	IRISH	MARIAN NIC SEáIN
ROSE QUIGLEY	IRISH	RóISíN Ní COIGLIGH
VIVIENNE KELLY	IRISH	BéBHINN Ní CHEALLAIGH
LILLIAN ZINKANT	IRISH	LIL NíC UINCANT
MAURA MCNICHOLAS	IRISH	MáIRE Uí NIOCLáIS
MIRIAM MALONE	IRISH	MIRIAM Ní MHAOILEOIN
CLAIRE JONES	IRISH	CLáR NIC SEOIN
NOELLE KENNEDY	IRISH	NOLLAIG Ní CHINNéIDE
VERA MACKEY	IRISH	FíORA Ní MHACA
ANN CARROLL	IRISH	ÁINE Ní CHEARBHALL
VIVIENNE HARRIS	IRISH	BéBHINN Ní HEARCHAí
THERéSE O'CALLAGHAN	IRISH	TREASA Ní CHEALLACHáIN
PETER LUCEY	IRISH	PEADAR Ó LUASAIGH
SHARON GLYNN	IRISH	SEáRóN NIC FHLOINN
AOIFE O'CONNOR	IRISH	AOIFE Ní CONCHUBHAIR
TERESA MURPHY	IRISH	TREASA Ní MHURCHú
KATHLEEN GRIFFIN	IRISH	CAITLíN Ní GHRíOFA
ALICE HUSSEY	IRISH	AILíS Ní HEOSA
DEIRDRE SUTTON	IRISH	DEIRDRE DE SUTúN
MARINA DOWNEY	IRISH	MARINA NIC GIOLLA DOMHNAIGH
DAN MURPHY	IRISH	DóNALL Ó MURCHú
MICHAEL FITZSIMONS	IRISH	MICHEáL MAC SíOMóIN
STEPHEN FRAMPTON	IRISH	STIOFáIN FRAMPTON
EOGHAN O'GARA	IRISH	EOGHAN Ó GADHRA
STEPHEN MCNAMARA	IRISH	STIOFáN MAC CONMARA
FERGAL HEGARTY	IRISH	FEARGHAL Ó HÉIGEARTAIGH
CIARáN SHEEHAN	IRISH	CIARáN Ó SíOCHáIN
ERIC PHILPOTT	IRISH	EIRIC MAC PHILIB
MICK BURKE	IRISH	MíCHEáL DE BúRCA
KEVIN DILLON	IRISH	CAOIMHíN DIOLúN
ÉAMONN RYAN	IRISH	ÉAMONN Ó RIAIN
PAUL MCGRATH	IRISH	PóL MAC CRAITH
FACHTNA O'DONOVAN	IRISH	FACHTNA Ó DONNABHáIN
P. A. MURPHY	IRISH	PáDRAIG A. Ó MURCHú
JOHN BLAKE	IRISH	SEáN DE BLáCA
TIMMY KELLEHER	IRISH	TADHG O CéILEACHAIR
DAVE BARRY	IRISH	DAITHí DE BARRA
TADHG MURPHY	IRISH	TADHG Ó MURCHú
BRENDAN LOMBARD	IRISH	BREANDáN LOMBARD
LAR PRENDERGAST	IRISH	LABHRAS DE PRIONDRAGáS
TOMáS WATERS	IRISH	TOMáS MAC CON UISCE
JIM BERRY	IRISH	SéAMUS Ó BéARA
WILLIE DORAN	IRISH	LIAM Ó DEORáIN
BRENDAN O'LEARY	IRISH	BREANDáN Ó LAOIRE
COLM FARRELL	IRISH	COLM Ó FEARAIL
HARRY KEHOE	IRISH	ANRAí MAC EOCHAIDH
PETER ATKINSON	IRISH	PEADAR MAC AIDICíN
STEPHEN BANVILLE	IRISH	STIOFáIN Dé BUINNBHíOL
TOMMY DWYER	IRISH	TOMáS Ó DUIBHIR
STEPHEN DOYLE	IRISH	STIOFáIN Ó DúIL
BRENDAN FENNELLY	IRISH	BREANDáN Ó FIONNALAIGH
MARTIN TREACY	IRISH	MáIRTíN Ó TREASAIGH
JAMES HORAN	IRISH	SéAMUS Ó HÓRáIN
JASON RYAN	IRISH	SéASUN Ó RIAIN
JO JO BARRETT	IRISH	SEOSAMH BAIRéID
EDDIE MURPHY	IRISH	EDDIE Ó MURCHú
RICHIE POWER	IRISH	RISTEARD DE PAOR
EDDIE KELLY	IRISH	ÉAMONN Ó CEALLAIGH
PADDY KEENAN	IRISH	PáDRAIG O'CIANAIN
PATSY HARTE	IRISH	PáDRAIG Ó HAIRTRí
EOIN REILLY	IRISH	EOIN Ó RAGHALLAIGH
MAURICE HORAN	IRISH	MUIRIS Ó HÓRáIN
EUGENE MCENTEE	IRISH	EOGHAN MAC AN TSAOI
MICHAEL JOHNSON	IRISH	MíCHEáL MAC SHEáIN
DANIEL HUGHES	IRISH	DóNALL Ó HAODHA
MIKE FINN	IRISH	MíCHEáL Ó BHFINN
LIAM WATSON	IRISH	LIAM MAC UAIT
MICHAEL GLEESON	IRISH	MíCHEáL Ó GLIASáIN
NIGEL NESTOR	IRISH	NIALL NESTOR
JUSTIN MCNULTY	IRISH	JUSTIN MAC AN ULTAIGH
JIM MCGUINNESS	IRISH	SéAMUS MAG AONGHUSA
DEREK SAVAGE	IRISH	DEREK MAC SABHAOIS
JACK FERRITER	IRISH	JACK FERRITER
JOHN JOE DOHERTY	IRISH	SEáN SEOSAMH Ó DOCHARTAIGH
HUGH KENNY	IRISH	AODH Ó CIONNAITH
RORY O'CONNELL	IRISH	RUAIRí Ó CONAILL
EAMONN DOHERTY	IRISH	ÉAMONN Ó DOCHARTAIGH
JAMES MCCARTAN, SENIOR	IRISH	SéAMAS MAC ARTáIN MóR
PAUL CONROY	IRISH	PóL Ó CONAIRE
SEáN ARMSTRONG	IRISH	SEáN Ó LABHRADHA TRéAN
NICKY JOYCE	IRISH	NICHOLáS SEOIGE
GARY SICE	IRISH	GARRAI Ó SAIGHEAS
KEVIN MCMANAMON	IRISH	CAOIMHíN MAC MEANMAN
NOEL SHEEHY	IRISH	NODHLAIG MAC AN TSíTHIGH
MARTIN FLANAGAN	IRISH	MáIRTíN Ó FLANNAGáIN
DAMIEN HEALY	IRISH	DAMIAN Ó HÉILí
EOIN QUIGLEY	IRISH	EOGHAN Ó COIGLIGH
BRIAN FARRELL	IRISH	BRIAIN Ó FEARAIL
JOHNNY NEVIN	IRISH	SEáN MAC NAOIMHíN
ENDA GALVIN	IRISH	ENDA Ó GALBHáIN
KIERAN FITZGERALD	IRISH	CIARáN MAC GEARAILT
DECLAN MEEHAN	IRISH	DéAGLáN Ó MíOCHáIN
PáDRAIC KELLY	IRISH	PáDRAIC Ó CEALLAIGH
PADDY O'ROURKE	IRISH	PáDRAIG Ó RúAIRC
AIDAN TUITE	IRISH	AODHáN DE TIúIT
CIAN WARD	IRISH	CIAN MAC AN BHAIRD
NICKEY BRENNAN	IRISH	NIOCLáS Ó BRAONáIN
SEáN ÓG Ó HAILPíN	IRISH	SEáN ÓG Ó HAILPíN
MICHAEL KEATING	IRISH	MíCHEáL Ó CéITINN
SEáNIE O'LEARY	IRISH	SEáN Ó LAOIRE
JAMES O'SHEA	IRISH	JAMES O'SHEA
BARRY JOHN KEANE	IRISH	BARRA SEáN Ó CATHAIN
JOHN O'KEEFFE	IRISH	SEáN Ó CAOIMH
DIARMUID MCMAHON	IRISH	DIARMAD MAC MATHúNA
ENDA MCNULTY	IRISH	ENDA MAC AN ULTAIGH
LARRY MURPHY	IRISH	LABHRáS Ó MURCHú
DARREN STAMP	IRISH	DARREN DE STAMP
JOHN CONLON	IRISH	SEáN Ó CONALLáIN
BRIAN CAMPION	IRISH	BRIAIN CAIMPION
ANDREW QUINN	IRISH	AINDRIAS Ó CUINN
ALAN MARKHAM	IRISH	AILéIN Ó MARCAHáIN
BARRY NUGENT	IRISH	BARRA Dé NUINSEANN
PAT VAUGHAN	IRISH	PáDRAIG Ó MACHáIN
COLIN RYAN	IRISH	CóILíN Ó RIAIN
JAMES MCINERNEY	IRISH	SéAMUS MAC AN AIRCHINNIGH
JIMMY GRAY	IRISH	SéAMUS DE GRAE
JONATHAN CLANCY	IRISH	SEáN MAC LANNCHAIDH
FERGAL LYNCH	IRISH	FERGAL Ó LOINGSIGH
BRENDAN BUGLER	IRISH	BREANDáN Dé BUIGLéIR
TOMáS MAC AN TSAOIR	IRISH	TOMáS MAC AN TSAOIR
BRIAN HANLEY	IRISH	BRIAIN Ó HÁINLE
CILLIAN FARRELL	IRISH	CILLIAN Ó FEARRGHAíLL
GER ROGAN	IRISH	GEARóID Ó RUAGáIN
JOHN CONRAN	IRISH	SEáN Ó CONARáIN
DAVE KEANE	IRISH	DAITHí Ó CATHáIN
ANTHONY O'RIORDAN	IRISH	ANTóIN O RIORDáIN
MICHEáL O'SULLIVAN	IRISH	MICHEáL Ó SúILLEABHáIN
CIARáN O'SULLIVAN	IRISH	CIARáN Ó SúILLEABHáIN
MARK O'SULLIVAN	IRISH	MARC Ó SúILLEABHáIN
DANIEL MCCARTAN	IRISH	DóNAL MAC ARTáIN
PAUL MCCOMISKEY	IRISH	PóL MAC COMASCAIGH
DICK STOKES	IRISH	RISTEARD STóC
NED CREGAN	IRISH	ÉAMONN Ó CRIAGáIN
PETER CREGAN	IRISH	PEADAR Ó CRíAGáIN
TOMMY COOKE	IRISH	TOMáS MAC DHABHóC
JIM PRIOR	IRISH	SéAMUS MAC AN PHRíORA
LEO O'CONNOR	IRISH	LEON Ó CONCHUBHAIR
TURLOUGH HERBERT	IRISH	TOIREALACH HOIREABARD
SEáN O'NEILL	IRISH	SEáN Ó NéILL
EOIN CONCANNON	IRISH	EOIN Ó CONCHEANAINN
ADRIAN FAHERTY	IRISH	ADRIAN Ó FATHARTA
DESSIE FINNEGAN	IRISH	DEASúN Ó FIONNAGáIN
RAY FINNEGAN	IRISH	RéAMONN Ó FIONNAGáIN
COLM JUDGE	IRISH	COLM MAC AN BHREITHEAMHAN
AARON HOEY	IRISH	AARON Ó H-EOCHAIDH
BILLY BYRNE	IRISH	LIAM O BROIN
PAUL FINN	IRISH	PóL Ó FINN
SéAMUS BARRON	IRISH	SéAMUS BARúN
JAMES BLACK	IRISH	SéAMUS Ó DUIBH
CHRIS MCGUINNESS	IRISH	CRIOSTóIR MAC AONGHUSA
WILLIE HYLAND	IRISH	LIAM Ó HAOLáIN
SIMON MCCRORY	IRISH	SIOMóN MAC RUAIRí
CONOR MCCANN	IRISH	CONCHúR MAC CANA
PADDY MOLLOY	IRISH	PáDRAIG Ó MAOLMHUAIDH
PAUL DURCAN	IRISH	PóL MAC DHUARCáIN
NEIL MCGEE	IRISH	NíALL MAC AOIDH
PADDY MCGRATH	IRISH	PáDRAIG MAC CRAITH
FRANK MCGLYNN	IRISH	FRAINC MAC GHLIONN
DAVE CLOHESSY	IRISH	DAITHí Ó CLOCHASAIGH
TOMMY MCCARTHY	IRISH	TOMáS MAC CáRTHAIGH
GRAEME MULCAHY	IRISH	GRéACHáIN Ó MAOLCHATHAIGH
CONOR FITZGERALD	IRISH	CONCHUR MAC GEARAILT
DONNCHA SHEEHAN	IRISH	DONNCHA Ó SíOCHáIN
DENIS O'SULLIVAN	IRISH	DONNCHA Ó SúILLEABHáIN
COLM CASSIDY	IRISH	COLM  Ó CAISIDE
GERARD HOEY	IRISH	GEARóID Ó H-EOCHAIDH
EOIN PRICE	IRISH	EOIN PRíS
BRENDAN MURTAGH	IRISH	BREANDáN MAC MUIREARTAIGH
KEVIN KEHOE	IRISH	CAOIMHíN MAC EOCHAIDH
RUAIRí DUNBAR	IRISH	RUAIRí DUNBAR
JACK KAVANAGH	IRISH	SEáN CAOMHáNACH
JAMIE O'SULLIVAN	IRISH	SéAMUS Ó SúILLEABHáIN
FIACHRA LYNCH	IRISH	FIACHRA Ó LOINGSIGH
KEN O'HALLORAN	IRISH	CIONNAITH Ó HALLúRáIN
NEAL MCAULEY	IRISH	NIALL MAG AMHALAí
EOIN COTTER	IRISH	EOIN COTTER
ALAN DILLON	IRISH	ALAN Ó DIOLUN
EDDIE MCCLOSKEY	IRISH	ÉAMONN MAC BHLOSCAIDH
MATTHEW O'HANLON	IRISH	MAITIú Ó HANLUAIN
NIALL BREEN	IRISH	NíALL Ó BRAOIN
STEPHEN MCDONNELL	IRISH	STIOFáIN MAC DOMHNAILL
PAUL RYAN	IRISH	PóL Ó RIAIN
PAUDIE KEHOE	IRISH	PáIDí MAC EOCHAIDH
RONAN CARROLL	IRISH	RóNáN Ó'CEARBHAILL
DAITHí CARROLL	IRISH	DAITHí Ó'CEARBHAILL
DONAL O'DONOGHUE	IRISH	DONAL Ó DONNCHú
JAMES NAGLE	IRISH	SéAMUS DE NóGLA
CATHAL SCALLY	IRISH	CATHAL MAC SCALAí
MICHAEL ARMSTRONG	IRISH	MíCHEáL Ó LABHRAí TRéAN
SEáN HAWES	IRISH	SEáN Ó HEACHACH
COLIN EGAN	IRISH	CóILíN MAC AOGáIN
JAMES MULROONEY	IRISH	SéAMUS Ó MAOLRUANAIDH
DARRAGH O'CONNELL	IRISH	DARRAGH Ó CONAILL
SHANE NOLAN	IRISH	SEáN Ó NUALLáIN
CYRIL DONNELLAN	IRISH	COIREALL Ó DóMHNALLáIN
ANDREW MITCHELL	IRISH	AINDRIú MISTéIL
JOHN SHAW	IRISH	SEáN SEáCH
BRIAN DOYLE	IRISH	BRIAIN Ó DúIL
PAUL COADY	IRISH	PóL MAC ODA
DWAINE KAVANAGH	IRISH	DUáIN CAOMHáNACH
NICKY ROBERTS	IRISH	NIOCLáS MAC ROIBEAIRD
JOHNNY COEN	IRISH	SEáN Ó COMDHAIN
SEAN O'NEILL	IRISH	SEáN Ó NéILL
BARRY DALY	IRISH	BARRA Ó DáLAIGH
JOHN A. DELANEY	IRISH	SEáN A. Ó DúLáINNE
DAIRE PLUNKETT	IRISH	DAIRE PLUINCéID
ÉANNA MURPHY	IRISH	ÉANNA Ó MURCHú
NIALL DOWDALL	IRISH	NIALL DúDAL
PAUL MURPHY	IRISH	PóL Ó MURCHú
COLIN FENNELLY	IRISH	CóILíN Ó FIONNALAIGH
KEVIN DOWNES	IRISH	CAOIMHíN Ó DUBHáIN
PAURIC MAHONY	IRISH	PáDRAIC Ó MATHúNA
PADDY HOGAN	IRISH	PáIDí Ó HÓGáIN
DARRAGH FIVES	IRISH	DARRAGH Ó CUAIG
DAVID O'SULLIVAN	IRISH	DáITHí Ó SúILLEABHáIN
STEPHEN LILLIS	IRISH	STIOFáN LAIGHLéIS
CONOR MCGRATH	IRISH	CONCHúIR MAC CRAITH
PATRICK O'CONNOR	IRISH	PáDRAIG Ó CONCHUBHAIR
CATHAL MCINERNEY	IRISH	CATHAL MAC AN OIRCHINNIGH
BILL COOPER	IRISH	LIAM CúIPéIR
JAMIE COUGHLAN	IRISH	SéAMUS Ó COCHLáIN
GER REDDIN	IRISH	GEARóID Ó ROIDEáIN
GARRETT SINNOTT	IRISH	GEARóID SIONóID
SEáN TOBIN	IRISH	SEáN Ó TóIBíN
KIERAN MARTIN	IRISH	CIARáN Ó MáIRTíN
THOMAS CARROLL	IRISH	TOMáS Ó CEARúIL
JOHN DOYLE	IRISH	SEáN Ó DúIL
BRENDAN MURPHY	IRISH	BREANDáN Ó MURCHú
BRIAN DOYLE	IRISH	BRIAIN Ó DúIL
MICHAEL FOLEY	IRISH	MICHEáL Ó FOGHLADHA
PHILIP MAHONY	IRISH	PILIB Ó MATHúNA
JAMES WALSH	IRISH	SéAMAS BREATHNACH
SHANE ENRIGHT	IRISH	SEáN MAC IONNRACHTAIGH
SéAMUS POWER	IRISH	SéAMUS DE PAOR
MICKEY BURKE	IRISH	MíCHEáL DE BúRCA
DECLAN HANNON	IRISH	DéAGLáN HANNáIN
MATTHEW RUTH	IRISH	MAITHIú DE RúT
JAMES REGAN	IRISH	SéAMUS Ó RíAGáIN
RICHIE MCCARTHY	IRISH	RISTEARD MAC CáRTHAIGH
TOM CONDON	IRISH	TOMáS CONDúN
DAVID BURKE	IRISH	DAITHí DE BúRCA
AIDAN HARTE	IRISH	AODáN Ó HAIRT
CONOR LEHANE	IRISH	CONCHUR Ó LIATHáIN
JAMES MCCARTHY	IRISH	SéAMUS MAC CáRTAIGH
JOE SHERIDAN	IRISH	SEOSAMH Ó SIRIDEáIN
STEPHEN KELLY	IRISH	STIOFáN Ó CEALLAIGH
CONOR MCCORMACK	IRISH	CONCHúIR MAC CORMAIC
PAUL SCHUTTE	IRISH	PóL SCHüTTE
PETER KELLY	IRISH	PEADAR Ó CEALLAIGH
STEPHEN LAVIN	IRISH	STIOFAIN O LIOBHAIN
SHANE CONNOLLY	IRISH	SéAN Ó CONGHAILE
NEIL GALLAGHER	IRISH	NIALL Ó GALLCHOBHAIR
PATRICK MCBREARTY	IRISH	PáDRAIG MAC BRIARTAIGH
RICHIE DOYLE	IRISH	RISTEARD Ó DúIL
CONOR FOGARTY	IRISH	CONCHúIR Ó FOGARTAIGH
VINCENT O'CONNOR	IRISH	UINSEANN Ó CONCHUBHAIR
TIMMY O'DOWD	IRISH	TADHG Ó DúDA
PAT MCCARTHY	IRISH	PáDRAIG MAC CáRTHAIGH
REGINA GORMAN	IRISH	RíONACH Ní GORMáIN
JANE DOLAN	IRISH	SINéAD Ní DHúLáIN
J. J. DOYLE	IRISH	SEAN SEOSAMH  Ó DúGHAILL
KAREN ATKINSON	IRISH	CARIN NIC AIDICíN
COLLEEN ATKINSON	IRISH	CAILíN NIC AIDICíN
DEIRDRE CODD	IRISH	DEIRDRE NíC ÓDA
JOSIE DWYER	IRISH	SEOSAMHIN NI DHUIBHIR
LENNY HOLOHAN	IRISH	LéAN Ní HUALLACHáIN
FIONA KAVANAGH	IRISH	FIONA CAOMHáNACH
CIARA O'CONNOR	IRISH	CIARA N í CONCHúR
NOELEEN LAMBERT	IRISH	NóILíN LAIMBEART
BRíD GORDON	IRISH	BRíD Ní MHUIRNEACHáIN
URSULA JACOB	IRISH	URSULA ÍáCóB
CLAIRE O'CONNOR	IRISH	CLáR Ní CONCHúBHAIR
KATRINA PARROCK	IRISH	CAITRíONA Ní PHARRóG
EVELYN QUIGLEY	IRISH	EIBHLíN Ní CHOIGLIGH
CIARA STOREY	IRISH	CIARA Ní STóIRí
STACEY REDMOND	IRISH	- STáIS Ní RéAMOINN
HEATHER COONEY	IRISH	HEATHER Ní CHUANA
MARTINA CONROY	IRISH	MARTINA Ní CHUANA
SANDRA TANNIAN	IRISH	SANDRA Ní THANAIDHEáIN
SARAH DERVAN	IRISH	SORCHA Ní DHOIRBHEáIN
NIAMH KILKENNY	IRISH	NIAMH NIC GIOLLA CHAINNIGH
TARA RUTTLEDGE	IRISH	TEAMHAIR Ní MHAOILDEIRG
SUSAN EARNER	IRISH	SIOBHáN Ní SHAOLAIGH
JENNIE SIMPSON	IRISH	SINéAD NIC SHíM
MICHAELA CONVERY	IRISH	MICHILíN NIC ÁINMHIRE
RHONA TORNEY	IRISH	RóNACH Ní THóRNA
NIAMH MCGRATH	IRISH	NIAMH NIC CRAITH
MAIRéAD GRAHAM	IRISH	MAIRéAD Ní GRéACHáIN
FIONNUALA CARR	IRISH	FIONNUALA Ní CHEARRA
EMMA KILKELLY	IRISH	EMMA NIC GIOLLA CHEALLAIGH
THERESE MANTON	IRISH	TREASA Ní MHANTáIN
EMER HAVERTY	IRISH	EIMEAR Ní HABHARTAIGH
BRENDA HANNEY	IRISH	BREANDA Ní HANNAIGH
ANN MARIE STARR	IRISH	ÁINE MáIRE Ní STARR
SINéAD KEANE	IRISH	SINéAD Ní CHATHáIN
JER D. O'CONNOR	IRISH	GEARóID PáDRAIG Ó CONCHUBHAIR
MARK MCDONALD	IRISH	MARC MAC DóMHNAILL
JIMMY TOBIN	IRISH	SéAMUS Ó TóIBíN
LORRAINE RYAN	IRISH	ÁINE Ní RIAIN
ORLA KILKENNY	IRISH	ÓRLAITH NIC GIOLLA CHAINNIGH
MICHELLE O'LEARY	IRISH	MICHILíN Ní LAOIRE
MICK DORNEY	IRISH	MíCHEáL Ó DOIRINNE
WILLIE GLEESON	IRISH	LIAM Ó GLIASáIN
WILLIE RYAN	IRISH	LIAM Ó RIAIN
MICKY CROSS	IRISH	MíCHEáL MAC AN CHROSáIN
AOIFE LYNSKEY	IRISH	AOIFE NI LIONSCAIGH
JOE POWER	IRISH	SEOSAMH DE PAOR
NOEL LANE	IRISH	NOLLAIG Ó LAIGHIN
HENRY MEAGHER	IRISH	PáDRAIG Ó MEACHAIR
MICHAEL RYAN	IRISH	MíCHEáL Ó RIAIN
ANTHONY MASTERSON	IRISH	ANTOINE MAC AN MHáIGHISTIR
DIARMAID BLAKE	IRISH	DIARMAID DE BLáCA
PADDY ENRIGHT	IRISH	PáDRAIG
PA MCINERNEY	IRISH	PáDRAIG MAC AN AIRCHINNIGH
ALAN COOMEY	IRISH	AILIN MAC COMAIDH
JOHN TIERNEY	IRISH	SEáN Ó TIARNAIGH
PETER O'REILLY	IRISH	PEADAR Ó RAGHALLAIGH
JIMMY O'CONNELL	IRISH	SéAMUS Ó CONAILL
ANDY MORAN	IRISH	AINDRIU Ó MORAIN
DONAL BRENNAN	IRISH	DONALL O BRAONAIN
PAUL SHARRY	IRISH	PóL MAC SEARRAIGH
JOHN HESLIN	IRISH	SEáN Ó HEISLIN
PAUDGE MULHARE	IRISH	PáDRAIG Ó MAOILCHéIRE
DEREK MULLIGAN	IRISH	DEIRG Ó MAOLAGáIN
JOHN LACK O'SULLIVAN	IRISH	SEáN LACK Ó SúILEABHáIN
JAS MURPHY	IRISH	SéAMUS Ó MURCHú
MICHAEL G. TUBRIDY	IRISH	MíCHEáL Ó TIOBRAIDE
TOMMY LEAHY	IRISH	TOMáS Ó LAOCHA
PAT GLENDON	IRISH	PáDRAIG MAC GIOLLA FHIONDáIN
DICK TOBIN	IRISH	RISTEARD TóIBíN
JOHN ROBERTS	IRISH	SEáN MAC ROIBEAIRD
MICK NEVILLE	IRISH	MíCHEáL Ó NIA
FRANK CUMMINS	IRISH	PRIONSIAS Ó COIMIN
JIM HASSETT	IRISH	SéAMUS HAISéID
MICK LEAHY	IRISH	MíCHEáL Ó LAOCHA
RICHIE FEENEY	IRISH	RISTEARD Ó FIANNAí
BILLY BURKE	IRISH	LIAM DE BúRCA
KEVIN MCKERNAN	IRISH	CAOIMHíN MAC THIARNáIN
KEVIN REILLY	IRISH	CAOIMHíN Ó RAGHALLAIGH
JIM HOGAN	IRISH	SéAMUS Ó HÓGáIN
DENIS REIDY	IRISH	DONNACHA Ó RIADA
EAMONN CALLAGHAN	IRISH	ÉAMONN Ó CEALLACHáíN
COLIN FORDE	IRISH	CóILíN MAC GIOLLARNáTH
JOHN GALVIN	IRISH	SEáN Ó GEALBHáIN
JOHN MCMAHON	IRISH	SEáN MAC MATHúNA
TOMMY BUTLER	IRISH	TOMáS DE BUITLéIR
COLM HONAN	IRISH	COLM Ó HEOGHANáIN
DONAL BOYLAN	IRISH	DóNALL Ó BAíOLLáIN
PAT CLEARY	IRISH	PáDRAIG Ó CLéIRIGH
JIM GREENE	IRISH	SéAMUS Ó HUAINE
SEáN TREACY	IRISH	SEáN Ó TREASAIGH
PADDY KELLY	IRISH	PáDRAIG Ó CEALLAIGH
GERARD MCGRATTAN	IRISH	GEARóID MAG REACHTAIN
MIKE MOLONEY	IRISH	MICHEáL Ó MAOLDOMHNAIGH
JAMES MCNAUGHTON	IRISH	SéAMUS
CHRISTY BYRNE	IRISH	CRIOSTóIR Ó BROIN
CIARáN LENEHAN	IRISH	CIARáN Ó LEANNACHáIN
PEADAR BYRNE	IRISH	PEADAR Ó BROIN
MORGAN O'FLAHERTY	IRISH	MORGAN Ó FLATHARTA
EOGHAN O'FLAHERTY	IRISH	EOIN O'FLATHARTA
DAVID GALLAGHER	IRISH	DAITHí Ó GALLCHóIR
BRIAN MEADE	IRISH	BRIAIN Ó MIACH
CIARáN KILKENNY	IRISH	CIARáN MAC GIOLLA CHAINNIGH
MURT KELLY	IRISH	CAOIMHíN Ó COFAIGH
CAHIR HEALY	IRISH	CAHIR Ó HÉILí
MARK LYDON	IRISH	MARC Ó LOIDEáIN
KATHLEEN HANRATTY	IRISH	CAITLíN Ní HANRACHTAIGH
DAMIEN MURRAY	IRISH	DAMIEN Ó MUIRí
JOHN O'BRIEN	IRISH	SEAN Ó BRIAIN
GARY O'BRIEN	IRISH	GARRAí Ó BRIAIN
MICHAEL FANNING	IRISH	MICHEáL Ó FIONNáIN
CORMAC DONNELLY	IRISH	CORMAC
GREGORY O'KANE	IRISH	GRéAGóIR Ó CATHáIN
DAVID KENNY	IRISH	DAITHí Ó CIONNAITH
PATRICK DONNELLAN	IRISH	PáDRAIG Ó DóNALLáIN
DAMIEN FOGARTY	IRISH	DAMIEN Ó FóGARTAIGH
SEáN CUMMINS	IRISH	SEáN Ó CUIMIN
FERGAL MOORE	IRISH	FERGAL Ó MóRA
DAMIEN QUINN	IRISH	DAMIEN Ó COINNE
NIALL BURKE	IRISH	NíALL DE BúRCA
SHANE DOWLING	IRISH	SEáN Ó DUALAING
SHANE MCNAUGHTON	IRISH	SEáN MAC NEACHTAIN
PAUL BRANIFF	IRISH	PóL Ó BRANNUIBH
PáDRAIG BOYLE	IRISH	PáDRAIG Ó BAOILL
JACK GUINEY	IRISH	JACK Ó GUINí
JOHNNY RYAN	IRISH	SEáN Ó RIAIN
MICK MEHIGAN	IRISH	MíCHEáL Ó MAOTHAGáIN
CHARLIE PAYE	IRISH	CATHAL PáIGH
JACK YOUNG	IRISH	SEáN DE SIúN
JERRY BECKETT	IRISH	DIARMAID BEICéID
WILLIAM DALY	IRISH	LIAM Ó DáLAIGH
CON KELLEHER	IRISH	CONCHUR Ó CéILEACHAIR
JACK LEHANE	IRISH	SEáN Ó LIATHáIN
DICK FLAVIN	IRISH	RISTEARD Ó FLAITHIMHíN
MICK GOULD	IRISH	MíCHEáL DE GúL
DENIS BERNARD	IRISH	DONNCHA Ó BEARNáIN
DENIS KELLEHER	IRISH	DONNCHA CéILEACHAIR
JOHNNY CREEDON	IRISH	SEáNIE Ó CRíODáIN
DAN MURRAY	IRISH	DóNALL Ó MUIRí
NIALL FITZGERALD	IRISH	NIALL MAC GEARAILT
PADDY CRONIN	IRISH	PáDRAIG Ó CRóINíN
DENIS CONNORS	IRISH	DONNCHA Ó CONCHUBHAIR
JIM AHERNE	IRISH	SéAMUS Ó HEACHTAIRN
JIM DOWNING	IRISH	SéAMUS Ó DúINíN
BILLY FIELD	IRISH	LIAM AN MHACHAIRE
PADDY O'DRISCOLL	IRISH	PáDRAIG Ó DRISCEOIL
NEALIE DUGGAN	IRISH	NIALL Ó DúGáIN
PADDY MOCLAIR	IRISH	PáDRAIG MOCLéIR
PATSY FLANNELLY	IRISH	PáDRAIG Ó FLANNAILE
ALF MURRAY	IRISH	ALF Ó MUIRí
PáDRAIG CARNEY	IRISH	PáDRAIG Ó CEARNAIGH
LIAM O'NEILL	IRISH	LIAM Ó NéILL
WILLIE JOYCE	IRISH	LIAM SEOIGE
TOM ALLEN	IRISH	TOMáS Ó AILíN
PAUL MCKENNA	IRISH	PóL MAC CIONNAITH
PHIL CAHILL	IRISH	PILIB Ó CATHAIL
JIMMY HARNEY	IRISH	SéAMUS Ó HATHAIRNE
TOMMY TREACY	IRISH	TOMáS Ó TREASAIGH
MICK CRONIN	IRISH	MíCHEáL Ó CRóINíN
WILLIE MEAGHER	IRISH	LIAM Ó MEACHAIR
FRANK MEAGHER	IRISH	PRIONSIAS Ó MEACHAIR
PODGE BYRNE	IRISH	PáDRAIG Ó BROIN
EDDIE BYRNE	IRISH	ÉAMONN Ó BROIN
ENDA WILLIAMS	IRISH	ÉANNA MAC UILLIAM
DAMIEN BURKE	IRISH	DAMIEN DE BúRCA
EDWARD COADY	IRISH	ÉAMONN MAC ODA
BERNIE GIBBS	IRISH	BEIRCHEART MAC GIB
JOHN MACKEY	IRISH	SEáN MAC AODHA
DAVE KAVANAGH	IRISH	DAITHí CAOMHáNACH
BILLY MOLOUGHNEY	IRISH	LIAM Ó MAOLFHACHTNA
EDDIE GLEESON	IRISH	ÉAMONN Ó GLIASáIN
JOHN COFFEY	IRISH	SEáN Ó COFAIGH
JACK KEANE	IRISH	SEáN Ó CATHáIN
CHRIS RYAN	IRISH	CRIOSTóIR Ó RIAIN
ARTHUR O'DONNELL	IRISH	ARTúR Ó DOMHNAILL
MARTIN MOCKLER	IRISH	MáIRTíN MOCLéIR
STEPHEN HACKETT	IRISH	STíOFáN HAICéID
TOM DUFFY	IRISH	TOMáS Ó DUFAIGH
MICK DARCY	IRISH	MíCHEáL Ó DORCHAí
PADDY LEAHY	IRISH	PáDRAIG Ó LIATHAIGH
JACK DARCY	IRISH	SEáN Ó DORCHAí
PADDY POWER	IRISH	PáDRAIG DE PAOR
JACK POWER	IRISH	SEáN DE PAOR
DENIS WALSH	IRISH	DONNCHA BREATHNACH
PADDY O'KEEFFE	IRISH	PáDRAIG Ó CUíV
JIM POWER	IRISH	SéAMUS DE PAOR
JEREMIAH LEAHY	IRISH	DIARMUID Ó LIATHAIGH
PATRICK MOORE	IRISH	PáDRAIG Ó MORDHA
MICK COLEMAN	IRISH	MíCHEáL Ó COLMáIN
BOB O'KEEFFE	IRISH	ROIBEáRD Ó CHAOIMH
JOHN FOX	IRISH	SEáN Ó SIONNAIGH
JIMMY MORRIS	IRISH	SéAMUS Ó MUIRIS
MICK MURPHY	IRISH	MíCHEáL Ó MURCHú
MARTIN MCNAMARA	IRISH	MáIRTíN MAC CONMARA
TOM KERWICK	IRISH	TOMáS Ó CIARMHAIC
PADDY BROLAN	IRISH	PáDRAIG Ó BREALLáIN
JACK MOCKLER	IRISH	SEáN Ó MOCLéIR
HUGH SHELLY	IRISH	AODH Ó SEALBHAIGH
TIM GLEESON	IRISH	TADHG Ó GLIASáIN
ANTHONY CAREW	IRISH	ANTóIN CARRúN
TOM KENNA	IRISH	TOMáS MAC CIONAOITH
JIMMY HUMPHREYS	IRISH	SéAMUS MAC UNFRAIDH
JACK GARGAN	IRISH	SEáN Ó GARGáIN
TOM DIXON	IRISH	TOMáS MAC RIOCAIRD
JIM DEVITT	IRISH	SéAMUS MAC DAIBHéID
MARK BERGIN	IRISH	MARC Ó BEIRGIN
JOHN MADDEN	IRISH	SEáN Ó MADáIN
JOHN MOCKLER	IRISH	SEáN MOCLéIR
NED BOWE	IRISH	ÉAMONN Ó BUAIGH
JAMES HANLEY	IRISH	SéAMUS Ó HÁINLE
NIALL O'BRIEN	IRISH	NIALL Ó BRIAIN
PAT MULCAHY	IRISH	PáDRAIG Ó MAOLCATHA
ROBBIE GREVILLE	IRISH	ROIBEáRD Ó GRIABHáIL
CONOR ALLIS	IRISH	CONCHúIR MAC ALAS
TOMMY GLYNN	IRISH	TOMAS MAG FHLOINN
SHAUN MURPHY	IRISH	SEáN Ó MURCHú
WILLIE DEVEREUX	IRISH	LIAM DéABHRúS
STEPHEN MURPHY	IRISH	STIOFáN Ó MURCHú
LEONARD MCKEEGAN	IRISH	LIONARD MAC AOGáIN
IARLA TANNIAN	IRISH	IARLATH O TANAIDHEáIN
CONOR COONEY	IRISH	CONCHúIR Ó CUANA
STEPHEN CLYNCH	IRISH	STIOFáN MAC LOINGSIGH
PATRICK KELLY	IRISH	PáDRAIG Ó CEALLAIGH
CILLIAN BUCKLEY	IRISH	CILLIAN Ó BUACHALLA
KIERAN JOYCE	IRISH	CIARáN SEOIGE
DARREN SWEETNAM	IRISH	DARRIN SUATNAM
DANIEL KEARNEY	IRISH	DóNALL Ó CEARNAIGH
STEPHEN O'KEEFFE	IRISH	STIOFáN Ó CUíV
STEPHEN DANIELS	IRISH	STIOFáIN Ó DóNAILL
GAVIN O'BRIEN	IRISH	GABHáN Ó BRIAIN
PADDY DOWDALL	IRISH	PáDRAIG DúDAL
NOEL SANDS	IRISH	NOLLAIG DE SAND
JOHN GROGAN	IRISH	SEáN
MARTY KAVANAGH	IRISH	MáIRTí CAOMHáNACH
NEIL MCGARRY	IRISH	NIALL MAG FHEARAIGH
PASCHAL RUSSELL	IRISH	PASCHAL RUISéIL
MICK MORONEY	IRISH	MíCHEáL Ó MAOLRUANAIDH
ROSS WHERITY	IRISH	ROSS Ó FABHARTAIGH
LEO MCLOONE	IRISH	LEO MAC GIOLLA UAIN
MARK MCHUGH	IRISH	MARC MAC AODH
KEVIN HYNES	IRISH	CAOIMHíN Ó HEIDHIN
JOSEPH COONEY	IRISH	SEOSAMH Ó CUANA
BARRY MONAGHAN	IRISH	BARRA Ó MANACHáIN
EAMON MCGEE	IRISH	ÉAMONN MAC AOIDH
BARRY MURPHY	IRISH	BARRA Ó MURCHú
JAMESIE BRENNAN	IRISH	SéAMUS Ó BRAONáIN
DECLAN WALSH	IRISH	DéAGLáN BREATHNACH
KIERAN STEVENSON	IRISH	CIARáN MAC STIOFáIN
OLLIE COLLINS	IRISH	OLIBHéAR Ó COILEáIN
RYAN MCGARRY	IRISH	RIAIN MAC GARRAí
BARNEY MCAULEY	IRISH	BARNAí MAG AMHALAí
SEáN DELARGY	IRISH	SEáN Ó DUíLEARGA
PAUL SHIELS	IRISH	PóL Ó SIAIL
PADDY RICHMOND	IRISH	PáDRAIG DE RISEAMANN
HARRY GRAY	IRISH	ANRAí MAC CATHAIL RIABHNAIGH
CHRISTY FORDE	IRISH	CRIOSTóIR MAC GIOLLARNáTH
BILLY DUFFY	IRISH	LIAM Ó DUFAIGH
JOHN KILLEEN	IRISH	SEáN Ó CILLíN
CHRISTOPHER JOYCE	IRISH	CRISTóIR SEOIGHE
TOMáS MCGRANE	IRISH	TOMáS MAG RáINE
GARY BIGGS	IRISH	GARRAí Ó BEIG
JOHNNY MCGRATTAN	IRISH	SEáNIE
OLLIE FAHY	IRISH	OILIBHéAR Ó FATHAIGH
GREG KENNEDY	IRISH	GRéAGóIR Ó CINNéIDE
SEáN ÓG SHEEHY	IRISH	SEáN ÓG MAC SíTHIGH
JIM BYRNE	IRISH	SéAMUS Ó BROIN
DENIS MEHIGAN	IRISH	DONNCHA Ó MAOTHAGáIN
BILLY O'NEILL	IRISH	LIAM Ó NéILL
ANDY SMITH	IRISH	AINDRIú MAC GABHANN
TOM HELEBERT	IRISH	TOMáS HOILEABARD
MATTIE KENNY	IRISH	MAITIú Ó CIONNAITH
NIALL DONOHUE	IRISH	NIALL Ó DONNCHú
EAMON KENNEDY	IRISH	ÉAMONN Ó CINNéIDE
ANDREW KEARY	IRISH	ANDRIú MAC GIOLLA CHéIRE
JOHN LEE	IRISH	SEáN Ó LAOI
EOIN MCCORMACK	IRISH	EOIN MAC CORMAIC
PETER CLEERE	IRISH	PEADAR DE CLéIR
KENNETH BURKE	IRISH	CIONNAITH DE BúRCA
BRIAN HORGAN	IRISH	BRIAN Ó HORGáIN
LIAM BURKE	IRISH	LIAM DE BúRCA
BRIAN FEENEY	IRISH	BRIAN Ó FIANNAí
CHRISTY CONNERY	IRISH	CRíOSTóIR Ó CONAIRE
GUSSIE RYAN	IRISH	AGAISTíN Ó RIAIN
MICHAEL SCULLY	IRISH	MíCHEáL Ó SCOLAí
PHILIP KENNEDY	IRISH	PILIB Ó CINNéIDE
AIDAN CUMMINS	IRISH	AODáN Ó COIMíN
WALTER BURKE	IRISH	UALTAROL;KK DE BúRCA
STEPHEN GREHAN	IRISH	STIOFáN Ó GRéACHáIN
KEN COOGAN	IRISH	CIONNAITH Ó CUAGáIN
CONOR PHELAN	IRISH	CONCHUR Ó FAOLáIN
JOHN MAHER	IRISH	SEáN Ó MEACHAIR
BRIAN DOWLING	IRISH	BRIAN Ó DUALAING
EDDIE MACKEY	IRISH	ÉAMONN MAC AODHA
MARK PHELAN	IRISH	MARC Ó FAOLáIN
PAT TENNYSON	IRISH	PáDRAIG TENNYSON
ALAN GEOGHEGAN	IRISH	ALAN
DARREN HANNIFFY	IRISH	DARRIN ó HAINIFIDH
BRENDAN KELLY	IRISH	BREANDáN Ó CEALLAIGH
JAMES MCHUGH	IRISH	SéAMUS MAC AODH
PATSY BROPHY	IRISH	PáDRAIG Ó BRóITHE
TOMáS MOYLAN	IRISH	TOMáS Ó MAOILEáIN
PADDY O'BRIEN	IRISH	PáDRAIG Ó BRIAIN
MICHEáL RYAN	IRISH	MíCHEáL Ó RIAIN
NOEL MORRIS	IRISH	NOLLAIG Ó MUIRIS
DARRAGH RABBITTE	IRISH	DARRAGH Ó COINíN
AIDAN BUTLER	IRISH	AODáN DE BUITLéIR
BRIAN O'MEARA	IRISH	BRIAN Ó MEáRA
AUSTIN BUCKLEY	IRISH	ÁISTíN Ó BUACHALLA
PAUL CAHILL	IRISH	PóL Ó CATHAIL
MARTIN CAREY	IRISH	MáIRTíN Ó CIARDHA
DERMOT LAWLER	IRISH	DIARMUID Ó LEATHLOBHAIR
MICHAEL HAVERTY	IRISH	MíCHEáL Ó HABHARTAIGH
PEARSE PIGGOTT	IRISH	PIARAS PIOGóID
RAYMIE RYAN	IRISH	RéAMONN Ó RIAIN
GER O'NEILL	IRISH	GEARóID Ó NéILL
BRENDAN KEOGH	IRISH	BREANDáN MAC EOCHAIDH
PADDY NEARY	IRISH	PáDRAIG Ó NáRAIGH
FRANK HOLOHAN	IRISH	PHRIONSIAS Ó HUALLACHáIN
KEVIN O'SULLIVAN	IRISH	CAOIMHíN Ó SúILLEABHáIN
BRENDAN CARROLL	IRISH	BREANDáN Ó CEARRúIL
LIAM MCGRATH	IRISH	LIAM MAC CRAITH
BRIAN GAYNOR	IRISH	BRIAN MAG FHIONNBHAIRR
KEVIN TUCKER	IRISH	CAOIMHíN Ó TUACHAIR
JOHN COSTIGAN	IRISH	SEáN MAC OISTIGíN
MICK LONERGAN	IRISH	MíCHEáL Ó LONGARGáIN
JOHN DILLON	IRISH	SEáN DIOLúN
TIM RYAN	IRISH	TADHG Ó RIAIN
CONNIE KEANE	IRISH	CONCHUR Ó CATHáIN
PAUDIE BUTLER	IRISH	PáDRAIG DE BUITLéIR
COLIN COEN	IRISH	CóILíN Ó COMHGHAIN
GER MAHON	IRISH	GEARóID MAC MATHúNA
P. J. DELANEY	IRISH	P. S. Ó DúLáINNE
SéADNA MOREY	IRISH	SéADNA Ó MóRA
AARON CUNNINGHAM	IRISH	AARON MAC CUINNEAGáIN
COLM GALVIN	IRISH	COLM Ó GEALBHáIN
WALTER WALSH	IRISH	UALTAR BREATHNACH
EOIN MURPHY	IRISH	EOGHAN Ó MURCHú
MARK KELLY	IRISH	MARC Ó CEALLAIGH
JOE BRENNAN	IRISH	SEOSAMH 'AN MUC' Ó BRAONáIN
JONATHAN GLYNN	IRISH	SEáN MAC GLOINN
TADHG HARAN	IRISH	TADHG Ó HEáRáIN
FEARGHAL FLANNERY	IRISH	FEARGHAL FLANNERY
PAUL GORDON	IRISH	PóL MAC MHUIRNEACHáIN
BRIAN FLAHERTY	IRISH	BRIAN Ó FLAHARTA
GERARD O'HALLORAN	IRISH	GEARóID Ó HALLúRáIN
JOHN MARNELL	IRISH	SEáN Ó MEARNáIL
SENAN COOKE	IRISH	SENAN MAC DHABHóC
MICHAEL HEALY	IRISH	MíCHEáL Ó HÉILí
PAUL O'CONNOR	IRISH	PóL Ó CONCHUBHAIR
CHARLIE MULGREW	IRISH	CATHAL Ó MAOLCHRAOIBHE
ANDREW CORDEN	IRISH	AINDRIú CóIRDáIN
TOMMY O'CONNELL	IRISH	TOMáS Ó CONAILL
CILLIAN O'CONNOR	IRISH	CILLIAN O'CONNOR
DAVID CLARKE	IRISH	DAITHí Ó CLéIRIGH
ÉAMONN PHELAN	IRISH	ÉAMONN Ó FAOLáIN
MICHAEL CONROY	IRISH	MICHEáL Ó CONRAOI
ENDA VARLEY	IRISH	ÉANNA MAC AN BHEARLAIGH
MICK O'DOWD	IRISH	MICHEáL Ó DUBHDA
LIAM MCHALE	IRISH	LIAM MACCEILE
RUAIRí CONVERY	IRISH	RUAIRí MAC AINMHIRE
MARTIN FINN	IRISH	MáIRTíN Ó FINN
TOM HOWARD	IRISH	TOMáS Ó HÍOMHAIR
BRIAN COSTELLO	IRISH	BRIAN MAC COISTEALA
JONATHAN MAHER	IRISH	SEáN Ó MEACHAIR
KEVIN MCLOUGHLIN	IRISH	CAOIMHíN MAC LOCHLAINN
LEE MACKEY	IRISH	LAOI MAC AODHA
MICHAEL WALSH	IRISH	MíCHEáL BREATHNACH
PAT SLOANE	IRISH	PáDRAIG Ó SLUáIN
TOM FLYNN	IRISH	TOMáS Ó FLOINN
JOHN FLYNN	IRISH	SEáN Ó FLOINN
CONOR DOHERTY	IRISH	CONCHúIR Ó DOCHARTAIGH
GER CAFFERKEY	IRISH	GEARóID MAC EAFARCAIGH
TONY HANNON	IRISH	ANTóIN Ó HANNáIN
DENIS COFFEY	IRISH	DONNCHA Ó COFAIGH
WAYNE MCNAMARA	IRISH	UáIN MAC CONMARA
DAVE BULFIN	IRISH	DAITHí BULFIN
KIERAN O'ROURKE	IRISH	CIARáN Ó RUAIRC
HUGH FLAVIN	IRISH	AODH Ó FLAITHIMHíN
PAUDIE O'DWYER	IRISH	PáIDí Ó DUBHUIR
EOIN FOLEY	IRISH	EOIN Ó FOGHLú
CIARáN SLEVIN	IRISH	CIARáN Ó SLéIBHíN
ALAN NEVILLE	IRISH	AILéIN Ó NIA
SEáN MCGRATH	IRISH	SEáN MAC CRAITH
KIERAN KINGSTON	IRISH	CIARáN MAC CLOCHAIRE
PADDY MEEGAN	IRISH	PáDRAIG Ó MIAGáIN
PADDY CAMPBELL	IRISH	PADRAIG Ó CAIMBéAL
BRIAN QUINN	IRISH	BRIAIN Ó COINN
JACK CARROLL	IRISH	SEáN Ó CEARúILL
KIERAN MCGRATH	IRISH	CIARáN MAC CRAITH
BARRY TEEHAN	IRISH	BARRA Ó TADHáIN
DIARMUID HORAN	IRISH	DIARMUID Ó HÓRáIN
SEáN CURRAN	IRISH	SEáN Ó CURRAOIN
WILLIE JOE PADDEN	IRISH	LIAM SEOSAMH MAC PHáIDíN
SéAMUS PLUNKETT	IRISH	SéAMUS PLUINCéID
CIARáN MAHER	IRISH	CIARáN Ó MEACHAIR
JACK DALY	IRISH	SEáN Ó DáLAIGH
JIM WALSH	IRISH	SéAMUS BREATHNACH
PAUL DOYLE	IRISH	PóL Ó DúIL
BILL GANNON	IRISH	LIAM MAG FHIONNáIN
FRANK MALONE	IRISH	PRIONSIAS Ó MAOILEOIN
JACK HIGGINS	IRISH	SEáN Ó HUIGINN
LARRY CRIBBIN	IRISH	LABHRáS MAC ROIBíN
FRANK CONLON	IRISH	PRIONSIAS Ó CONALLáIN
JOHN REIDY	IRISH	SEáN Ó RIADA
DAN TROY	IRISH	DóNALL Ó TROITHIGH
GEORGE MAGAN	IRISH	SEOIRSE MAG ANNAIDH
TOM FINLAY	IRISH	TOMáS Ó FIONNALAIGH
BOB DOHERTY	IRISH	RIOBEARD Ó DOCHARTAIGH
LARRY BLAKE	IRISH	LABHRáS DE BLáCA
TULL CONSIDINE	IRISH	TRAOLACH MAC CONSAIDíN
DONAL WHELAN	IRISH	DóNALL Ó FAOILEáIN
TIM O'CALLAGHAN	IRISH	TADHG Ó CEALLACHáIN
DENIS O'DRISCOLL	IRISH	DONNCHA Ó DRISCEOIL
KIERAN COLLINS	IRISH	CIARáN Ó COILEáIN
MICHAEL CREEDON	IRISH	MíCHEáL Ó CRíODáIN
MARK HEALY	IRISH	MARC Ó HÉILí
BERTIE O'BRIEN	IRISH	BEIRCHEART Ó BRIAIN
JOHN EVANS	IRISH	SEáN Ó HÉIMHíN
PADDY HAYES	IRISH	PáDRAIG Ó HAODHA
MICHAEL MAGUIRE	IRISH	MíCHEáL MAG UIDHIR
MICHAEL BURNS	IRISH	MíCHEáL Ó BROIN
EOIN O'MAHONY	IRISH	EOIN Ó MATHúNA
MARTIN HACKETT	IRISH	MáIRTíN HAICéID
PADDY DONOGHUE	IRISH	PáDRAIG Ó DONNCHú
TOM DWAN	IRISH	TOMáS Ó DUáIN
PHIL BYRNE	IRISH	PILIB Ó BROIN
MICK NEVILLE	IRISH	MíCHEáL Ó NIA
HARRY DAWSON	IRISH	ANRAí Ó DAWSúIN
DANNY RYAN	IRISH	DóNALL Ó RIAIN
JER COLLISON	IRISH	DIARMUID MAC COILLIGH
DINNY RYAN	IRISH	DONNCHA Ó RIAIN
JACK RYAN	IRISH	SEáN Ó RIAIN
JIMMY COONEY	IRISH	SéAMUS Ó CUANA
MAURICE FITZMAURICE	IRISH	MUIRIS MAC MUIRIS
RICHARD KISSANE	IRISH	RISTEARD Ó CíOSáIN
MAURICE KELLY	IRISH	MUIRIS Ó CEALLAIGH
TOM DUNNE	IRISH	TOMáS DOINN
JIMMY RAMSELL	IRISH	SéAMUS RAMSAILL
BARRY MURPHY	IRISH	BARRA Ó MURCHú
RYAN MCHUGH	IRISH	RIAN MAC AODH
ENDA BARRETT	IRISH	ENDA DE BAIRéID
STEPHEN GRIFFIN	IRISH	STIOFáIN Ó GRíOFA
DAVID WALSH	IRISH	DAITHí BREATHNACH
MARTIN O'REILLY	IRISH	MáIRTíN Ó RAGHALLAIGH
MIKE CUMMINS	IRISH	MíCHEáL Ó CUIMIN
PAT LEAHY	IRISH	PáDRAIG Ó LIATHAIGH
JER DWYER	IRISH	DIARMUID Ó DUBHUIR
NED LAMBE	IRISH	ÉAMONN Ó LUAIN
JACK DUNNE	IRISH	SEáN Ó DOINN
JOHN KIDNEY	IRISH	SEáN Ó DUáIN
DINNY KIDNEY	IRISH	DONNCHA Ó DUáIN
JAMES DELEA	IRISH	SéAMUS Ó DUILé
RONAN SWEENEY	IRISH	RóNáN MAC SUIBHNE
PAUDIE O'BRIEN	IRISH	PáIDí Ó BRIAIN
JOE TIMMONS	IRISH	SEOSAMH Ó TIOMáIN
PáDRAIG HAUGHEY	IRISH	PáDRAIG Ó HEOCHAIDH
JIMMY MULROY	IRISH	SEáMUS Ó MAOLRUA
KEVIN KEANE	IRISH	CAOIMHíN Ó CATHAIN
DONAL VAUGHAN	IRISH	DóMHNALL MAC ÚACHáN
BARRY MORAN	IRISH	BARRA Ó MóRáIN
AIDAN O'SHEA	IRISH	AODáN Ó Sé
JACK RALEIGH	IRISH	SEáN RáLAIGH
ELIAS O'KEEFFE	IRISH	ELIAS Ó CAOIMH
FRANK MCGRATH	IRISH	PRIONSIAS MAC CRAITH
TOM FLEMING	IRISH	TOMáS PLéIMEANN
DICK MORRISSEY	IRISH	RISTEARD Ó MUIREASA
ANDY KELLY	IRISH	AIDNDRIú Ó CEALLAIGH
MICHAEL QUINLIVAN	IRISH	MíCHEáL Ó CAOINNEALBHáIN
ALAN O'SULLIVAN	IRISH	ALAN Ó SúILLEABHáIN
BILLY QUINN	IRISH	LIAM Ó COINN
RUAIRI O'RAHILLY	IRISH	RORY O RAGHELAIGH
SEáN HYDE	IRISH	SEáN DE HÍDE
JOHNNY BUCKLEY	IRISH	SEáN Ó BUACHALLA
JIM BROPHY	IRISH	SéAMUS Ó BRóITHE
PADDY HAYES	IRISH	PáDRAIG Ó HAODHA
DAN MCCARTHY	IRISH	DóNALL MAC CáRTHAIGH
DAN MOYLAN	IRISH	DóNALL Ó MAOILEáIN
MICKEY MURPHY	IRISH	MíCHEáL Ó MURCHú
TONY MANSFIELD	IRISH	ANTAINE MóINBHíOL
CONNIE KELLY	IRISH	CONCHUR Ó CEALLAIGH
ZANE KEENAN	IRISH	ZANE Ó CUINNEACHáIN
SEáN ÓG Ó CIARDUBHáIN	IRISH	SEáN ÓG Ó CIARDUBHáIN
BILL WALSH	IRISH	LIAM BREATHNACH
JOHN MITCHELL	IRISH	SEáN MISTéIL
BARNEY MOYLAN	IRISH	BRIAN Ó MAOILEáIN
JACK HARDING	IRISH	SEáN HAIRDíN
JOHN O'DWYER	IRISH	SEáN Ó DUIBHIR
MATT GILSENAN	IRISH	MAITIú MAC GIOLLA SEANáIN
ODHRáN MAC NIALLAIS	IRISH	ODHRáN MAC NIALLAIS
JERRY CRONIN	IRISH	DIARMUID Ó CRóINíN
DAVID GEANEY	IRISH	DAITHí Ó GEIBHEANNAIGH
DAITHí COONEY	IRISH	DAITHí Ó CUANA
MICK COWAN	IRISH	MíCHEáL Ó COMHAIN
ANDREW O'FLYNN	IRISH	AINDRIú Ó FLOINN
DARREN MCCARTHY	IRISH	DARREN MAC CáRTHAIGH
FIONTáN Ó CURRAOIN	IRISH	FIONTáN Ó CURRAOIN
LESTER RYAN	IRISH	LESTER Ó RIAIN
KEVIN O'BRIEN	IRISH	CAOIMHíN Ó BRIAIN
KIERAN BERGIN	IRISH	CIARáN Ó BEIRGíN
MARTIN HAYES	IRISH	MáIRTíN Ó HAODHA
MICK KENNEDY	IRISH	MíCHEáL Ó CINNéIDE
JIM ROCHE	IRISH	SéAMUS DE RóISTE
WILLIE GALVIN	IRISH	LIAM Ó GEALBHáIN
JOHN CUSACK	IRISH	SEáN CíOSóG
DONAL MONAGHAN	IRISH	DóNALL Ó MUINEACHáIN
JOHNNY HUGHES	IRISH	SEáN Ó HAODHA
CRAIG DOYLE	IRISH	CRéAG Ó DúGHAILL
STEPHEN MAHER	IRISH	STIOFáN Ó MEACHAIR
MATTHEW WHELAN	IRISH	MAITIú Ó FAOILEáIN
SéAMUS HARNEDY	IRISH	SéAMUS Ó HAIRTNéADA
JAMES RYAN	IRISH	SéAMUS Ó RIAIN
PAT HAYDEN	IRISH	PáDRAIG Ó HEIDEáIN
TOMMY RING	IRISH	TOMáS Ó RINN
JOHN HOLOHAN	IRISH	SEáN Ó HUALLACHáIN
STEPHEN WALSH	IRISH	STIOFáN BREATHNACH
JAMES O'DONOGHUE	IRISH	SéAMUS Ó DONNCHú
PAUL MANNION	IRISH	PóL Ó MAINNíN
SéAMUS O'SHEA	IRISH	SéAMUS Ó Sé
BILLY STANTON	IRISH	LIAM STANDúN
GEORGE GARRETT	IRISH	SEOIRSE MAC GEARóID
WILLIAM DORNEY	IRISH	LIAM
ROB O'SHEA	IRISH	ROIBEARD Ó Sé
MARK ELLIS	IRISH	MARC EILíS
STEPHEN MOYLAN	IRISH	STIOFáN
PáDRAIC COLLINS	IRISH	PáDRAIC Ó COILEáIN
KILIAN MURPHY	IRISH	CILLIAN Ó MURCHú
STEPHEN WHITE	IRISH	STIOFáN DE FAOITE
MICHAEL O'SULLIVAN	IRISH	MíCHEáL Ó SúILLEABHáIN
DAVID MCINERNEY	IRISH	DAITHí MAC AN OIRCHINNIGH
CONOR RYAN	IRISH	CONCHúR Ó RIAIN
SHANE O'DONNELL	IRISH	SEáN Ó DóNAILL
DAVID ENGLISH	IRISH	DAVID ENGLISH
DOMHNALL O'DONOVAN	IRISH	DOMHNALL Ó DONNABHáIN
PAUL KINNERK	IRISH	PóL MAC AN AIRCHINNIGH
CONOR COONEY	IRISH	CONOR COONEY
PETER DUGGAN	IRISH	PETER DUGGAN
ALAN BYRNE	IRISH	AILéIN Ó BROIN
TOM CREEDON	IRISH	TOMáS Ó CRíODáIN
PAUL FLANAGAN	IRISH	PóL Ó FLANAGáIN
JACKSON MCGREEVY	IRISH	MAC SIACAIS MAG RIABHAIGH
BRIAN CUTHBERT	IRISH	BRíAN MAC CúIBREITH
DEAN ROCK	IRISH	DéIN MAC CONCHARRAIGE
JONNY COOPER	IRISH	SEáN CúIPéIR
JACK MCCAFFREY	IRISH	SEáN MAC GAFRAIDH
ROB HENNELLY	IRISH	RIOBEARD Ó HIONNAILE
DARREN DALY	IRISH	DáIRE Ó DáLAIGH
ALAN FREEMAN	IRISH	ALAN FREEMAN
TOM CUNNIFFE	IRISH	TOMAS Ó CONDUIBH
CHRIS BARRETT	IRISH	CRISTóIR BAIRéID
DEREK MCGRATH	IRISH	DEREK MAC CRAITH
JOHN CUMMINS	IRISH	SEáN Ó CUIMIN
COLIN WALSHE	IRISH	CóILíN BREATHNACH
ALAN O'CONNOR	IRISH	AILéIN Ó CONCHUBHAIR
WILLIAM MAHER	IRISH	LIAM Ó MEACHAIR
DAN O'SULLIVAN	IRISH	DóNALL Ó SúILLEABHáIN
JAKE DILLON	IRISH	JAKE Ó DIOLúIN
CHARLIE WARE	IRISH	CATHAL MAC AN MHAOIR
ÉAMONN KELLY	IRISH	ÉAMONN KELLY
GERARD MONAN	IRISH	GEARóID MóNáIN
SEáN FARRELL	IRISH	SEáN Ó FEARAIL
MARK KERINS	IRISH	MARC Ó CEIRíN
DIARMUID CLOONAN	IRISH	DIARMUID Ó CLUANáIN
JUSTIN CAMPBELL	IRISH	SAERBHREATHACH MAC CATHMHAOIL
SéAMUS QUALTER	IRISH	SéAMUS MAC UALTAIR
MICHAEL COSGROVE	IRISH	MíCHEáL MAC OSCAIR
KILLIAN COSGROVE	IRISH	KILLIAN MAC OSCAIR
MARTY BARRETT	IRISH	MáIRTíN BAIRéID
JOHN RYAN	IRISH	SEáN Ó RIAIN
LIAM HOGAN	IRISH	LIAM Ó HÓGáIN
DENIS MURPHY	IRISH	DONNCHA Ó MURCHú
LEONARD MCGRATH	IRISH	LIONARD MAC CRAITH
SéAMUS CULLINANE	IRISH	SéAMUS
JIMMY DUGGAN	IRISH	SéAMUS DUAGáIN
DENIS MAHER	IRISH	DENIS Ó MEACHAIR
CONOR KENNY	IRISH	CONCHúIR Ó CIONNAITH
SHANE CARTHY	IRISH	SHANE Ó CARTHAIGH
PADDY MURPHY	IRISH	PáDRIAG Ó MURCHú
PODGE DORAN	IRISH	PADRAIG Ó DEORADHáIN
MáGHNUS BREATHNACH	IRISH	MáGHNUS BREATHNACH
PATRICK LARKIN	IRISH	PáDRAIG Ó LORCáIN
T. J. CONNOLLY	IRISH	T. S. Ó CONGHAILE
PáDRAIG WALSH	IRISH	PáDRAIG BREATHNACH
PAT MCGRATH	IRISH	PáDRAIG MAC CRAITH
JOE FITZPATRICK	IRISH	SEOSAMH MAC GIOLLA PáDRAIG
MICK ROCHFORD	IRISH	MíCHEáL DE ROSFORT
DINNY LANIGAN	IRISH	DONNCHA Ó LONAGáIN
PADDY BARRY	IRISH	PáIDí DE BARRA
TOM MCGRATH	IRISH	TOMáS MAC CRAITH
MICK MULLANE	IRISH	MíCHEáL Ó MAOLáIN
SEAMUS QUAID	IRISH	SéAMUS MAC UAID
JAMES BARRY	IRISH	SéAMUS DE BARRA
JIM GUERIN	IRISH	SéAMUS Ó GéARáIN
CONOR CLASSON	IRISH	CONOR Ó CLASSAIG
JOHN O'DONOVAN	IRISH	SEáN Ó DONNABHáIN
FRANK O'KEEFFE	IRISH	PRIONSIAS Ó CAOIMH
RAY CONNELLAN	IRISH	RéAMONN  Ó COINNIALLáINN
PATRICK MEAGHER	IRISH	PáDRAIG Ó MEACHAIR
GREG HUGHES	IRISH	GRéAGóIR Ó HAODHA
MIKEY LEE	IRISH	MíCHEáL Ó LAOI
ALAN CADOGAN	IRISH	AILéIN Ó CEADAGáIN
DAMIEN CAHALANE	IRISH	DAMIEN Ó CATHALáIN
AUSTIN GLEESON	IRISH	ÁISTíN Ó GLIASáIN
JOE CLARKE	IRISH	SEOSAMH Ó CLéIRCH
BERNARD DEAY	IRISH	BEARNARD Ó DEá
GERRY KEEGAN	IRISH	GAERóID MAC AOGáIN
DES DILLON	IRISH	DEASúN DIOLúN
BOBBY DONOVAN	IRISH	ROIBEáRD Ó DONNABHáIN
LARRY FANNING	IRISH	LABHRáS Ó FAINíN
EOIN KELLY	IRISH	EOIN Ó CEALLAIGH
NED KAVANAGH	IRISH	ÉAMONN CAOMHáNACH
BILLY WALTON	IRISH	LIAM DE BHáLTúN
JIM DONEGAN	IRISH	SéAMUS Ó DONNAGáIN
PETER PRENDERGAST	IRISH	PEADAR DE PRIONDRAGáS
TOM WALTON	IRISH	TOMáS DE BHáLTúN
FRANK WHITE	IRISH	PROINSIAS DE FAOITE
JIMMY KELLY	IRISH	SéAMUS Ó CEALLAIGH
PAUDIE LANNON	IRISH	PáIDí
BILLY PURCELL	IRISH	LIAM PUIRSéIL
DANNY OWENS	IRISH	DONNCHA MAC EOIN
BRENDAN KEESHAN	IRISH	BREANDáN Ó CISEáIN
LIAM CARROLL	IRISH	LIAM Ó CEARúIL
SEáN O'MEARA	IRISH	SEáN Ó MEáRA
MICK KENNEDY	IRISH	MíCHEáL Ó CINNéIDE
NOEL MITCHELL	IRISH	NOLLAIG MISTéIL
MICK COUGHLAN	IRISH	MíCHEáL Ó COCHLAINN
NOEL BERGIN	IRISH	NOLLAIG Ó BEIRGIN
ADRIAN CAHILL	IRISH	ÓDREáIN Ó CATHAIL
GARY CAHILL	IRISH	GARRAí Ó CATHAIL
ROY MANNION	IRISH	RUADH Ó MAINNíN
BRIAN HENNESSY	IRISH	BRIAIN Ó HAONASA
FRANK WHELEHAN	IRISH	PRIONSIAS Ó FAOILEACHáIN
AODH HORAN	IRISH	AODH Ó HÓRáIN
PAT MOYLAN	IRISH	PáDRAIG Ó MAOILEáIN
SEáN MOYLAN	IRISH	SEáN Ó MAOILEáIN
BASIL JOHNSON	IRISH	BREASAL MAC SEáIN
BRIAN LYONS	IRISH	BRIAIN Ó LAIGHIN
HUGH DOLAN	IRISH	AODH Ó DúLáIN
GERRY BURKE	IRISH	GEARóID DE BúRCA
JOE DOOLEY	IRISH	SEOSAMH Ó DúLAOICH
TOM WHITE	IRISH	TOMáS DE FAOITE
SEáN WHITE	IRISH	SEáN DE FAOITE
BILLY KEANE	IRISH	LIAM Ó CATHáIN
DERMOT DEVERY	IRISH	DIARMUID Ó DAIRBHRE
MICK MORRISSEY	IRISH	MíCHEáL Ó MUIREASA
CON DOWDALL	IRISH	CONN DúDAL
PAUL MORRIS	IRISH	PóL Ó MUIRIS
RONAN MAHER	IRISH	RóNáN Ó MEACHAIR
GER AYLWARD	IRISH	GEARóID AIGHLEART
BRIAN KENNEDY	IRISH	BRIAIN Ó CINNéIDE
MARTIN CASEY	IRISH	MáIRTíN Ó CATHASAIGH
JACK RUSSELL	IRISH	SEáN RUISéIL
AIDAN SOMERS	IRISH	AODáN Ó SOMACHáIN
LEE CHIN	IRISH	LEE CHIN
RAY CAWLEY	IRISH	RéAMONN MAC AMHALAí
VINCENT CRONIN	IRISH	UINSEANN Ó CRóINíN
GUS HARRINGTON	IRISH	AGAISTíN Ó HARRACHTáIN
BRENDAN LARKIN	IRISH	BREANDáN Ó LORCáIN
NED COUGHLAN	IRISH	ÉAMONN Ó COCHLAINN
TOMMY BURKE	IRISH	TOMáS DE BúRCA
MICK ARCHER	IRISH	MíCHEáL MAC ARCAIL
DERMOT KEHILLY	IRISH	DIARMUID MAC CAOCHLAOICH
BRIAN HURLEY	IRISH	BRíAN Ó HURTHUILE
JOHN O'ROURKE	IRISH	SEáN Ó RUAIRC
KILLIAN BURKE	IRISH	CILLIAN DE BúRCA
BRIAN LAWTON	IRISH	BRIAIN Ó LACHTNáIN
DES O'GRADY	IRISH	DEASúN Ó GRáDA
MARK FANNING	IRISH	MARC Ó FAINíN
ANDY CREAGH	IRISH	AINDRIú CRAOBHACH
BERNARD HURLEY	IRISH	BEARNARD Ó HURTHUILE
NOEL GALVIN	IRISH	NOLLAIG Ó GEALBHáIN
COLM O'DRISCOLL	IRISH	COLM Ó DRISCEOIL
BRIAN O'DRISCOLL	IRISH	BRíAN Ó DRISCEOIL
RUAIRí DEANE	IRISH	RUAIRí Ó DéIN
DAVID HANRAHAN	IRISH	DAITHí Ó HANRACHáIN
KILLIAN CRONIN	IRISH	CILLIAN Ó CRóINíN
KIERAN MORRISON	IRISH	CIARáN Ó MUIREASáIN
TIM F. HAYES	IRISH	TADHG P. Ó HAODHA
CONOR DORMAN	IRISH	CONCHúR Ó DORNáIN
TOM CLANCY	IRISH	TOMáS MAC LANNCHAIDH
DONAL O'NEILL	IRISH	DóNAL Ó NéILL
DONAL KEOGAN	IRISH	DóNAL Ó CEOGáIN
SHANE WALSH	IRISH	SHEADHNA BREATHNACH
MICHAEL MCCORMACK	IRISH	MíCHEáL MAC CORMAIC
JOHNNY SHEEHAN	IRISH	SEáN Ó SíOCHáIN
IAN LYNAM	IRISH	EOIN Ó LAIGHEANáIN
BRIAN SHEEHAN	IRISH	BRIAIN Ó SíOCHáIN
DAVID QUIRKE	IRISH	DAITHí Ó COIRC
MARK PRENDERGAST	IRISH	MARC DE PRIONDRAGáS
ADRIAN COUGHLAN	IRISH	AODRáN Ó COCHLAINN
BRIAN O'KEEFFE	IRISH	BRIAIN Ó CUíV
AUSTIN WALSH	IRISH	ÁISTíN BREATHNACH
SEáNIE O'FARRELL	IRISH	SEáNIE Ó FEARAIL
BRIAN O'DRISCOLL	IRISH	BRIAIN Ó DRISCEOIL
LIAM MEANEY	IRISH	LIAM Ó MAONAIGH
DARREN RONAN	IRISH	DARIN Ó RóNáIN
JOEY HOLDEN	IRISH	SEOSAMH Ó HOLDáIN
JONJO FARRELL	IRISH	SEáN SEOSAMH Ó FEARAIL
JOHN POWER	IRISH	SEáN DE PAOR
PAUDIE O'NEILL	IRISH	PáIDí Ó NéILL
PADDY RIORDAN	IRISH	PáDRAIG Ó RIORDáN
DAVID BURKE	IRISH	DAITHí DE BúRCA
CORMAC COSTELLO	IRISH	CORMAC MAC COISDEALBHA
TADHG MURPHY	IRISH	TADHG Ó MURCHú
BRENDAN MAHER	IRISH	BREANDáN Ó MEACHAIR
HUGH MCFADDEN	IRISH	HUGH BRADY
MARTIN MCGRATH	IRISH	MáIRTíN MAC CRAITH
JOHN FARRELL	IRISH	SEáN Ó FEARAíL
PAT LENNON	IRISH	PáDRAIG Ó LEANNáIN
PADDY JOHNSTON	IRISH	PáDRAIG MAC SEáIN
MICK SPAIN	IRISH	MíCHEáL DE SPáINN
ANDY DUNWORTH	IRISH	AINDRIú Ó DONNUARTAIGH
BRIAN KELLY	IRISH	BRíAN Ó CEALLAIGH
PAUL GEANEY	IRISH	PóL Ó GéIBHEANNAIGH
STEPHEN O'BRIEN	IRISH	STIOFáIN Ó BRíAIN
FIONN FITZGERALD	IRISH	FIONN MAC GEARAILT
PAUL MURPHY	IRISH	PóL Ó MURCHú
EDDIE BOYLE	IRISH	ÉAMONN Ó BAOILL
MICHAEL GEANEY	IRISH	MíCHEáL Ó GéIBHEANNAIGH
ARRON GRAFFIN	IRISH	ARRON MAC DHUIFINN
EPHIE FITZGERALD	IRISH	EAFRáIM MAC GEARAILT
DAN CURRAMS	IRISH	DóNALL Ó CORRáIM
SéAMUS HEERY	IRISH	SéAMUS Ó HÍORUA
CHRISTO HAND	IRISH	CRIOSTóIR MAG LAITHIMH
MOSSIE FINN	IRISH	MUIRIS Ó FINN
CIARáN MCDONALD	IRISH	CIARáN MAC DóNAILL
BILLY DWYER	IRISH	LIAM Ó DUIBHIR
SHEM DELANEY	IRISH	SéAMUS Ó DúLáINNE
ANDY BUCKLEY	IRISH	ANDRIú Ó BUACHALLA
MICK LANE	IRISH	MíCHEáL  Ó LAIGHIN
JOHN SHEEDY	IRISH	SEáN Ó SíODA
JACK BERGIN	IRISH	SEáN Ó BEIRGIN
DICK DUNPHY	IRISH	RISTEARD Ó DONNCHAIDH
EDDIE DUNPHY	IRISH	ÉAMONN Ó DONNCHAIDH
PATSY FOLEY	IRISH	PADRAIG Ó FOGHLú
PAUL PHELAN	IRISH	PóL Ó FAOILEáIN
JAMES LOGUE	IRISH	SéAMUS Ó LAOGHóG
GER MAGUIRE	IRISH	GEARóID MAG UIDHIR
MATTHEW CONLAN	IRISH	MAITIú Ó CONALLáIN
LIAM DONNELLY	IRISH	LIAM Ó DONNAILE
COLUM CORLESS	IRISH	COLUM MAC CORLUIS
NED QUINN	IRISH	ÉAMONN Ó CUINN
ALFIE CULLEN	IRISH	AILFRID Ó CUILINN
AONGHUS CLARKE	IRISH	AONGHUS Ó CLéIREACH
SéAMUS HEARNE	IRISH	SéAMUS
JIM FLOOD	IRISH	SéAMUS Ó MAOLTUILE
MAURICE FLYNN	IRISH	MUIRIS Ó FLOINN
TOM BRAZILL	IRISH	TOMáS Ó BREASAIL
JOHN CONDON	IRISH	SEáN Ó CONDúN
PATRICK FLYNN	IRISH	PADRAIG Ó FLOINN
JOHN MCGRATH	IRISH	SEáN MAC CRAITH
HAULIE DALY	IRISH	MíCHEáL Ó DáLAIGH
DANNY MCCORMACK	IRISH	DóNALL MAC CORMAIC
HENRY BUTLER	IRISH	ANRAí DE BUITLéIR
PETER HUBAN	IRISH	PEADAR Ó HÚBáIN
TOM WALL	IRISH	TOMáS DE BHáL
DICK ROCHE	IRISH	RISTEARD DE RóISTE
DOM ENRIGHT	IRISH	DOMINIC MAC IONNRACHTAIGH
CORMAC MURPHY	IRISH	CORMAC Ó MURCHú
KEVIN KELLY	IRISH	CAOIMHíN Ó CEALLAIGH
JOE MCLOUGHNEY	IRISH	SEOSAMH MAC LACHTNA
JIM O'BRIEN	IRISH	SéAMUS Ó BRIAIN
PHILLY RYAN	IRISH	PILIB Ó RIAIN
TOM KEVIN	IRISH	TOMáS Ó CAOIMHíN
DAN GRACE	IRISH	DóNALL DE GRáS
MARTIN POWER	IRISH	MáIRTíN DE PAOR
EOIN BRISLANE	IRISH	EOIN Ó BREASLáIN
ALAN BYRNE	IRISH	AILéIN Ó BROIN
BILL HIGGINS	IRISH	LIAM Ó HUIGINN
MAURICE MURPHY	IRISH	MUIRIS Ó MURCHú
JOE KEARNEY	IRISH	SEOSAMH Ó CEARNAIGH
JACK EGAN	IRISH	SEáN MAC AOGáIN
DAVID AHERN	IRISH	DAITHí Ó HEATHíRN
BERTIE MULLINS	IRISH	BEIRCHEART  Ó MAOLáIN
JOHNNY KENNEALLY	IRISH	SEáN Ó CINNAOLAIDH
DONAL MCCARTHY	IRISH	DóMHNALL MAC CARTHAIGH
JOSA LEE	IRISH	SEOSAMH Ó LAOI
DENIS O'RIORDAN	IRISH	DONNCHA Ó RIORDáIN
PAT KING	IRISH	PADRAIG Ó CIONGA
CON MURPHY	IRISH	CONCHUR Ó MURCHú
BERNIE MURPHY	IRISH	BEIRCHEART Ó MURCHú
SéAMUS GILLEN	IRISH	SéAMUS Ó GILíN
TOM KINGSTON	IRISH	TOMáS MAC CLOCHAIRE
NED MCEVOY	IRISH	ÉAMONN MAC FHíOBHUí
JACKIE O'CONNELL	IRISH	SEáN Ó CONAILL
SHANE MCGOVERN	IRISH	SEáN MAG SHAMHRáIN
MICHEáL O'BRIEN	IRISH	MICHEáL Ó BRIAIN
PAT BUCKLEY	IRISH	PADRAIG Ó BUACHALLA
DENIS WALSH	IRISH	DONNCHA BREATHNACH
JOHNNY O'CALLAGHAN	IRISH	SEáNIE Ó CEALLAICHáIN
FRANK O'SULLIVAN	IRISH	PRIONSIAS Ó SúILLEABHáIN
BARRY HENNESSY	IRISH	BARRA Ó HAONGHUSA
CIARáN CLARKE	IRISH	CIARáN Ó CLéIRICH
CIAN LYNCH	IRISH	CIAN Ó LOINGSIGH
PAT HERBERT	IRISH	PADRAIG HOIREABARD
CATHAL MANNION	IRISH	CATHAL Ó MAINNíN
ENDA ROWLAND	IRISH	ÉANNA Ó ROTHLáIN
BENNY GAUGHRAN	IRISH	BRíAN MAC ÉACHRáIN
MURTY KENNEDY	IRISH	MáIRTíN Ó CINNéIDE
IAN BYRNE	IRISH	IAIN Ó BROIN
PADDY COBBE	IRISH	PáDRAIG COBB
JOHN MCDONOGH	IRISH	SEáN MAC DONNCHA
GERRY DOYLE	IRISH	GEARóID Ó DúIL
TOM MORRISSEY	IRISH	TOMáS Ó MUIREASA
CONOR MCDONALD	IRISH	CONCHUR MAC DóMHNAILL
RONAN LYNCH	IRISH	RóNáN Ó LOINGSIGH
ALAN CORCORAN	IRISH	ÁILéIN Ó CORCáIN
JAMES DEMPSEY	IRISH	SéAMUS Ó DíOMSAIGH
MURT CONNOLLY	IRISH	MáIRTíN Ó CONGHAILE
WILLIE O'NEILL	IRISH	LIAM Ó NéILL
GERALD MULCAHY	IRISH	GEARóID Ó MAOLCATHA
CHARLES DWYER	IRISH	CATHAL Ó DUIBHIR
SHANE PRENDERGAST	IRISH	SEáN DE PRIONDRAS
BRENDAN O'SULLIVAN	IRISH	BREANDáN Ó SúILLEABHáIN
SEáN FORAN	IRISH	SEáN Ó FUARáIN
NED WADE	IRISH	ÉAMONN MAC UAID
SYLVESTER MULDOWNEY	IRISH	SAILBHEASTAR Ó MAOLDOMHNAIGH
JACKIE GOOD	IRISH	SEáNIE GUD
MICK HICKEY	IRISH	MíCHEáL Ó HICí
NED CAREW	IRISH	ÉAMONN CARRúN
KEVIN O'CONNOR	IRISH	CAOIMHíN Ó CONCHUBHAIR
EDDIE DALY	IRISH	ÉAMONN Ó DáLAIGH
TOM CURRAN	IRISH	TOMáS Ó CORRáIN
WILL KERWICK	IRISH	LIAM Ó CIARMHAIC
STEPHEN MURPHY	IRISH	STIOFáN Ó MURCHú
KEITH CARMODY	IRISH	CEITEACH Ó CEAMADA
DAVID BUTLER	IRISH	DAITHí DE BUITLéIR
PAUD COSTELLOE	IRISH	PADRAIG Ó COSIDEALBHA
BRYAN MURPHY	IRISH	BRIAIN Ó MURCHú
RORY HORGAN	IRISH	RUAIRí Ó HORGáIN
DANIEL COLLINS	IRISH	DóNALL Ó COILEáIN
SHANE BENNETT	IRISH	SEáN MAC BEINéID
STEPHEN BENNETT	IRISH	STIOFáN MAC BEINéID
TOM DEVINE	IRISH	TOMáS Ó DAIMHIN
PATRICK CURRAN	IRISH	PADRAIG Ó CORRáIN
CONOR WHELAN	IRISH	CONCHúIR Ó FAOLáIN
BRIAN MOLLOY	IRISH	BRíAN Ó MAOLMHUAIDH
RONAN DWANE	IRISH	RóNáN Ó DUáIN
LIAM HAYES	IRISH	LIAM Ó HAODHA
FRANCIS COLLINS	IRISH	PRIONSIAS Ó COILEáIN
MICKEY MULLINS	IRISH	MíCHEáL Ó MAOLáIN
NOLLAIG CLEARY	IRISH	NOLLAIG Ní CHLéIRIGH
DONAL KEENAN	IRISH	DóNALL Ó CIANáIN
SEáN HAYES	IRISH	SEáN Ó HAODHA
PHILLY RYAN	IRISH	PILIB Ó RIAIN
SéAMUS MCCARTHY	IRISH	SéAMUS MAC CáRTHAIGH
JOHN OWENS	IRISH	SEáN Ó HEOGHAIN
COLM O'FLAHERTY	IRISH	COLM Ó FLATHARTA
COLIN O'RIORDAN	IRISH	CóILíN Ó RíORDáIN
EVAN COMERFORD	IRISH	ÉIMHíN MAC CUMASCAIGH
SéAMUS KENNEDY	IRISH	SéAMUS Ó CINNéIDE
JASON LONERGAN	IRISH	IáSóN Ó LONARGáIN
LIAM CASEY	IRISH	LIAM Ó CATHASAIGH
JIMMY FEEHAN	IRISH	SéAMUS Ó FIACHáIN
STEVEN O'BRIEN	IRISH	STíOFáN Ó BRIAN
IAN FAHEY	IRISH	IAIN Ó FATHAIGH
PADDY MORRISSEY	IRISH	PADRAIG Ó MUIREASA
GERRY ENRIGHT	IRISH	GEARóID MAC IONNRACHTAIGH
DAVID WALSH	IRISH	DAITHí BREATHNACH
RICHIE QUIRKE	IRISH	RISTEARD Ó COIRC
FRANK HOWLIN	IRISH	PRIONSIAS HúILíN
MICHAEL GOONAN	IRISH	MíCHEáL Ó GAMHNáIN
JIM O'MEARA	IRISH	SéAMUS Ó MEáRA
TOMMY SHEEHAN	IRISH	TOMáS Ó SíOCHáIN
SEáN BRETT	IRISH	SEáN DE BREIT
DAMIEN BYRNE	IRISH	DAMIEN Ó BROIN
NIALL CURRAN	IRISH	NIALL Ó CORRáIN
PETER KING	IRISH	PEADAR Ó CIONGA
PA MORRISSEY	IRISH	PADRAIG Ó MUIREASA
BRIAN LACEY	IRISH	BRIAIN Ó LAITHEASA
ROBBIE COSTIGAN	IRISH	ROIBEáRD Ó COSTAGáIN
KEVIN MULRYAN	IRISH	CAOIMHíN Ó MAOILRIAIN
NIALL FITZGERALD	IRISH	NIALL MAC GEARAILT
AIDAN FITZGERALD	IRISH	AODáN MAC GEARAILT
BENNY HICKEY	IRISH	BEIRCHEART Ó HICí
BENNY HAHESSY	IRISH	BEIRCHEART Ó HAITHEASA
BRIAN MULVIHILL	IRISH	BRIAIN Ó MAOILMHICHIL
DAMIAN O'BRIEN	IRISH	DAMIAN Ó BRIAIN
ÉAMONN HANRAHAN	IRISH	ÉAMONN Ó HANRACHáIN
JIM HEALY	IRISH	SéAMUS Ó HÉILí
LIAM CRONIN	IRISH	LIAM Ó CRóINíN
MICHAEL PHELAN	IRISH	MíCHEáL Ó FAOILEáIN
TADHG DE BúRCA	IRISH	TADHG DE BúRCA
RICHIE REID	IRISH	RISTEARD Ó MAOILDEIRG
JOE LYNG	IRISH	SEOSAMH Ó LOINN
ROB LENNON	IRISH	RIOBEARD Ó LEANNáIN
DIARMUID CODY	IRISH	DIARMUID MAC ÓDA
JOHN HANBURY	IRISH	SEáN Ó HANMHUIRE
JASON FLYNN	IRISH	IASóN Ó FLOINN
PáDRAIC MANNION	IRISH	PáDRAIC Ó MAINNíN
DAITHí BURKE	IRISH	DAITHí DE BúRCA
PAUL KILLEEN	IRISH	PóL Ó CILLíN
GEARóID MCINERNEY	IRISH	GEARóID MAC AN AIRCHINNIGH
GREG LALLY	IRISH	GREGóIR Ó MAOLALAIDH
JOHN DUFFY	IRISH	SEáN Ó DUFAIGH
BRIAN FENTON	IRISH	BRíAN Ó FIANNACHTA
DARREN MCCORMACK	IRISH	DARRIN MAC CORMAIC
PáDRAIG BREHONY	IRISH	PáDRAIG Ó BREITHIúNAGH
JOHN RYAN	IRISH	SEáN Ó RIAIN
JOHN TWOMEY	IRISH	SEáN Ó TúAMA
JOHN SMALL	IRISH	SEáN Ó CAOILTE
JONATHAN LYNE	IRISH	SEáN Ó LAIGHIN
PEADAR HEALY	IRISH	PEADAR Ó HÉALAITHE
CIARáN CRONIN	IRISH	CIARáN Ó CRONíN
JOHNNY EGAN	IRISH	SEáN MAC AOGáIN
PATRICK CURTIN	IRISH	PADRAIG MAC CURTAIN
GERRY O'MALLEY	IRISH	GEARóID Ó MáILLE
MICK MURPHY	IRISH	MíCHEáL Ó MURCHú
JOHN CONWAY	IRISH	SEAN Ó CONBHUí
PHELIM MURRAY	IRISH	FéILIM Ó MUIRí
PETER QUINN	IRISH	PEADAR Ó CUINN
PADDY MCGILL	IRISH	PADRAIG MAC AN GHAILL
DAN MCCORMACK	IRISH	DóNALL MAC CORMAIC
P. J. SCULLY	IRISH	P. S. Ó SCOLAí
JOHN FITZGIBBON	IRISH	SEáN MAC GIOBúIN
BRIAN SMYTH	IRISH	BRIAN MAC GABHANN
MARTIN FITZGERALD	IRISH	MáIRTíN MAC GIOLLA PHáDRAIG
BOBBY DUGGAN	IRISH	RIOBEARD DUAGáIN
BRENDAN SLOAN	IRISH	BREANDáN Ó SLUáIN
PADDY DIXON	IRISH	PáDRAIG MAC RIOCAIRD
KEVIN MCCONNELL	IRISH	CAOIMHíN MAC DHóNAILL
FRANKIE BYRNE	IRISH	PRIONSIAS Ó BROIN
IAN MAGUIRE	IRISH	IAIN MAG UIDHIR
PETER KELLEHER	IRISH	PEADAR O CéILEACHAIR
STEPHEN CRONIN	IRISH	STIOFáN Ó CRóINíN
BRENDAN LANDERS	IRISH	BREANDáN DE LONDRAS
DARRAGH COEN	IRISH	DARRAGH Ó CADHAIN
WILLIE WALSH	IRISH	LIAM BREATHNACH
AIDEN MCCABE	IRISH	AODáN MAC CáBA
JACK BROWNE	IRISH	SEáN DE BRúN
CONOR CLEARY	IRISH	CONCHUR Ó CLéIRIGH
ARON SHANAGHER	IRISH	ARON Ó SEANACHAIR
DAVID REIDY	IRISH	DAITHí Ó RIADA
NIALL CASHMAN	IRISH	NIALL Ó CíOSáIN
CONOR DOOLEY	IRISH	CONCHUR Ó DúLAOICH
SéAMUS BOURKE	IRISH	SéAMUS DE BúRCA
PAT CRONIN	IRISH	PáDRAIG  CRóINíN
AMBROSE HICKEY	IRISH	AMBRóS Ó HÍCí
MURT CONNOR	IRISH	MUIREARTACH Ó CONCHUBHAIR
SEáN WHITE	IRISH	SEáN DE FAOITE
SEáN POWTER	IRISH	SEáN POTAR
DIARMAID BYRNES	IRISH	BIARMAID Ó BROIN
RORY KINSELLA	IRISH	RUAIRí CINSEALACH
JAMES TOHER	IRISH	SéAMUS Ó TUACHAIR
MICK KINSELLA	IRISH	MíCHEáL CINSEALACH
EMMET NOLAN	IRISH	EIMéID Ó NUALLáIN
MICK FINUCANE	IRISH	MíCHEáL MAC FIONMHACáIN
OISíN KELLY	IRISH	EIMéID Ó NUALLáIN
SHANE KINGSTON	IRISH	SEáN MAC CLOCHAIRE
GARY O'DONNELL	IRISH	GARRAí Ó DOMHNAILL
DAMIEN COMER	IRISH	DAMIEN Ó CIARAGáIN
DANNY CUMMINS	IRISH	DóNAL Ó COIMíN
LIAM SILKE	IRISH	LIAM Ó SIODA
MICHAEL O'DWYER	IRISH	MíCHEáL Ó DUBHUIR
PHILIP AUSTIN	IRISH	PILIB MAC AIBHISTíN
KEVIN O'HALLORAN	IRISH	CAOIMHíN Ó HALLúRáIN
GARY BRENNAN	IRISH	GEARóID Ó BRAONáIN
LIAM BLANCHFIELD	IRISH	LIAM DE BLUINSíN
EDDIE JOHN O'SULLIVAN	IRISH	ÉAMONN SEáN Ó SúILLEABHáIN
DICK BRENNAN	IRISH	RISTEARD Ó BRAONáIN
CONOR O'SHEA	IRISH	CONCHUR Ó Sé
JOHN KIELY	IRISH	SEáN Ó CADHLA
GREG MAHER	IRISH	GRéAGóIR Ó MEACHAIR
JOHN LONG	IRISH	SEáN Ó LONGáIN
MíCHEáL Ó CRóINíN	IRISH	MíCHEáL Ó CRóINíN
DEE O'CONNOR	IRISH	D. Ó CONCHUBHAIR
EDMOND NED HAYES	IRISH	ÉAMONN Ó HAODHA
