LAKE AUSTIN	LAKENAME	LAKE AUSTIN
LAKE UNION	LAKENAME	LAKE UNION
LAKE COMO	LAKENAME	LAKE COMO
PAW PAW LAKE	LAKENAME	PAW PAW LAKE
REELFOOT LAKE	LAKENAME	REELFOOT LAKE
BENNETT LAKE	LAKENAME	BENNETT LAKE
LAKE SCUGOG	LAKENAME	LAKE SCUGOG
KASSHABOG LAKE	LAKENAME	KASSHABOG LAKE
HORNINDALSVATNET	LAKENAME	HORNINDALSVATNET
LAKE VOLTA	LAKENAME	LAKE VOLTA
NARES LAKE	LAKENAME	NARES LAKE
WITTON LAKES	LAKENAME	WITTON LAKES
LAKE OF TWO MOUNTAINS	LAKENAME	LAKE OF TWO MOUNTAINS
AMISTAD RESERVOIR	LAKENAME	AMISTAD RESERVOIR
AMISTAD RESERVOIR	LAKENAME	PRESA AMISTAD
RAJA KA TAL	LAKENAME	RAJA KA TAL
BANKSON LAKE	LAKENAME	BANKSON LAKE
LLYN TRAWSFYNYDD	LAKENAME	LLYN TRAWSFYNYDD
LAKE WALTER E. LONG	LAKENAME	LAKE WALTER E. LONG
ABRAHAM LAKE	LAKENAME	ABRAHAM LAKE
BUSH LAKE	LAKENAME	BUSH LAKE
LOCH LAGGAN	LAKENAME	LOCH LAGGAN
LAKE BäSTETRäSK	LAKENAME	LAKE BäSTETRäSK
MICHIGAMME RIVER	LAKENAME	MICHIGAMME RIVER
GAZIVODA LAKE	LAKENAME	GAZIVODA LAKE
CHILLIWACK LAKE	LAKENAME	CHILLIWACK LAKE
LAKE LAVINE	LAKENAME	LAKE LAVINE
KATCHEWANOOKA LAKE	LAKENAME	KATCHEWANOOKA LAKE
LONG LAKE	LAKENAME	LONG LAKE
MARIE LAKE	LAKENAME	MARIE LAKE
MANN LAKES	LAKENAME	MANN LAKES
MCLEOD LAKE	LAKENAME	MCLEOD LAKE
MIQUELON LAKE	LAKENAME	MIQUELON LAKE
MOORE LAKE	LAKENAME	MOORE LAKE
MOONSHINE LAKE	LAKENAME	MOONSHINE LAKE
MUSREAU LAKE	LAKENAME	MUSREAU LAKE
NAKAMUN LAKE	LAKENAME	NAKAMUN LAKE
NARROW LAKE	LAKENAME	NARROW LAKE
NORTH BUCK LAKE	LAKENAME	NORTH BUCK LAKE
OLIVIA LAKE	LAKENAME	OLIVIA LAKE
PENINSULA LAKE	LAKENAME	PENINSULA LAKE
PINE LAKE	LAKENAME	PINE LAKE
PAYNE LAKE	LAKENAME	PAYNE LAKE
REESOR LAKE	LAKENAME	REESOR LAKE
ROCK LAKE	LAKENAME	ROCK LAKE
SANDY LAKE	LAKENAME	SANDY LAKE
SASKATOON LAKE	LAKENAME	SASKATOON LAKE
SAUER LAKE	LAKENAME	SAUER LAKE
SEIBERT LAKE	LAKENAME	SEIBERT LAKE
SMOKE LAKE	LAKENAME	SMOKE LAKE
SPRAY LAKES RESERVOIR	LAKENAME	SPRAY LAKES RESERVOIR
SPRING LAKE	LAKENAME	SPRING LAKE
ST. MARY RESERVOIR	LAKENAME	ST. MARY RESERVOIR
STEELE LAKE	LAKENAME	STEELE LAKE
THUNDER LAKE	LAKENAME	THUNDER LAKE
TOUCHWOOD LAKE	LAKENAME	TOUCHWOOD LAKE
TRAVERS RESERVOIR	LAKENAME	TRAVERS RESERVOIR
TUCKER LAKE	LAKENAME	TUCKER LAKE
TWIN LAKE	LAKENAME	TWIN LAKE
TYRRELL LAKE	LAKENAME	TYRRELL LAKE
WOLF LAKE	LAKENAME	WOLF LAKE
LAKE VEREVI	LAKENAME	LAKE VEREVI
LAKE VEREVI	LAKENAME	VEREVI JäRV
LOCH SGADABHAGH	LAKENAME	LOCH SGADABHAGH
SPRING HOLLOW RESERVOIR	LAKENAME	SPRING HOLLOW RESERVOIR
CHAGAN LAKE	LAKENAME	CHAGAN LAKE
GRAYS LAKE	LAKENAME	GRAYS LAKE
SAPUNG LAKE	LAKENAME	SAPUNG LAKE
LINDEMAN LAKE	LAKENAME	LINDEMAN LAKE
SHOSHONE LAKE	LAKENAME	SHOSHONE LAKE
LAKE VISAGINAS	LAKENAME	LAKE VISAGINAS
HEART LAKE	LAKENAME	HEART LAKE
LAKE JACOMO	LAKENAME	LAKE JACOMO
SALIM ALI LAKE	LAKENAME	SALIM ALI LAKE
WEST BEARSKIN LAKE	LAKENAME	WEST BEARSKIN LAKE
WEST BEARSKIN LAKE	LAKENAME	BEARSKIN LAKE
WEST BEARSKIN LAKE	LAKENAME	BIRCH LAKE
WILLIAMSON LAKE	LAKENAME	WILLIAMSON LAKE
PITELIS	LAKENAME	PITELIS
LAKE MARMARA	LAKENAME	LAKE MARMARA
ATWOOD LAKE	LAKENAME	ATWOOD LAKE
LEESVILLE LAKE	LAKENAME	LEESVILLE LAKE
GáKKAJáVRI	LAKENAME	GáKKAJáVRI
ALLEN POND PARK	LAKENAME	ALLEN POND
WICKIUP RESERVOIR	LAKENAME	WICKIUP RESERVOIR
MARTHA LAKE	LAKENAME	LAKE MARTHA
BLUE LAKE	LAKENAME	BLUE LAKE
SABKHAT AL-JABBUL	LAKENAME	SABKHAT AL-JABBUL
SABKHAT AL-JABBUL	LAKENAME	سبخة الجبول
LAKE SABRINA	LAKENAME	LAKE SABRINA
PATRICIA LAKE	LAKENAME	PATRICIA LAKE / LAKE PATRICIA
TBILISI SEA	LAKENAME	TBILISI LAKE
AAPAJäRVI	LAKENAME	AAPAJäRVI
ENIJäRVI	LAKENAME	ENIJäRVI
ENäJäRVI	LAKENAME	ENäJäRVI
LAKE HAAPAJäRVI	LAKENAME	LAKE HAAPAJäRVI
HANKAVESI	LAKENAME	HANKAVESI
ÄKäSJäRVI	LAKENAME	ÄKäSJäRVI
HAUHONSELKä	LAKENAME	HAUHONSELKä
HIRVIJäRVI RESERVOIR	LAKENAME	HIRVIJäRVI RESERVOIR
KARHIJäRVI	LAKENAME	KARHIJäRVI
KAAVINJäRVI	LAKENAME	KAAVINJäRVI
KUOHIJäRVI	LAKENAME	KUOHIJäRVI
KUUSAMOJäRVI	LAKENAME	KUUSAMOJäRVI
NäLäNTöJäRVI	LAKENAME	NäLäNTöJäRVI
MUURASJäRVI	LAKENAME	MUURASJäRVI
MUURUEJäRVI	LAKENAME	MUURUEJäRVI
NUORAMOISJäRVI	LAKENAME	NUORAMOISJäRVI
PäLKäNEVESI	LAKENAME	PäLKäNEVESI
RIKKAVESI	LAKENAME	RIKKAVESI
RUTAJäRVI	LAKENAME	RUTAJäRVI
LAKE DOMBAY	LAKENAME	LAKE DOMBAY
LAKE DéLLő	LAKENAME	LAKE DéLLő
LAKE DESEDA	LAKENAME	DESEDA
LAKE GARANCSI	LAKENAME	LAKE GARANCSI
LAKE GőTéS	LAKENAME	LAKE GőTéS
LAKE FEHéR	LAKENAME	LAKE FEHéR
LAKE NAPLáS	LAKENAME	LAKE NAPLáS
LAKE PéCS	LAKENAME	LAKE PéCS
LAKE PALATINUS	LAKENAME	LAKE PALATINUS
LAKE SáRKáNY	LAKENAME	LAKE SáRKáNY
LAKE ÖREG	LAKENAME	LAKE ÖREG
JUMBLES RESERVOIR	LAKENAME	JUMBLES RESERVOIR
BIRCH LAKE	LAKENAME	BIRCH LAKE
LAC SANTE	LAKENAME	LAC SANTE
BLACK LAKES	LAKENAME	BLACK LAKES
WAYOH RESERVOIR	LAKENAME	WAYOH RESERVOIR
TURTON AND ENTWISTLE RESERVOIR	LAKENAME	TURTON AND ENTWISTLE RESERVOIR
BELMONT RESERVOIR	LAKENAME	BELMONT RESERVOIR
LAKE AMTKELI	LAKENAME	LAKE AMTKELI
LAKE AMTKELI	LAKENAME	Амтҟьал
LAKE AMTKELI	LAKENAME	ამტყელის ტბა
LAKE AMTKELI	LAKENAME	Амткел
RUMWORTH LODGE RESERVOIR	LAKENAME	RUMWORTH LODGE RESERVOIR
DINGLE RESERVOIR	LAKENAME	DINGLE RESERVOIR
WATER RESOURCES MANAGEMENT IN NICARAGUA	LAKENAME	LAKE NICARAGUA
LAKE MUTANDA	LAKENAME	LAKE MUTANDA
GORTON RESERVOIRS	LAKENAME	GORTON RESERVOIRS
DODGE RESERVOIR	LAKENAME	DODGE RESERVOIR
LOCKE LAKE	LAKENAME	LOCKE LAKE
STICKLE TARN, LANGDALE	LAKENAME	STICKLE TARN
LAKE DEM	LAKENAME	LAKE DEM
MARE D'OURSI	LAKENAME	MARE D'OURSI
LAKE CARROLL	LAKENAME	LAKE CARROLL
LAKE LORNE	LAKENAME	LAKE LORNE
LITTLE PARA RESERVOIR	LAKENAME	SOUTH PARA RESERVOIR
LAKE MUHAZI	LAKENAME	LAKE MUHAZI
POWDERMILL RESERVOIR	LAKENAME	POWDERMILL RESERVOIR
CHANDOS LAKE	LAKENAME	CHANDOS LAKE
LAKE HIGA	LAKENAME	LAKE HIGA
MURTNAGHURT LAGOON	LAKENAME	MURTNAGHURT LAGOON
CHELKER RESERVOIR	LAKENAME	CHELKER RESERVOIR
LOíZA LAKE	LAKENAME	LAGO LOíZA
BASSIN ROND	LAKENAME	BASSIN ROND
LAKE HARNEY	LAKENAME	LAKE HARNEY
LAKE OF CUTILIA	LAKENAME	LAKE OF CUTILIA
SINGANALLUR LAKE	LAKENAME	SINGANALLUR LAKE
LAKE TōGō	LAKENAME	LAKE TōGō
LAKE TōGō	LAKENAME	東郷池
LAKE MUNSON	LAKENAME	LAKE MUNSON
BORAX LAKE	LAKENAME	BORAX LAKE
LAKE MING	LAKENAME	LAKE MING
CHUB LAKE	LAKENAME	CHUB LAKE
LAKE THOMPSON	LAKENAME	LAKE THOMPSON
SPRING POND, MASSACHUSETTS	LAKENAME	SPRING POND, MASSACHUSETTS
POISON POND	LAKENAME	POISON POND
ANGOSTURA RESERVOIR	LAKENAME	ANGOSTURA RESERVOIR
SHADEHILL RESERVOIR	LAKENAME	SHADEHILL RESERVOIR
STANDLEY LAKE	LAKENAME	STANDLEY LAKE
LLYN LLYFFANT	LAKENAME	LLYN LLYFFANT
STAUNTON HAROLD RESERVOIR	LAKENAME	STAUNTON HAROLD RESERVOIR
LAKE PFLUGERVILLE	LAKENAME	LAKE PFLUGERVILLE
KAPCHAGAY RESERVOIR	LAKENAME	KAPCHAGAY RESERVOIR
LAKE KUNUNURRA	LAKENAME	LAKE KUNUNURRA
JOHN HENDRY PARK	LAKENAME	JOHN HENDRY PARK
ELMER THOMAS LAKE	LAKENAME	ELMER THOMAS LAKE
LAKE CERRILLOS	LAKENAME	LAGO CERRILLOS
LAKE PLASTIRAS	LAKENAME	LAKE PLASTIRAS
LAKE PLASTIRAS	LAKENAME	Τ. Λίμνη Πλαστήρα
LAKE ALBINA	LAKENAME	LAKE ALBINA
LAKE OF THE LONE INDIAN	LAKENAME	LAKE OF THE LONE INDIAN
POTRERO DE LOS FUNES DAM	LAKENAME	POTRERO DE LOS FUNES
SHADOW LAKE	LAKENAME	SHADOW LAKE
UPPER STILLWATER RESERVOIR	LAKENAME	UPPER STILLWATER RESERVOIR
UPPER REDWATER LAKE	LAKENAME	UPPER REDWATER LAKE
PERUćAC LAKE	LAKENAME	PERUćAC LAKE
MARTON MERE LOCAL NATURE RESERVE	LAKENAME	MARTON MERE
GOKYO LAKES	LAKENAME	GOKYO LAKES
RATHBUN LAKE	LAKENAME	RATHBUN LAKE
SLEZSKá HARTA DAM	LAKENAME	SLEZSKá HARTA DAM
MOON LAKE	LAKENAME	MOON LAKE
LAKE BYRON	LAKENAME	LAKE BYRON
LAKE CHALA	LAKENAME	LAKE CHALA
NORTH FORK POUND RESERVOIR	LAKENAME	NORTH FORK OF POUND LAKE
HOPE MILLS LAKE	LAKENAME	HOPE MILLS LAKE
WIENERWALDSEE	LAKENAME	WIENERWALDSEE
LAG PRAU PULTé	LAKENAME	LAG PRAU PULTé
NúI CốC LAKE	LAKENAME	NúI CốC LAKE
ĐịNH BìNH LAKE	LAKENAME	ĐịNH BìNH LAKE
LAKE SAPSHO	LAKENAME	LAKE SAPSHO
CONNORS LAKE	LAKENAME	CONNORS LAKE
LAKE SURPRISE	LAKENAME	LAKE SURPRISE
LYON LAKE	LAKENAME	LYON LAKE
TETAPAGA LAKE	LAKENAME	TETAPAGA LAKE
CURTIS LAKE	LAKENAME	CURTIS LAKE
LAKE IKAZN	LAKENAME	LAKE IKAZN
LAKE RABISHA	LAKENAME	LAKE RABISHA
WESTONS MILL POND	LAKENAME	WESTONS MILL POND
VOMBSJöN	LAKENAME	VOMBSJöN
TASERSUAQ	LAKENAME	TASERSUAQ
LOCH VOIL	LAKENAME	LOCH VOIL
LAKE JEFFERSON	LAKENAME	LAKE JEFFERSON
LAKE ELIZABETH	LAKENAME	LAKE ELIZABETH
CEDAR LAKE	LAKENAME	CEDAR LAKE
LAKE ABITA	LAKENAME	LAKE ABITA
ALDER LAKE	LAKENAME	ALDER LAKE
CANONSBURG LAKE	LAKENAME	CANONSBURG LAKE
EDWARD MEDARD PARK AND RESERVOIR	LAKENAME	EDWARD MEDARD RESERVOIR
ZAINSK RESERVOIR	LAKENAME	ZAINSK RESERVOIR, ZAY RESERVOIR
LLYN NANTLLE UCHAF	LAKENAME	LLYN NANTLLE UCHAF
LAITAURE	LAKENAME	LAITAURE
HIGH RID RESERVOIR	LAKENAME	HIGH RID RESERVOIR
CRYSTAL LAKE	LAKENAME	CRYSTAL LAKE
HEATON PARK RESERVOIR	LAKENAME	HEATON PARK RESERVOIR
BLACK MOSS RESERVOIRS	LAKENAME	UPPER AND LOWER BLACK MOSS RESERVOIRS
THORVALDSON LAKE	LAKENAME	THORVALDSON LAKE
OGDEN RESERVOIRS	LAKENAME	UPPER AND LOWER OGDEN RESERVOIRS
CALF HEY RESERVOIR	LAKENAME	CALF HEY RESERVOIR
MEANDER CREEK RESERVOIR	LAKENAME	MEANDER CREEK RESERVOIR
IRO LAKE	LAKENAME	LAKE IRO
LéRé LAKE	LAKENAME	LAKE LéRé
TIXALL WIDE	LAKENAME	TIXALL WIDE
PAUNKüLA RESERVOIR	LAKENAME	PAUNKüLA RESERVOIR
SOODLA RESERVOIR	LAKENAME	SOODLA RESERVOIR
VEISJäRV	LAKENAME	VEISJäRV
KARUJäRV	LAKENAME	KARUJäRV
LAKE KUREMAA	LAKENAME	LAKE KUREMAA
LAKE KUREMAA	LAKENAME	KUREMAA JäRV
LAKE ENDLA	LAKENAME	LAKE ENDLA
LAKE KAHALA	LAKENAME	LAKE KAHALA
LAKE KAIAVERE	LAKENAME	LAKE KAIAVERE
SUTLEPA SEA	LAKENAME	SUTLEPA MERI
LAKE KOOSA	LAKENAME	LAKE KOOSA
LAKE RAKU	LAKENAME	LAKE RAKU
LAKE AGALI	LAKENAME	LAKE AGALI
UNDU BAY	LAKENAME	UNDU BAY
LAKE VAGULA	LAKENAME	LAKE VAGULA
ADRISKA	LAKENAME	ADRISKA
AASTEJäRV	LAKENAME	AASTEJäRV
LAKE HINO	LAKENAME	LAKE HINO
LAKE TõHELA	LAKENAME	LAKE TõHELA
LAKE TõHELA	LAKENAME	TõHELA JäRV
LAKE AKSTE	LAKENAME	AKSTE
LAKE AHERU	LAKENAME	LAKE AHERU
LAKE ERMISTU	LAKENAME	LAKE ERMISTU
LAKE ERMISTU	LAKENAME	ERMISTU JäRV
AKNAJäRV	LAKENAME	AKNAJäRV
LAKE ALATSKIVI	LAKENAME	LAKE ALATSKIVI
AHVENAJäRV	LAKENAME	AHVENAJäRV
LAKE KALLI	LAKENAME	LAKE KALLI
LAKE LAVASSAARE	LAKENAME	LAKE LAVASSAARE
LAKE ÕISU	LAKENAME	LAKE ÕISU
ÄHIJäRV	LAKENAME	ÄHIJäRV
HILBA	LAKENAME	HILBA
HAANJA KõVERJäRV	LAKENAME	HAANJA KõVERJäRV
LAKE TAMULA	LAKENAME	LAKE TAMULA
LAKE TAMULA	LAKENAME	TAMULA JäRV
ARUJäRV	LAKENAME	ARUJäRV
LAKE AUKSI	LAKENAME	AUKSI
LAKE ERASTVERE	LAKENAME	LAKE ERASTVERE
LAKE AALUPI	LAKENAME	AALUPI
ENGLI	LAKENAME	ENGLI
LAKE ARBI	LAKENAME	LAKE ARBI
LAKE ARBI	LAKENAME	ARBI JäRV
HOLVANDI KIVIJäRV	LAKENAME	HOLVANDI KIVIJäRV
ILLI LAKES	LAKENAME	ILLI LAKES
JäNUKJäRV	LAKENAME	JäNUKJäRV
LAKE JäRVEMäE	LAKENAME	LAKE JäRVEMäE
LAKE HüüDRE	LAKENAME	HüüDRE
LAKE IMATU	LAKENAME	LAKE IMATU
LAKE JäRVEPää	LAKENAME	JäRVEPää
LAKE JAALA	LAKENAME	LAKE JAALA
KAJUMERI	LAKENAME	KAJUMERI
KALIJäRV	LAKENAME	KALIJäRV
JõKSI	LAKENAME	JõKSI
LAKE KAHRILA	LAKENAME	LAKE KAHRILA
KANARIKU	LAKENAME	KANARIKU
KARJATSE MERI	LAKENAME	KARJATSE MERI
KäRNJäRV	LAKENAME	KäRNJäRV
KARSNA	LAKENAME	KARSNA
LAKE KAURU	LAKENAME	LAKE KAURU
KASARITSA VERIJäRV	LAKENAME	KASARITSA VERIJäRV
KASTJäRV	LAKENAME	KASTJäRV
KARIJäRV	LAKENAME	KARIJäRV
KIKKAJäRV	LAKENAME	KIKKAJäRV
KIIDJäRV	LAKENAME	KIIDJäRV
KEERI	LAKENAME	KEERI
KISEJäRV	LAKENAME	KISEJäRV
LAKE KAVADI	LAKENAME	LAKE KAVADI
KõNNU PIKKJäRV	LAKENAME	KõNNU PIKKJäRV
LAKE KäSMU	LAKENAME	LAKE KäSMU
LAKE KIRIKUMäE	LAKENAME	LAKE KIRIKUMäE
LAKE KONSU	LAKENAME	KONSU JäRV
LAKE KLOOGA	LAKENAME	LAKE KLOOGA
KOSE VALGJäRV	LAKENAME	KOSE VALGJäRV
KURGJäRV	LAKENAME	KURGJäRV
LAKE KüTI	LAKENAME	LAKE KüTI
LAHOJäRV	LAKENAME	LAHOJäRV
LAKE KUBIJA	LAKENAME	KUBIJA
LEEVAKU PAISJäRV	LAKENAME	LEEVAKU PAISJäRV
LõõDLA	LAKENAME	LõõDLA
LAKE LASVA	LAKENAME	LAKE LASVA
LAKE LEIGO	LAKENAME	LEIGO
LüüBNITSA UMBJäRV	LAKENAME	LüüBNITSA UMBJäRV
LAKE LOHJA	LAKENAME	LAKE LOHJA
MAKSAMERI	LAKENAME	MAKSAMERI
MEHIKOORMA UMBJäRV	LAKENAME	MEHIKOORMA UMBJäRV
LAKE MõRTSUKA	LAKENAME	MõRTSUKA
LAKE MäNNIKU	LAKENAME	LAKE MäNNIKU
LAKE LOOSU	LAKENAME	LOOSU
MöLDRI MERI	LAKENAME	MöLDRI MERI
NOOTJäRV	LAKENAME	NOOTJäRV
PABRA	LAKENAME	PABRA
NOODASJäRV	LAKENAME	NOODASJäRV
LAKE NüPLI	LAKENAME	NüPLI
LAKE MEELVA	LAKENAME	LAKE MEELVA
NEITSIJäRV	LAKENAME	NEITSIJäRV
PALOJüRI	LAKENAME	PALOJüRI
PAIDE TEHISJäRV	LAKENAME	PAIDE TEHISJäRV
LAKE PAIDRA	LAKENAME	PAIDRA
PANNJäRV	LAKENAME	PANNJäRV
LAKE MURATI	LAKENAME	LAKE MURATI
NIINSAARE	LAKENAME	NIINSAARE
LAKE MAARDU	LAKENAME	LAKE MAARDU
LAKE MAARDU	LAKENAME	MAARDU JäRV
PAPPJäRV	LAKENAME	PAPPJäRV
PAUKJäRV	LAKENAME	PAUKJäRV
PIIRAKAJäRV	LAKENAME	PIIRAKAJäRV
PILLEJäRV	LAKENAME	PILLEJäRV
PESUJäRV	LAKENAME	JõUGA PESUJäRV
PLAANI KüLAJäRV	LAKENAME	PLAANI KüLAJäRV
PõRMUJäRV	LAKENAME	PõRMUJäRV
RääTSMA	LAKENAME	RääTSMA
PROSSA	LAKENAME	PROSSA
RääKJäRV	LAKENAME	RääKJäRV
LAKE RATVA	LAKENAME	LAKE RATVA
LAKE RAIGASTVERE	LAKENAME	RAIGASTVERE
LAKE RAADI	LAKENAME	LAKE RAADI
RõUGE VALGJäRV	LAKENAME	RõUGE VALGJäRV
SELGJäRV	LAKENAME	SELGJäRV
RõUGE LIINJäRV	LAKENAME	RõUGE LIINJäRV
LAKE PORKUNI	LAKENAME	LAKE PORKUNI
RäPINA PAISJäRV	LAKENAME	RäPINA PAISJäRV
SOITSJäRV	LAKENAME	SOITSJäRV
SNELLI TIIK	LAKENAME	SNELLI TIIK
PULLIJäRV	LAKENAME	PULLIJäRV
SUUR PEHMEJäRV	LAKENAME	SUUR PEHMEJäRV
LAKE TABINA	LAKENAME	LAKE TABINA
RõUGE SUURJäRV	LAKENAME	RõUGE SUURJäRV
RATASJäRV	LAKENAME	RATASJäRV
SõMERPALU PAISJäRV	LAKENAME	SõMERPALU PAISJäRV
LAKE TOOMA	LAKENAME	LAKE TOOMA
UHTJäRV	LAKENAME	UHTJäRV
UBAJäRV	LAKENAME	UBAJäRV
LAKE TIHU	LAKENAME	LAKE TIHU
ÜVARJäRV	LAKENAME	ÜVARJäRV
VäINJäRV	LAKENAME	VäINJäRV
LAKE TUDU	LAKENAME	LAKE TUDU
VASKNA	LAKENAME	VASKNA
VAIKNE	LAKENAME	VAIKNE
VäIMELA MäEJäRV	LAKENAME	VäIMELA MäEJäRV
LAKE ULJASTE	LAKENAME	LAKE ULJASTE
VäIMELA ALAJäRV	LAKENAME	VäIMELA ALAJäRV
LAKE VANAMõISA	LAKENAME	LAKE VANAMõISA
VööLAMERI	LAKENAME	VööLAMERI
VõNGJäRV	LAKENAME	VõNGJäRV
VIITINA ALAJäRV	LAKENAME	VIITINA ALAJäRV
LAKE VISSI	LAKENAME	LAKE VISSI
VIITNA PIKKJäRV	LAKENAME	VIITNA PIKKJäRV
GREENDROP LAKE	LAKENAME	GREENDROP LAKE
RUTH RESERVOIR	LAKENAME	RUTH RESERVOIR
MASAZIRGOL	LAKENAME	MASAZIRGOL
BOYUK ALAGOL	LAKENAME	BOYUK ALAGOL
ORTO-TOKOY RESERVOIR	LAKENAME	ORTO-TOKOY RESERVOIR
JAGDISHPUR RESERVOIR	LAKENAME	JAGDISHPUR RESERVOIR
BISHAZARI TAL	LAKENAME	BISHAZARI TAL
GHODAGHODI TAL	LAKENAME	GHODAGHODI TAL
OTTER LAKE	LAKENAME	OTTER LAKE
LAKE EUGENIA	LAKENAME	LAKE EUGENIA
MARY LAKE	LAKENAME	MARY LAKE
LAKE AMADOR	LAKENAME	LAKE AMADOR
RANCHO SECO RECREATIONAL PARK	LAKENAME	RANCHO SECO LAKE
ØYVATNET	LAKENAME	ØYVATNET
ALMADEN RESERVOIR	LAKENAME	ALMADEN RESERVOIR
CALERO RESERVOIR	LAKENAME	CALERO RESERVOIR
TIMBER LAKE	LAKENAME	TIMBER LAKE
LAKE HENNESSEY	LAKENAME	LAKE HENNESSEY
ÅRESJöN	LAKENAME	ÅRESJöN
PETREL LAKE	LAKENAME	LAGUNA PETREL
LAKE TIROTO	LAKENAME	LAKE TIROTO
ARCOS RESERVOIR	LAKENAME	ARCOS RESERVOIR
ALMODóVAR RESERVOIR	LAKENAME	ALMODóVAR RESERVOIR
BORNOS RESERVOIR	LAKENAME	BORNOS RESERVOIR
BARBATE RESERVOIR	LAKENAME	BARBATE RESERVOIR
CELEMíN RESERVOIR	LAKENAME	CELEMíN RESERVOIR
EMBALSE DE GUADALCACíN	LAKENAME	EMBALSE DE GUADALCACíN
LOS HURONES RESERVOIR	LAKENAME	LOS HURONES RESERVOIR
ZAHARA-EL GASTOR RESERVOIR	LAKENAME	ZAHARA-EL GASTOR RESERVOIR
CHARCO REDONDO RESERVOIR	LAKENAME	CHARCO REDONDO RESERVOIR
BENíNAR RESERVOIR	LAKENAME	BENíNAR RESERVOIR
GUADARRANQUE RESERVOIR	LAKENAME	GUADARRANQUE RESERVOIR
CUEVAS DEL ALMANZORA RESERVOIR	LAKENAME	CUEVAS DEL ALMANZORA RESERVOIR
ARENóS RESERVOIR	LAKENAME	ARENóS RESERVOIR
BEMBéZAR RESERVOIR	LAKENAME	BEMBéZAR RESERVOIR
GUADALMELLATO RESERVOIR	LAKENAME	GUADALMELLATO RESERVOIR
IZNAJAR RESERVOIR	LAKENAME	IZNAJAR RESERVOIR
GUADANUñO RESERVOIR	LAKENAME	GUADANUñO RESERVOIR
LA BREñA RESERVOIR	LAKENAME	LA BREñA RESERVOIR
MARTíN GONZALO RESERVOIR	LAKENAME	MARTíN GONZALO RESERVOIR
PUENTE NUEVO RESERVOIR	LAKENAME	PUENTE NUEVO RESERVOIR
RETORTILLO RESERVOIR	LAKENAME	RETORTILLO RESERVOIR
LITTLE YIRKIE LAKE	LAKENAME	LITTLE YIRKIE LAKE
SAN RAFAEL DE NAVALLANA RESERVOIR	LAKENAME	SAN RAFAEL DE NAVALLANA RESERVOIR
YEGUAS RESERVOIR	LAKENAME	YEGUAS RESERVOIR
SIERRA BOYERA RESERVOIR	LAKENAME	SIERRA BOYERA RESERVOIR
CANALES RESERVOIR	LAKENAME	CANALES RESERVOIR
COLOMERA RESERVOIR	LAKENAME	COLOMERA RESERVOIR
CUBILLAS RESERVOIR	LAKENAME	CUBILLAS RESERVOIR
EL PORTILLO RESERVOIR	LAKENAME	EL PORTILLO RESERVOIR
FRANCISCO ABELLáN RESERVOIR	LAKENAME	FRANCISCO ABELLáN RESERVOIR
LOS BERMEJALES RESERVOIR	LAKENAME	LOS BERMEJALES RESERVOIR
QUéNTAR RESERVOIR	LAKENAME	QUéNTAR RESERVOIR
SAN CLEMENTE RESERVOIR	LAKENAME	SAN CLEMENTE RESERVOIR
RULES RESERVOIR	LAKENAME	RULES RESERVOIR
NEGRATíN RESERVOIR	LAKENAME	NEGRATíN RESERVOIR
BéZNAR RESERVOIR	LAKENAME	BéZNAR RESERVOIR
LAGUNA HONDA RESERVOIR	LAKENAME	LAGUNA HONDA RESERVOIR
LAKE KRASNOYE	LAKENAME	LAKE KRASNOYE
LAKE KRASNOYE	LAKENAME	Красное
LAKE PARKER	LAKENAME	PARKER POND
LAKE PARKER	LAKENAME	LAKE PARKER
CRACKER LAKE	LAKENAME	CRACKER LAKE
LAKE ZABUYE	LAKENAME	ZABUYE LAKE
LAKE VAN ARSDALE	LAKENAME	LAKE VAN ARSDALE
JOHNSON LAKE	LAKENAME	JOHNSON LAKE
LAKE HANCOCK	LAKENAME	LAKE HANCOCK
LAKE HOLLINGSWORTH	LAKENAME	LAKE HOLLINGSWORTH
CROOKED LAKE, FLORIDA	LAKENAME	CROOKED LAKE
LAKE BLUE RIDGE	LAKENAME	LAKE BLUE RIDGE
NYDALASJöN	LAKENAME	NYDALASJöN
QUARTZ LAKE	LAKENAME	QUARTZ LAKE
BRUSDALSVATNET	LAKENAME	BRUSDALSVATNET
DURGAM CHERUVU	LAKENAME	DURGAM CHERUVU
LAKE SELINA	LAKENAME	LAKE SELINA
LAKE WESTWOOD	LAKENAME	LAKE WESTWOOD
LAKE AğGöL	LAKENAME	LAKE AğGöL
NORTH BEND LAKE	LAKENAME	NORTH BEND LAKE
PARKINSONS LAKE	LAKENAME	PARKINSONS LAKE
LAKE ROTOTOA	LAKENAME	LAKE ROTOTOA
LAKE KERETA	LAKENAME	LAKE KERETA
GANGA CHHU	LAKENAME	GANGA CHHU
SHAMKIR RESERVOIR	LAKENAME	SHAMKIR RESERVOIR
IMJA TSHO	LAKENAME	IMJA TSHO
LAKE KEZENOYAM	LAKENAME	LAKE KEZENOY-AM
AGSTAFACHAY RESERVOIR	LAKENAME	AGSTAFACHAY RESERVOIR
KHANBULANCHAY RESERVOIR	LAKENAME	KHANBULANCHAY RESERVOIR
YENIKEND RESERVOIR	LAKENAME	YENIKEND RESERVOIR
DOG BONE LAKE	LAKENAME	DOG BONE LAKE
ASPEN LAKE	LAKENAME	ASPEN LAKE
JEYRANBATAN RESERVOIR	LAKENAME	JEYRANBATAN RESERVOIR
KUHURLUY	LAKENAME	KUHURLUY
LAKE SILS, CATALONIA	LAKENAME	SILS LAKE
LAKE SILS, CATALONIA	LAKENAME	ESTANY DE SILS
SLEEPY HOLLOW LAKE, GREENE COUNTY, NEW YORK	LAKENAME	SLEEPY HOLLOW LAKE
POTATO LAKE	LAKENAME	POTATO LAKE
MOSS ECCLES TARN	LAKENAME	MOSS ECCLES TARN
SAROORNAGAR LAKE	LAKENAME	SAROORNAGAR LAKE
DAUNIšKIS	LAKENAME	DAUNIšKIS
BALDWIN LAKE	LAKENAME	BALDWIN LAKE
LAKE EMILY	LAKENAME	LAKE EMILY
ĶīšEZERS, RIGA	LAKENAME	ĶīšEZERS
CHARD RESERVOIR	LAKENAME	CHARD RESERVOIR
HAWKRIDGE RESERVOIR	LAKENAME	HAWKRIDGE RESERVOIR
KHADZHIBEY ESTUARY	LAKENAME	KHADZHIBEY ESTUARY
SUTTON BINGHAM RESERVOIR	LAKENAME	SUTTON BINGHAM RESERVOIR
OTTERHEAD LAKES	LAKENAME	OTTERHEAD LAKES
LAKE BURTON	LAKENAME	LAKE BURTON
LAKE BURTON	LAKENAME	BURTON LAGOON
WILLIAMS LAKE	LAKENAME	WILLIAMS LAKE
AZURE LAKE	LAKENAME	AZURE LAKE
HOBSON LAKE	LAKENAME	HOBSON  LAKE
ANGUS HORNE LAKE	LAKENAME	ANGUS HORNE LAKE
MURTLE LAKE	LAKENAME	MURTLE LAKE
BROCK RESERVOIR	LAKENAME	BROCK RESERVOIR
TWIN LAKES	LAKENAME	TWIN LAKES
KIRKJUVATN	LAKENAME	KIRKJUVATN
LAKE LILLINONAH	LAKENAME	LAKE LILLINONAH
LAKE STRUSTA	LAKENAME	STRUSTA
QARGHA RESERVOIR	LAKENAME	QARGHA RESERVOIR
QARGHA RESERVOIR	LAKENAME	BAND QARGHAI
QARGHA RESERVOIR	LAKENAME	LAKE QARGHA
LAC DE TRACOUET	LAKENAME	LAC DE TRACOUET
LAC DE TRACOUET	LAKENAME	(LAC NOIR)
PIPMUACAN RESERVOIR	LAKENAME	PIPMUACAN RESERVOIR
LAKE NAMAKAGON	LAKENAME	LAKE NAMAKAGON
WłOCłAWEK RESERVOIR	LAKENAME	WłOCłAWEK RESERVOIR
DNIEPER-BUG ESTUARY	LAKENAME	DNIEPER-BUG ESTUARY
LENA LAKE	LAKENAME	LENA LAKE
EPULAFQUéN LAKE	LAKENAME	EPULAFQUéN LAKE
KUYALNIK ESTUARY	LAKENAME	KUYALNIK ESTUARY
LAKE ENGOLASTERS	LAKENAME	LAKE ENGOLASTERS
XINFENGJIANG RESERVOIR	LAKENAME	XINFENGJIANG RESERVOIR
BUG ESTUARY	LAKENAME	BUG ESTUARY
LYGNERN	LAKENAME	LYGNERN
THREE BEARS LAKE	LAKENAME	THREE BEARS LAKE
GREEN LAKE	LAKENAME	GREEN LAKE
LOWER TWO MEDICINE LAKE	LAKENAME	LOWER TWO MEDICINE LAKE
BRENNSEE	LAKENAME	BRENNSEE
AFRITZER SEE	LAKENAME	AFRITZER SEE
AFRITZER SEE	LAKENAME	LAKE AFRITZ
LANGBATHSEEN	LAKENAME	VORDERER LANGBATHSEE
LANGBATHSEEN	LAKENAME	HINTERER LANGBATHSEE
EGELSEE	LAKENAME	EGELSEE
KLEINSEE	LAKENAME	KLEINSEE
GöSSELSDORFER SEE	LAKENAME	GöSSELDORFER SEE
LAKE PRESSEGG	LAKENAME	LAKE PRESSEGG
SILBERSEE	LAKENAME	SILBERSEE
STAPPITZER SEE	LAKENAME	STAPPITZER SEE
LAKE TURNER	LAKENAME	LAKE TURNER
HARRISVILLE POND	LAKENAME	HARRISVILLE POND
COBALT LAKE	LAKENAME	COBALT LAKE
UPPER TWO MEDICINE LAKE	LAKENAME	UPPER TWO MEDICINE LAKE
NO NAME LAKE	LAKENAME	NO NAME LAKE
PRAY LAKE	LAKENAME	PRAY LAKE
TWO MEDICINE LAKE	LAKENAME	TWO MEDICINE LAKE
LONG LAKE	LAKENAME	LONG LAKE
ELLIS LAKE	LAKENAME	ELLIS LAKE
LONG LAKE	LAKENAME	LONG LAKE
LONG LAKE	LAKENAME	LONG LAKE
LONG LAKE	LAKENAME	LONG LAKE
DNIEPER ESTUARY	LAKENAME	DNIEPER ESTUARY
VěSTONICE RESERVOIR	LAKENAME	VěSTONICE RESERVOIR
STORDALSVATNET	LAKENAME	STORDALSVATNET
CRANE PRAIRIE RESERVOIR	LAKENAME	CRANE PRAIRIE RESERVOIR
BOY LAKE	LAKENAME	BOY LAKE
YOUNG MAN LAKE	LAKENAME	YOUNG MAN LAKE
OLDMAN LAKE	LAKENAME	OLDMAN LAKE
PITAMAKAN LAKE	LAKENAME	PITAMAKAN LAKE
LAKE OF THE SEVEN WINDS	LAKENAME	LAKE OF THE SEVEN WINDS
KATOYA LAKE	LAKENAME	KATOYA LAKE
RUNNING CRANE LAKE	LAKENAME	RUNNING CRANE LAKE
MORNING STAR LAKE	LAKENAME	MORNING STAR LAKE
LONELY LAKES	LAKENAME	LONELY LAKES
MEDICINE GRIZZLY LAKE	LAKENAME	MEDICINE GRIZZLY LAKE
GUNSIGHT LAKE	LAKENAME	GUNSIGHT LAKE
LAKE NGAROTO	LAKENAME	LAKE NGAROTO
RESCOBIE LOCH	LAKENAME	RESCOBIE LOCH
BOEUNG KAK	LAKENAME	BOEUNG KAK LAKE
TICHA RESERVOIR	LAKENAME	TICHA RESERVOIR
BAKER LAKE	LAKENAME	BAKER LAKE
LAKE TIKUB	LAKENAME	LAKE TIKUB
LAKE HINDMARSH	LAKENAME	LAKE HINDMARSH
SWEETWATER RESERVOIR	LAKENAME	SWEETWATER RESERVOIR
TWIN LAKES	LAKENAME	TWIN LAKES
RED EAGLE LAKE	LAKENAME	RED EAGLE LAKE
MEDICINE OWL LAKE	LAKENAME	MEDICINE OWL LAKE
GOAT LAKE	LAKENAME	GOAT LAKE
OTOKOMI LAKE	LAKENAME	OTOKOMI LAKE
CRACKER LAKE	LAKENAME	CRACKER LAKE
LAKE JOSEPHINE	LAKENAME	LAKE JOSEPHINE
UPPER GRINNELL LAKE	LAKENAME	UPPER GRINNELL LAKE
POIA LAKE	LAKENAME	POIA LAKE
KENNEDY LAKE	LAKENAME	KENNEDY LAKE
TINEMAHA RESERVOIR	LAKENAME	TINEMAHA RESERVOIR
WINDMAKER LAKE	LAKENAME	WINDMAKER LAKE
FISHERCAP LAKE	LAKENAME	FISHERCAP LAKE
REDROCK LAKE	LAKENAME	REDROCK LAKE
ICEBERG LAKE	LAKENAME	ICEBERG LAKE
KAKISA LAKE	LAKENAME	KAKISA LAKE
TATHLINA LAKE	LAKENAME	TATHLINA LAKE
NONACHO LAKE	LAKENAME	NONACHO LAKE
LAKE ROTOKARE	LAKENAME	LAKE ROTOKARE
IPASHA LAKE	LAKENAME	IPASHA LAKE
HELEN LAKE	LAKENAME	HELEN LAKE
PTARMIGAN LAKE	LAKENAME	PTARMIGAN LAKE
NATAHKI LAKE	LAKENAME	NATAHKI LAKE
SUE LAKE	LAKENAME	SUE LAKE
MARGARET LAKE	LAKENAME	MARGARET LAKE
MOKOWANIS LAKE	LAKENAME	MOKOWANIS LAKE
ATSINA LAKE	LAKENAME	ATSINA LAKE
ELIZABETH LAKE	LAKENAME	ELIZABETH LAKE
BEAVERLODGE LAKE	LAKENAME	BEAVERLODGE LAKE
OTATSO LAKE	LAKENAME	OTATSO LAKE
SLIDE LAKE	LAKENAME	SLIDE LAKE
MARTIN LAKE	LAKENAME	MARTIN LAKE
BUFFALO LAKE	LAKENAME	BUFFALO LAKE
BLACKWATER LAKE	LAKENAME	BLACKWATER LAKE
HOWARD LAKE	LAKENAME	HOWARD LAKE
FIREDRAKE LAKE	LAKENAME	FIREDRAKE LAKE
LAC BELOT	LAKENAME	LAC BELOT
BOYD LAKE	LAKENAME	BOYD LAKE
LYNX LAKE	LAKENAME	LYNX LAKE
MOSQUITO LAKE	LAKENAME	MOSQUITO LAKE
MINSTER POOL	LAKENAME	MINSTER POOL
BAALENSEE	LAKENAME	BAALENSEE
STONEY INDIAN LAKE	LAKENAME	STONEY INDIAN LAKE
NAHSUKIN LAKE	LAKENAME	NAHSUKIN LAKE
HATCHET LAKE	LAKENAME	HATCHET LAKE
BENCH LAKE	LAKENAME	BENCH LAKE
GLENNS LAKE	LAKENAME	GLENNS LAKE
WHITECROW LAKE	LAKENAME	WHITECROW LAKE
KAINA LAKE	LAKENAME	KAINA LAKE
KOOTENAI LAKES	LAKENAME	KOOTENAI LAKES
REDHORN LAKE	LAKENAME	REDHORN LAKE
COSLEY LAKE	LAKENAME	COSLEY LAKE
MICHE WABUN LAKE	LAKENAME	MICHE WABUN LAKE
GOAT HAUNT LAKE	LAKENAME	GOAT HAUNT LAKE
LAKE JANET	LAKENAME	LAKE JANET
SHAHEEYA LAKE	LAKENAME	SHAHEEYA LAKE
LAKE FRANCES	LAKENAME	LAKE FRANCES
WAHSEEJA LAKE	LAKENAME	WAHSEEJA LAKE
CARCAJOU LAKE	LAKENAME	CARCAJOU LAKE
LAKE WURDEMAN	LAKENAME	LAKE WURDEMAN
FALLING LEAF LAKE	LAKENAME	FALLING LEAF LAKE
LAKE NOONEY	LAKENAME	LAKE NOONEY
SNOW MOON LAKE	LAKENAME	SNOW MOON LAKE
LAKE OKU	LAKENAME	LAKE OKU
NANTAHALA LAKE	LAKENAME	NANTAHALA LAKE
OXFORD LAKE	LAKENAME	OXFORD LAKE
LITTLE LANGDALE	LAKENAME	BLEA TARN
LITTLE LANGDALE	LAKENAME	LITTLE LANGDALE TARN
TUNSTALL RESERVOIR	LAKENAME	TUNSTALL RESERVOIR
WASKERLEY RESERVOIR	LAKENAME	WASKERLEY RESERVOIR
SMIDDY SHAW RESERVOIR	LAKENAME	SMIDDY SHAW RESERVOIR
HISEHOPE RESERVOIR	LAKENAME	HISEHOPE RESERVOIR
LAKE WAY	LAKENAME	LAKE WAY
LAKE MAITLAND	LAKENAME	LAKE MAITLAND
MILLE LACS LAKE	LAKENAME	MILLE LACS LAKE
101 MILE LAKE	LAKENAME	101
103 MILE LAKE	LAKENAME	103
105 MILE LAKE	LAKENAME	105
THE LOE	LAKENAME	THE LOE
BLUE RIVER RESERVOIR	LAKENAME	BLUE RIVER RESERVOIR
AMPERVEILSEE	LAKENAME	AMPERVEILSEE
DANJIANGKOU RESERVOIR	LAKENAME	DANJIANGKOU RESERVOIR
SWIMMING RIVER RESERVOIR	LAKENAME	SWIMMING RIVER RESERVOIR
JACKSTRAW LAKE	LAKENAME	JACKSTRAW LAKE
STRIPED ELK LAKE	LAKENAME	STRIPED ELK LAKE
LAKE ISABEL	LAKENAME	LAKE ISABEL
AURICE LAKE	LAKENAME	AURICE LAKE
BUFFALO WOMAN LAKE	LAKENAME	BUFFALO WOMAN LAKE
BEAVER WOMAN LAKE	LAKENAME	BEAVER WOMAN LAKE
HARRISON LAKE	LAKENAME	HARRISON LAKE
LAKE ELLEN WILSON	LAKENAME	LAKE ELLEN WILSON
LINCOLN LAKE	LAKENAME	LINCOLN LAKE
STONE CANYON RESERVOIR	LAKENAME	STONE CANYON RESERVOIR
AVALANCHE LAKE	LAKENAME	AVALANCHE LAKE
UPPER SNYDER LAKE	LAKENAME	UPPER SNYDER LAKE
SNYDER LAKE	LAKENAME	SNYDER LAKE
GEM LAKE	LAKENAME	GEM LAKE
AKAIYAN LAKE	LAKENAME	AKAIYAN LAKE
FEATHER WOMAN LAKE	LAKENAME	FEATHER WOMAN LAKE
HIDDEN LAKE	LAKENAME	HIDDEN LAKE
HIDDEN LAKE WINERY	LAKENAME	HIDDEN LAKE
LAKE VARAžDIN	LAKENAME	LAKE VARAžDIN
LAKE VARAžDIN	LAKENAME	VARAžDINSKO JEZERO
FREDETTE LAKE	LAKENAME	FREDETTE LAKE
LAKE DUBRAVA	LAKENAME	LAKE DUBRAVA
LAKE DUBRAVA	LAKENAME	DUBRAVSKO JEZERO
ARROW LAKE	LAKENAME	ARROW LAKE
LAKE EVANGELINE	LAKENAME	LAKE EVANGELINE
RUGER LAKE	LAKENAME	RUGER LAKE
CAMAS LAKE	LAKENAME	CAMAS LAKE
ROGERS LAKE	LAKENAME	ROGERS LAKE
TROUT LAKE	LAKENAME	TROUT LAKE
LOGGING LAKE	LAKENAME	LOGGING LAKE
CUCAO AND HUILLINCO	LAKENAME	CUCAO AND HUILLICNO LAKE
CUCAO AND HUILLINCO	LAKENAME	LAGO CUCAO Y HUILLINCO
LAKE SONFON	LAKENAME	LAKE TORISIM
LAKE SONFON	LAKENAME	LAKE CONFON
LAKE TE PARITU	LAKENAME	LAKE TE PARITU
LAKE TE PARITU	LAKENAME	BLACK LAKE
LAKE AROAROTAMAHINE	LAKENAME	LAKE AROAROTAMAHINE
LAKE AROAROTAMAHINE	LAKENAME	GREEN LAKE
GREEN LAKE	LAKENAME	GREEN LAKE
GYRFALCON LAKE	LAKENAME	GYRFALCON LAKE
LOWER QUARTZ LAKE	LAKENAME	LOWER QUARTZ LAKE
MIDDLE QUARTZ LAKE	LAKENAME	MIDDLE QUARTZ LAKE
QUARTZ LAKE	LAKENAME	QUARTZ LAKE
CERULEAN LAKE	LAKENAME	CERULEAN LAKE
BULRUSH LAKE	LAKENAME	BULRUSH LAKE
LUXHAY RESERVOIR	LAKENAME	LUXHAY RESERVOIR
WINONA LAKE	LAKENAME	WINONA LAKE
UPPER KINTLA LAKE	LAKENAME	UPPER KINTLA LAKE
PATIENCE LAKE	LAKENAME	PATIENCE LAKE
CHEVIOT LAKE	LAKENAME	PATIENCE LAKE
BLACKSTRAP LAKE	LAKENAME	BLACKSTRAP LAKE
INDI LAKE	LAKENAME	INDI LAKE
BEAR GULCH RESERVOIR	LAKENAME	BEAR GULCH RESERVOIR
SJöSMYRSJöN	LAKENAME	SJöSMYRSJöN
RUSH LAKE	LAKENAME	RUSH LAKE
BLAE LOCH, BEITH	LAKENAME	BLAE LOCH
PANTHER POND	LAKENAME	PANTHER POND
WEDGEMOUNT LAKE	LAKENAME	WEDGEMOUNT LAKE
GRAND SABLE LAKE	LAKENAME	GRAND SABLE LAKE
OTSEGO LAKE	LAKENAME	OTSEGO LAKE
 ATA PUAI	LAKENAME	ALPINE LAKE / ATA PUAI
LAKE BRIDGEPORT	LAKENAME	BRIDGEPORT LAKE
CHAMCOOK LAKE	LAKENAME	CHAMCOOK LAKE
FORGGENSEE	LAKENAME	FORGGENSEE
COUNTRYSIDE LAKE	LAKENAME	COUNTRYSIDE LAKE
STITHIANS RESERVOIR	LAKENAME	STITHIANS RESERVOIR
LONG LAKE	LAKENAME	LONG LAKE
GALRIGS LOCH, AYRSHIRE	LAKENAME	GALRIGS LOCH
ÅNGARDSVATNET	LAKENAME	ÅNGARDSVATNET
CLEVENS LOCH, AYRSHIRE	LAKENAME	CLEVENS LOCH
MARIDALSVANNET	LAKENAME	MARIDALSVANNET
SKJæRSJøEN	LAKENAME	SKJæRSJøEN
SOUTH MANISTIQUE LAKE	LAKENAME	SOUTH MANISTIQUE LAKE
LAKE ESRUM	LAKENAME	ESRUM Sø
LAKE CHAFFEE	LAKENAME	LAKE CHAFFEE
OSTROWSKIE LAKE	LAKENAME	OSTROWSKIE LAKE
KAKAGI LAKE	LAKENAME	KAKAGI LAKE
WALDSEA LAKE	LAKENAME	WALDSEA LAKE
LAKE BERMIN	LAKENAME	LAKE BERMIN
LAKE EJAGHAM	LAKENAME	LAKE EJAGHAM
MASCARDI LAKE	LAKENAME	MASCARDI LAKE
MADUM LAKE	LAKENAME	MADUM LAKE
LAKE CLAIBORNE	LAKENAME	LAKE CLAIBORNE
GRüNER SEE	LAKENAME	GRüNER SEE
LAKE AYAKUM	LAKENAME	AYAKE KUMUHU LAKE, AYAKUM LAKE
LOCH OF STAIR	LAKENAME	LOCH OF STAIR
AYAMARU LAKES	LAKENAME	AYAMARU LAKES
WHITE BEAR LAKE	LAKENAME	WHITE BEAR LAKE LAKE
SMALL PRESPA LAKE	LAKENAME	SMALL PRESPA LAKE
PANIAI LAKES	LAKENAME	LAKE PANIAI
GIBBS LAKE	LAKENAME	GIBBS LAKE
PAPAKOMEKA LAKE	LAKENAME	PAPAKOMEKA LAKE
ANDERSON LAKE	LAKENAME	ANDERSON LAKE
CANTON LAKE	LAKENAME	CANTON LAKE
FRENTRESS LAKE	LAKENAME	FRENTRESS LAKE
LAKE LYOKSHMOZERO	LAKENAME	LAKE LYOKSHMOZERO
LAKE LYOKSHMOZERO	LAKENAME	Лёкшмозеро
LAKE HILLCREST	LAKENAME	LAKE HILLCREST
MAPANUEPE LAKE	LAKENAME	MAPANUEPE LAKE
LAANECOORIE WEIR	LAKENAME	LAANECOORIE RESERVOIR
LAKE CACHí	LAKENAME	'''LAKE CACHI
LAKE CACHí	LAKENAME	REPRESA DE CACH
LOCH ETCHACHAN	LAKENAME	LOCH ETCHACHAN
GOYDER LAGOON	LAKENAME	GOYDER LAGOON
GRASSI LAKES	LAKENAME	GRASSI LAKES
GRAVELLY LAKE	LAKENAME	GRAVELLY LAKE
CHIPPING NORTON LAKE	LAKENAME	CHIPPING NORTON LAKE
GADLOCH	LAKENAME	GADLOCH
LAKE OF THE CLOUDS	LAKENAME	LAKE OF THE CLOUDS
LAKE BASAKA	LAKENAME	LAKE BASAKA
BULLHEAD LAKE	LAKENAME	BULLHEAD LAKE
LAKE RACHAEL	LAKENAME	LAKE RACHAEL
LAKE KENOZERO	LAKENAME	LAKE KENOZERO
LAKE KENOZERO	LAKENAME	Кенозеро
BALKANA LAKE	LAKENAME	BALKANA
LAKE UNDOZERO	LAKENAME	LAKE UNDOZERO
LAKE UNDOZERO	LAKENAME	Ундозеро
BILEćA LAKE	LAKENAME	BILEćA LAKE
HRAST LAKE	LAKENAME	HRAST
LOCHEND LOCH, COYLTON	LAKENAME	LOCHEND LOCH
LAC DU VERNEY	LAKENAME	LAC DU VERNEY
LOCH NA KEAL	LAKENAME	LOCH NA KEAL
LOCH SCRIDAIN	LAKENAME	LOCH SCRIDAIN
ALSASK LAKE	LAKENAME	ALSASK LAKE
CABRI LAKE	LAKENAME	CABRI LAKE
LAKE YAMMA YAMMA	LAKENAME	LAKE YAMMA YAMMA
CRESCENT LAKE	LAKENAME	BRENT BAYOU LAKES
ENA LAKE	LAKENAME	ENA LAKE
MILTON LAKE	LAKENAME	MILTON LAKE
CEDAR LAKE	LAKENAME	CEDAR LAKE
PETIT LAC SAINT-FRANçOIS	LAKENAME	PETIT LAC SAINT-FRANçOIS
EASTMAIN RESERVOIR	LAKENAME	EASTMAIN RESERVOIR
BUTCHERS LAKE	LAKENAME	BUTCHERS LAKE
DAVIS LAKE	LAKENAME	DAVIS LAKE
LAKE RESCUE	LAKENAME	LAKE RESCUE
LAKE VARSH	LAKENAME	LAKE VARSH
LAKE VARSH	LAKENAME	Озеро Варш
BIG CEDAR LAKE	LAKENAME	BIG CEDAR LAKE
EGLINTON LOCH	LAKENAME	EGLINTON LOCH
MENINDEE LAKES	LAKENAME	MENINDEE LAKES
LAKE KOZHOZERO	LAKENAME	LAKE KOZHOZERO
LAKE KOZHOZERO	LAKENAME	Кожозеро
JUNIPERS RESERVOIR	LAKENAME	JUNIPERS RESERVOIR
BAINBRIDGE LAKE	LAKENAME	BAINBRIDGE LAKE
COX LAKE	LAKENAME	COX LAKE
LAKE TATAWAI	LAKENAME	LAKE TATAWAI
ESARY LAKE	LAKENAME	ESARY LAKE
HORNE LAKE	LAKENAME	HORNE LAKE
LACY LAKE	LAKENAME	LACY LAKE
LOON LAKE	LAKENAME	LOON LAKE
MARSHY LAKE	LAKENAME	MARSHY LAKE
MCCOY LAKE	LAKENAME	MCCOY LAKE
LOWES LOCH	LAKENAME	LOWES LOCH OR THE LOCHS
SPIDER LAKE	LAKENAME	SPIDER LAKE
SUMMIT LAKE	LAKENAME	SUMMIT LAKE
BEAUFORT LAKE	LAKENAME	BEAUFORT LAKE
DICKSON LAKE	LAKENAME	DICKSON LAKE
ELSIE LAKE	LAKENAME	ELSIE LAKE
OSHINOW LAKE	LAKENAME	OSHINOW LAKE
ASH LAKE	LAKENAME	ASH LAKE
LOWRY LAKE	LAKENAME	LOWRY LAKE
MORAN LAKE	LAKENAME	MORAN LAKE
PAVIKEN	LAKENAME	PAVIKEN
PEAR LAKE	LAKENAME	PEAR LAKE
NIMNIM LAKE	LAKENAME	NIMNIM LAKE
CAPES LAKE	LAKENAME	CAPES LAKE
GRINDSTONE LAKE	LAKENAME	GRINDSTONE LAKE
LAKE RAWA PENING	LAKENAME	RAWA PENING
TURNBULL LAKE	LAKENAME	TURNBULL LAKE
JUNIOR LAKE	LAKENAME	JUNIOR LAKE
LONG LAKE	LAKENAME	LONG LAKE
LOIS LAKE	LAKENAME	LOIS LAKE
NAHMINT LAKE	LAKENAME	NAHMINT LAKE
GRACIE LAKE	LAKENAME	GRACIE LAKE
TURTLE LAKE	LAKENAME	TURTLE LAKE
FATHER AND SON LAKE	LAKENAME	FATHER AND SON LAKE LAKE
CASS LAKE	LAKENAME	CASSLAKE
LAKE BILL WALLER	LAKENAME	LAKE BILL WALLER
KILDONAN LAKE	LAKENAME	KILDONAN LAKE
UCHUCK LAKE	LAKENAME	UCHUCK LAKE
SKULL LAKE	LAKENAME	SKULL LAKE
AMEDROZ LAKE	LAKENAME	AMEDROZ LAKE
HELEN LAKE	LAKENAME	HELEN LAKE
MIRROR LAKE	LAKENAME	MIRROR LAKE
PöYRYSJäRVI	LAKENAME	PöYRYSJäRVI
LENGLINGEN	LAKENAME	LENGLINGEN
ANGUS LAKE	LAKENAME	ANGUS LAKE
ANDERSON LAKE	LAKENAME	ANDERSON LAKE
WAGNER LAKES	LAKENAME	WAGNER LAKES
ILTHPAYA LAKE	LAKENAME	ILTHPAYA LAKE
MACALLAN LAKE	LAKENAME	MACALLAN LAKE
BRIGADE LAKE	LAKENAME	BRIGADE LAKE
SURPRISE LAKE	LAKENAME	SURPRISE LAKE
EFFINGHAM LAKE	LAKENAME	EFFINGHAM LAKE
ANGORA LAKE	LAKENAME	ANGORA LAKE
WANETTA LAKE	LAKENAME	WANETTA LAKE
MURIEL LAKE	LAKENAME	MURIEL LAKE
LADUE RESERVOIR	LAKENAME	LADUE RESERVOIR
LINDSTON LOCH, SOUTH AYRSHIRE	LAKENAME	LINDSTON LOCH
LITTLE CULTUS LAKE	LAKENAME	LITTLE CULTUS LAKE
FORDS LAKE	LAKENAME	FORDS LAKE
LADY LAKE	LAKENAME	LADY LAKE
CARCLUIE LOCH	LAKENAME	CARCLUIE LOCH
PANTHER LAKE	LAKENAME	PANTHER LAKE
VIEW LAKE	LAKENAME	VIEW LAKE
MERCS LAKE	LAKENAME	MERCS LAKE
FOURTH LAKE	LAKENAME	FOURTH LAKE
LIZARD POND	LAKENAME	LIZARD POND
FORBUSH LAKE	LAKENAME	FORBUSH LAKE
HAWTHORN LAKE	LAKENAME	HAWTHORN LAKE
FRANCIS LAKE	LAKENAME	FRANCIS LAKE
ARROWSMITH LAKE	LAKENAME	ARROWSMITH LAKE
DARLINGTON LAKE	LAKENAME	DARLINGTON LAKE
TSABLE LAKE	LAKENAME	TSABLE LAKE
FISHTAIL LAKE	LAKENAME	FISHTAIL LAKE
PEAK LAKE	LAKENAME	PEAK LAKE
HIDDEN LAKE	LAKENAME	HIDDEN LAKE
ROWBOTHAM LAKE	LAKENAME	ROWBOTHAM LAKE
SOMERS LAKE	LAKENAME	SOMERS LAKE
KERSE LOCH	LAKENAME	KERSE LOCH
PATERSON LAKE	LAKENAME	PATERSON LAKE
MARBLEROCK LAKE	LAKENAME	MARBLEROCK  LAKE
MARSH MARIGOLD LAKE	LAKENAME	MARSH MARIGOLD LAKE
FAITH LAKE	LAKENAME	FAITH LAKE
ARUM LAKE	LAKENAME	ARUM LAKE
KIM LAKE	LAKENAME	KIM LAKE
POUM LAKE	LAKENAME	POUM LAKE
SILVER SNAG LAKE	LAKENAME	SILVER SNAG LAKE
JUNE LAKE	LAKENAME	JUNE LAKE
DUCK LAKE	LAKENAME	DUCK LAKE
TOY LAKE	LAKENAME	TOY LAKE
SILVER LAKE	LAKENAME	SILVER LAKE
GLOBE FLOWER LAKE	LAKENAME	GLOBE FLOWER LAKE
GREIG LAKE	LAKENAME	GREIG LAKE
HELLEBORE LAKE	LAKENAME	HELLEBORE LAKE
SARITA LAKE	LAKENAME	SARITA LAKE
BEWLAY LAKE	LAKENAME	BEWLAY LAKE
BIG PLATTE LAKE	LAKENAME	PLATTE LAKE
CONSINKA LAKE	LAKENAME	CONSINKA LAKE
MAY LAKE	LAKENAME	MAY LAKE
JACK SHARK LAKE	LAKENAME	JACK SHARK LAKE
LIMESTONE LAKE	LAKENAME	LIMESTONE LAKE
HENRY LAKE	LAKENAME	HENRY LAKE
CARTER LAKE	LAKENAME	CARTER LAKE
WHEATON LAKE	LAKENAME	WHEATON LAKE
RALPH LAKE	LAKENAME	RALPH LAKE
PEARL LAKE	LAKENAME	PEARL LAKE
KAMMAT LAKE	LAKENAME	KAMMATLAKE
MENOKEN LAKE	LAKENAME	MENOKEN LAKE OR NORTH TOPEKA OXBOW LAKE
GOVIND BALLABH PANT SAGAR	LAKENAME	GOVIND VALLABH PANT SAGAR
ST. MARY LAKE	LAKENAME	ST. MARY LAKE
DOFINIVKA ESTUARY	LAKENAME	GREAT ADZHALYK ESTUARY
EGå ENGSø	LAKENAME	EGå ENGSø
GEM LAKE	LAKENAME	GEM LAKE
LIZARD LAKE	LAKENAME	LIZARD LAKE
CHARITY LAKE	LAKENAME	CHARITY LAKE
AMPHITHEATRE LAKE	LAKENAME	AMPHITHEATRELAKE
AVALANCHE LAKE, OOTY	LAKENAME	AVALANCHE LAKE
EMERALD LAKE, OOTY	LAKENAME	EMERALD LAKE
NORM LAKE	LAKENAME	NORM LAKE
BALL LAKE	LAKENAME	BALL LAKE
CIRCLET LAKE	LAKENAME	CIRCLET LAKE
SUNRISE LAKE	LAKENAME	SUNRISE LAKE
CROTEAU LAKE	LAKENAME	CROTEAU LAKE
DIVERS LAKE	LAKENAME	DIVERS LAKE
WILLIAMS FORK RESERVOIR	LAKENAME	WILLIAMS FORK RESERVOIR
SEAGULL LAKE	LAKENAME	SEAGULL LAKE
JOHN BROWN LAKE	LAKENAME	JOHN BROWN LAKE
LAKE BLANCHE	LAKENAME	LAKE BLANCHE
BATTLESHIP LAKE	LAKENAME	BATTLESHIP LAKE
MARIWOOD LAKE	LAKENAME	MARIWOOD LAKE
TOMAHAWK LAKE	LAKENAME	TOMAHAWK LAKE
OTTER LAKE	LAKENAME	OTTER LAKE
LAKE BEAUTIFUL	LAKENAME	LAKE BEAUTIFUL
BREWSTER LAKE	LAKENAME	BREWSTER LAKE
AMOR LAKE	LAKENAME	AMOR LAKE
LAKE HELEN MACKENZIE	LAKENAME	LAKE HELEN MACKENZIE
GANGABAL LAKE	LAKENAME	GANGBAL LAKE
DARWAN LAKE	LAKENAME	DARVAN LAKE
BööN TSAGAAN LAKE	LAKENAME	BööN TSAGAAN LAKE
LAKE JOE	LAKENAME	LAKE JOE OR EAST OAKWOOD DRIVE LAKE
HEALY LAKE	LAKENAME	HEALY LAKE
SHELTON LAKE	LAKENAME	SHELTON LAKE
ASTON RESERVOIR	LAKENAME	ASTON RESERVOIR
RHODODENDRON LAKE	LAKENAME	RHODODENDRON LAKE
BOOMER LAKE	LAKENAME	BOOMER LAKE
LITTLE RED WATER LAKE	LAKENAME	LITTLE RED WATER LAKE
LACUL MORII	LAKENAME	LACUL MORII
ZHARI NAMCO	LAKENAME	ZHARI NAMCO
TANGRA YUMCO	LAKENAME	TANGRA YUMCO
LAKE DâMBOVIțA	LAKENAME	LAKE DâMBOVIțA
LAKE LETTA	LAKENAME	LAKE LETTA
WARD LAKE	LAKENAME	WARD LAKE
LAKE OF THE WOODS	LAKENAME	LAKE OF THE WOODS
ROUND LAKE	LAKENAME	ROUND LAKE
TARAGO RESERVOIR	LAKENAME	TARAGO RESERVOIR
JäRLASJöN	LAKENAME	JäRLASJöN
HOLMTRäSKET	LAKENAME	HOLMTRäSKET
HALLBOSJöN	LAKENAME	HALLBOSJöN
GRINDSJöN	LAKENAME	GRINDSJöN
GöLAN	LAKENAME	GöLAN
FRöSJöN	LAKENAME	FRöSJöN
FLEMINGSBERGSVIKEN	LAKENAME	FLEMINGSBERGSVIKEN
GETAREN	LAKENAME	GETAREN
DUVEHOLMSSJöN	LAKENAME	DUVEHOLMSSJöN
KAGGHAMRAåNS SJöSYSTEM	LAKENAME	KAGGHAMRAåNS SJöSYSTEM
KLäMMINGEN	LAKENAME	KLäMMINGEN
KäRRSJöN	LAKENAME	KäRRSJöN
DAMMTORPSSJöN	LAKENAME	DAMMTORPSSJöN
BORNSJöN	LAKENAME	BORNSJöN
KVARNSJöN, GLADö	LAKENAME	KVARNSJöN
BåVEN	LAKENAME	BåVEN
LOCKVATTNET	LAKENAME	LOCKVATTNET
LISSMASJöN	LAKENAME	LISSMASJöN
AXAREN	LAKENAME	AXAREN
LåNGHALSEN	LAKENAME	LåNGHALSEN
ÄLLMORA TRäSK	LAKENAME	ÄLLMORA TRäSK
LUVSJöN	LAKENAME	LUVSJöN
LYCKSJöN	LAKENAME	LYCKSJöN
NATEN	LAKENAME	NATEN
MALMSJöN	LAKENAME	MALMSJöN
LåNGSJöN, HANVEDEN	LAKENAME	LåNGSJöN
ORRHAMMAREN	LAKENAME	ORRHAMMAREN
RAMSJöN, HANINGE KOMMUN	LAKENAME	RAMSJöN
RUDTRäSKET	LAKENAME	RUDTRäSKET
NäVSJöN	LAKENAME	NäVSJöN
SALTSKOGSFJäRDEN	LAKENAME	SALTSKOGSFJäRDEN
SVARTSJöN, HANVEDEN	LAKENAME	SVARTSJöN
STORA SKOGSSJöN	LAKENAME	STORA SKOGSSJöN
TREHöRNINGEN, HANVEDEN	LAKENAME	TREHöRNINGEN
STENSJöN, TYRESTA	LAKENAME	STENSJöN
TREHöRNINGEN, TYRESTA	LAKENAME	TREHöRNINGEN
TORNBERGSSJöN	LAKENAME	TORNBERGSSJöN
TULLAN	LAKENAME	TULLAN
TISNAREN	LAKENAME	TISNAREN
YNGERN	LAKENAME	YNGERN
ULVSJöN	LAKENAME	ULVSJöN
YNGAREN	LAKENAME	YNGAREN
ÖLJAREN	LAKENAME	ÖLJAREN
TULLINGESJöN	LAKENAME	TULLINGESJöN
VISNAREN	LAKENAME	VISNAREN
TRäSKATEN	LAKENAME	TRäSKATEN
SöDERBYSJöN	LAKENAME	SöDERBYSJöN
STRåLSJöN	LAKENAME	STRåLSJöN
SEGERSJöN	LAKENAME	SEGERSJöN
SILLEN	LAKENAME	SILLEN
ORMPUTTEN	LAKENAME	ORMPUTTEN
LåNGSJöN, TYRESTA	LAKENAME	LåNGSJöN
SOMRAN	LAKENAME	SOMRAN
NEDRE RUDASJöN	LAKENAME	NEDRE RUDASJöN
MARVIKEN, SöDERMANLAND	LAKENAME	MARVIKEN
MåSNAREN	LAKENAME	MåSNAREN
NäSNAREN	LAKENAME	NäSNAREN
MöRTSJöN, TYRESTA	LAKENAME	MöRTSJöN
LILLA SKOGSSJöN	LAKENAME	LILLA SKOGSSJöN
LUNDSJöN–DAMMSJöN	LAKENAME	LUNDSJöN–DAMMSJöN
KVARNSJöN, LISSMA	LAKENAME	KVARNSJöN
KäLLTORPSSJöN	LAKENAME	KäLLTORPSSJöN
LIKSTAMMEN	LAKENAME	LIKSTAMMEN
KARPTJäRN	LAKENAME	KARPTJäRN
KOLSNAREN	LAKENAME	KOLSNAREN
ÅRSJöN, TYRESTA	LAKENAME	ÅRSJöN
ÖRINGESJöN	LAKENAME	ÖRINGESJöN
ÖRAN	LAKENAME	ÖRAN
LAKE JIVARO	LAKENAME	LAKE JIVARO
WET SLEDDALE RESERVOIR	LAKENAME	WET SLEDDALE RESERVOIR
COGRA MOSS	LAKENAME	COGRA MOSS
BRICK TOWNSHIP RESERVOIR	LAKENAME	BRICK RESERVOIR
LAKE SEBRING	LAKENAME	LAKE SEBRING
NGORING LAKE	LAKENAME	NGORING LAKE
GYARING LAKE	LAKENAME	GYARING LAKE
CRESCENT LAKE	LAKENAME	CRESCENT LAKE
BRULE LAKE	LAKENAME	BRULE LAKE
RICE LAKE	LAKENAME	RICE LAKE
COUNTERFEIT LAKE	LAKENAME	COUNTERFEIT LAKE
BELSTON LOCH	LAKENAME	BELSTON LOCH
BARR BEACON RESERVOIR	LAKENAME	BARR BEACON RESERVOIR
CHETPUT AERI	LAKENAME	CHETPET LAKE
BONNET LAKE	LAKENAME	BONNET LAKE OR LAKE BONNET
MUD LAKE	LAKENAME	MUD LAKE OR PAULIE'S LAKE
GOAT LAKE	LAKENAME	GOAT LAKE
ALICE LAKE	LAKENAME	ALICE LAKE
ALPINE LAKE	LAKENAME	ALPINE LAKE
ALPINE LAKE	LAKENAME	ALPINE LAKE
ALTURAS LAKE	LAKENAME	ALTURAS LAKE
EDITH LAKE	LAKENAME	EDITH LAKE
ARDETH LAKE	LAKENAME	ARDETH LAKE
FARLEY LAKE	LAKENAME	FARLEY LAKE
TOXAWAY LAKE	LAKENAME	TOXAWAY LAKE
YELLOW BELLY LAKE	LAKENAME	YELLOW BELLY LAKE
MCDONALD LAKE	LAKENAME	MCDONALD LAKE
PETTIT LAKE	LAKENAME	PETTIT LAKE
VERNON LAKE	LAKENAME	VERNON LAKE
EDNA LAKE	LAKENAME	EDNA LAKE
VIRGINIA LAKE	LAKENAME	VIRGINIA LAKE
ELK LAKE	LAKENAME	ELK LAKE
IMOGENE LAKE	LAKENAME	IMOGENE LAKE
HELL ROARING LAKE	LAKENAME	HELL ROARING LAKE
PLAID LOCH	LAKENAME	PLAID LOCH
LOWER HANSON LAKE	LAKENAME	LOWER HANSON LAKE
MIDDLE HANSON LAKE	LAKENAME	MIDDLE HANSON LAKE
UPPER HANSON LAKE	LAKENAME	UPPER HANSON LAKE
PERKINS LAKE	LAKENAME	PERKINS LAKE
ALIDADE LAKE	LAKENAME	ALIDADE LAKE
AZURE LAKE	LAKENAME	AZURE LAKE
ARROWHEAD LAKE	LAKENAME	ARROWHEAD LAKE
ROCK ISLAND LAKE	LAKENAME	ROCK ISLAND LAKE
PATS LAKE	LAKENAME	PATS LAKE
THE HOLE	LAKENAME	THE HOLE
JOHNSON LAKE	LAKENAME	JOHNSON LAKE
SNOWBANK LAKE	LAKENAME	SNOWBANK LAKE
ISLAND LAKE	LAKENAME	ISLAND LAKE
GLACIER LAKE	LAKENAME	GLACIER LAKE
SCENIC LAKE	LAKENAME	SCENIC LAKE
DIAMOND LAKE	LAKENAME	DIAMOND LAKE
TRIANGLE LAKE	LAKENAME	TRIANGLE LAKE
BROWNS LAKE	LAKENAME	BROWNS LAKE
SLIDE LAKE	LAKENAME	SLIDE LAKE
BLUE JAY LAKE	LAKENAME	BLUE JAY LAKE
CLIFF LAKE	LAKENAME	CLIFF LAKE
LIMBER LAKE	LAKENAME	LIMBER LAKE
PACKRAT LAKE	LAKENAME	PACKRAT LAKE
HIDDEN LAKE	LAKENAME	HIDDEN LAKE
BENEDICT LAKE	LAKENAME	BENEDICT LAKE
EVERLY LAKE	LAKENAME	EVERLY LAKE
THREE ISLAND LAKE	LAKENAME	THREE ISLAND LAKE
ROCK SLIDE LAKE	LAKENAME	ROCK SLIDE LAKE
HEART LAKE	LAKENAME	HEART LAKE
CAMP LAKE	LAKENAME	CAMP LAKE
LITTLE SPANGLE LAKE	LAKENAME	LITTLE SPANGLE LAKE
SPANGLE LAKE	LAKENAME	SPANGLE LAKE
LAKE INGEBORG	LAKENAME	LAKE INGEBORG
LOW PASS LAKE	LAKENAME	LOW PASS LAKE
OREAMNUS LAKE	LAKENAME	OREAMNUS LAKE
THREE LAKE	LAKENAME	THREE LAKE
CONY LAKE	LAKENAME	CONY LAKE
MCWILLARDS LAKE	LAKENAME	MCWILLARDS LAKE
SURPRISE LAKE	LAKENAME	SURPRISE LAKE
CONFUSION LAKE	LAKENAME	CONFUSION LAKE
TIMPA LAKE	LAKENAME	TIMPA LAKE
CHICKADEE LAKE	LAKENAME	CHICKADEE LAKE
PANCHO LAKE	LAKENAME	PANCHO LAKE
DANDY LAKE	LAKENAME	DANDY LAKE
PLUMMER LAKE	LAKENAME	PLUMMER LAKE
BLUE ROCK LAKE	LAKENAME	BLUE ROCK LAKE
MEADOW LAKE	LAKENAME	MEADOW LAKE
LITTLE WARBONNET LAKE	LAKENAME	LITTLE WARBONNET LAKE
WARBONNET LAKE	LAKENAME	WARBONNET LAKE
BRAXON LAKE	LAKENAME	BRAXON LAKE
BARON LAKE	LAKENAME	BARON LAKE
UPPER BARON LAKE	LAKENAME	UPPER BARON LAKE
LITTLE BARON LAKE	LAKENAME	LITTLE BARON LAKE
BLUEBOX LAKE	LAKENAME	BLUEBOX LAKE
REGAN LAKE	LAKENAME	REGAN LAKE
CROOKED LAKE	LAKENAME	CROOKED LAKE
PULPIT LAKE	LAKENAME	PULPIT LAKE
MARSHALL LAKE	LAKENAME	MARSHALL LAKE
RENDEZVOUS LAKE	LAKENAME	RENDEZVOUS LAKE
LITTLE REDFISH LAKE	LAKENAME	LITTLE REDFISH LAKE
UPPER CRAMER LAKE	LAKENAME	UPPER CRAMER LAKE
MIDDLE CRAMER LAKE	LAKENAME	MIDDLE CRAMER LAKE
LOWER CRAMER LAKE	LAKENAME	LOWER CRAMER LAKE
LAKE KATHRYN	LAKENAME	LAKE KATHRYN
PROFILE LAKE	LAKENAME	PROFILE LAKE
LUCILLE LAKE	LAKENAME	LUCILLE LAKE
MUSHROOM LAKE	LAKENAME	MUSHROOM LAKE
LILY LAKE	LAKENAME	LILY LAKE
BOWKNOT LAKE	LAKENAME	BOWKNOT LAKE
LEAH LAKE	LAKENAME	LEAH LAKE
LOGJAM LAKE	LAKENAME	LOGJAM LAKE
LOWER BEAD LAKE	LAKENAME	LOWER BEAD LAKE
UPPER BEAD LAKE	LAKENAME	UPPER BEAD LAKE
LEGGIT LAKE	LAKENAME	LEGGIT LAKE
SOUTH PALMERSTON LOCH	LAKENAME	SOUTH PALMERSTON LOCH
LOCH SHIELD	LAKENAME	LOCH SHIELD
LITTLE BONNET LAKE	LAKENAME	LITTLE BONNET LAKE
TALUS LAKE	LAKENAME	TALUS LAKE
DUDLEY LAKE	LAKENAME	DUDLEY LAKE
CIRQUE LAKE	LAKENAME	CIRQUE LAKE
TRAPPER LAKE	LAKENAME	TRAPPER LAKE
BEARPAW LAKE	LAKENAME	BEARPAW LAKE
LAKE KOVZHSKOYE	LAKENAME	LAKE KOVZHSKOYE
LAKE KOVZHSKOYE	LAKENAME	Ковжское озеро
COW LAKE	LAKENAME	COW LAKE
ELK RANCH RESERVOIR	LAKENAME	ELK RANCH RESERVOIR
MINK LAKE	LAKENAME	MINK LAKE
MICA LAKE	LAKENAME	MICA LAKE
HOLLY LAKE	LAKENAME	HOLLY LAKE
GRIZZLY BEAR LAKE	LAKENAME	GRIZZLY BEAR LAKE
ARROWHEAD POOL	LAKENAME	ARROWHEAD POOL
RAMSHEAD LAKE	LAKENAME	RAMSHEAD LAKE
LAKE OF THE CRAGS	LAKENAME	LAKE OF THE CRAGS
LAKE KISALE	LAKENAME	LAKE KISALE
LAKE NZILO	LAKENAME	LAKE NZILO
LAKE ZIMBAMBO	LAKENAME	ZIMBAMBO
LAUREL LAKE	LAKENAME	LAUREL LAKE
DELTA LAKE	LAKENAME	DELTA LAKE
SURPRISE LAKE	LAKENAME	SURPRISE LAKE
LAKE HENRY	LAKENAME	LAKE HENRY
WHITEHILL LOCH	LAKENAME	WHITEHILL LOCH
LAKE WEBB	LAKENAME	LAKE WEBB
LAKE EVANS	LAKENAME	LAKE EVANS
SEA EYE LAKE	LAKENAME	LAKE MUSHYL, MORSKOY GLAZ
BRUNTWOOD LOCH	LAKENAME	BRUNTWOOD LOCH
LOCH GATE	LAKENAME	LOCH GATE
LAKE BOYA	LAKENAME	LAKE BOYA
LAKE LUCAS	LAKENAME	LAKE LUCAS
LAKE IVANHOE	LAKENAME	LAKE IVANHOE
KATEPWA LAKE	LAKENAME	KATEPWA LAKE
BUENA VISTA LAKE	LAKENAME	BUENA VISTA LAKE
LAKE STREETY	LAKENAME	LAKE STREETY
LAKE BLOUIN	LAKENAME	LAC BLOUIN
AMPHITHEATER LAKE	LAKENAME	AMPHITHEATER LAKE
ICEFLOE LAKE	LAKENAME	ICEFLOE LAKE
KIT LAKE	LAKENAME	KIT LAKE
BLACK LOCH, NEW CUMNOCK	LAKENAME	BLACK LOCH
CREOCH LOCH	LAKENAME	CREOCH LOCH
LOCH O' TH' LOWES, NEW CUMNOCK	LAKENAME	LOCH O' TH' LOWES
JYVäSJäRVI	LAKENAME	JYVäSJäRVI
PERIYA AERI	LAKENAME	PERIYA ERI
GUPHAPOKHARI	LAKENAME	GUPHAPOKHARI
BANDRA TALAO	LAKENAME	BANDRA TALAO
BANDRA TALAO	LAKENAME	SWAMI VIVEKANAND TALAO
TITLEY POOL	LAKENAME	TITLEY POOL
HEYBURN LAKE	LAKENAME	HEYBURN LAKE
ALNSJøEN	LAKENAME	ALNSJøEN
KERN LAKE	LAKENAME	KERN LAKE
BEAR LAKE	LAKENAME	BEAR LAKE
BOULDER LAKE	LAKENAME	BOULDER LAKE
SULLIVAN LAKE	LAKENAME	SULLIVAN LAKE
CASTLE LAKE	LAKENAME	CASTLE LAKE
JIMMY SMITH LAKE	LAKENAME	JIMMY SMITH LAKE
CIRQUE LAKE	LAKENAME	CIRQUE LAKE
CORNICE LAKE	LAKENAME	CORNICE LAKE
CRATER LAKE	LAKENAME	CRATER LAKE
COVE LAKE	LAKENAME	COVE LAKE
SWIMM LAKE	LAKENAME	SWIMM LAKE
ROUGH LAKE	LAKENAME	ROUGH LAKE
RAINBOW LAKE	LAKENAME	RAINBOW LAKE
OCALKENS LAKE	LAKENAME	OCALKENS LAKE
HEART LAKE	LAKENAME	HEART LAKE
PHYLLIS LAKE	LAKENAME	PHYLLIS LAKE
FOURTH OF JULY LAKE	LAKENAME	FOURTH OF JULY LAKE
WASHINGTON LAKE	LAKENAME	WASHINGTON LAKE
GUNSIGHT LAKE	LAKENAME	GUNSIGHT LAKE
DIKE LAKE	LAKENAME	DIKE LAKE
QUARTZITE LAKE	LAKENAME	QUARTZITE LAKE
TIN CUP LAKE	LAKENAME	TIN CUP LAKE
NECK LAKE	LAKENAME	NECK LAKE
SHEEP LAKE	LAKENAME	SHEEP LAKE
SLIDE LAKE	LAKENAME	SLIDE LAKE
WALKER LAKE	LAKENAME	WALKER LAKE
SNOW LAKE	LAKENAME	SNOW LAKE
GENTIAN LAKE	LAKENAME	GENTIAN LAKE
HOOK LAKE	LAKENAME	HOOK LAKE
ISLAND LAKE	LAKENAME	ISLAND LAKE
GOAT LAKE	LAKENAME	GOAT LAKE
LITTLE FROG LAKE	LAKENAME	LITTLE FROG LAKE
FROG LAKE	LAKENAME	FROG LAKE
WATERDOG LAKE	LAKENAME	WATERDOG LAKE
LODGEPOLE LAKE	LAKENAME	LODGEPOLE LAKE
WILLOW LAKE	LAKENAME	WILLOW LAKE
SAPPHIRE LAKE	LAKENAME	SAPPHIRE LAKE
HIDDEN LAKE	LAKENAME	HIDDEN LAKE
LONESOME LAKE	LAKENAME	LONESOME LAKE
TINY LAKE	LAKENAME	TINY LAKE
ROCK LAKE	LAKENAME	ROCK LAKE
NOISY LAKE	LAKENAME	NOISY LAKE
GLACIER LAKE	LAKENAME	GLACIER LAKE
EMERALD LAKE	LAKENAME	EMERALD LAKE
QUIET LAKE	LAKENAME	QUIET LAKE
SCREE LAKE	LAKENAME	QUIET LAKE
SHALLOW LAKE	LAKENAME	SHALLOW LAKE
HOODOO LAKE	LAKENAME	HOODOO LAKE
LAKE SEMINOLE	LAKENAME	LAKE SEMINOLE
LOCH A'AN	LAKENAME	LOCH A'AN
MANALI AERI	LAKENAME	MANALI AERI
MANALI AERI	LAKENAME	MATHUR AERI
MANALI AERI	LAKENAME	MADAVARAM AERI
HEART LAKE	LAKENAME	HEART LAKE
LOWER DEADWOOD LAKE	LAKENAME	LOWER DEADWOOD LAKE
UPPER DEADWOOD LAKE	LAKENAME	UPPER DEADWOOD LAKE
BOARDMAN LAKE	LAKENAME	BOARDMAN LAKE
LOWER SMOKY DOME LAKE	LAKENAME	LOWER SOMKY DOME LAKE
UPPER SMOKY DOME LAKE 1	LAKENAME	UPPER SOMKY DOME LAKE 1
UPPER SMOKY DOME LAKE 2	LAKENAME	UPPER SOMKY DOME LAKE 2
WEST SMOKY DOME LAKE	LAKENAME	WEST SOMKY DOME LAKE
LAKE BAROMBI KOTO	LAKENAME	LAKE BAROMBI KOTO
LAKE DISSONI	LAKENAME	LAKE DISSONI
SNOWDRIFT LAKE	LAKENAME	SNOWDRIFT LAKE
LAKE TAMINAH	LAKENAME	LAKE TAMINAH
TIMBERLINE LAKE	LAKENAME	TIMBERLINE LAKE
RIMROCK LAKE	LAKENAME	RIMROCK LAKE
LOCH EILT	LAKENAME	LOCH EILT
LAKE AGNES	LAKENAME	LAKE AGNES
FORGET-ME-NOT LAKES	LAKENAME	FORGET-ME-NOT LAKES
COYOTE LAKE	LAKENAME	COYOTE LAKE
INDIAN LAKE	LAKENAME	INDIAN LAKE
LAKE NOTORO	LAKENAME	LAKE NOTORO
LAKE NOTORO	LAKENAME	能取湖
LAKE TōFUTSU	LAKENAME	LAKE TōFUTSU
LAKE TōFUTSU	LAKENAME	濤沸湖
MARION LAKE	LAKENAME	MARION LAKE
VISHANSAR LAKE	LAKENAME	VISHANSAR LAKE
ASSEAN LAKE	LAKENAME	ASSEAN LAKE
SOUTH LAKE	LAKENAME	SOUTH LAKE
WAUBEE LAKE	LAKENAME	WAUBEE LAKE
LAKE ELSMAN	LAKENAME	LAKE ELSMAN
HENDERSON LAKE	LAKENAME	HENDERSON LAKE
HENDERSON LAKE	LAKENAME	HENDERSON LAKE
KOW SWAMP	LAKENAME	KOW SWAMP
LOCH LOYAL	LAKENAME	LOCH LOYAL
LAKE EFFIE	LAKENAME	LAKE EFFIE
GALLETUé LAKE	LAKENAME	GALLETUé LAKE
LAKE CIșMIGIU	LAKENAME	LAKE CIșMIGIU
LAKE CIșMIGIU	LAKENAME	LACUL CIșMIGIU
LAKE FUNDENI	LAKENAME	LAKE FUNDENI
LAKE FUNDENI	LAKENAME	LACUL FUNDENI
LAKE TARNOBRZEG	LAKENAME	LAKE TARNOBRZEG OR MACHOWSKI RESERVOIR
LAKE ALTAMAHA	LAKENAME	LAKE ALTAMAHA
SARATOGA LAKE	LAKENAME	SARATOGA LAKE
TULIAN LAKE	LAKENAME	TULIAN LAKE
EUNICE LAKE	LAKENAME	EUNICE LAKE
MOTIJHIL	LAKENAME	MOTIJHIL
LAKE WEAVER	LAKENAME	LAKE WEAVER OR LAKE WEADER
ABHAYAVAPI	LAKENAME	ABHAYA WEWA
PASHAN LAKE	LAKENAME	PASHAN LAKE
LAKE GHIOROC	LAKENAME	LAKE GHIOROC
LAKE ROY	LAKENAME	LAKE ROY
JINJI LAKE	LAKENAME	JINJI LAKE
JINJI LAKE	LAKENAME	金鸡湖
JIESA LAKE	LAKENAME	JIESA LAKE
DAJIA LAKE	LAKENAME	DAJIA LAKE
DAWA LAKE	LAKENAME	DAWA LAKE
TARUO LAKE	LAKENAME	TARUO LAKE
RENQINGXIUBU LAKE	LAKENAME	RENQINGXIUBU LAKE
ANG LAREN LAKE	LAKENAME	ANG LAREN LAKE
BANGDA LAKE	LAKENAME	BANDA LAKE
GUOZHA LAKE	LAKENAME	GUOZHA LAKE
LONGMU LAKE	LAKENAME	LONGMU LAKE
LAKE INA	LAKENAME	LAKE INA
MOUNTAIN LODGE LAKE	LAKENAME	MOUNTAIN LODGE LAKE
BLACK HORSE LAKE	LAKENAME	BLACK HORSE LAKE
LAKE DUBAY	LAKENAME	LAKE DUBAY
KRISHANSAR LAKE	LAKENAME	KRISHANSAR LAKE
WOAHINK LAKE	LAKENAME	WOAHINK LAKE
SUTTLE LAKE	LAKENAME	SUTTLE LAKE
CLEAWOX LAKE	LAKENAME	CLEAWOX LAKE
SHESHNAG LAKE	LAKENAME	SHESHNAG LAKE
PEñUELAS LAKE	LAKENAME	PEñUELAS LAKE
LAGUNA DEL INCA	LAKENAME	LAGUNA DEL INCA
TOWER LAKE	LAKENAME	TOWER LAKE
ROSTHERNE MERE	LAKENAME	ROSTHERNE MERE
MINERSVILLE RESERVOIR	LAKENAME	MINERSVILLE RESERVOIR
FRANK LAKE	LAKENAME	FRANK LAKE
TOWER LAKES	LAKENAME	TOWER LAKES
ELECTRA LAKE	LAKENAME	ELECTRA LAKE
GANGA LAKE	LAKENAME	GANGA LAKE
TELMEN LAKE	LAKENAME	TELMEN LAKE
DöRGöN LAKE	LAKENAME	DöRGöN LAKE
ARROCAMPO RESERVOIR	LAKENAME	ARROCAMPO RESERVOIR
LAKE RUBY	LAKENAME	LAKE RUBY
LAKE BESS	LAKENAME	LAKE BESS
KATNOSA	LAKENAME	KATNOSA
RIH DIL	LAKENAME	RIH DIL
BJøRNSJøEN	LAKENAME	BJøRNSJøEN
STONE LAKE	LAKENAME	STONE LAKE
SEč DAM	LAKENAME	SEč
QUARRY LAKE	LAKENAME	QUARRY LAKE
MULLUTU-SUURLAHT	LAKENAME	MULLUTU-SUURLAHT
DEAN MILLS RESERVOIR	LAKENAME	DEAN MILLS RESERVOIR
THRISSUR KOLE WETLANDS	LAKENAME	THRISSUR KOLE WETLANDS
LAKE SILVER	LAKENAME	LAKE SILVER
SEEON LAKES	LAKENAME	SEEON LAKES
PECKS LAKE	LAKENAME	PECKS LAKE
LAKE CONINE	LAKENAME	LAKE CONINE OR LAKE CONNIE
LOWER REDWATER LAKE	LAKENAME	LOWER REDWATER LAKE
LAKE EASY	LAKENAME	LAKE EASY
LAC LA LOCHE	LAKENAME	LAC LA LOCHE
LAKE MOODY	LAKENAME	LAKE MOODY
SALAR DE ARIZARO	LAKENAME	SALAR DE ARIZARO
PEELER LAKE	LAKENAME	PEELER LAKE
KROKSJöN, SKELLEFTEå KOMMUN	LAKENAME	KROKSJöN
LECH DL DRAGON	LAKENAME	LECH DL DRAGON
SIRI LAKE	LAKENAME	SIRI LAKE
LAKE OPETA	LAKENAME	LAKE OPETA
LAKE NIGHTHORSE	LAKENAME	LAKE NIGHTHORSE
SHIHU LAKE	LAKENAME	SHIHU LAKE
SHIHU LAKE	LAKENAME	石湖
ELK LAKE	LAKENAME	ELK LAKE
LAKE BISINA	LAKENAME	LAKE BISINA
LAKE ELOISE	LAKENAME	LAKE ELOISE
LAKE SUMMIT	LAKENAME	LAKE SUMMIT
CRYSTAL LAKE	LAKENAME	CRYSTAL LAKE
AYLESFORD LAKE	LAKENAME	AYLESFORD LAKE
LOCH ACHAIDH NA H-INICH	LAKENAME	LOCH ACHAIDH NA H-INICH
ZIGETANGCUO LAKE	LAKENAME	ZIGETANGCUO LAKE
ZIGETANGCUO LAKE	LAKENAME	兹格塘错
LAKE NYER	LAKENAME	NYER LAKE
TONG TSO	LAKENAME	TONG TSO
LAKE URRU	LAKENAME	URRU LAKE
LAKE JARGö	LAKENAME	JARGö LAKE
TSO NGöN	LAKENAME	TSO NGöN
ANTELOPE RESERVOIR	LAKENAME	ANTELOPE RESERVOIR
LAKE WINTERSET	LAKENAME	LAKE WINTERSET
LAVA LAKE	LAKENAME	LAVA LAKE
LAKE LULU	LAKENAME	LAKE LULU
TAM DIL	LAKENAME	TAM DIL
CARSE LOCH	LAKENAME	CARSE LOCH
HILLEND LOCH	LAKENAME	HILLEND LOCH
ALWAL LAKE	LAKENAME	ALWAL LAKE
LOCH MONAR	LAKENAME	LOCH MONAR
SWAN LAKE	LAKENAME	SWAN LAKE
UNITY POND	LAKENAME	UNITY POND
WILD HORSE RESERVOIR	LAKENAME	WILD HORSE RESERVOIR
SHEEPSCOT POND	LAKENAME	SHEEPSCOT POND
ST. GEORGE LAKE	LAKENAME	ST. GEORGE LAKE
LAKE MOTOSU	LAKENAME	LAKE MOTOSU
LAKE MOTOSU	LAKENAME	MOTOSU-KO
LAKE MOTOSU	LAKENAME	本栖湖
ALLT NA LAIRIGE	LAKENAME	ALLT NA LAIRIGE RESERVOIR
LINKINS LAKE	LAKENAME	LINKINS LAKE
INDEPENDENCE LAKE	LAKENAME	INDEPENDENCE LAKE
LOST MAN LAKE	LAKENAME	LOST MAN LAKE
WILLIAMS LAKE	LAKENAME	WILLIAMS LAKE
LOCH ASCOG	LAKENAME	LOCH ASCOG
ELLENVATN	LAKENAME	ELLENVATN
ØDEVATN	LAKENAME	ØDEVATNET
TODACHEENE LAKE	LAKENAME	TODACHEENE LAKE
BLACKFORD POND	LAKENAME	BLACKFORD POND
LAKE TISSONGO	LAKENAME	LAKE TISSONGO
LAKE SHōJI	LAKENAME	LAKE SHōJI
LAKE SHōJI	LAKENAME	SHōJI-KO
LAKE SHōJI	LAKENAME	精進湖
PATRICIA LAKE	LAKENAME	PATRICIA LAKE
LOFTON RESERVOIR	LAKENAME	LOFTON RESERVOIR
YATESVILLE DAM	LAKENAME	YATESVILLE LAKE
BLIDINJE LAKE	LAKENAME	BLIDINJE LAKE
VACHA RESERVOIR	LAKENAME	VACHA RESERVOIR
LINDQUIST LAKE	LAKENAME	LINDQUIST LAKE
ASGOG LOCH	LAKENAME	ASGOG CASTLE ANDLOCH
AUCHA LOCHY	LAKENAME	AUCHA LOCHY
AUCHENGAICH RESERVOIR	LAKENAME	AUCHENGAICH RESERVOIR
BEOCHLICH	LAKENAME	BEOCHLICH RESERVOIR
BISHOP'S GLEN RESERVOIR	LAKENAME	BISHOP’S GLEN RESERVOIR
BLACKMILL LOCH	LAKENAME	BLACKMILL LOCH
CAM LOCH	LAKENAME	CAM LOCH
CRAIGNAFEICH RESERVOIRS	LAKENAME	DAM ON CRAIGNAFEOCH BURN
CRARAE RESERVOIR	LAKENAME	CRARAE RESERVOIR
CROSSHILL LOCH	LAKENAME	CROSSHILL LOCH
CRUACHAN RESERVOIR	LAKENAME	CRUACHAN RESERVOIR
DAILL LOCH	LAKENAME	DAILL LOCH
DHU LOCH	LAKENAME	DHU LOCH
TAIPING LAKE	LAKENAME	TAIPING LAKE
FEORLIN	LAKENAME	FEORLIN
ARDLUSSA FISHING LOCH	LAKENAME	ARDLUSSA FISHING LOCH
GLEANN DUBH	LAKENAME	GLEANN DUBH
GLEANN LOCH	LAKENAME	GLEANN LOCH
MODAK SAGAR	LAKENAME	MODAK SAGAR
LOCH TARSAN	LAKENAME	LOCH TARSAN
HELENSBURGH NO. 1 RESERVOIR	LAKENAME	HELENSBURGH, NO 1 RESERVOIR
HELENSBURGH NO. 2 RESERVOIR	LAKENAME	HELENSBURGH NO. 2 RESERVOIR
KILDUSKLAND RESERVOIR	LAKENAME	KILDUSKLAND RESERVOIR DAM
KIRK DAM	LAKENAME	KIRK DAM
KNOCKRUAN LOCH	LAKENAME	KNOCKRUAN LOCH
LEORIN LOCH	LAKENAME	LEORIN LOCH
LINDOWAN RESERVOIR	LAKENAME	LINDOWAN RESERVOIR
LOCH A' CHAORAINN	LAKENAME	LOCH A' CHAORAINN
LOCH A' BHARAIN	LAKENAME	LOCH A' BHARAIN
GREEN PETER RESERVOIR	LAKENAME	GREEN PETER RESERVOIR
BROME LAKE	LAKENAME	BROME LAKE
BROME LAKE	LAKENAME	LAC BROME
BANJARA LAKE	LAKENAME	BANJARA LAKE
RAYMOND GARY LAKE	LAKENAME	RAYMOND GARY LAKE
NORCAN LAKE	LAKENAME	NORCAN LAKE
GRIFFY LAKE	LAKENAME	GRIFFY LAKE
ENAMAKKAL LAKE	LAKENAME	ENAMAKKAL LAKE
LAKE SUIGETSU	LAKENAME	LAKE SUIGETSU
WOKKPASH LAKE	LAKENAME	WOKKPASH LAKE
LAKE CONACHE	LAKENAME	LAKE CONACHE
LOCH ACHALL	LAKENAME	LOCH ACHALL
LOCH Bà	LAKENAME	LOCH BA
LOCH AFFRIC	LAKENAME	LOCH AFFRIC
STAFFELSEE	LAKENAME	STAFFELSEE
MALLARD LAKE	LAKENAME	MALLARD LAKE
LAKE ZHIZHITSKOYE	LAKENAME	LAKE ZHIZHITSKOYE
LAKE ZHIZHITSKOYE	LAKENAME	Жижицкое озеро
GOOSE LAKE	LAKENAME	GOOSE LAKE
LAKE DEFOREST	LAKENAME	LAKE DEFOREST
LA BRAVA LAKE	LAKENAME	LA BRAVA LAKE
LAKE MARIAM	LAKENAME	LAKE MARIAM
MOUNTAIN MEADOWS RESERVOIR	LAKENAME	MOUNTAIN MEADOWS RESERVOIR
BIG SAGE RESERVOIR	LAKENAME	BIG SAGE RESERVOIR
LAKE MARTHA	LAKENAME	LAKE MARTHA
WALLATANI LAKE	LAKENAME	WALLATANI
QACHU QUTA	LAKENAME	QACHU QUTA
SUNSET LAKE	LAKENAME	SUNSET LAKE
BASS LAKE	LAKENAME	BASS LAKE
CEDAR LAKE, ST. CROIX COUNTY, WISCONSIN	LAKENAME	CEDAR LAKE
LAKE OTIS	LAKENAME	LAKE OTIS
LAKE TIKSHOZERO	LAKENAME	LAKE TIKSHOZERO
LAKE TIKSHOZERO	LAKENAME	Тикшозеро
GJERSJøEN	LAKENAME	GJERSJøEN
NøKLEVANN	LAKENAME	NøKLEVANN
LAKE LINK	LAKENAME	LAKE LINK
CH'UXñA QUTA	LAKENAME	CH'UXñA QUTA
LAKE LACKAWANNA	LAKENAME	LAKE LACKAWANNA
FOX SAGAR LAKE	LAKENAME	FOX SAGAR LAKE
JURI QUTA	LAKENAME	JURI QUTA
TES LAKE	LAKENAME	TES LAKE
LAKE MOHAWKSIN	LAKENAME	LAKE MOHAWKSIN
PORTAGE LAKE	LAKENAME	PORTAGE LAKE
KIRBY LAKE	LAKENAME	KIRBY LAKE
YAWARKUCHA	LAKENAME	YAWARKUCHA
LAKE FLORENCE	LAKENAME	LAKE FLORENCE
JACK LONDON LAKE	LAKENAME	JACK LONDON LAKE
LAKE WOYTCHUGGA	LAKENAME	LAKE WOYTCHUGGA
EłK LAKE	LAKENAME	LAKE FIRLEJ
MINAM LAKE	LAKENAME	MINAM LAKE
LAKE DEXTER	LAKENAME	LAKE DEXTER
BREITENBUSH LAKE	LAKENAME	BREITENBUSH LAKE
REED LOCH	LAKENAME	REED LOCH
UPPER POND	LAKENAME	UPPER POND
UPPER POND	LAKENAME	OBERTEICH
BEAR POND	LAKENAME	BEAR POND
PUSHAW LAKE	LAKENAME	PUSHAW LAKE
UPPER LEAD MOUNTAIN POND	LAKENAME	UPPER LEAD MOUNTAIN POND
BEDDINGTON LAKE	LAKENAME	BEDDINGTON LAKE
LAKE WOOLEEN	LAKENAME	LAKE WOOLEEN
MAGONE LAKE	LAKENAME	MAGONE LAKE
MILLER LAKE	LAKENAME	MILLER LAKE
MANN LAKE	LAKENAME	MANN LAKE
LAKE MAUMELLE	LAKENAME	LAKE MAUMELLE
LAKE THOMAS A EDISON	LAKENAME	LAKE THOMAS A EDISON
LITTLE GRASS VALLEY RESERVOIR	LAKENAME	LITTLE GRASS VALLEY RESERVOIR
COPCO LAKE	LAKENAME	COPCO LAKE
ISLAND LAKE	LAKENAME	ISLAND LAKE
LAKE DAISY	LAKENAME	LAKE DAISY
WALDISEE	LAKENAME	WALDISEE
JASPER LAKE	LAKENAME	JASPER LAKE
CLEAR LAKE	LAKENAME	CLEAR LAKE
LAKE LOVERING	LAKENAME	LAKE LOVERING
LAKE LOVERING	LAKENAME	LAC LOVERING
KABOOTAR KHANA	LAKENAME	KABOOTAR KHANA, DADAR
TENMILE LAKE	LAKENAME	TENMILE LAKE
BAKER LAKE	LAKENAME	BAKER LAKE
BIG LOST LAKE	LAKENAME	BIG LOST LAKE
LITTLE LOST LAKE	LAKENAME	LITTLE LOST LAKE
LOWER NORTON LAKE	LAKENAME	LOWER NORTON LAKE
UPPER NORTON LAKE	LAKENAME	UPPER NORTON LAKE
SMOKY LAKE	LAKENAME	SMOKY LAKE
DOLLAR LAKE	LAKENAME	DOLLAR LAKE
PENNY LAKE	LAKENAME	DOLLAR LAKE
MILL LAKE	LAKENAME	MILL LAKE
MINER LAKE	LAKENAME	MINER LAKE
TITUS LAKE	LAKENAME	TITUS LAKE
PARADISE LAKE	LAKENAME	PARADISE LAKE
SNOWSLIDE LAKE	LAKENAME	SNOWSLIDE LAKE
NORTH TENMILE LAKE	LAKENAME	NORTH TENMILE LAKE
BIG FALL CREEK LAKE	LAKENAME	BIG FALL CREEK LAKE
GOVERNOR’S PUNCH BOWL	LAKENAME	GOVERNOR’S PUNCH BOWL
LOWER DEER LAKE	LAKENAME	LOWER DEER LAKE
UPPER DEER LAKE	LAKENAME	UPPER DEER LAKE
NORTH AMBER LAKE	LAKENAME	NORTH AMBER LAKE
SOUTH AMBER LAKE	LAKENAME	SOUTH AMBER LAKE
SILVER LAKE	LAKENAME	SILVER LAKE
WINDOW LAKE	LAKENAME	WINDOW LAKE
NORTH FORK LAKE	LAKENAME	NORTH FORK LAKE
GREAT ST BERNARD LAKE	LAKENAME	GREAT ST BERNARD LAKE
LAKE CLEVELAND	LAKENAME	LAKE CLEVELAND
EEL LAKE	LAKENAME	EEL LAKE
LAG DA BREIL	LAKENAME	LAG DA BREIL
LAG DA BREIL	LAKENAME	BRIGELSER SEE
HOSMER LAKE	LAKENAME	HOSMER LAKE
LOCH MEALT	LAKENAME	LOCH MEALT
DORIS LAKE	LAKENAME	DORIS LAKE
COOPER CREEK RESERVOIR	LAKENAME	COOPER CREEK RESERVOIR
HILLS CREEK RESERVOIR	LAKENAME	HILLS CREEK RESERVOIR
PEARLY LAKE	LAKENAME	PEARLY LAKE
JOHN C. BOYLE RESERVOIR	LAKENAME	JOHN C. BOYLE RESERVOIR
LAKE ELBERT	LAKENAME	LAKE ELBERT
ÉTANG DE LERS	LAKENAME	ÉTANG DE LERS
LAKE GROSS	LAKENAME	LAKE GROSS
Q'ARA QUTA	LAKENAME	Q'ARA QUTA
JACH'A QUTA	LAKENAME	JACH'A QUTA
MAGIC RESERVOIR	LAKENAME	MAGIC RESERVOIR
MORMON RESERVOIR	LAKENAME	MORMON RESERVOIR
MACKAY RESERVOIR	LAKENAME	MACKAY RESERVOIR
ROUND LAKE	LAKENAME	ROUND LAKE
KHARI KHARI LAKES	LAKENAME	KHARI KHARI LAKES
LOCH SPEY	LAKENAME	LOCH SPEY
LAKE HARRIS	LAKENAME	LAKE HARRIS
KELLY LAKE	LAKENAME	KELLY LAKE
FOO LAKE	LAKENAME	FOO LAKE
LAKE CANYON	LAKENAME	LAKE CANYON
COFTON RESERVOIR	LAKENAME	COFTON RESERVOIR
SKONSVIKVATNAN	LAKENAME	SKONSVIKVATNAN
LAKE WHILLANS	LAKENAME	LAKE WHILLANS
CHRISTINA LAKE	LAKENAME	CHRISTINA LAKE
COBB RESERVOIR	LAKENAME	COBB RESERVOIR
LAKE WIMAUMA	LAKENAME	LAKE WIMAUMA
LAKE CZORSZTYN	LAKENAME	JEZIORO CZORSZTYńSKIE
LAKE CZORSZTYN	LAKENAME	LAKE CZORSZTYN
LAGOA DA PEDREIRA	LAKENAME	LAGOA DA PEDREIRA
LAGOA DA PEDREIRA	LAKENAME	LAKE PEDREIRA
LAKE ŠAS	LAKENAME	LAKE ŠAS
LAKE ŠAS	LAKENAME	ŠASKO JEZERO / Шаско Језеро
LAKE ŠAS	LAKENAME	LIQENI I SHASIT
LAKE GOSSI	LAKENAME	LAKE GOSSI
LAKE ROżNóW	LAKENAME	JEZIORO ROżNOWSKIE
LAKE ROżNóW	LAKENAME	LAKE ROżNOW
TUYAJTO LAKE	LAKENAME	TUYAJTO LAKE
LAKE DOBCZYCE	LAKENAME	JEZIORO DOBCZYCKIE
LAKE DOBCZYCE	LAKENAME	LAKE DOBCZYCE
SIRINDHORN DAM RESERVOIR	LAKENAME	SIRINDHORN DAM RESERVOIR
LAKE AUGUST	LAKENAME	LAKE AUGUST
SEBKHA EL MELAH	LAKENAME	SEBKHA EL MELAH
LAKE ZAKHER	LAKENAME	LAKE ZAKHER
LAKE REED	LAKENAME	LAKE REED
VADAKKE MADHOM	LAKENAME	BRAHMASWAM MADHAM
LAKE MUGESERA	LAKENAME	LAKE MUGESERA
NED LAKE	LAKENAME	NED LAKE
BITA LAKE	LAKENAME	BITA LAKE
SHUDU LAKE	LAKENAME	SHUDU LAKE
LAKE FOX	LAKENAME	LAKE FOX
OLALLIE LAKE	LAKENAME	OLALLIE LAKE
LILY LAKE	LAKENAME	LILY LAKE
DEKA LAKE	LAKENAME	DEKA LAKE
SULPHUROUS LAKE	LAKENAME	SULPHUROUS LAKE
JUBILEE LAKE	LAKENAME	JUBILEE LAKE
LAGOA DA FAJã DOS CUBRES	LAKENAME	LAGOA DA FAJã DOS CUBRES
LAGOA DA FAJã DE SANTO CRISTO	LAKENAME	LAGOA DA FAJã DE SANTO CRISTO
RIVER LAKE	LAKENAME	RIVER LAKE
MEADOW GROUNDS LAKE	LAKENAME	MEADOW GROUNDS LAKE\N THUMB|CENTER|200PX
MIDWAY HIGH LAKES AREA	LAKENAME	TAKHLAKH LAKE
PADGETT LAKE	LAKENAME	PADGETT LAKE
ASHFORD LAKE	LAKENAME	ASHFORD LAKE
MARSH CREEK LAKE	LAKENAME	MARSH CREEK LAKE
LOCH HUMPHREY	LAKENAME	LOCH HUMPHREY
WARLEY MOOR RESERVOIR	LAKENAME	WARLEY MOOR RESERVOIR
WEBBERS FALLS LAKE	LAKENAME	WEBBERS FALLS LAKE
LAKE PARKER	LAKENAME	LAKE PARKER
LOCH OF CRAIGLUSH	LAKENAME	LOCH OF CRAIGLUSH
CRYSTAL LAKE	LAKENAME	CRYSTAL LAKE
MOSSø	LAKENAME	MOSSø
WOLF LAKE	LAKENAME	WOLF LAKE
LAKE HOWARD	LAKENAME	LAKE HOWARD
KIMSAQUCHA	LAKENAME	KIMSAQUCHA
KIMSAQUCHA	LAKENAME	KIMSAQUCHA
ARHUAYCOCHA	LAKENAME	ARHUAYCOCHA
COLONIAL LAKE	LAKENAME	COLONIAL LAKE
TURTLE-FLAMBEAU FLOWAGE	LAKENAME	TURTLE-FLAMBEAU FLOWAGE
LAKE HART	LAKENAME	LAKE HART
LAKE MCLEOD	LAKENAME	LAKE MCLEOD
LAKE SYLVA	LAKENAME	LAKE SYLVA
LAKE SHIPP	LAKENAME	LAKE SHIPP
EAGLE LAKE	LAKENAME	EAGLE LAKE\N THUMBNAIL|OVERLOOKING EAGLE LAKE AT SUNSET.
RAMAPO LAKE	LAKENAME	RAMAPO LAKE
MERCER LAKE	LAKENAME	MERCER LAKE
WANAQUE RESERVOIR	LAKENAME	WANAQUE RESERVOIR
POMPTON LAKE	LAKENAME	POMPTON LAKE
LUNA LAKE	LAKENAME	LUNA LAKE
DAGGER LAKE	LAKENAME	DAGGER LAKE
SON BEEL	LAKENAME	SON BEEL
MINDELSEE	LAKENAME	MINDELSEE
GREEN VIEW LAKE	LAKENAME	GREEN VIEW LAKE
TRAPPER LAKE	LAKENAME	TRAPPER LAKE
RATTI GALI LAKE	LAKENAME	RATTI GALI LAKE
SARAL LAKE	LAKENAME	SARAL LAKE
WILLARD POND	LAKENAME	WILLARD POND
LAKE RING	LAKENAME	LAKE RING
LAKE TARNIțA	LAKENAME	LAKE TARNIțA
LAKE NEALE	LAKENAME	LAKE NEALE
PITICOCHA	LAKENAME	PITICOCHA
LAKE DEY DEY	LAKENAME	LAKE DEY DEY
WADDELL LAKE	LAKENAME	WADDELL LAKE
KETTLING LAKE	LAKENAME	KETTLING LAKE
DOUBTFUL LAKE	LAKENAME	DOUBTFUL LAKE
HIDDEN LAKE	LAKENAME	HIDDEN LAKE
KLAWATTI LAKE	LAKENAME	KLAWATTI LAKE
MORAINE LAKE	LAKENAME	MORAINE LAKE
MONOGRAM LAKE	LAKENAME	MONOGRAM LAKE
STOUT LAKE	LAKENAME	STOUT LAKE
WILCOX LAKES	LAKENAME	WILCOX LAKES
LAKE BUCKEYE	LAKENAME	LAKE BUCKEYE
LAKE ELIZABETH	LAKENAME	LAKE ELIZABETH
LAKE SMALLER RITSA	LAKENAME	LAKE SMALLER RITSA
LAKE SMALLER RITSA	LAKENAME	პატარა რიწა
SOUTH BAR LAKE	LAKENAME	SOUTH BAR LAKE
FOXHILL PARK	LAKENAME	WOODWARD POND
LAC MARVILLE	LAKENAME	LAC MARVILLE
THORNTON LAKES	LAKENAME	THORNTON LAKES
GREEN LAKE	LAKENAME	GREEN LAKE
IPSOOT LAKE	LAKENAME	IPSOOT LAKE
BERDEEN LAKE	LAKENAME	BERDEEN LAKE
BLUM LAKES	LAKENAME	BLUM LAKES
WELLINGTON LAKE	LAKENAME	WELLINGTON LAKE
LAKE CALABAY	LAKENAME	LAKE CALABAY
TWIN LAKES	LAKENAME	TWIN LAKES
AZURE LAKE	LAKENAME	AZURE LAKE
SILVER LAKE	LAKENAME	SILVER LAKE
HANGING LAKE	LAKENAME	HANGING LAKE
COPPER LAKE	LAKENAME	COPPER LAKE
EGG LAKE	LAKENAME	EGG LAKE
PRICE LAKE	LAKENAME	PRICE LAKE
SULPHIDE LAKE	LAKENAME	SULPHIDE LAKE
LAKE OTRADNOYE	LAKENAME	LAKE OTRADNOYE
FOSS RESERVOIR	LAKENAME	FOSS RESERVOIR
DHARMASAGAR	LAKENAME	DHARMASAGAR
LAGO DI CHIRONICO	LAKENAME	LAGO DI CHIRONICO
JöRISEEN	LAKENAME	JöRISEEN
VORDERSEE	LAKENAME	VORDERSEE
LAI DA RAVAIS-CH	LAKENAME	LAI DA RAVAIS-CH
TURTMANNSEE	LAKENAME	TURTMANNSEE
LAKE SMART	LAKENAME	LAKE SMART
LAKE VRUTCI	LAKENAME	LAKE VRUTCI
WEINGARTENSEE	LAKENAME	WEINGARTENSEE
PADINJARECHIRA	LAKENAME	PADINJARECHIRA
SPIDER LAKE	LAKENAME	SPIDER LAKE
LAKE MAUDE	LAKENAME	LAKE MAUDE
UPPER NIHOTUPU RESERVOIR	LAKENAME	UPPER NIHOTUPU RESERVOIR
LAKE PINAROO	LAKENAME	LAKE PINAROO
IMAGE LAKE	LAKENAME	IMAGE LAKE
JOUTJäRVI	LAKENAME	JOUTJäRVI
LAKE MAY	LAKENAME	LAKE MAY
BRABRAND LAKE	LAKENAME	BRABRAND LAKE
LAKE GEM	LAKENAME	LAKE GEM
LOCH OF BOSQUOY	LAKENAME	LOCH OF BOSQUOY
WAQWAQUCHA	LAKENAME	WAQWAQUCHA
LITTLE SWAN LAKE	LAKENAME	LITTLE SWAN LAKE
TIANPING RESERVOIR	LAKENAME	TIANPING RESERVOIR
HUANGCAI RESERVOIR	LAKENAME	HUANGCAI RESERVOIR
JARBIDGE LAKE	LAKENAME	JARBIDGE LAKE
LOCH OF KIRBISTER	LAKENAME	LOCH OF KIRBISTER
LAKE MAGOG	LAKENAME	LAKE MAGOG
LAKE MAGOG	LAKENAME	LAC MAGOG
LAKE IDYL	LAKENAME	LAKE IDYL
KORATTUR AERI	LAKENAME	KORATTUR AERI
LAKE FANNIE	LAKENAME	LAKE FANNIE
SPANGGUR TSO	LAKENAME	SPANGGUR TSO
ROSE LAKE	LAKENAME	ROSE LAKE
CHITLAPAKKAM AERI	LAKENAME	CHITLAPAKKAM AERI
SCREECH LAKE	LAKENAME	SCREECH LAKE
CORNY LAKE	LAKENAME	CORNY LAKE
IOWA LAKE	LAKENAME	IOWA LAKE
MANYMOON LAKE	LAKENAME	MANYMOON LAKE
TACK LAKE	LAKENAME	TACK LAKE
ANDERSON LAKE	LAKENAME	ANDERSON LAKE
LAKE NIEGOCIN	LAKENAME	LAKE NIEGOCIN
SILVER LAKE	LAKENAME	SILVER LAKE
BULGE LAKE	LAKENAME	BULGE LAKE
DOGTROT LAKE	LAKENAME	DOGTROT LAKE
SLIP LAKE	LAKENAME	SLIP LAKE
MAHAMAYA IRRIGATION PROJECT	LAKENAME	MAHAMAYA LAKE
BOUDER LAKE	LAKENAME	BOUDER LAKE
LICHEN LAKE	LAKENAME	LICHEN LAKE
LAKE BEULAH	LAKENAME	LAKE BEULAH
WILLOW LAKE	LAKENAME	WILLOW LAKE
CHALK LAKE	LAKENAME	CHALK LAKE
CRYSTAL CREEK RESERVOIR	LAKENAME	CRYSTAL CREEK RESERVOIR
MIDDLE LAKE HAMILTON	LAKENAME	MIDDLE LAKE HAMILTON
LAC AUX BISCUITS	LAKENAME	COOKIES LAKE
LOCH CALDER	LAKENAME	LOCH CALDER
HOWARD LAKE	LAKENAME	HOWARD LAKE
UKONOM LAKE	LAKENAME	UKONOM LAKE
LAGUNA SECA	LAKENAME	LAGUNA SECA
LAKE HAMILTON	LAKENAME	LAKE HAMILTON
KAYAMKULAM KAYAL	LAKENAME	KAYAMKULAM KAYAL
LAKE MOORE, NEW SOUTH WALES	LAKENAME	LAKE MOORE
LAKE ZHALANASHKOL	LAKENAME	ZHALANASHKOL
LAKE ZHALANASHKOL	LAKENAME	Жалаңашкөл
VYHANAščANSKAJE LAKE	LAKENAME	VYGONOSHCHANSKOYE
LAKE MIRROR	LAKENAME	LAKE MIRROR
LOCH OF SKAILL	LAKENAME	LOCH OF SKAILL
MUCKLE WATER	LAKENAME	MUCKLE WATER
SPRING LAKE	LAKENAME	SPRING LAKE
LAKE CANNON	LAKENAME	LAKE CANNON
LAKE BACALAR	LAKENAME	LAKE BACALAR
INDIAN TOM LAKE	LAKENAME	INDIAN TOM LAKE
BLUE SPRINGS LAKE	LAKENAME	BLUE SPRINGS LAKE
LAKE RUJIšTE	LAKENAME	LAKE RUJIšTE
LAKE LUCERNE	LAKENAME	LAKE LUCERNE
LITTLE LAKE HAMILTON	LAKENAME	LITTLE LAKE HAMILTON
LAKE OF THE CROSS	LAKENAME	LAKE OF THE CROSS
ELDERBERRY FOREBAY	LAKENAME	ELDERBERRY FOREBAY
LOST GROVE LAKE	LAKENAME	LOST GROVE LAKE
THE LONG WATER	LAKENAME	THE LONG WATER
ENGINEERS LAKE	LAKENAME	ENGINEERS LAKE
CROCHE LAKE	LAKENAME	CROCHE LAKE
LAKE PANSY	LAKENAME	LAKE PANSY
LAKE HARTRIDGE	LAKENAME	LAKE HARTRIDGE
LAKE NORCONIAN	LAKENAME	LAKE NORCONIAN
LAKE VALENCIA	LAKENAME	LAKE VALENCIA
LAKE ST. GEORGE	LAKENAME	LAKE ST. GEORGE
LAKE JESSIE	LAKENAME	LAKE JESSIE
LAKE IDYLWILD	LAKENAME	LAKE IDYLWILD
MOKE LAKE	LAKENAME	MOKE LAKE
LAC DES CHICOTS	LAKENAME	LAC DES CHICOTS  POPULARLY DESIGNATED IN FRENCH \
CHESLATTA LAKE	LAKENAME	CHESLATTA LAKE
REEVES LAKE	LAKENAME	REEVES LAKE
TISSø	LAKENAME	TISSø
LAKE ROCHELLE	LAKENAME	LAKE ROCHELLE
LAKE LACHARD	LAKENAME	LAKE LACHARD
HAMLIN LAKE	LAKENAME	HAMLIN LAKE
LAKE PIVA	LAKENAME	LAKE PIVA
LAKE PIVA	LAKENAME	PIVSKO JEZERO
LAC LA PLONGE	LAKENAME	LAC LA PLONGE
LAKE ECHO	LAKENAME	LAKE ECHO
WILLOW SPRINGS LAKE	LAKENAME	WILLOW SPRINGS LAKE
LAKE CLAY	LAKENAME	LAKE CLAY
LLUEST-WEN RESERVOIR	LAKENAME	LLUEST-WEN RESERVOIR
LAC DU FOU	LAKENAME	LAC DU FOU
LAKE JUNE IN WINTER	LAKENAME	LAKE JUNE IN WINTER
MILLUQUCHA	LAKENAME	MILLUQUCHA
KANLLAQUCHA	LAKENAME	KANLLAQUCHA
LAKE TRENCHE	LAKENAME	LAKE TRENCHE
LAKE LESCARBOT	LAKENAME	LAKE LESCARBOT
LAKE HACKETT	LAKENAME	LAKE HACKETT
LAKE JOSEPHINE	LAKENAME	LAKE JOSEPHINE
VANCHIKULAM	LAKENAME	VANCHIKULAM
LAKE CHARLOTTE	LAKENAME	LAKE CHARLOTTE
HUASCACOCHA	LAKENAME	HUASCACOCHA
LAKE BUTLER	LAKENAME	LAKE BUTLER
LAKE SIRENA	LAKENAME	LAKE SIRENA
GANGA LAKE	LAKENAME	GANGA LAKE
LAKE HENRY	LAKENAME	LAKE HENRY
LAKE PARRISH	LAKENAME	LAKE PARRISH
DAVENPORT LAKE	LAKENAME	DAVENPORT LAKE
NEPTUNE LAKE	LAKENAME	NEPTUNE LAKE
TUNICA LAKE	LAKENAME	TUNICA LAKE
LAKE WHITTINGTON	LAKENAME	LAKE WHITTINGTON
MARS LAKE	LAKENAME	MARS LAKE
VENUS LAKE	LAKENAME	VENUS LAKE
POTROK AIKE	LAKENAME	POTROK AIKE
SUTTON SALT LAKE	LAKENAME	SUTTON SALT LAKE
SISKIWIT LAKE	LAKENAME	SISKIWIT LAKE
SISKIWIT LAKE	LAKENAME	SISKIWIT LAKE
LAKE FONTAINE	LAKENAME	LAKE FONTAINE
LAKE TERRIEN	LAKENAME	LAKE TERRIEN
LAKE CHAREST	LAKENAME	LAKE CHAREST
LAKE VAUGHAN	LAKENAME	LAKE VAUGHAN
COMANCHE RESERVOIR	LAKENAME	COMANCHE RESERVOIR
LAKE STUBBE	LAKENAME	LAKE STUBBE/ STUBBE Sø
HALFWAY LAKE	LAKENAME	HALFWAY LAKE
KRASNOYARSK RESERVOIR	LAKENAME	KRASNOYARSK RESERVOIR
FORBES LAKE	LAKENAME	FORBES LAKE
ALA-KINTAUS	LAKENAME	ALA-KINTAUS
FRENCH FARM LAKE	LAKENAME	FRENCH FARM LAKE
WASK'AQUCHA	LAKENAME	WASK'AQUCHA
VALAICHCHENAI LAGOON	LAKENAME	VALAICHCHENAI LAGOON
TAMPUQUCHA	LAKENAME	TAMPUQUCHA
KUKAKLEK LAKE	LAKENAME	KUKAKLEK LAKE
LAKE MCCOY	LAKENAME	LAKE MCCOY
WATERHEN LAKE	LAKENAME	WATERHEN LAKE
MIKAKUCHA	LAKENAME	MIKAKUCHA
GRASSY LAKE	LAKENAME	GRASSY LAKE
SREERAMAN CHIRA	LAKENAME	SREERAMAN CHIRA
LAKE KANKAKEE	LAKENAME	LAKE KANKAKEE
LONG LAKE	LAKENAME	LONG LAKE
LAKE SENNITSA	LAKENAME	LAKE SENNITSA
LAKE SENNITSA	LAKENAME	Сенница
LITTLE GRASSY LAKE	LAKENAME	LITTLE GRASSY LAKE
LAKE WABANO	LAKENAME	WABANO LAKE
LAKE ISET	LAKENAME	LAKE ISET
LAKE HUNTER	LAKENAME	LAKE HUNTER
SUNKARUQUCHA	LAKENAME	SUNKARUQUCHA
SACH'AWAKAYUQ	LAKENAME	SACH'AWAKAYUQ
HINCKLEY RESERVOIR	LAKENAME	HINCKLEY RESERVOIR
EARL PARK LAKE	LAKENAME	EARL PARK LAKE
SULLIVAN LAKE	LAKENAME	SULLIVAN LAKE
LITTLE MISEMA LAKE	LAKENAME	LITTLE MISEMA LAKE
MISEMA LAKE	LAKENAME	MISEMA LAKE
FALLDUCK LAKES	LAKENAME	FALLDUCK LAKES
LAKE WIRE	LAKENAME	LAKE WIRE
MONDONAC LAKE	LAKENAME	LAKE MONDONAC
KIMSAQUCHA	LAKENAME	KIMSAQUCHA
WARURUMIQUCHA	LAKENAME	WARURUMIQUCHA
ARMAQUCHA	LAKENAME	ARMAQUCHA
PUKAQUCHA	LAKENAME	PUKAQUCHA
ENCHANTED POND	LAKENAME	ENCHANTED POND
SPRUCE KNOB LAKE	LAKENAME	SPRUCE KNOB LAKE
WILDSEE	LAKENAME	WILDSEE
BLAKEMERE POND	LAKENAME	BLAKEMERE POND
VEľKé HINCOVO PLESO	LAKENAME	VEľKé HINCOVO PLESO
PUKAQUCHA	LAKENAME	PUKAQUCHA
VYNTHALA LAKE	LAKENAME	VYNTHALA LAKE
LAKE KUYUCUK	LAKENAME	LAKE KUYUCUK
CEDARTREE LAKE	LAKENAME	CEDARTREE LAKE
LAKE CRESCENT	LAKENAME	LAKE CRESCENT
LACUL LEBEDELOR	LAKENAME	LACUL LEBEDELOR
OBINITSA LAKE	LAKENAME	OBINITSA LAKE
HILLäKESTE LAKE	LAKENAME	HILLäKESTE LAKE
LAKE SAFYANY	LAKENAME	SAFYANY
GARCíA SOLA RESERVOIR	LAKENAME	GARCíA SOLA RESERVOIR
LAKE POHORILE	LAKENAME	POHORILE
LAKE BILE	LAKENAME	BILE
LIME LAKE	LAKENAME	LIME LAKE
NORRIS LAKE	LAKENAME	NORRIS LAKE
LAKE VăCăREșTI	LAKENAME	LAKE VăCăREșTI
LAKE VăCăREșTI	LAKENAME	LACUL VăCăREșTI
LAKE ALAN HENRY	LAKENAME	LAKE ALAN HENRY
KAUSAR NAG	LAKENAME	KAUSAR NAG
QUADDICK RESERVOIR	LAKENAME	QUADDICK RESERVOIR
POTANIPO POND	LAKENAME	POTANIPO POND
LAKE PARADISE	LAKENAME	LAKE PARADISE
CROOKED LAKE	LAKENAME	CROOKED LAKE
EAGLE LAKE	LAKENAME	EAGLE LAKE
GERBER RESERVOIR	LAKENAME	GERBER RESERVOIR
WALLED LAKE	LAKENAME	WALLED LAKE
LAKE BARREA	LAKENAME	LAGO DI BARREA
WINSLOW LAKE	LAKENAME	WINSLOW LAKE
BARKER LAKES	LAKENAME	BARKER LAKE
GREENBOOTH RESERVOIR	LAKENAME	GREENBOOTH RESERVOIR
TODD LAKE	LAKENAME	TODD LAKE
LONG LAKE	LAKENAME	LONG LAKE
SILVER LAKE	LAKENAME	SILVER LAKE
LAKE DUNMORE	LAKENAME	LAKE DUNMORE
NORMAN MITCHELL LAKE	LAKENAME	NORMAN MITCHELL LAKE
LAKE VERMILLION	LAKENAME	LAKE VERMILLION
KAWAGUESAGA LAKE	LAKENAME	KAWAGUESAGA LAKE
WILLOW RESERVOIR	LAKENAME	WILLOW RESERVOIR
LAKE KHANTAYSKOYE	LAKENAME	LAKE KHANTAYSKOYE
CHITGAR LAKE	LAKENAME	CHITGAR LAKE
JERSEY CITY FLOWAGE	LAKENAME	JERSEY CITY FLOWAGE
LAKE INNISFREE	LAKENAME	LAKE INNISFREE
GALBRAITH LAKE	LAKENAME	GALBRAITH LAKE
FOSTER JOSEPH SAYERS RESERVOIR	LAKENAME	FOSTER JOSEPH SAYERS RESERVOIR
LAKE COORONG	LAKENAME	LAKE COORONG
LAKE BULOKE	LAKENAME	LAKE BULOKE
LAKE CUYAMACA	LAKENAME	LAKE CUYAMACA
CH'UXñA QUTA	LAKENAME	CH'UXñA QUTA
LOCH ARDINNING	LAKENAME	LOCH ARDINNING
LOCH MàMA	LAKENAME	LOCH MàMA
LOCH NA CREIGE DUIBHE, LOCHABER	LAKENAME	LOCH NA CREIGE DUIBHE
LOCH BRàIGH HORRISDALE	LAKENAME	LOCH BRàIGH HORRISDALE
STELLA LAKE	LAKENAME	STELLA LAKE
TERESA LAKE	LAKENAME	TERESA LAKE
LAKE TREMBLANT	LAKENAME	LAKE TREMBLANT
LAKE BARDWELL	LAKENAME	LAKE BARDWELL
LOCH NA H-OIDHCHE	LAKENAME	LOCH NA H-OIDHCHE
LOCH BAD AN SGALAIG	LAKENAME	LOCH BAD AN SGALAIG
IKOP PAT	LAKENAME	IKOP PAT
PACZKOWSKI LAKE	LAKENAME	PACZKOWSKI LAKE
PARADISE LAKE	LAKENAME	LAC PARADIS
FLORAS LAKE	LAKENAME	FLORAS LAKE
PARADISE LAKE	LAKENAME	PARADISE LAKE
LAC DES JONCS	LAKENAME	LAC DES JONCS
DUNCAN	LAKENAME	DUNCAN LAKE
LAKE WALLACE	LAKENAME	LAKE WALLACE
BORSKO JEZERO	LAKENAME	BORSKO JEZERO
LAKE CALERO	LAKENAME	LAKE CALERO
TISSA WEWA	LAKENAME	TISSA WEWA
TISSA WEWA	LAKENAME	TISSA WEWA
LOCH CALLATER	LAKENAME	CALLATER LOCH
LOCH DAVAN	LAKENAME	LOCH DAVAN
LOCH OF TANKERNESS	LAKENAME	LOCH OF TANKERNESS
LOCH FITHIE	LAKENAME	LOCH FITHIE
LOCH OF FORFAR	LAKENAME	LOCH OF FORFAR
LAKE ST. MARTIN	LAKENAME	LAKE ST. MARTIN
GRANITE LAKE	LAKENAME	GRANITE LAKE
LAKE VOLGO	LAKENAME	LAKE VOLGO
LAKE VOLGO	LAKENAME	Озеро Волго
CHARLOTTE LAKE	LAKENAME	CHARLOTTE LAKE
ROCK LAKE	LAKENAME	ROCK LAKE
LAKE MOGOTOYEVO	LAKENAME	LAKE MOGOTOYEVO
LAKE VSELUG	LAKENAME	LAKE VSELUG
LAKE VSELUG	LAKENAME	Озеро Вселуг
RIEMER SEE	LAKENAME	RIEMER SEE
BREEZE LAKE	LAKENAME	BREEZE LAKE
LAKE ANTOINE	LAKENAME	LAKE ANTOINE
LAKE PENO	LAKENAME	LAKE PENO
LAKE PENO	LAKENAME	Озеро Пено
BLUE LAKE	LAKENAME	BLUE LAKE
GILLETTS LAKE	LAKENAME	GILLETTS LAKE
SHELDRAKE LAKE	LAKENAME	SHELDRAKE LAKE
ZWENKAUER SEE	LAKENAME	ZWENKAUER SEE
WąSOSZE	LAKENAME	WąSOSZE
LOCH AVICH	LAKENAME	LOCH AVICH
LAKE PLACID	LAKENAME	LAKE PLACID
SILVERMERE	LAKENAME	SILVERMERE
MIRROR LAKE	LAKENAME	MIRROR LAKE
FUMEE LAKE	LAKENAME	FUMEE LAKE
GOOSE LAKE	LAKENAME	GOOSE LAKE
LONG LAKE	LAKENAME	LONG LAKE
SILVER LAKE	LAKENAME	SILVER LAKE
LAKE BELOYE, RYAZAN OBLAST	LAKENAME	LAKE BELOYE
LAKE KAMPESKA	LAKENAME	LAKE KAMPESKA
UKKADAM LAKE	LAKENAME	UKKADAM PERIYAKULAM
UKKADAM LAKE	LAKENAME	VALAAG KULAM
LAKE GRIBBEN	LAKENAME	LAKE GRIBBEN
DEER LAKE	LAKENAME	DEER LAKE
TEAL LAKE	LAKENAME	TEAL LAKE
LAKE BANCROFT	LAKENAME	LAKE BANCROFT
OCEAN LAKE	LAKENAME	OCEAN LAKE
LAKE CRYSTAL	LAKENAME	LAKE CRYSTAL
CHEBACCO LAKE	LAKENAME	CHEBACCO LAKE
KHAPTAD LAKE	LAKENAME	KHAPTAD LAKE
SWAN LAKE	LAKENAME	SWAN LAKE
TUC-EL-NUIT LAKE	LAKENAME	TUC-EL-NUIT LAKE
THAYER LAKE	LAKENAME	THAYER LAKE
PANCH POKHARI	LAKENAME	PANCH POKHARI
LOST LAKE	LAKENAME	LOST LAKE
LOCH STACK	LAKENAME	LOCH STACK
LAKE TINGSTäDE	LAKENAME	LAKE TINGSTäDE
PERKINS LAKE	LAKENAME	PERKINS LAKE
WILSON RESERVOIR	LAKENAME	WILSON RESERVOIR
DEEP CREEK RESERVOIR	LAKENAME	DEEP CREEK RESERVOIR
WILLOW CREEK RESERVOIR	LAKENAME	WILLOW CREEK RESERVOIR
MEREDOSIA LAKE	LAKENAME	MEREDOSIA LAKE
EVERGREEN LAKE	LAKENAME	EVERGREEN LAKE
LAKE CECS	LAKENAME	LAKE CECS
RACHEL LAKE	LAKENAME	RACHEL LAKE
JABBA ZOMALU LAKE	LAKENAME	JABBA ZOMALU LAKE
LAKE OF THE IDOLS	LAKENAME	LAKE OF THE IDOLS
CRYSTAL LAKE	LAKENAME	CRYSTAL LAKE
TISLIT LAKE	LAKENAME	LAKE TISLIT
LONG LAKE	LAKENAME	LONG LAKE
LAKE EVA	LAKENAME	LAKE EVA
NEOR LAKE	LAKENAME	NEOR LAKE
LAKE MERZBACHER	LAKENAME	LAKE MERZBACHER
VIHERI	LAKENAME	VIHERI
SNOW LAKE, KING COUNTY, WASHINGTON	LAKENAME	SNOW LAKE
LAC DE GASCHET	LAKENAME	LAKE OF GASCHET / LAC DE GASCHET
MARGARET LAKE, KITTITAS COUNTY, WASHINGTON STATE	LAKENAME	MARGARET LAKE
UDAISAGAR LAKE	LAKENAME	UDAI SAGAR LAKE
LAKE KüçüKçEKMECE	LAKENAME	LAKE KüçüKçEKMECE
LAKE VALHALLA	LAKENAME	LAKE VALHALLA
WRIGHTSVILLE RESERVOIR	LAKENAME	WRIGHTSVILLE RESERVOIR
FOGGY LAKE	LAKENAME	FOGGY LAKE
DOODH TALAI LAKE	LAKENAME	DOODH TALAI LAKE
RICHLAND CREEK RESERVOIR	LAKENAME	RICHLAND CREEK RESERVOIR
KATORA LAKE	LAKENAME	KATORA LAKE
GOAT LAKE	LAKENAME	GOAT LAKE
SAWA LAKE	LAKENAME	SAWA LAKE
SAIDGAI LAKE	LAKENAME	SAIDGAI LAKE
EUNICE LAKE	LAKENAME	EUNICE LAKE
CHALLWAQUCHA	LAKENAME	CHALLWAQUCHA
FOXES TARN	LAKENAME	FOXES TARN
LAKE PILCHICOCHA	LAKENAME	LAKE PILCHICOCHA
DHANRAUL DAM	LAKENAME	DHANRAUL DAM
DHANRAUL DAM	LAKENAME	DHANDHRAUL DAM
BASHIGRAM LAKE	LAKENAME	BASHIGRAM LAKE
LAKE ORON	LAKENAME	LAKE ORON
SPRAGUE LAKE	LAKENAME	SPRAGUE LAKE
MYNäJäRVI	LAKENAME	MYNäJäRVI
FARM ISLAND LAKE	LAKENAME	FARM ISLAND LAKE
COLDWATER LAKE	LAKENAME	COLDWATER LAKE
ICEBERG LAKE, WHATCOM COUNTY, WASHINGTON	LAKENAME	ICEBERG LAKE
MAZAMA LAKES	LAKENAME	MAZAMA LAKES
LAKE INGALLS	LAKENAME	LAKE INGALLS
UPPER OTAY RESERVOIR	LAKENAME	UPPER OTAY RESERVOIR
NUTSCALE RESERVOIR	LAKENAME	NUTSCALE RESERVOIR
BONNY LAKE	LAKENAME	LAKE BONNY
DOCKERY LAKE	LAKENAME	DOCKERY LAKE
LAKE GREGORY	LAKENAME	LAKE GREGORY, NUWARA ELIYA
SUCCESS LAKE	LAKENAME	SUCCESS LAKE
GUN LAKE	LAKENAME	GUN LAKE
CHAIN LAKES, ALBERTA	LAKENAME	NORTH CHAIN LAKE
CHAIN LAKES, ALBERTA	LAKENAME	MIDDLE CHAIN LAKE
CHAIN LAKES, ALBERTA	LAKENAME	MAGEE LAKE
DANCE LAKE	LAKENAME	DANCE LAKE
LAKE EMDRUP	LAKENAME	EMDRUP Sø
GENTOFTE LAKE	LAKENAME	GENTOFTE Sø
LONG LAKE	LAKENAME	LONG LAKE
LONG LAKE	LAKENAME	LONG LAKE
LONG LAKE	LAKENAME	LONG LAKE
LONG LAKE	LAKENAME	LONG LAKE
LONG LAKE	LAKENAME	LONG LAKE
PACHECO RESERVOIR	LAKENAME	PACHECO LAKE
RAMAROSHAN SITE	LAKENAME	RAMAROSAN LAKE
LITTLE LAKE BONNY	LAKENAME	LITTLE LAKE BONNY
LAKE GIBSON	LAKENAME	LAKE GIBSON
LAKE CEVA	LAKENAME	LAKE CEVA
CRUMP LAKE	LAKENAME	CRUMP LAKE
SJæLSø	LAKENAME	SJæLSø
LAKE SERENE	LAKENAME	LAKE SERENE
LAKE HORNEY	LAKENAME	LAKE HORNEY
SORABORA WEWA	LAKENAME	SORABORA WEWA
LOCH DOCHARD	LAKENAME	LOCH DOCHARD
LOCH A' GHOBHAINN	LAKENAME	LOCH A' GHOBHAINN
LOCH SHURRERY	LAKENAME	LOCH SHURRERY
LOCH LUNDIE	LAKENAME	LOCH LUNDIE
LOCH A' BHAINNE	LAKENAME	LOCH A' BHAINNE
LOCH HOWIE	LAKENAME	LOCH HOWIE
LOCH SKAE	LAKENAME	LOCH SKAE
LOCHRUTTON LOCH	LAKENAME	LOCHRUTTON LOCH
LOCHABER LOCH	LAKENAME	LOCHABER LOCH
LAKE TRAKOšćAN	LAKENAME	LAKE TRAKOšćAN
LAKE TRAKOšćAN	LAKENAME	TRAKOšćANSKO JEZERO
BANANA LAKE	LAKENAME	BANANA LAKE
LAKE MAURICE	LAKENAME	LAKE MAURICE
LAKE DOT	LAKENAME	LAKE DOT
MEILIN RESERVOIR	LAKENAME	MEILIN RESERVOIR
SHENZHEN RESERVOIR	LAKENAME	SHENZHEN RESERVOIR
