Belgium	largestSettlement	Brussels
Bermuda	largestSettlement	St. George's, Bermuda
Cocos (Keeling) Islands	largestSettlement	Bantam, Cocos (Keeling) Islands
Guam	largestSettlement	Dededo, Guam
Monaco	largestSettlement	Monte Carlo
Hoy	largestSettlement	Lyness
Soay, Skye	largestSettlement	Mol-chlach
United States Minor Outlying Islands	largestSettlement	Wake Island
Outer Hebrides	largestSettlement	Stornoway
Great Cumbrae	largestSettlement	Millport, Isle of Cumbrae
North Uist	largestSettlement	Lochmaddy
South Uist	largestSettlement	Lochboisdale
Barra	largestSettlement	Castlebay
Benbecula	largestSettlement	Balivanich
Raasay	largestSettlement	Inverarish
Australian Antarctic Territory	largestSettlement	Mirny Station
Lismore, Scotland	largestSettlement	Achnacroish
Foula	largestSettlement	Ham (disambiguation)
Isle of Mull	largestSettlement	Tobermory, Mull
Rùm	largestSettlement	Kinloch Castle
Gigha	largestSettlement	Ardminish
Muck, Scotland	largestSettlement	Port Mòr
Mainland, Shetland	largestSettlement	Lerwick
Mainland, Orkney	largestSettlement	Kirkwall
Eigg	largestSettlement	Cleadale, Eigg
Coll	largestSettlement	Arinagour
Tiree	largestSettlement	Scarinish
Yell, Shetland	largestSettlement	Mid Yell
Fetlar	largestSettlement	Houbie
Unst	largestSettlement	Baltasound
Papa Stour	largestSettlement	Biggings
Whalsay	largestSettlement	Symbister
Stronsay	largestSettlement	Whitehall, Orkney
Westray	largestSettlement	Pierowall
West Burra	largestSettlement	Hamnavoe
South Ronaldsay	largestSettlement	St Margaret's Hope
Burray	largestSettlement	Burray Village
Shapinsay	largestSettlement	Balfour, Orkney
Isle of Bute	largestSettlement	Rothesay, Bute
Great Bernera	largestSettlement	Breaclete
Baleshare	largestSettlement	Samhla
Seil	largestSettlement	Ellenabeich
Trinidad and Tobago	largestSettlement	San Fernando, Trinidad and Tobago
Gibraltar	largestSettlement	Westside (Gibraltar)
South Walls	largestSettlement	Longhope, Orkney
Colonsay	largestSettlement	Scalasaig
Isle of Arran	largestSettlement	Brodick
Jura, Scotland	largestSettlement	Craighouse
Lewis and Harris	largestSettlement	Stornoway
Islay	largestSettlement	Port Ellen
Skye	largestSettlement	Portree
