PROJECT GUTENBERG	LIBRARYNAME	PROJECT GUTENBERG
MANATEE COUNTY, FLORIDA	LIBRARYNAME	MANATEE COUNTY PUBLIC LIBRARY SYSTEM
SARASOTA COUNTY, FLORIDA	LIBRARYNAME	SARASOTA COUNTY PUBLIC LIBRARIES
AMERICAN UNIVERSITY	LIBRARYNAME	AMERICAN UNIVERSITY LIBRARY
BODLEIAN LIBRARY	LIBRARYNAME	BODLEIAN LIBRARY
RUIDOSO, NEW MEXICO	LIBRARYNAME	RUIDOSO PUBLIC LIBRARY
AOZORA BUNKO	LIBRARYNAME	青空文庫
BIBLIOTHèQUE NATIONALE DE FRANCE	LIBRARYNAME	''
FAMILY HISTORY LIBRARY	LIBRARYNAME	FAMILY HISTORY LIBRARY
ENOCH PRATT FREE LIBRARY	LIBRARYNAME	ENOCH PRATT FREE LIBRARY
NEW YORK PUBLIC LIBRARY	LIBRARYNAME	NEW YORK PUBLIC LIBRARY
CAMBRIDGE UNIVERSITY LIBRARY	LIBRARYNAME	CAMBRIDGE UNIVERSITY LIBRARY
FOLGER SHAKESPEARE LIBRARY	LIBRARYNAME	FOLGER SHAKESPEARE LIBRARY
NEWBERRY LIBRARY	LIBRARYNAME	NEWBERRY LIBRARY
NATIONAL LIBRARY OF NEW ZEALAND	LIBRARYNAME	NATIONAL LIBRARY OF NEW ZEALAND
NATIONAL LIBRARY OF NEW ZEALAND	LIBRARYNAME	TE PUNA MāTAURANGA O AOTEAROA
ROYAL LIBRARY, DENMARK	LIBRARYNAME	DET KONGELIGE BIBLIOTEK, DANMARKS NATIONALBIBLIOTEK OG KøBENHAVNS UNIVERSITETSBIBLIOTEK
VATICAN LIBRARY	LIBRARYNAME	BIBLIOTHECA APOSTOLICA VATICANA
OHIO UNIVERSITY	LIBRARYNAME	OHIO UNIVERSITY LIBRARIES
OVIATT LIBRARY	LIBRARYNAME	DELMAR T. OVIATT LIBRARY
LANL RESEARCH LIBRARY	LIBRARYNAME	LANL RESEARCH LIBRARY
NATIONAL RESEARCH COUNCIL CANADA NATIONAL SCIENCE LIBRARY	LIBRARYNAME	NRC NATIONAL SCIENCE LIBRARY
BAKER-BERRY LIBRARY	LIBRARYNAME	BAKER-BERRY LIBRARY
W. E. B. DU BOIS LIBRARY	LIBRARYNAME	W. E. B. DU BOIS LIBRARY
GARRISON LIBRARY	LIBRARYNAME	GARRISON LIBRARY
CECIL H. GREEN LIBRARY	LIBRARYNAME	CECIL H. GREEN LIBRARY
STATE LIBRARY OF VICTORIA	LIBRARYNAME	STATE LIBRARY OF VICTORIA
NATIONAL LIBRARY OF SOUTH AFRICA	LIBRARYNAME	NATIONAL LIBRARY OF SOUTH AFRICA
OTTAWA PUBLIC LIBRARY	LIBRARYNAME	OTTAWA PUBLIC LIBRARY
FREE LIBRARY OF PHILADELPHIA	LIBRARYNAME	FREE LIBRARY OF PHILADELPHIA
WIDENER LIBRARY	LIBRARYNAME	HARRY ELKINS WIDENER
WIDENER LIBRARY	LIBRARYNAME	MEMORIAL LIBRARY
CHICAGO PUBLIC LIBRARY	LIBRARYNAME	CHICAGO PUBLIC LIBRARY
SEATTLE PUBLIC LIBRARY	LIBRARYNAME	THE SEATTLE PUBLIC LIBRARY
TAYLOR INSTITUTION	LIBRARYNAME	TAYLOR INSTITUTION
NATIONAL LIBRARY OF WALES	LIBRARYNAME	LLYFRGELL GENEDLAETHOL CYMRU
LIBRARY AND ARCHIVES CANADA	LIBRARYNAME	LIBRARY AND ARCHIVES CANADA
CONNEMARA PUBLIC LIBRARY	LIBRARYNAME	CONNEMARA PUBLIC LIBRARY
CONNEMARA PUBLIC LIBRARY	LIBRARYNAME	(கன்னிமாரா நூலகம்)
L. P. FISHER PUBLIC LIBRARY	LIBRARYNAME	L. P. FISHER PUBLIC LIBRARY
NATIONAL LIBRARY OF IRELAND	LIBRARYNAME	NATIONAL LIBRARY OF IRELAND
UNITED STATES NATIONAL AGRICULTURAL LIBRARY	LIBRARYNAME	U.S. NATIONAL AGRICULTURAL LIBRARY
OSLER LIBRARY OF THE HISTORY OF MEDICINE	LIBRARYNAME	OSLER LIBRARY OF THE HISTORY OF MEDICINE
LOS ANGELES PUBLIC LIBRARY	LIBRARYNAME	LOS ANGELES PUBLIC LIBRARY
STATE LIBRARY OF WESTERN AUSTRALIA	LIBRARYNAME	STATE LIBRARY OF WESTERN AUSTRALIA
ATLANTA–FULTON PUBLIC LIBRARY SYSTEM	LIBRARYNAME	ATLANTA–FULTON PUBLIC LIBRARY SYSTEM
HONG KONG CENTRAL LIBRARY	LIBRARYNAME	HONG KONG CENTRAL LIBRARY
STATE LIBRARY OF NEW SOUTH WALES	LIBRARYNAME	STATE LIBRARY OF NEW SOUTH WALES
LUIS ÁNGEL ARANGO LIBRARY	LIBRARYNAME	LUIS ANGEL ARANGO LIBRARY
CLEVELAND PUBLIC LIBRARY	LIBRARYNAME	CLEVELAND PUBLIC LIBRARY
TORONTO PUBLIC LIBRARY	LIBRARYNAME	TORONTO PUBLIC LIBRARY
MISSISSAUGA LIBRARY SYSTEM	LIBRARYNAME	MISSISSAUGA LIBRARY SYSTEM
NORTH YORK CENTRAL LIBRARY	LIBRARYNAME	NORTH YORK CENTRAL LIBRARY
LIBRARY OF PARLIAMENT	LIBRARYNAME	LIBRARY OF PARLIAMENT
STOCKHOLM PUBLIC LIBRARY	LIBRARYNAME	STOCKHOLMS STADSBIBLIOTEK
LINDA HALL LIBRARY	LIBRARYNAME	LINDA HALL LIBRARY OF SCIENCE, ENGINEERING AND TECHNOLOGY
WEST FLORIDA PUBLIC LIBRARY	LIBRARYNAME	WEST FLORIDA PUBLIC LIBRARY
ASTOR LIBRARY	LIBRARYNAME	THE ASTOR LIBRARY
EDMONTON PUBLIC LIBRARY	LIBRARYNAME	EDMONTON PUBLIC LIBRARY
WELLCOME LIBRARY	LIBRARYNAME	WELLCOME LIBRARY
LEIDEN UNIVERSITY LIBRARY	LIBRARYNAME	LEIDEN UNIVERSITY LIBRARY
LIBRARY OF VIRGINIA	LIBRARYNAME	LIBRARY OF VIRGINIA
SACKLER LIBRARY	LIBRARYNAME	SACKLER LIBRARY
VANCOUVER PUBLIC LIBRARY	LIBRARYNAME	VANCOUVER PUBLIC LIBRARY
SAN FRANCISCO PUBLIC LIBRARY	LIBRARYNAME	SAN FRANCISCO PUBLIC LIBRARY
KING TOWNSHIP PUBLIC LIBRARY	LIBRARYNAME	KING TOWNSHIP PUBLIC LIBRARY
CALGARY PUBLIC LIBRARY	LIBRARYNAME	CALGARY PUBLIC LIBRARY
GRANDE BIBLIOTHèQUE DU QUéBEC	LIBRARYNAME	GRANDE BIBLIOTHèQUE DU QUéBEC
HARVARD LIBRARY	LIBRARYNAME	THE HARVARD LIBRARY
NATIONAL LIBRARY OF IRAN	LIBRARYNAME	NATIONAL LIBRARY OF IRAN
BAVARIAN STATE LIBRARY	LIBRARYNAME	BAYERISCHE STAATSBIBLIOTHEK
HUNTSVILLE-MADISON COUNTY PUBLIC LIBRARY	LIBRARYNAME	HUNTSVILLE-MADISON COUNTY PUBLIC LIBRARY
BLAIR-CALDWELL AFRICAN AMERICAN RESEARCH LIBRARY	LIBRARYNAME	BLAIR-CALDWELL AFRICAN AMERICAN RESEARCH LIBRARY
GLASGOW UNIVERSITY LIBRARY	LIBRARYNAME	UNIVERSITY OF GLASGOW LIBRARY
NATIONAL LIBRARY OF THE NETHERLANDS	LIBRARYNAME	KONINKLIJKE BIBLIOTHEEK
ONE NATIONAL GAY & LESBIAN ARCHIVES	LIBRARYNAME	ONE NATIONAL GAY & LESBIAN ARCHIVES AT THE UNIVERSITY OF SOUTHERN CALIFORNIA LIBRARIES
ONE NATIONAL GAY & LESBIAN ARCHIVES	LIBRARYNAME	ONE ARCHIVES GALLERY & MUSEUM, WEST HOLLYWOOD
AUSTRIAN NATIONAL LIBRARY	LIBRARYNAME	ÖSTERREICHISCHE NATIONALBIBLIOTHEK
BERLIN STATE LIBRARY	LIBRARYNAME	BERLIN STATE LIBRARY
BERLIN STATE LIBRARY	LIBRARYNAME	STAATSBIBLIOTHEK ZU BERLIN
NATIONAL LIBRARY OF ROMANIA	LIBRARYNAME	BIBLIOTECA NAţIONALă A ROMâNIEI
NATIONAL LIBRARY OF PERU	LIBRARYNAME	BIBLIOTECA NACIONAL DEL PERú
COUNTY OF LOS ANGELES PUBLIC LIBRARY	LIBRARYNAME	COUNTY OF LOS ANGELES PUBLIC LIBRARY
SAN JOSé PUBLIC LIBRARY	LIBRARYNAME	SAN JOSé PUBLIC LIBRARY
PUBLIC LIBRARY OF CINCINNATI AND HAMILTON COUNTY	LIBRARYNAME	PUBLIC LIBRARY OF CINCINNATI AND HAMILTON COUNTY
BRITISH LIBRARY SOUND ARCHIVE	LIBRARYNAME	BRITISH LIBRARY SOUND ARCHIVE
HONG KONG PUBLIC LIBRARIES	LIBRARYNAME	HONG KONG PUBLIC LIBRARIES
WINNIPEG PUBLIC LIBRARY	LIBRARYNAME	WINNIPEG PUBLIC LIBRARY
KING COUNTY LIBRARY SYSTEM	LIBRARYNAME	KING COUNTY LIBRARY SYSTEM
DIMENNA–NYSELIUS LIBRARY	LIBRARYNAME	DIMENNA-NYSELIUS LIBRARY
BRAMPTON LIBRARY	LIBRARYNAME	BRAMPTON LIBRARY
UNIVERSITY OF MICHIGAN LIBRARY	LIBRARYNAME	UNIVERSITY OF MICHIGAN LIBRARY
SAN DIEGO COUNTY LIBRARY	LIBRARYNAME	SAN DIEGO COUNTY LIBRARY
SAN DIEGO PUBLIC LIBRARY	LIBRARYNAME	SAN DIEGO PUBLIC LIBRARY
NATIONAL AND UNIVERSITY LIBRARY OF SLOVENIA	LIBRARYNAME	NUK - NARODNA IN UNIVERZITETNA KNJIžNICA
LIBRARY OF ASHURBANIPAL	LIBRARYNAME	LIBRARY OF ASHURBANIPAL
LIBRARY COMPANY OF PHILADELPHIA	LIBRARYNAME	LIBRARY COMPANY OF PHILADELPHIA
MERTON COLLEGE LIBRARY	LIBRARYNAME	MERTON COLLEGE LIBRARY
TOMPKINS COUNTY PUBLIC LIBRARY	LIBRARYNAME	TOMPKINS COUNTY PUBLIC LIBRARY
GöTTINGEN STATE AND UNIVERSITY LIBRARY	LIBRARYNAME	STAATS- UND UNIVERSITäTSBIBLIOTHEK GöTTINGEN
BELFAST CENTRAL LIBRARY	LIBRARYNAME	BELFAST CENTRAL LIBRARY
MENNONITE HISTORICAL LIBRARY	LIBRARYNAME	MENNONITE HISTORICAL LIBRARY
SCHOMBURG CENTER FOR RESEARCH IN BLACK CULTURE	LIBRARYNAME	SCHOMBURG CENTER
SCHOMBURG CENTER FOR RESEARCH IN BLACK CULTURE	LIBRARYNAME	FOR RESEARCH IN BLACK CULTURE
WILLIAM T. YOUNG LIBRARY	LIBRARYNAME	WILLIAM T. YOUNG LIBRARY
MITCHELL LIBRARY	LIBRARYNAME	MITCHELL LIBRARY
RYERSON UNIVERSITY LIBRARY	LIBRARYNAME	RYERSON UNIVERSITY LIBRARY
BIBLIOTECA NACIONAL DE ESPAñA	LIBRARYNAME	BIBLIOTECA NACIONAL DE ESPAñA
NATIONAL AUDIO-VISUAL CONSERVATION CENTER	LIBRARYNAME	PACKARD CAMPUS
CENTRAL CATHOLIC LIBRARY	LIBRARYNAME	LEABHARLANN AN CHREIDIMH
MALIK NATIONAL MUSEUM OF IRAN	LIBRARYNAME	MALEK NATIONAL LIBRARY AND MUSEUM
NATIONAL LIBRARY OF COLOMBIA	LIBRARYNAME	BIBLIOTECA NACIONAL DE COLOMBIA
BROWARD COUNTY LIBRARY	LIBRARYNAME	BROWARD COUNTY LIBRARY SYSTEM
SUMMIT FREE PUBLIC LIBRARY	LIBRARYNAME	SUMMIT FREE PUBLIC LIBRARY
CALIFORNIA STATE LIBRARY	LIBRARYNAME	CALIFORNIA STATE LIBRARY
INNISFIL PUBLIC LIBRARY	LIBRARYNAME	INNISFIL PUBLIC LIBRARY
NATIONAL LIBRARY OF BELARUS	LIBRARYNAME	Нацыянальная бібліятэка Беларусі
NATIONAL LIBRARY OF BELARUS	LIBRARYNAME	Национальная библиотека Беларуси
WILLIAM ANDREWS CLARK MEMORIAL LIBRARY	LIBRARYNAME	WILLIAM ANDREWS CLARK MEMORIAL LIBRARY
SAINT JOHN FREE PUBLIC LIBRARY	LIBRARYNAME	SAINT JOHN FREE PUBLIC LIBRARY
PICKERING PUBLIC LIBRARY	LIBRARYNAME	PICKERING PUBLIC LIBRARY
CITY OF SYDNEY LIBRARY	LIBRARYNAME	CITY OF SYDNEY LIBRARY
BRITISH LIBRARY OF POLITICAL AND ECONOMIC SCIENCE	LIBRARYNAME	BRITISH LIBRARY OF POLITICAL AND ECONOMIC SCIENCE
COLUMBUS METROPOLITAN LIBRARY	LIBRARYNAME	COLUMBUS METROPOLITAN LIBRARY
GRACE A. DOW MEMORIAL LIBRARY	LIBRARYNAME	GRACE A. DOW MEMORIAL LIBRARY
LIBRIVOX	LIBRARYNAME	LIBRIVOX
INTERNATIONAL LIBRARY OF AFRICAN MUSIC	LIBRARYNAME	INTERNATIONAL LIBRARY OF AFRICAN MUSIC
UNIVERSITY OF CALIFORNIA, BERKELEY LIBRARIES	LIBRARYNAME	UC BERKELEY LIBRARIES
ALLEN COUNTY PUBLIC LIBRARY	LIBRARYNAME	ALLEN COUNTY PUBLIC LIBRARY
NATIONAL LIBRARY OF THE PHILIPPINES	LIBRARYNAME	NATIONAL LIBRARY OF THE PHILIPPINES
NATIONAL LIBRARY OF THE PHILIPPINES	LIBRARYNAME	PAMBANSANG AKLATAN NG PILIPINAS
TRADITIONAL KNOWLEDGE DIGITAL LIBRARY	LIBRARYNAME	TRADITIONAL KNOWLEDGE DIGITAL LIBRARY
DALLAS PUBLIC LIBRARY	LIBRARYNAME	DALLAS PUBLIC LIBRARY
TOPEKA & SHAWNEE COUNTY PUBLIC LIBRARY	LIBRARYNAME	TOPEKA & SHAWNEE COUNTY
TOPEKA & SHAWNEE COUNTY PUBLIC LIBRARY	LIBRARYNAME	PUBLIC LIBRARY
PALOS VERDES LIBRARY DISTRICT	LIBRARYNAME	PALOS VERDES LIBRARY DISTRICT
STONY PLAIN PUBLIC LIBRARY	LIBRARYNAME	STONY PLAIN PUBLIC LIBRARY
SANTA CLARA COUNTY LIBRARY	LIBRARYNAME	SANTA CLARA COUNTY LIBRARY DISTRICT
SAXON STATE AND UNIVERSITY LIBRARY DRESDEN	LIBRARYNAME	SAXON STATE AND UNIVERSITY LIBRARY DRESDEN
SAXON STATE AND UNIVERSITY LIBRARY DRESDEN	LIBRARYNAME	''SäCHSISCHE LANDESBIBLIOTHEK –
SAXON STATE AND UNIVERSITY LIBRARY DRESDEN	LIBRARYNAME	STAATS- UND UNIVERSITäTSBIBLIOTHEK DRESDEN
SAXON STATE AND UNIVERSITY LIBRARY DRESDEN	LIBRARYNAME	''
RADCLIFFE SCIENCE LIBRARY	LIBRARYNAME	RADCLIFFE SCIENCE LIBRARY
NATIONAL LIBRARY OF POLAND	LIBRARYNAME	BIBLIOTEKA NARODOWA
CHARLES V. PARK LIBRARY	LIBRARYNAME	CHARLES V. PARK LIBRARY
NEW YORK SOCIETY LIBRARY	LIBRARYNAME	NEW YORK SOCIETY LIBRARY
MAMARONECK PUBLIC LIBRARY	LIBRARYNAME	MAMARONECK PUBLIC LIBRARY
AURARIA LIBRARY	LIBRARYNAME	AURARIA LIBRARY
WELLINGTON CITY LIBRARIES	LIBRARYNAME	WELLINGTON CITY LIBRARIES
NATIONAL LIBRARY OF AZERBAIJAN	LIBRARYNAME	NATIONAL LIBRARY OF AZERBAIJAN
LETTERKENNY LIBRARY AND ARTS CENTRE	LIBRARYNAME	LETTERKENNY LIBRARY AND ARTS CENTRE
THUNDER BAY PUBLIC LIBRARY	LIBRARYNAME	THUNDER BAY PUBLIC LIBRARY
WOMEN'S LIBRARY	LIBRARYNAME	THE WOMEN'S LIBRARY @ LSE
JEWISH PUBLIC LIBRARY	LIBRARYNAME	JEWISH PUBLIC LIBRARY
NATIONAL ARCHIVES AND LIBRARY OF ETHIOPIA	LIBRARYNAME	NATIONAL ARCHIVES AND LIBRARY OF ETHIOPIA
NATIONAL LIBRARY OF KOREA	LIBRARYNAME	NATIONAL LIBRARY OF KOREA
LONDON PUBLIC LIBRARY	LIBRARYNAME	LONDON PUBLIC LIBRARY
MONTREAL PUBLIC LIBRARIES NETWORK	LIBRARYNAME	MONTREAL PUBLIC LIBRARIES NETWORK
GREATER SUDBURY PUBLIC LIBRARY	LIBRARYNAME	GREATER SUDBURY PUBLIC LIBRARY
GREATER SUDBURY PUBLIC LIBRARY	LIBRARYNAME	BIBLIOTHèQUE PUBLIQUE DU GRAND SUDBURY
GREATER VICTORIA PUBLIC LIBRARY	LIBRARYNAME	GREATER VICTORIA PUBLIC LIBRARY
SWISS NATIONAL LIBRARY	LIBRARYNAME	SCHWEIZERISCHE NATIONALBIBLIOTHEK
SWISS NATIONAL LIBRARY	LIBRARYNAME	BIBLIOTHèQUE NATIONALE SUISSE
SWISS NATIONAL LIBRARY	LIBRARYNAME	BIBLIOTECA NAZIONALE SVIZZERA
GRAINGER ENGINEERING LIBRARY	LIBRARYNAME	THE GRAINGER ENGINEERING LIBRARY INFORMATION CENTER
THOMAS AND DOROTHY LEAVEY LIBRARY	LIBRARYNAME	LEAVEY LIBRARY
NATIONAL LIBRARY OF CHINA	LIBRARYNAME	NATIONAL LIBRARY OF CHINA
UNIVERSITY OF CALIFORNIA, SANTA BARBARA LIBRARY	LIBRARYNAME	UNIVERSITY OF CALIFORNIA, SANTA BARBARA LIBRARY
CUYAHOGA COUNTY PUBLIC LIBRARY	LIBRARYNAME	CUYAHOGA COUNTY PUBLIC LIBRARY
OREGON STATE LIBRARY	LIBRARYNAME	OREGON STATE LIBRARY
JAFFNA PUBLIC LIBRARY	LIBRARYNAME	JAFFNA PUBLIC LIBRARY
JAFFNA PUBLIC LIBRARY	LIBRARYNAME	யாழ் பொது நூலகம்
PORTSMOUTH PUBLIC LIBRARY	LIBRARYNAME	PORTSMOUTH PUBLIC LIBRARY
CHEKHOV LIBRARY	LIBRARYNAME	Центральная городская публичная библиотека имени А.П.Чехова
KETTLESON MEMORIAL LIBRARY	LIBRARYNAME	KETTLESON MEMORIAL LIBRARY
HUNTINGTON BEACH PUBLIC LIBRARY	LIBRARYNAME	HUNTINGTON BEACH PUBLIC LIBRARY
WILMETTE PUBLIC LIBRARY	LIBRARYNAME	WILMETTE PUBLIC LIBRARY
COLUMBIA UNIVERSITY LIBRARIES	LIBRARYNAME	COLUMBIA UNIVERSITY LIBRARIES/INFORMATION SERVICES
ADRIANCE MEMORIAL LIBRARY	LIBRARYNAME	ADRIANCE MEMORIAL LIBRARY
NATIONAL PARLIAMENTARY LIBRARY OF UKRAINE	LIBRARYNAME	NATIONAL PARLIAMENTARY LIBRARY OF UKRAINE
RUSSIAN NATIONAL PUBLIC LIBRARY FOR SCIENCE AND TECHNOLOGY	LIBRARYNAME	RUSSIAN NATIONAL PUBLIC LIBRARY FOR SCIENCE AND TECHNOLOGY
RUSSIAN NATIONAL PUBLIC LIBRARY FOR SCIENCE AND TECHNOLOGY	LIBRARYNAME	(Государственная публичная научно-техническая библиотека )
LIBRARY OF MICHIGAN	LIBRARYNAME	LIBRARY OF MICHIGAN
HALIFAX PUBLIC LIBRARIES	LIBRARYNAME	HALIFAX PUBLIC LIBRARIES
SNO-ISLE LIBRARIES	LIBRARYNAME	SNO-ISLE LIBRARIES
PENNSYLVANIA STATE UNIVERSITY LIBRARIES	LIBRARYNAME	PENN STATE UNIVERSITY LIBRARIES
NEW YORK STATE LIBRARY	LIBRARYNAME	NEW YORK STATE LIBRARY
CONTRA COSTA COUNTY LIBRARY	LIBRARYNAME	CONTRA COSTA COUNTY LIBRARY
ROSEVILLE PUBLIC LIBRARY	LIBRARYNAME	ROSEVILLE PUBLIC LIBRARY
LILLIAN GOLDMAN LAW LIBRARY	LIBRARYNAME	LILLIAN GOLDMAN LAW LIBRARY
YALE UNIVERSITY LIBRARY	LIBRARYNAME	YALE UNIVERSITY LIBRARY
CAPITAL AREA DISTRICT LIBRARY	LIBRARYNAME	CAPITAL AREA DISTRICT LIBRARIES
MILWAUKEE PUBLIC LIBRARY	LIBRARYNAME	MILWAUKEE PUBLIC LIBRARY
MADAN PURASKAR PUSTAKALAYA	LIBRARYNAME	मदन पुरस्कार पुस्तकालय
NATIONAL LIBRARY OF NORWAY	LIBRARYNAME	NASJONALBIBLIOTEKET
LIBRI PROHIBITI	LIBRARYNAME	LIBRI PROHIBITI
NATIONAL LIBRARY OF ISRAEL	LIBRARYNAME	הספרייה הלאומית
NUNAVUT PUBLIC LIBRARY SERVICES	LIBRARYNAME	NUNAVUT PUBLIC LIBRARY SERVICES
MID-CONTINENT PUBLIC LIBRARY	LIBRARYNAME	MID-CONTINENT PUBLIC LIBRARY
ORANGE COUNTY LIBRARY SYSTEM	LIBRARYNAME	ORANGE COUNTY LIBRARY SYSTEM
GREATER MANCHESTER COUNTY RECORD OFFICE	LIBRARYNAME	GREATER MANCHESTER COUNTY RECORD OFFICE
FOSTER BUSINESS LIBRARY	LIBRARYNAME	ALBERT O. AND EVELYN W. FOSTER BUSINESS LIBRARY
LEDUC PUBLIC LIBRARY	LIBRARYNAME	LEDUC PUBLIC LIBRARY
ESCONDIDO PUBLIC LIBRARY	LIBRARYNAME	ESCONDIDO PUBLIC LIBRARY
PRIDE LIBRARY	LIBRARYNAME	PRIDE LIBRARY
WESTERVILLE PUBLIC LIBRARY	LIBRARYNAME	WESTERVILLE PUBLIC LIBRARY
FOLSOM LIBRARY	LIBRARYNAME	RICHARD G. FOLSOM LIBRARY
ST. LOUIS PUBLIC LIBRARY	LIBRARYNAME	ST. LOUIS PUBLIC LIBRARY
LLOYDMINSTER PUBLIC LIBRARY	LIBRARYNAME	LLOYDMINSTER PUBLIC LIBRARY
ALLYN AND BETTY TAYLOR LIBRARY	LIBRARYNAME	ALLYN AND BETTY TAYLOR LIBRARY
WEST LEBANON-PIKE TOWNSHIP PUBLIC LIBRARY	LIBRARYNAME	WEST LEBANON-PIKE TOWNSHIP PUBLIC LIBRARY
NEWARK PUBLIC LIBRARY	LIBRARYNAME	THE NEWARK PUBLIC LIBRARY
UNIVERSITY OF BRITISH COLUMBIA LIBRARY	LIBRARYNAME	UNIVERSITY OF BRITISH COLUMBIA LIBRARY
STANLEY MEMORIAL LIBRARY	LIBRARYNAME	STANLEY MEMORIAL LIBRARY
DETROIT PUBLIC LIBRARY	LIBRARYNAME	DETROIT PUBLIC LIBRARY
NATIONAL CENTRAL LIBRARY	LIBRARYNAME	NATIONAL CENTRAL LIBRARY OF FLORENCE
WASHINGTON UNIVERSITY LIBRARIES	LIBRARYNAME	JOHN M. OLIN LIBRARY, WASHINGTON UNIVERSITY IN ST. LOUIS
TELEKI LIBRARY	LIBRARYNAME	TELEKI LIBRARY
UNIVERSITY OF CALIFORNIA, LOS ANGELES LIBRARY	LIBRARYNAME	UCLA LIBRARY
KITCHENER PUBLIC LIBRARY	LIBRARYNAME	KITCHENER PUBLIC LIBRARY
JACKSONVILLE PUBLIC LIBRARY	LIBRARYNAME	JACKSONVILLE PUBLIC LIBRARY
PORTLAND PUBLIC LIBRARY	LIBRARYNAME	PORTLAND PUBLIC LIBRARY
MARGARET I. KING LIBRARY	LIBRARYNAME	MARGARET I. KING LIBRARY
DURHAM UNIVERSITY LIBRARY	LIBRARYNAME	DURHAM UNIVERSITY LIBRARY
TWIN LAKES LIBRARY SYSTEM	LIBRARYNAME	TWIN LAKES LIBRARY SYSTEM
FRESNO COUNTY PUBLIC LIBRARY	LIBRARYNAME	FRESNO COUNTY PUBLIC LIBRARY
LIBRARY OF AGUDAS CHASSIDEI CHABAD	LIBRARYNAME	LIBRARY OF AGUDAS CHASSIDEI CHABAD
WüRTTEMBERGISCHE LANDESBIBLIOTHEK	LIBRARYNAME	WüRTTEMBERGISCHE LANDESBIBLIOTHEK
PHILOLOGICAL LIBRARY	LIBRARYNAME	PHILOLOGICAL LIBRARY OF FREIE UNIVERSITäT BERLIN
COQUITLAM PUBLIC LIBRARY	LIBRARYNAME	COQUITLAM PUBLIC LIBRARY
BURNABY PUBLIC LIBRARY	LIBRARYNAME	BURNABY PUBLIC LIBRARY
RIJKSMUSEUM RESEARCH LIBRARY	LIBRARYNAME	RIJKSMUSEUM RESEARCH LIBRARY
TEXAS A&M UNIVERSITY LIBRARIES	LIBRARYNAME	TEXAS A&M UNIVERSITY LIBRARIES
SURREY LIBRARIES	LIBRARYNAME	SURREY PUBLIC LIBRARY
THE VALLEY LIBRARY	LIBRARYNAME	THE VALLEY LIBRARY
JOSEPH S. STAUFFER LIBRARY	LIBRARYNAME	JOSEPH S. STAUFFER LIBRARY
LETHBRIDGE PUBLIC LIBRARY	LIBRARYNAME	LETHBRIDGE PUBLIC LIBRARY
HAMILTON PUBLIC LIBRARY	LIBRARYNAME	HAMILTON PUBLIC LIBRARY
PETERBOROUGH PUBLIC LIBRARY	LIBRARYNAME	PETERBOROUGH PUBLIC LIBRARY
KENT FREE LIBRARY	LIBRARYNAME	KENT FREE LIBRARY
PERKINS BRAILLE AND TALKING BOOK LIBRARY	LIBRARYNAME	PERKINS BRAILLE AND TALKING BOOK LIBRARY
AURORA PUBLIC LIBRARY	LIBRARYNAME	AURORA PUBLIC LIBRARY
OAKVILLE PUBLIC LIBRARY	LIBRARYNAME	OAKVILLE PUBLIC LIBRARY
CHURCHILL ARCHIVES CENTRE	LIBRARYNAME	CHURCHILL ARCHIVES CENTRE
BIRMINGHAM PUBLIC LIBRARY	LIBRARYNAME	BIRMINGHAM PUBLIC LIBRARY
SHER-E-KASHMIR UNIVERSITY OF AGRICULTURAL SCIENCES AND TECHNOLOGY OF KASHMIR	LIBRARYNAME	CENTRAL LIBRARY SKUAST-K
OAKLAND PUBLIC LIBRARY	LIBRARYNAME	OAKLAND PUBLIC LIBRARY
RUTHERFORD LIBRARY	LIBRARYNAME	RUTHERFORD LIBRARY,
NATIONAL LIBRARY OF BRAZIL	LIBRARYNAME	BIBLIOTECA NACIONAL DO BRASIL
BIRKENHEAD PUBLIC LIBRARY	LIBRARYNAME	BIRKENHEAD PUBLIC LIBRARY
BIRKENHEAD PUBLIC LIBRARY	LIBRARYNAME	TE WHARE MATAURANGA O BIRKENHEAD
NEW HAVEN FREE PUBLIC LIBRARY	LIBRARYNAME	NEW HAVEN FREE PUBLIC LIBRARY
BUFFALO & ERIE COUNTY PUBLIC LIBRARY	LIBRARYNAME	BUFFALO & ERIE COUNTY PUBLIC LIBRARY
MILLENNIUM LIBRARY	LIBRARYNAME	MILLENNIUM LIBRARY
LAWSON MCGHEE LIBRARY	LIBRARYNAME	LAWSON MCGHEE LIBRARY
BIBLIOTHèQUE SAINT-JEAN	LIBRARYNAME	BIBLIOTHèQUE SAINT-JEAN,
FULLERTON PUBLIC LIBRARY	LIBRARYNAME	THE FULLERTON PUBLIC LIBRARY
WICHITA PUBLIC LIBRARY	LIBRARYNAME	WICHITA PUBLIC LIBRARY
MARK O. HATFIELD LIBRARY	LIBRARYNAME	MARK O. HATFIELD LIBRARY
BIBLIOTHèQUE DE LAVAL	LIBRARYNAME	BIBLIOTHèQUE DE LAVAL
NORTH OLYMPIC LIBRARY SYSTEM	LIBRARYNAME	NORTH OLYMPIC LIBRARY SYSTEM
UNIVERSITY OF MOUNT OLIVE	LIBRARYNAME	MOYE LIBRARY
NATIONAL LIBRARY FOR CHILDREN AND YOUNG ADULTS	LIBRARYNAME	NATIONAL LIBRARY FOR CHILDREN AND YOUNG ADULTS
INNER TEMPLE LIBRARY	LIBRARYNAME	INNER TEMPLE LIBRARY
NATIONAL LIBRARY OF TURKEY	LIBRARYNAME	NATIONAL LIBRARY OF TURKEY
NATIONAL LIBRARY OF TURKEY	LIBRARYNAME	MILLî KüTüPHANE
TROY PUBLIC LIBRARY	LIBRARYNAME	TROY PUBLIC LIBRARY
CHARLOTTE MECKLENBURG LIBRARY	LIBRARYNAME	CHARLOTTE MECKLENBURG LIBRARY
MICHIGAN STATE UNIVERSITY LIBRARIES	LIBRARYNAME	MICHIGAN STATE UNIVERSITY LIBRARIES
ALBERT AND TEMMY LATNER JEWISH PUBLIC LIBRARY	LIBRARYNAME	ALBERT AND TEMMY LATNER JEWISH PUBLIC LIBRARY
WORKING CLASS MOVEMENT LIBRARY	LIBRARYNAME	WORKING CLASS MOVEMENT LIBRARY
WHITCHURCH–STOUFFVILLE PUBLIC LIBRARY	LIBRARYNAME	WHITCHURCH-STOUFFVILLE PUBLIC LIBRARY
AGENCY FOR THE LEGAL DEPOSIT LIBRARIES	LIBRARYNAME	AGENCY FOR THE LEGAL DEPOSIT LIBRARIES
AMES FREE LIBRARY	LIBRARYNAME	AMES FREE LIBRARY
JAGIELLONIAN LIBRARY	LIBRARYNAME	BIBLIOTEKA JAGIELLOńSKA
QUESET HOUSE	LIBRARYNAME	QUESET HOUSE
HILLMAN LIBRARY	LIBRARYNAME	HILLMAN LIBRARY OF THE UNIVERSITY LIBRARY SYSTEM , UNIVERSITY OF PITTSBURGH
WHITBY PUBLIC LIBRARY	LIBRARYNAME	WHITBY PUBLIC LIBRARY
NATIONAL LIBRARY OF GREECE	LIBRARYNAME	Εθνική Βιβλιοθήκη της Ελλάδος
NATIONAL LIBRARY OF GREECE	LIBRARYNAME	ETHNIKí VIVLIOTHíKI TIS ELLáDOS
KANSAS CITY PUBLIC LIBRARY	LIBRARYNAME	KANSAS CITY PUBLIC LIBRARY
JEFFERSONVILLE TOWNSHIP PUBLIC LIBRARY	LIBRARYNAME	JEFFERSONVILLE TOWNSHIP PUBLIC LIBRARY
SARATOGA SPRINGS PUBLIC LIBRARY	LIBRARYNAME	SARATOGA SPRINGS PUBLIC LIBRARY
UNIVERSITY OF ALBERTA HOSPITAL	LIBRARYNAME	JOHN W. SCOTT HEALTH SCIENCES LIBRARY
HENNEPIN COUNTY LIBRARY	LIBRARYNAME	HENNEPIN COUNTY LIBRARY
SOUTHFIELD PUBLIC LIBRARY	LIBRARYNAME	SOUTHFIELD PUBLIC LIBRARY
FREDERICTON PUBLIC LIBRARY	LIBRARYNAME	FREDERICTON PUBLIC LIBRARY
BIBLIOTECA NACIONAL DE CHILE	LIBRARYNAME	NATIONAL LIBRARY OF CHILE
BRACKEN HEALTH SCIENCES LIBRARY	LIBRARYNAME	BRACKEN HEALTH SCIENCES LIBRARY
NATIONAL SPORT INFORMATION CENTRE	LIBRARYNAME	NATIONAL SPORT INFORMATION CENTRE
CARL H. PFORZHEIMER COLLECTION OF SHELLEY AND HIS CIRCLE	LIBRARYNAME	THE CARL H. PFORZHEIMER COLLECTION OF SHELLEY AND HIS CIRCLE
ELLIS LIBRARY	LIBRARYNAME	ELMER ELLIS LIBRARY
GRAND RAPIDS PUBLIC LIBRARY	LIBRARYNAME	GRAND RAPIDS PUBLIC LIBRARY
OCEAN COUNTY LIBRARY	LIBRARYNAME	OCEAN COUNTY LIBRARY
LIBRARY OF THE RUSSIAN ACADEMY OF SCIENCES	LIBRARYNAME	LIBRARY OF THE RUSSIAN ACADEMY OF SCIENCES
MOFFAT LIBRARY	LIBRARYNAME	MOFFAT LIBRARY OF WASHINGTONVILLE
VANCOUVER ISLAND REGIONAL LIBRARY	LIBRARYNAME	VANCOUVER ISLAND REGIONAL LIBRARY
NORTHWESTERN UNIVERSITY LIBRARY	LIBRARYNAME	NORTHWESTERN UNIVERSITY LIBRARY
READING PUBLIC LIBRARY	LIBRARYNAME	READING PUBLIC LIBRARY
VIRGINIA BEACH PUBLIC LIBRARY SYSTEM	LIBRARYNAME	VIRGINIA BEACH PUBLIC LIBRARY SYSTEM
MUSKOKA LAKES TOWNSHIP PUBLIC LIBRARIES	LIBRARYNAME	MUSKOKA LAKES TOWNSHIP PUBLIC LIBRARIES
DR. JOHN ARCHER LIBRARY	LIBRARYNAME	DR. JOHN ARCHER LIBRARY
HOUGHTON LIBRARY	LIBRARYNAME	HOUGHTON LIBRARY
BYU FAMILY HISTORY LIBRARY	LIBRARYNAME	BYU FAMILY HISTORY LIBRARY
GEORGIA TECH LIBRARY	LIBRARYNAME	GEORGIA TECH LIBRARY
PUSKARICH PUBLIC LIBRARY SYSTEM	LIBRARYNAME	PUSKARICH PUBLIC LIBRARY SYSTEM
RAZA LIBRARY	LIBRARYNAME	RAZA LIBRARY
PRITZKER MILITARY MUSEUM & LIBRARY	LIBRARYNAME	PRITZKER MILITARY MUSEUM & LIBRARY
MARKHAM PUBLIC LIBRARY	LIBRARYNAME	MARKHAM PUBLIC LIBRARY
NATIONAL CENTRAL LIBRARY	LIBRARYNAME	NATIONAL CENTRAL LIBRARY
NATIONAL CENTRAL LIBRARY	LIBRARYNAME	國家圖書館
DISTRICT OF COLUMBIA PUBLIC LIBRARY	LIBRARYNAME	DISTRICT OF COLUMBIA PUBLIC LIBRARY
VERNADSKY NATIONAL LIBRARY OF UKRAINE	LIBRARYNAME	Національна бібліотека України імені В. І. Вернадського
NATIONAL LIBRARY OF ARMENIA	LIBRARYNAME	NATIONAL LIBRARY OF ARMENIA
NATIONAL LIBRARY OF ARMENIA	LIBRARYNAME	Հայաստանի Ազգային Գրադարան
ALLEGHENY COUNTY LIBRARY ASSOCIATION	LIBRARYNAME	ALLEGHENY COUNTY LIBRARY ASSOCIATION
EVERETT PUBLIC LIBRARY	LIBRARYNAME	EVERETT PUBLIC LIBRARY
WILLIAMSPORT-WASHINGTON TOWNSHIP PUBLIC LIBRARY	LIBRARYNAME	WILLIAMSPORT-WASHINGTON TOWNSHIP PUBLIC LIBRARY
PALMERSTON NORTH CITY LIBRARY	LIBRARYNAME	PALMERSTON NORTH CITY LIBRARY
FRANCIS SKARYNA BELARUSIAN LIBRARY AND MUSEUM	LIBRARYNAME	FRANCIS SKARYNA BELARUSIAN LIBRARY AND MUSEUM
OMAHA PUBLIC LIBRARY	LIBRARYNAME	OMAHA PUBLIC LIBRARY
WEST VANCOUVER MEMORIAL LIBRARY	LIBRARYNAME	WEST VANCOUVER MEMORIAL LIBRARY
WESTERN COUNTIES REGIONAL LIBRARY	LIBRARYNAME	WESTERN COUNTIES REGIONAL LIBRARY
HAROLD B. LEE LIBRARY	LIBRARYNAME	HAROLD B. LEE LIBRARY
OPENBARE BIBLIOTHEEK AMSTERDAM	LIBRARYNAME	OPENBARE BIBLIOTHEEK AMSTERDAM
UNIVERSITY OF KASHMIR	LIBRARYNAME	ALLAMA IQBAL LIBRARY
WINDSOR PUBLIC LIBRARY	LIBRARYNAME	WINDSOR PUBLIC LIBRARY
RICHMOND HILL PUBLIC LIBRARY	LIBRARYNAME	RICHMOND HILL PUBLIC LIBRARY
MAUGHAN LIBRARY	LIBRARYNAME	MAUGHAN LIBRARY,
MAUGHAN LIBRARY	LIBRARYNAME	KING'S COLLEGE LONDON
NATIONAL AND UNIVERSITY LIBRARY IN ZAGREB	LIBRARYNAME	NACIONALNA I SVEUčILIšNA KNJIžNICA U ZAGREBU
ALAMEDA COUNTY LIBRARY	LIBRARYNAME	ALAMEDA COUNTY LIBRARY
SEBY JONES LIBRARY	LIBRARYNAME	SEBY JONES LIBRARY
GEORGE A. SMATHERS LIBRARIES	LIBRARYNAME	UNIVERSITY OF FLORIDA LIBRARIES
SHANGHAI LIBRARY	LIBRARYNAME	SHANGHAI LIBRARY
ARTEXTE INFORMATION CENTRE	LIBRARYNAME	ARTEXTE
STRATHCONA COUNTY LIBRARY	LIBRARYNAME	STRATHCONA COUNTY LIBRARY
REGINA PUBLIC LIBRARY	LIBRARYNAME	REGINA PUBLIC LIBRARY
HAMILTON LIBRARY	LIBRARYNAME	UNIVERSITY OF HAWAII AT MāNOA
NATIONAL LIBRARY OF MYANMAR	LIBRARYNAME	NATIONAL LIBRARY OF MYANMAR
HAMILTON CITY LIBRARIES	LIBRARYNAME	HAMILTON CITY LIBRARIES
ST. JOHNSBURY ATHENAEUM	LIBRARYNAME	ST. JOHNSBURY ATHENAEUM
NATIONAL LIBRARY OF ALGERIA	LIBRARYNAME	NATIONAL LIBRARY OF ALGERIA
NATIONAL LIBRARY OF ALGERIA	LIBRARYNAME	(المكتبة الوطنيّة الجزائريّة)
SULTAN QABOOS UNIVERSITY LIBRARY	LIBRARYNAME	SULTAN QABOOS UNIVERSITY LIBRARY
NATIONAL LIBRARY OF MOLDOVA	LIBRARYNAME	NATIONAL LIBRARY OF THE REPUBLIC OF MOLDOVA
NATIONAL LIBRARY OF ESTONIA	LIBRARYNAME	EESTI RAHVUSRAAMATUKOGU
NATIONAL LIBRARY OF GUYANA	LIBRARYNAME	NATIONAL LIBRARY OF GUYANA
HOYT LIBRARY	LIBRARYNAME	HOYT LIBRARY
ARAPAHOE LIBRARY DISTRICT	LIBRARYNAME	ARAPAHOE LIBRARY DISTRICT
FARMINGTON PUBLIC LIBRARY	LIBRARYNAME	FARMINGTON PUBLIC LIBRARY
GHENT UNIVERSITY LIBRARY	LIBRARYNAME	UNIVERSITEITSBIBLIOTHEEK GENT
BANGOR PUBLIC LIBRARY	LIBRARYNAME	BANGOR PUBLIC LIBRARY
GEORGINA PUBLIC LIBRARIES	LIBRARYNAME	GEORGINA PUBLIC LIBRARIES
MOBILE PUBLIC LIBRARY	LIBRARYNAME	MOBILE PUBLIC LIBRARY
MCCARTNEY LIBRARY	LIBRARYNAME	MCCARTNEY LIBRARY
SUNNYVALE PUBLIC LIBRARY	LIBRARYNAME	SUNNYVALE PUBLIC LIBRARY
HENRY MADDEN LIBRARY	LIBRARYNAME	HENRY MADDEN LIBRARY
HILLSBORO PUBLIC LIBRARY	LIBRARYNAME	HILLSBORO PUBLIC LIBRARY
EAU GALLIE PUBLIC LIBRARY	LIBRARYNAME	EAU GALLIE PUBLIC LIBRARY
ANDREW BAYNE MEMORIAL LIBRARY	LIBRARYNAME	ANDREW BAYNE MEMORIAL LIBRARY
ST. LOUIS MERCANTILE LIBRARY	LIBRARYNAME	ST. LOUIS MERCANTILE LIBRARY
NATIONAL LIBRARY OF KUWAIT	LIBRARYNAME	NATIONAL LIBRARY OF KUWAIT
NATIONAL LIBRARY OF KUWAIT	LIBRARYNAME	مكتبة الكويت الوطنية
NATIONAL LIBRARY OF BANGLADESH	LIBRARYNAME	বাংলাদেশ জাতীয় গ্রন্থাগার
NATIONAL LIBRARY OF KAZAKHSTAN	LIBRARYNAME	NATIONAL LIBRARY OF THE REPUBLIC OF KAZAKHSTAN
NATIONAL LIBRARY OF KAZAKHSTAN	LIBRARYNAME	Национальная Библиотека Республики Казахстан
NATIONAL LIBRARY OF VENEZUELA	LIBRARYNAME	BIBLIOTECA NACIONAL DE VENEZUELA
NATIONAL LIBRARY OF VENEZUELA	LIBRARYNAME	NATIONAL LIBRARY OF VENEZUELA
CORVALLIS-BENTON COUNTY PUBLIC LIBRARY	LIBRARYNAME	CORVALLIS-BENTON COUNTY PUBLIC LIBRARY
MULTNOMAH COUNTY LIBRARY	LIBRARYNAME	MULTNOMAH COUNTY LIBRARY
TRINITY COLLEGE LIBRARY	LIBRARYNAME	THE LIBRARY OF TRINITY COLLEGE DUBLIN
DULWICH LIBRARY	LIBRARYNAME	DULWICH LIBRARY
HENRY FORD CENTENNIAL LIBRARY	LIBRARYNAME	HENRY FORD CENTENNIAL LIBRARY
NORTHBROOK PUBLIC LIBRARY	LIBRARYNAME	NORTHBROOK PUBLIC LIBRARY
UNIVERSITY OF HOUSTON LIBRARIES	LIBRARYNAME	UNIVERSITY OF HOUSTON LIBRARIES
SHEFFIELD ARCHIVES	LIBRARYNAME	SHEFFIELD ARCHIVES
KING FAHD NATIONAL LIBRARY	LIBRARYNAME	(KINGDOM OF SAUDI ARABIA)
KING FAHD NATIONAL LIBRARY	LIBRARYNAME	KING FAHD NATIONAL LIBRARY
KING FAHD NATIONAL LIBRARY	LIBRARYNAME	(مكتبة الملك فهد الوطنية)
NATIONAL LIBRARY OF BURKINA FASO	LIBRARYNAME	BIBLIOTHEQUE NATIONALE DU BURKINA
DUNEDIN PUBLIC LIBRARIES	LIBRARYNAME	DUNEDIN PUBLIC LIBRARIES
DUNEDIN PUBLIC LIBRARIES	LIBRARYNAME	Kā KETE WāNAKA O ŌTEPOTI
STATE LIBRARY OF OHIO	LIBRARYNAME	STATE LIBRARY OF OHIO
DARWEN LIBRARY	LIBRARYNAME	DARWEN LIBRARY
AKWESASNE CULTURAL CENTER	LIBRARYNAME	AKWESASNE CULTURAL CENTER
COUNTY OF BRANT PUBLIC LIBRARY	LIBRARYNAME	COUNTY OF BRANT PUBLIC LIBRARY
LEWISTON PUBLIC LIBRARY	LIBRARYNAME	LEWISTON PUBLIC LIBRARY
AUBURN PUBLIC LIBRARY	LIBRARYNAME	AUBURN PUBLIC LIBRARY
INDIAN TRAILS PUBLIC LIBRARY DISTRICT	LIBRARYNAME	INDIAN TRAILS PUBLIC LIBRARY DISTRICT
ALAMOGORDO PUBLIC LIBRARY	LIBRARYNAME	ALAMOGORDO PUBLIC LIBRARY
CECIL COUNTY PUBLIC LIBRARY	LIBRARYNAME	CECIL COUNTY PUBLIC LIBRARY
HERZOG AUGUST LIBRARY	LIBRARYNAME	HERZOG AUGUST LIBRARY
UNIVERSITY OF THE ANDES LIBRARY SERVICES	LIBRARYNAME	SERVICIOS BIBLIOTECARIOS DE LA UNIVERSIDAD DE LOS ANDES
BIBLIOTECA NAZIONALE VITTORIO EMANUELE III	LIBRARYNAME	BIBLIOTECA NAZIONALE
BIBLIOTECA NAZIONALE VITTORIO EMANUELE III	LIBRARYNAME	VITTORIO EMANUELE III
CHRISTCHURCH CITY LIBRARIES	LIBRARYNAME	CHRISTCHURCH CITY LIBRARIES
AUCKLAND LIBRARIES	LIBRARYNAME	AUCKLAND LIBRARIES
AUCKLAND LIBRARIES	LIBRARYNAME	NGā WHARE MāTAURANGA O TāMAKI MAKAURAU
UNCG UNIVERSITY LIBRARIES	LIBRARYNAME	WALTER CLINTON JACKSON LIBRARY
PORTSMOUTH PUBLIC LIBRARY	LIBRARYNAME	PORTSMOUTH PUBLIC LIBRARY
IRVING K. BARBER LEARNING CENTRE	LIBRARYNAME	IRVING K. BARBER LEARNING CENTRE
BRANFORD PRICE MILLAR LIBRARY	LIBRARYNAME	PORTLAND STATE UNIVERSITY LIBRARY
MOUNT PROSPECT PUBLIC LIBRARY	LIBRARYNAME	MOUNT PROSPECT PUBLIC LIBRARY
EAST SMITHFIELD PUBLIC LIBRARY	LIBRARYNAME	EAST SMITHFIELD PUBLIC LIBRARY
GRACE MELLMAN COMMUNITY LIBRARY	LIBRARYNAME	GRACE MELLMAN COMMUNITY LIBRARY
CARLSBAD CITY LIBRARY	LIBRARYNAME	CARLSBAD CITY LIBRARY
RIVERSIDE COUNTY LIBRARY SYSTEM	LIBRARYNAME	RIVERSIDE COUNTY LIBRARY SYSTEM
HEIDELBERG UNIVERSITY LIBRARY	LIBRARYNAME	UNIVERSITY LIBRARY
THOMAS BRANIGAN MEMORIAL LIBRARY	LIBRARYNAME	THOMAS BRANIGAN MEMORIAL LIBRARY
ANDOVER PUBLIC LIBRARY	LIBRARYNAME	ANDOVER PUBLIC LIBRARY
MORTON GROVE PUBLIC LIBRARY	LIBRARYNAME	MORTON GROVE PUBLIC LIBRARY
CENTRAL LIBRARY	LIBRARYNAME	CENTRAL LIBRARY OF NATIONAL AUTONOMOUS UNIVERSITY OF MEXICO
OIL CREEK LIBRARY DISTRICT	LIBRARYNAME	OIL CREEK LIBRARY DISTRICT
NATIONAL TAIWAN LIBRARY	LIBRARYNAME	NATIONAL TAIWAN LIBRARY
NATIONAL TAIWAN LIBRARY	LIBRARYNAME	國立中央圖書館臺灣分館
AUSTRALIAN NATIONAL UNIVERSITY LIBRARY	LIBRARYNAME	AUSTRALIAN NATIONAL UNIVERSITY LIBRARY
UNIVERSITY COLLEGE DUBLIN LIBRARY	LIBRARYNAME	UCD LIBRARYLEABHARLANN UCD
NATIONAL LIBRARY OF ALBANIA	LIBRARYNAME	BIBLIOTEKA KOMBëTARE E SHQIPëRISë
JAMES E. WALKER LIBRARY	LIBRARYNAME	JAMES E. WALKER LIBRARY
LAWRENCE PUBLIC LIBRARY	LIBRARYNAME	LAWRENCE PUBLIC LIBRARY
MASON COUNTY DISTRICT LIBRARY	LIBRARYNAME	MASON COUNTY DISTRICT LIBRARY
LUDINGTON PUBLIC LIBRARY	LIBRARYNAME	LUDINGTON PUBLIC LIBRARY
SCOTTVILLE PUBLIC LIBRARY	LIBRARYNAME	SCOTTVILLE PUBLIC LIBRARY
MAADI LIBRARY	LIBRARYNAME	MAADI LIBRARY
UNIVERSITY OF PRETORIA LIBRARY SERVICES	LIBRARYNAME	UNIVERSITY OF PRETORIA LIBRARY SERVICES
PROVO CITY LIBRARY	LIBRARYNAME	PROVO LIBRARY AT ACADEMY SQUARE
BRITISH LIBRARY	LIBRARYNAME	BRITISH LIBRARY
LIBRARY OF CONGRESS	LIBRARYNAME	LIBRARY OF CONGRESS
GRAFTON PUBLIC LIBRARY	LIBRARYNAME	GRAFTON PUBLIC LIBRARY
UNIVERSITY AT BUFFALO LIBRARIES	LIBRARYNAME	UNIVERSITY AT BUFFALO LIBRARIES
NATIONAL LIBRARY OF LATVIA	LIBRARYNAME	NATIONAL LIBRARY OF LATVIA
NATIONAL LIBRARY OF LATVIA	LIBRARYNAME	LATVIJAS NACIONāLā BIBLIOTēKA
NEWCASTLE UNIVERSITY LIBRARY	LIBRARYNAME	NEWCASTLE UNIVERSITY LIBRARY
KHUDA BAKHSH ORIENTAL LIBRARY	LIBRARYNAME	KHUDA BAKHSH ORIENTAL LIBRARY
KITENGESA COMMUNITY LIBRARY	LIBRARYNAME	KITENGESA COMMUNITY LIBRARY
GREAT RIVER REGIONAL LIBRARY	LIBRARYNAME	GREAT RIVER REGIONAL LIBRARY
DESASEVINI GRAMEENA VAYANASALA	LIBRARYNAME	DESASEVINI GRAMEENA VAYANASALA
RED FEATHER LAKES COMMUNITY LIBRARY	LIBRARYNAME	RED FEATHER LAKES COMMUNITY LIBRARY
CORNELL ENGINEERING LIBRARY	LIBRARYNAME	CORNELL ENGINEERING LIBRARY
PILKINGTON LIBRARY	LIBRARYNAME	PILKINGTON LIBRARY
BENTON HARBOR PUBLIC LIBRARY	LIBRARYNAME	BENTON HARBOR PUBLIC LIBRARY
HENRY C. WOLF LAW LIBRARY	LIBRARYNAME	THE WOLF LAW LIBRARY
MESA PUBLIC LIBRARY	LIBRARYNAME	MESA PUBLIC LIBRARY
MAULANA AZAD LIBRARY	LIBRARYNAME	MAULANA AZAD LIBRARY
SCHIAPPA BRANCH LIBRARY	LIBRARYNAME	SCHIAPPA BRANCH LIBRARY
BERLIN-PECK MEMORIAL LIBRARY	LIBRARYNAME	BERLIN-PECK MEMORIAL LIBRARY
IMAGINON	LIBRARYNAME	IMAGINON: THE JOE AND JOAN MARTIN CENTER
MALCOLM A. LOVE LIBRARY	LIBRARYNAME	MALCOLM A. LOVE LIBRARY
NATIONAL LIBRARY OF THE CZECH REPUBLIC	LIBRARYNAME	NATIONAL LIBRARY
NATIONAL LIBRARY OF THE CZECH REPUBLIC	LIBRARYNAME	OF THE CZECH REPUBLIC
BIBLIOTHECA THYSIANA	LIBRARYNAME	BIBLIOTHECA THYSIANA
METROPOLITAN LIBRARY SYSTEM	LIBRARYNAME	METROPOLITAN LIBRARY SYSTEM
NEWPORT PUBLIC LIBRARY	LIBRARYNAME	NEWPORT PUBLIC LIBRARY
UNIVERSITY LIBRARY OF SOUTHERN DENMARK	LIBRARYNAME	UNIVERSITY LIBRARY OF SOUTHERN DENMARK
HARTFORD PUBLIC LIBRARY	LIBRARYNAME	HARTFORD PUBLIC LIBRARY
MINNESOTA STATE LAW LIBRARY	LIBRARYNAME	MINNESOTA STATE LAW LIBRARY
FORT FRONTENAC LIBRARY	LIBRARYNAME	FORT FRONTENAC LIBRARY, KINGSTON, ONTARIO, CANADA
MEDICINE HAT PUBLIC LIBRARY	LIBRARYNAME	MEDICINE HAT PUBLIC LIBRARY
MERRILL-CAZIER LIBRARY	LIBRARYNAME	MERRILL-CAZIER LIBRARY
COOK MEMORIAL PUBLIC LIBRARY DISTRICT	LIBRARYNAME	COOK MEMORIAL PUBLIC LIBRARY DISTRICT
MONROE COUNTY DISTRICT LIBRARY, WOODSFIELD, OHIO	LIBRARYNAME	MONROE COUNTY DISTRICT LIBRARY
DAKOTA COUNTY LIBRARY	LIBRARYNAME	DAKOTA COUNTY PUBLIC LIBRARY SYSTEM
GREIFSWALD UNIVERSITY LIBRARY	LIBRARYNAME	UNIVERSITäTSBIBLIOTHEK GREIFSWALD
PALM BEACH COUNTY LIBRARY SYSTEM	LIBRARYNAME	PALM BEACH COUNTY LIBRARY SYSTEM
NANJING LIBRARY	LIBRARYNAME	NANJING LIBRARY
NANJING LIBRARY	LIBRARYNAME	南京图书馆
BIBLIOTECA NAZIONALE CENTRALE DI ROMA	LIBRARYNAME	BIBLIOTECA NAZIONALE CENTRALE DI ROMA
LA CRESCENT PUBLIC LIBRARY	LIBRARYNAME	LA CRESCENT PUBLIC LIBRARY
CODRINGTON LIBRARY	LIBRARYNAME	THE CODRINGTON LIBRARY
FORT WORTH LIBRARY	LIBRARYNAME	FORT WORTH PUBLIC LIBRARY
MIMICO CENTENNIAL LIBRARY	LIBRARYNAME	MIMICO CENTENNIAL LIBRARY
LIBRARY INFORMATION NETWORK OF CLACKAMAS COUNTY	LIBRARYNAME	LIBRARIES IN CLACKAMAS COUNTY
CARNEGIE LIBRARY OF HOMESTEAD	LIBRARYNAME	CARNEGIE LIBRARY OF HOMESTEAD
SEWICKLEY PUBLIC LIBRARY	LIBRARYNAME	SEWICKLEY PUBLIC LIBRARY OF THE QUAKER VALLEY SCHOOL DISTRICT
RIZAL LIBRARY	LIBRARYNAME	RIZAL LIBRARY
NORTHERN IRELAND MUSIC ARCHIVE	LIBRARYNAME	NORTHERN IRELAND MUSIC ARCHIVE
FARMINGTON COMMUNITY LIBRARY	LIBRARYNAME	FARMINGTON COMMUNITY LIBRARY
ATENEO PROFESSIONAL SCHOOLS LIBRARY	LIBRARYNAME	ATENEO PROFESSIONAL SCHOOLS LIBRARY
SMITHSONIAN LIBRARIES	LIBRARYNAME	SMITHSONIAN LIBRARIES
FRASER VALLEY REGIONAL LIBRARY	LIBRARYNAME	FRASER VALLEY REGIONAL LIBRARY
D. B. WELDON LIBRARY	LIBRARYNAME	THE D. B. WELDON LIBRARY
METROPOLITAN LIBRARY SYSTEM	LIBRARYNAME	METROPOLITAN LIBRARY SYSTEM
BIBLIOTECA PALATINA, PARMA	LIBRARYNAME	BIBLIOTECA PALATINA
WIRTZ LABOR LIBRARY	LIBRARYNAME	WIRTZ LABOR LIBRARY
NEWBERG PUBLIC LIBRARY	LIBRARYNAME	NEWBERG PUBLIC LIBRARY
YORK UNIVERSITY LIBRARIES	LIBRARYNAME	YORK UNIVERSITY LIBRARIES
STADSBIBLIOTHEEK HAARLEM	LIBRARYNAME	STADSBIBLIOTHEEK HAARLEM
XIAMEN UNIVERSITY LIBRARIES	LIBRARYNAME	XIAMEN UNIVERSITY LIBRARIES
ZHEJIANG UNIVERSITY LIBRARIES SYSTEM	LIBRARYNAME	ZHEJIANG UNIVERSITY LIBRARIES
UNIVERSITY OF TORONTO LIBRARIES	LIBRARYNAME	UNIVERSITY OF TORONTO LIBRARIES
EDAYAR GRAMEENA VAYANASALA	LIBRARYNAME	EDAYAR GRAMEENA VAYANASALA
NATIONAL LIBRARY OF CAPE VERDE	LIBRARYNAME	INSTITUTO DE BIBLIOTECA NACIONAL E DO LIVRO
GERMAN NATIONAL LIBRARY OF ECONOMICS	LIBRARYNAME	GERMAN NATIONAL LIBRARY OF ECONOMICS
GERMAN NATIONAL LIBRARY OF ECONOMICS	LIBRARYNAME	(DEUTSCHE ZENTRALBIBLIOTHEK FüR WIRTSCHAFTSWISSENSCHAFTEN )
HERRICK DISTRICT LIBRARY	LIBRARYNAME	HERRICK DISTRICT LIBRARY
IUPUI UNIVERSITY LIBRARY	LIBRARYNAME	IUPUI UNIVERSITY LIBRARY
RICHMOND PUBLIC LIBRARY	LIBRARYNAME	RICHMOND PUBLIC LIBRARY
HERSHEY PUBLIC LIBRARY	LIBRARYNAME	HERSHEY PUBLIC LIBRARY
SHORTGRASS LIBRARY SYSTEM	LIBRARYNAME	SHORTGRASS PUBLIC LIBRARY SYSTEM
LEROY PUBLIC LIBRARY	LIBRARYNAME	LEROY PUBLIC LIBRARY
ROCHESTER PUBLIC LIBRARY	LIBRARYNAME	ROCHESTER PUBLIC LIBRARY
SPRING GROVE PUBLIC LIBRARY	LIBRARYNAME	SPRING GROVE PUBLIC LIBRARY
ALBERT LEA PUBLIC LIBRARY	LIBRARYNAME	ALBERT LEA PUBLIC LIBRARY
ZUMBROTA PUBLIC LIBRARY	LIBRARYNAME	ZUMBROTA PUBLIC LIBRARY
WINONA PUBLIC LIBRARY	LIBRARYNAME	WINONA PUBLIC LIBRARY
WEST CONCORD PUBLIC LIBRARY	LIBRARYNAME	WEST CONCORD PUBLIC LIBRARY
WABASHA PUBLIC LIBRARY	LIBRARYNAME	WABASHA PUBLIC LIBRARY
ST. CHARLES PUBLIC LIBRARY	LIBRARYNAME	ST. CHARLES PUBLIC LIBRARY
SPRING VALLEY PUBLIC LIBRARY	LIBRARYNAME	SPRING VALLEY PUBLIC LIBRARY
RUSHFORD PUBLIC LIBRARY	LIBRARYNAME	RUSHFORD PUBLIC LIBRARY
MáRIO DE ANDRADE LIBRARY	LIBRARYNAME	BIBLIOTECA MáRIO DE ANDRADE
WITTLIFF COLLECTIONS	LIBRARYNAME	THE WITTLIFF COLLECTIONS, TEXAS STATE UNIVERSITY, SAN MARCOS, TX
DAVENPORT PUBLIC LIBRARY	LIBRARYNAME	DAVENPORT PUBLIC LIBRARY
PRESTON PUBLIC LIBRARY	LIBRARYNAME	PRESTON PUBLIC LIBRARY
PINE ISLAND VAN HORN PUBLIC LIBRARY	LIBRARYNAME	PINE ISLAND VAN HORN PUBLIC LIBRARY
OWATONNA PUBLIC LIBRARY	LIBRARYNAME	OWATONNA PUBLIC LIBRARY
NORTHFIELD PUBLIC LIBRARY	LIBRARYNAME	NORTHFIELD PUBLIC LIBRARY
BLOOMING PRAIRIE PUBLIC LIBRARY	LIBRARYNAME	BLOOMING PRAIRIE PUBLIC LIBRARY
AUSTIN PUBLIC LIBRARY	LIBRARYNAME	AUSTIN PUBLIC LIBRARY
MABEL PUBLIC LIBRARY	LIBRARYNAME	MABEL PUBLIC LIBRARY
BROWNSDALE PUBLIC LIBRARY	LIBRARYNAME	BROWNSDALE PUBLIC LIBRARY
CANNON FALLS PUBLIC LIBRARY	LIBRARYNAME	CANNON FALLS LIBRARY
CALEDONIA PUBLIC LIBRARY	LIBRARYNAME	CALEDONIA PUBLIC LIBRARY
KENYON PUBLIC LIBRARY	LIBRARYNAME	KENYON PUBLIC LIBRARY
KASSON PUBLIC LIBRARY	LIBRARYNAME	KASSON PUBLIC LIBRARY
HOUSTON PUBLIC LIBRARY	LIBRARYNAME	HOUSTON PUBLIC LIBRARY
CHATFIELD PUBLIC LIBRARY	LIBRARYNAME	CHATFIELD PUBLIC LIBRARY
U. GRANT MILLER LIBRARY	LIBRARYNAME	U. GRANT MILLER LIBRARY
VANDERBILT TELEVISION NEWS ARCHIVE	LIBRARYNAME	VANDERBILT TELEVISION NEWS ARCHIVE
VILNIUS UNIVERSITY LIBRARY	LIBRARYNAME	VILNIUS UNIVERSITY LIBRARY
ST JOHNS COUNTY PUBLIC LIBRARY SYSTEM	LIBRARYNAME	ST JOHNS COUNTY PUBLIC LIBRARY SYSTEM
ST. LOUIS COUNTY LIBRARY	LIBRARYNAME	ST. LOUIS COUNTY LIBRARY
PATMA LIBRARY	LIBRARYNAME	PERPUSTAKAAN ALAM DAN TAMADUN MELAYU
NATIONAL DIGITAL LIBRARY OF KOREA	LIBRARYNAME	NATIONAL DIGITAL LIBRARY OF KOREA
BUKIT BATOK COMMUNITY LIBRARY	LIBRARYNAME	BUKIT BATOK COMMUNITY LIBRARY
WAUCONDA AREA LIBRARY	LIBRARYNAME	WAUCONDA AREA LIBRARY
PEMBROKE PUBLIC LIBRARY	LIBRARYNAME	PEMBROKE PUBLIC LIBRARY
BAIT AL HIKMAT	LIBRARYNAME	BAIT AL-HIKMAT
BAIT AL HIKMAT	LIBRARYNAME	بیت الحکمہ
DUKE UNIVERSITY LIBRARIES	LIBRARYNAME	DUKE UNIVERSITY LIBRARIES
CAMBRIDGE UNIVERSITY MUSEUM OF ZOOLOGY	LIBRARYNAME	UNIVERSITY MUSEUM OF ZOOLOGY, CAMBRIDGE
WEST LINCOLN PUBLIC LIBRARY	LIBRARYNAME	WEST LINCOLN PUBLIC LIBRARY
COLEGIO ARUBANO	LIBRARYNAME	COLEGIO ARUBANO
FAYETTEVILLE PUBLIC LIBRARY	LIBRARYNAME	FAYETTEVILLE PUBLIC LIBRARY
JEFFERSON HILLS PUBLIC LIBRARY	LIBRARYNAME	JEFFERSON HILLS PUBLIC LIBRARY
EASTERN COUNTIES REGIONAL LIBRARY	LIBRARYNAME	EASTERN COUNTIES REGIONAL LIBRARY
ATLANTIC COUNTY LIBRARY	LIBRARYNAME	ATLANTIC COUNTY LIBRARY SYSTEM
WILLIAM F. EKSTROM LIBRARY	LIBRARYNAME	WILLIAM F. EKSTROM LIBRARY
UNIVERSITY OF CHICAGO LIBRARY	LIBRARYNAME	UNIVERSITY OF CHICAGO LIBRARY
MCGILL UNIVERSITY LIBRARY	LIBRARYNAME	MCGILL UNIVERSITY LIBRARY
WESTPORT LIBRARY	LIBRARYNAME	THE WESTPORT LIBRARY
PANJAB DIGITAL LIBRARY	LIBRARYNAME	PANJAB DIGITAL LIBRARY
JOLIET PUBLIC LIBRARY	LIBRARYNAME	JOLIET PUBLIC LIBRARY
VIGO COUNTY PUBLIC LIBRARY	LIBRARYNAME	VIGO COUNTY PUBLIC LIBRARY
VICTOR CIVITA LATIN AMERICAN LIBRARY	LIBRARYNAME	BIBLIOTECA LATINO-AMERICANA VICTOR CIVITA
MARK AND EMILY TURNER MEMORIAL LIBRARY	LIBRARYNAME	MARK & EMILY TURNER MEMORIAL LIBRARY
SHAKER HEIGHTS PUBLIC LIBRARY	LIBRARYNAME	SHAKER HEIGHTS PUBLIC LIBRARY
NATIONAL SCIENCE LIBRARY & RESOURCE CENTRE – SRI LANKA	LIBRARYNAME	NSLRC
UNIVERSITY OF NORTH TEXAS LIBRARIES	LIBRARYNAME	UNIVERSITY OF NORTH TEXAS LIBRARIES\N----
DULUTH PUBLIC LIBRARY	LIBRARYNAME	DULUTH PUBLIC LIBRARY
CASS DISTRICT LIBRARY	LIBRARYNAME	CASS DISTRICT LIBRARY
KOREA UNIVERSITY LIBRARY SYSTEM	LIBRARYNAME	KOREA UNIVERSITY LIBRARIES
SAMUEL READ HALL LIBRARY	LIBRARYNAME	SAMUEL READ HALL LIBRARY
STATE CENTRAL LIBRARY, HYDERABAD	LIBRARYNAME	STATE CENTRAL LIBRARY HYDERABAD
CHESTER COUNTY LIBRARY SYSTEM	LIBRARYNAME	CHESTER COUNTY LIBRARY SYSTEM
CLERMONT COUNTY PUBLIC LIBRARY	LIBRARYNAME	CLERMONT COUNTY PUBLIC LIBRARY
RICHLAND LIBRARY	LIBRARYNAME	RICHLAND LIBRARY
KINGSTON FRONTENAC PUBLIC LIBRARY	LIBRARYNAME	KINGSTON FRONTENAC PUBLIC LIBRARY
VAUGHAN PUBLIC LIBRARIES	LIBRARYNAME	VAUGHAN PUBLIC LIBRARIES
TCHAIKOVSKY HOUSE IN TAGANROG	LIBRARYNAME	Нотно-музыкальный отдел Центральной городской публичной библиотеки имени А.П.Чехова
NATIONAL LIBRARY OF NORTHERN CYPRUS	LIBRARYNAME	NATIONAL LIBRARY OF NORTHERN CYPRUS
NATIONAL LIBRARY OF NORTHERN CYPRUS	LIBRARYNAME	MILLî KüTüPHANE
ALPENA COUNTY LIBRARY	LIBRARYNAME	ALPENA COUNTY LIBRARY
SERVING EVERY OHIOAN LIBRARY CENTER	LIBRARYNAME	SERVING EVERY OHIOAN LIBRARY CONSORTIUM
JOHN CRERAR LIBRARY	LIBRARYNAME	JOHN CRERAR LIBRARY
CALUMET PUBLIC LIBRARY	LIBRARYNAME	CALUMET PUBLIC LIBRARY
GEORGE F SMITH LIBRARY OF THE HEALTH SCIENCES	LIBRARYNAME	GEORGE F SMITH LIBRARY OF THE HEALTH SCIENCES
CENTRAL PHILIPPINE UNIVERSITY LIBRARY	LIBRARYNAME	CENTRAL PHILIPPINE UNIVERSITY LIBRARY
CENTRAL PHILIPPINE UNIVERSITY LIBRARY	LIBRARYNAME	----
ROBERT H. GODDARD LIBRARY	LIBRARYNAME	ROBERT H. GODDARD LIBRARY
WORCESTER PUBLIC LIBRARY	LIBRARYNAME	WORCESTER PUBLIC LIBRARY
BIBLIOTHèQUE INGUIMBERTINE	LIBRARYNAME	BIBLIOTHèQUE INGUIMBERTINE
E-RARA.CH	LIBRARYNAME	E-RARA.CH
LINDEN PUBLIC LIBRARY	LIBRARYNAME	LINDEN PUBLIC LIBRARY
ITU MUSTAFA INAN LIBRARY	LIBRARYNAME	ITU MUSTAFA INAN LIBRARY
NUECES COUNTY KEACH FAMILY LIBRARY	LIBRARYNAME	NUECES COUNTY KEACH FAMILY LIBRARY
SUPERIOR PUBLIC LIBRARY	LIBRARYNAME	SUPERIOR PUBLIC LIBRARY
SPIES PUBLIC LIBRARY	LIBRARYNAME	SPIES PUBLIC LIBRARY
CALCASIEU PARISH PUBLIC LIBRARY	LIBRARYNAME	CALCASIEU PARISH PUBLIC LIBRARY
YUMA COUNTY LIBRARY DISTRICT	LIBRARYNAME	YUMA COUNTY LIBRARY
CAL POLY POMONA UNIVERSITY LIBRARY	LIBRARYNAME	CAL POLY POMONA UNIVERSITY LIBRARY
UNIVERSITY OF COLOMBO LIBRARY	LIBRARYNAME	UNIVERSITY OF COLOMBO LIBRARY
FEMINIST LIBRARY	LIBRARYNAME	FEMINIST LIBRARY
VISALIA BRANCH LIBRARY	LIBRARYNAME	VISALIA BRANCH LIBRARY
KERN COUNTY LIBRARY	LIBRARYNAME	KERN COUNTY LIBRARY
SAINT-SULPICE LIBRARY	LIBRARYNAME	SAINT-SULPICE LIBRARY
SAINT-SULPICE LIBRARY	LIBRARYNAME	BIBLIOTHèQUE SAINT-SULPICE
ZAPORIZHIA REGION UNIVERSAL SCIENTIFIC LIBRARY NAMED AFTER A.M. GORKY	LIBRARYNAME	ZAPORIZHIA REGION UNIVERSAL SCIENTIFIC LIBRARY NAMED AFTER A.M. GORKY
NATIONAL LIBRARY OF INDONESIA	LIBRARYNAME	PERPUSTAKAAN NASIONAL REPUBLIK INDONESIA
CALIFORNIA AREA PUBLIC LIBRARY	LIBRARYNAME	CALIFORNIA AREA PUBLIC LIBRARY
WARSAW PUBLIC LIBRARY	LIBRARYNAME	BIBLIOTEKA PUBLICZNA M.ST. WARSZAWY
WARSAW UNIVERSITY LIBRARY	LIBRARYNAME	BIBLIOTEKA UNIWERSYTECKA W WARSZAWIE
STATE LIBRARY OF MASSACHUSETTS	LIBRARYNAME	STATE LIBRARY OF MASSACHUSETTS
BYTOWN MECHANICS' INSTITUTE	LIBRARYNAME	BYTOWN MECHANICS' INSTITUTE.
HULL HISTORY CENTRE	LIBRARYNAME	HULL HISTORY CENTRE
HUMBOLDT PUBLIC LIBRARY	LIBRARYNAME	HUMBOLDT PUBLIC LIBRARY
OSHAWA PUBLIC LIBRARY	LIBRARYNAME	OSHAWA PUBLIC LIBRARIES
ZENTRALBIBLIOTHEK DER TU UND UDK BERLIN	LIBRARYNAME	UNIVERSITY LIBRARY OF THE TU BERLIN AND UDK
BIBLIOTECA COMUNALE DEGLI INTRONATI	LIBRARYNAME	BIBLIOTECA COMUNALE DEGLI INTRONATI
EUGENE PUBLIC LIBRARY	LIBRARYNAME	EUGENE PUBLIC LIBRARY
FOLEY CENTER LIBRARY	LIBRARYNAME	FOLEY CENTER
WATERFIELD LIBRARY	LIBRARYNAME	HARRY LEE WATERFIELD LIBRARY
BUSOLWE PUBLIC LIBRARY	LIBRARYNAME	BUSOLWE PUBLIC LIBRARY
HALTON HILLS PUBLIC LIBRARY	LIBRARYNAME	HALTON HILLS PUBLIC LIBRARY
ANNA CENTENARY LIBRARY	LIBRARYNAME	NATIONAL LIBRARY
AVRIL ROBARTS LIBRARY	LIBRARYNAME	AVRIL ROBARTS LIBRARY
GLADSTONE LIBRARY	LIBRARYNAME	BLOOR AND GLADSTONE LIBRARY
SOUTH ASIAN AMERICAN DIGITAL ARCHIVE	LIBRARYNAME	SOUTH ASIAN AMERICAN DIGITAL ARCHIVE
MANDEL PUBLIC LIBRARY OF WEST PALM BEACH	LIBRARYNAME	MANDEL PUBLIC LIBRARY OF WEST PALM BEACH
WALKER MEMORIAL LIBRARY	LIBRARYNAME	WALKER MEMORIAL LIBRARY
GUILFORD MEMORIAL LIBRARY	LIBRARYNAME	GUILFORD MEMORIAL LIBRARY
DELHI PUBLIC LIBRARY	LIBRARYNAME	DELHI PUBLIC LIBRARY
LAWRENCE PUBLIC LIBRARY	LIBRARYNAME	LAWRENCE PUBLIC LIBRARY
HONAN-ALLSTON LIBRARY	LIBRARYNAME	HONAN-ALLSTON BRANCH OF THE BPL
NEHRU MEMORIAL MUSEUM & LIBRARY	LIBRARYNAME	NEHRU MEMORIAL MUSEUM & LIBRARY
MAUREEN AND MIKE MANSFIELD LIBRARY	LIBRARYNAME	MAUREEN AND MIKE MANSFIELD LIBRARY
MAUREEN AND MIKE MANSFIELD LIBRARY	LIBRARYNAME	UNIVERSITY OF MONTANA
OLD STRATHCONA BRANCH	LIBRARYNAME	OLD STRATHCONA BRANCH
STANLEY A. MILNER LIBRARY	LIBRARYNAME	STANLEY A. MILNER LIBRARY
MILWAUKEE COUNTY FEDERATED LIBRARY SYSTEM	LIBRARYNAME	MILWAUKEE COUNTY FEDERATED LIBRARY SYSTEM
TSURUMA CENTRAL LIBRARY	LIBRARYNAME	名古屋市鶴舞中央図書館
JOHNSON COUNTY PUBLIC LIBRARY	LIBRARYNAME	JOHNSON COUNTY PUBLIC LIBRARY
INTERNATIONAL DUNHUANG PROJECT	LIBRARYNAME	INTERNATIONAL DUNHUANG PROJECT
COLOGNE PUBLIC LIBRARY	LIBRARYNAME	STADTBIBLIOTHEK KöLN
OAKLAND PUBLIC LIBRARY	LIBRARYNAME	OAKLAND PUBLIC LIBRARY
LIBRARY OF THE FREE UNIVERSITY OF BOZEN-BOLZANO	LIBRARYNAME	THE LIBRARY OF THE FREE UNIVERSITY OF BOZEN/BOLZANO
JOE AND RIKA MANSUETO LIBRARY	LIBRARYNAME	JOE AND RIKA MANSUETO LIBRARY
PUBLIC LIBRARY OF ENID AND GARFIELD COUNTY	LIBRARYNAME	PUBLIC LIBRARY OF ENID AND GARFIELD COUNTY
CORY LIBRARY FOR HISTORICAL RESEARCH	LIBRARYNAME	CORY LIBRARY FOR HUMANITIES RESEARCH
MADISON, NEBRASKA PUBLIC LIBRARY	LIBRARYNAME	MADISON PUBLIC LIBRARY
UNIVERSITY CITY PUBLIC LIBRARY	LIBRARYNAME	UNIVERSITY CITY PUBLIC LIBRARY
FERGUSON MUNICIPAL PUBLIC LIBRARY	LIBRARYNAME	FERGUSON MUNICIPAL PUBLIC LIBRARY
EUCLID PUBLIC LIBRARY	LIBRARYNAME	EUCLID PUBLIC LIBRARY
PRINCETON UNIVERSITY LIBRARY	LIBRARYNAME	PRINCETON UNIVERSITY LIBRARY
PHILLIPS LIBRARY	LIBRARYNAME	PHILLIPS LIBRARY
DERBY CENTRAL LIBRARY	LIBRARYNAME	DERBY CENTRAL LIBRARY
DR. VIJAY PAL MEMORIAL LIBRARY	LIBRARYNAME	DR. VIJAY PAL MEMORIAL LIBRARY
SAYAJI RAO GAEKWAD LIBRARY	LIBRARYNAME	SAYAJI RAO GAEKWAD LIBRARY
MUNICH DIGITIZATION CENTER	LIBRARYNAME	MUNICH DIGITIZATION CENTER
SAFFORD CITY-GRAHAM COUNTY LIBRARY	LIBRARYNAME	SAFFORD CITY-GRAHAM COUNTY LIBRARY
DOHENY LIBRARY	LIBRARYNAME	DOHENY LIBRARY
BIRKENHEAD CENTRAL LIBRARY	LIBRARYNAME	BIRKENHEAD CENTRAL LIBRARY
CALAIS FREE LIBRARY	LIBRARYNAME	CALAIS FREE LIBRARY
GRATEFUL DEAD ARCHIVE	LIBRARYNAME	GRATEFUL DEAD ARCHIVE
CHARLES M. BAILEY PUBLIC LIBRARY	LIBRARYNAME	CHARLES M. BAILEY PUBLIC LIBRARY
READING CENTRAL LIBRARY	LIBRARYNAME	READING CENTRAL LIBRARY
CORNISH LIBRARY	LIBRARYNAME	CORNISH LIBRARY
EVELYN RUTNAM INSTITUTE FOR INTER-CULTURAL STUDIES	LIBRARYNAME	EVELYN RUTNAM INSTITUTE FOR INTER-CULTURAL STUDIES
YUBA COUNTY LIBRARY	LIBRARYNAME	YUBA COUNTY LIBRARY
ANDERSONIAN LIBRARY	LIBRARYNAME	ANDERSONIAN LIBRARY
HEDBERG PUBLIC LIBRARY	LIBRARYNAME	HEDBERG PUBLIC LIBRARY
PENINSULA LIBRARY SYSTEM	LIBRARYNAME	PENINSULA LIBRARY SYSTEM
MONCTON PUBLIC LIBRARY	LIBRARYNAME	MONCTON PUBLIC LIBRARY
MéRIDA BOLIVARIAN LIBRARY	LIBRARYNAME	BIBLIOTECA BOLIVARIANA DE MéRIDA
SHERBORN LIBRARY	LIBRARYNAME	SHERBORN LIBRARY
WEBSTER GROVES PUBLIC LIBRARY	LIBRARYNAME	WEBSTER GROVES PUBLIC LIBRARY
BROOKS PUBLIC LIBRARY	LIBRARYNAME	BROOKS PUBLIC LIBRARY
MIGUEL DE BENAVIDES LIBRARY	LIBRARYNAME	MIGUEL DE BENAVIDES LIBRARY
MIGUEL DE BENAVIDES LIBRARY	LIBRARYNAME	AKLATANG MIGUEL DE BENAVIDES
MIGUEL DE BENAVIDES LIBRARY	LIBRARYNAME	BIBLIOTECA MIGUEL DE BENAVIDES
BRUCE T. HALLE LIBRARY	LIBRARYNAME	BRUCE T. HALLE LIBRARY
UNAH LIBRARY	LIBRARYNAME	UNAH LIBRARY
INSTITUTO AUTóNOMO DE BIBLIOTECAS E INFORMACIóN DEL ESTADO MéRIDA	LIBRARYNAME	INSTITUTO AUTóNOMO DE BIBLIOTECAS E INFORMACIóN DEL ESTADO MéRIDA
ROCKLAND PUBLIC LIBRARY	LIBRARYNAME	ROCKLAND PUBLIC LIBRARY
BROWN MEMORIAL LIBRARY	LIBRARYNAME	BROWN MEMORIAL LIBRARY
SANTA MONICA PUBLIC LIBRARY	LIBRARYNAME	SANTA MONICA PUBLIC LIBRARY
NATIONAL LIBRARY OF MONGOLIA	LIBRARYNAME	Монгол Улсын Үндэсний Номын Сан
UNIVERSITY OF ZAMBIA LIBRARY	LIBRARYNAME	UNIVERSITY OF ZAMBIA LIBRARY
BIBLIOTHèQUE MUNICIPALE DE DOUAI	LIBRARYNAME	BIBLIOTHèQUE MARCELINE DESBORDES-VALMORE
NEW YORK FREE CIRCULATING LIBRARY	LIBRARYNAME	NEW YORK FREE CIRCULATING LIBRARY
CARNEGIE PUBLIC LIBRARY	LIBRARYNAME	CARNEGIE PUBLIC LIBRARY
CZECH NATIONAL LIBRARY OF TECHNOLOGY	LIBRARYNAME	CZECH NATIONAL LIBRARY OF TECHNOLOGY
CZECH NATIONAL LIBRARY OF TECHNOLOGY	LIBRARYNAME	(NáRODNí TECHNICKá KNIHOVNA )
BARRIE PUBLIC LIBRARY	LIBRARYNAME	BARRIE PUBLIC LIBRARY
PONCE MUNICIPAL LIBRARY	LIBRARYNAME	BIBLIOTECA MUNICIPAL MARIANA SUáREZ DE LONGO
JUBILEE LIBRARY, BRIGHTON	LIBRARYNAME	JUBILEE LIBRARY
LITHGOW PUBLIC LIBRARY	LIBRARYNAME	LITHGOW PUBLIC LIBRARY
PROSVJETA	LIBRARYNAME	''
INTERNATIONAL LIBRARY LA VIGNA	LIBRARYNAME	BIBLIOTECA INTERNAZIONALE LA VIGNA
GARDINER PUBLIC LIBRARY	LIBRARYNAME	GARDINER PUBLIC LIBRARY
WATERVILLE PUBLIC LIBRARY	LIBRARYNAME	WATERVILLE PUBLIC LIBRARY
NATIONAL LIBRARY OF ANGOLA	LIBRARYNAME	NATIONAL LIBRARY OF ANGOLA
NATIONAL LIBRARY OF ANGOLA	LIBRARYNAME	BIBLIOTECA NACIONAL DE ANGOLA
NATIONAL LIBRARY OF VIETNAM	LIBRARYNAME	THư VIệN QUốC GIA VIệT NAM
NATIONAL LIBRARY OF JAMAICA	LIBRARYNAME	NATIONAL LIBRARY OF JAMAICA
NASHVILLE PUBLIC LIBRARY	LIBRARYNAME	NASHVILLE PUBLIC LIBRARY
CAMDEN PUBLIC LIBRARY	LIBRARYNAME	CAMDEN PUBLIC LIBRARY
CURTIS MEMORIAL LIBRARY	LIBRARYNAME	CURTIS MEMORIAL LIBRARY
SOUTHWEST HARBOR PUBLIC LIBRARY	LIBRARYNAME	SOUTHWEST HARBOR PUBLIC LIBRARY
COLUMBIA HEIGHTS PUBLIC LIBRARY	LIBRARYNAME	COLUMBIA HEIGHTS PUBLIC LIBRARY
ULYSSES PHILOMATHIC LIBRARY	LIBRARYNAME	ULYSSES PHILOMATHIC LIBRARY
THE PEOPLE'S LIBRARY	LIBRARYNAME	THE PEOPLE'S LIBRARY
BAMBERG STATE LIBRARY	LIBRARYNAME	STAATSBIBLIOTHEK BAMBERG
JOHN M. PFAU LIBRARY	LIBRARYNAME	JOHN M. PFAU LIBRARY
MONTANA STATE UNIVERSITY LIBRARY	LIBRARYNAME	MONTANA STATE UNIVERSITY LIBRARY
PRESBYTERIAN HISTORICAL SOCIETY	LIBRARYNAME	PRESBYTERIAN HISTORICAL SOCIETY
INFORMATION CENTRE FOR FOREIGN LANGUAGE RESEARCH	LIBRARYNAME	INFORMATIONSZENTRUM FüR FREMDSPRACHENFORSCHUNG
LONGUEUIL PUBLIC LIBRARIES NETWORK	LIBRARYNAME	LE RéSEAU DES BIBLIOTHèQUES PUBLIQUES DE LONGUEUIL
CONCORDIA UNIVERSITY LIBRARIES	LIBRARYNAME	CONCORDIA UNIVERSITY LIBRARIES
KOBE CITY ARCHIVES	LIBRARYNAME	KOBE CITY ARCHIVES
HAINAN LIBRARY	LIBRARYNAME	HAINAN LIBRARY
TAMIL HERITAGE FOUNDATION	LIBRARYNAME	TAMIL HERITAGE FOUNDATION
REPUBLICAN SCIENTIFIC MEDICAL LIBRARY	LIBRARYNAME	Рэспубліканская навуковая медыцынская бібліятэка
REPUBLICAN SCIENTIFIC MEDICAL LIBRARY	LIBRARYNAME	Республиканская научная медицинская библиотека
PRUSSIAN HERITAGE IMAGE ARCHIVE	LIBRARYNAME	PRUSSIAN HERITAGE IMAGE ARCHIVE
PRUSSIAN HERITAGE IMAGE ARCHIVE	LIBRARYNAME	BILDARCHIV PREUßISCHER KULTURBESITZ
KUNSTBIBLIOTHEK BERLIN	LIBRARYNAME	KUNSTBIBLIOTHEK BERLIN
NATIONAL AND UNIVERSITY LIBRARY OF THE REPUBLIKA SRPSKA	LIBRARYNAME	Народна и универзитетска библиотека Републике Српске
JOHANNESBURG CITY LIBRARY	LIBRARYNAME	JOHANNESBURG CITY LIBRARY
SURREY CITY CENTRE PUBLIC LIBRARY	LIBRARYNAME	CITY CENTRE LIBRARY, SURREY LIBRARIES
SEELEY G. MUDD MANUSCRIPT LIBRARY	LIBRARYNAME	SEELEY G. MUDD MANUSCRIPT LIBRARY
EVANSVILLE VANDERBURGH PUBLIC LIBRARY	LIBRARYNAME	EVANSVILLE VANDERBURGH
EVANSVILLE VANDERBURGH PUBLIC LIBRARY	LIBRARYNAME	PUBLIC LIBRARY
WILSONVILLE PUBLIC LIBRARY	LIBRARYNAME	WILSONVILLE PUBLIC LIBRARY
BERLIN CENTRAL AND REGIONAL LIBRARY	LIBRARYNAME	ZENTRAL- UND LANDESBIBLIOTHEK BERLIN
NEW YORK LAW INSTITUTE	LIBRARYNAME	THE NEW YORK LAW INSTITUTE
HESSIAN STATE LIBRARY	LIBRARYNAME	LANDESBIBLIOTHEK WIESBADEN
THRISSUR PUBLIC LIBRARY	LIBRARYNAME	THRISSUR PUBLIC LIBRARY
LAWRENCE MEMORIAL LIBRARY	LIBRARYNAME	LAWRENCE MEMORIAL LIBRARY
HEREFORD CATHEDRAL LIBRARY	LIBRARYNAME	HEREFORD CATHEDRAL LIBRARY
KROPYVNYTSKYI REGION UNIVERSAL RESEARCH LIBRARY	LIBRARYNAME	KROPYVNYTSKYI REGIONAL UNIVERSAL RESEARCH LIBRARY NAMED AFTER D. CHIZHEVSKY
DES MOINES PUBLIC LIBRARY	LIBRARYNAME	DES MOINES PUBLIC LIBRARY
MONROE COUNTY PUBLIC LIBRARY	LIBRARYNAME	MONROE COUNTY PUBLIC LIBRARY
EAST GREENBUSH COMMUNITY LIBRARY	LIBRARYNAME	EAST GREENBUSH COMMUNITY LIBRARY
KURSK STATE UNIVERSITY LIBRARY	LIBRARYNAME	Научная библиотека Курского государственного университета
THE TEXAS COLLECTION	LIBRARYNAME	THE TEXAS COLLECTION, BAYLOR UNIVERSITY, WACO, TX
HUBBARD FREE LIBRARY	LIBRARYNAME	HUBBARD FREE LIBRARY
BIBLIOTECA PALAFOXIANA	LIBRARYNAME	BIBLIOTECA PALAFOXIANA
SAINTE-BARBE LIBRARY	LIBRARYNAME	BIBLIOTHèQUE SAINTE-BARBE
GERMAN NATIONAL LIBRARY OF MEDICINE	LIBRARYNAME	GERMAN NATIONAL LIBRARY OF MEDICINE
GERMAN NATIONAL LIBRARY OF MEDICINE	LIBRARYNAME	(DEUTSCHE ZENTRALBIBLIOTHEK FüR MEDIZIN)
GERMAN NATIONAL LIBRARY OF SCIENCE AND TECHNOLOGY	LIBRARYNAME	GERMAN NATIONAL LIBRARY OF SCIENCE AND TECHNOLOGY
GERMAN NATIONAL LIBRARY OF SCIENCE AND TECHNOLOGY	LIBRARYNAME	(TECHNISCHE INFORMATIONSBIBLIOTHEK )
CLEARVIEW PUBLIC LIBRARY	LIBRARYNAME	CLEARVIEW PUBLIC LIBRARY
WEST GERMAN AUDIO BOOK LIBRARY FOR THE BLIND	LIBRARYNAME	WEST GERMAN AUDIO BOOK LIBRARY FOR THE BLIND
WEST GERMAN AUDIO BOOK LIBRARY FOR THE BLIND	LIBRARYNAME	(WESTDEUTSCHE BLINDENHöRBüCHEREI )
STANFORD UNIVERSITY LIBRARIES	LIBRARYNAME	STANFORD UNIVERSITY LIBRARIES
BURLINGTON COUNTY LIBRARY	LIBRARYNAME	BURLINGTON COUNTY LIBRARY
ÇOMÜ LIBRARY	LIBRARYNAME	THE ÇOMÜ LIBRARY
EISENHOWER PUBLIC LIBRARY DISTRICT	LIBRARYNAME	EISENHOWER PUBLIC LIBRARY DISTRICT
CITY AND UNIVERSITY LIBRARY IN OSIJEK	LIBRARYNAME	GRADSKA I SVEUčILIšNA KNJIžNICA OSIJEK
CHEROKEE PUBLIC LIBRARY	LIBRARYNAME	CHEROKEE PUBLIC LIBRARY
UNIVERSITà CATTOLICA DEL SACRO CUORE LIBRARY	LIBRARYNAME	UNIVERSITà CATTOLICA DEL SACRO CUORE LIBRARY
GERMAN CENTRAL LIBRARY FOR THE BLIND	LIBRARYNAME	THE GERMAN CENTRAL LIBRARY FOR THE BLIND
GERMAN CENTRAL LIBRARY FOR THE BLIND	LIBRARYNAME	(DEUTSCHE ZENTRALBüCHEREI FüR BLINDE)
UNIVERSITY OF MINNESOTA LIBRARIES	LIBRARYNAME	UNIVERSITY OF MINNESOTA LIBRARIES
BOCA RATON PUBLIC LIBRARY	LIBRARYNAME	BOCA RATON PUBLIC LIBRARY
BOCA RATON PUBLIC LIBRARY	LIBRARYNAME	DOWNTOWN LOCATION
BOCA RATON PUBLIC LIBRARY	LIBRARYNAME	SPANISH RIVER LIBRARY AND COMMUNITY CENTER LOCATION
MONTREAL CHILDREN'S LIBRARY	LIBRARYNAME	MONTREAL CHILDREN'S LIBRARY
MONTREAL CHILDREN'S LIBRARY	LIBRARYNAME	(BIBLIOTHèQUE DES JEUNES DE MONTRéAL)
CENTRAL LIBRARY, IIT, BOMBAY	LIBRARYNAME	IIT BOMBAY CENTRAL LIBRARY
PATTEN FREE LIBRARY	LIBRARYNAME	PATTEN FREE LIBRARY
AMSTERDAM UNIVERSITY LIBRARY	LIBRARYNAME	AMSTERDAM UNIVERSITY LIBRARY
PURDY-KRESGE LIBRARY	LIBRARYNAME	PURDY-KRESGE LIBRARY
KAVI NARMAD CENTRAL LIBRARY	LIBRARYNAME	NARMAD CENTRAL LIBRARY
ENERGY FM	LIBRARYNAME	ENERGY FM
NATIONAL LIBRARY OF MONTENEGRO	LIBRARYNAME	NACIONALNA BIBLIOTEKA CRNE GORE \
UTS LIBRARY	LIBRARYNAME	UTS LIBRARY
NATIONAL LIBRARY OF MOZAMBIQUE	LIBRARYNAME	NATIONAL LIBRARY OF MOZAMBIQUE
NATIONAL LIBRARY OF MOZAMBIQUE	LIBRARYNAME	BIBLIOTECA NACIONAL DE MOçAMBIQUE
SOUTH PORTLAND PUBLIC LIBRARY	LIBRARYNAME	SOUTH PORTLAND PUBLIC LIBRARY
BAXTER MEMORIAL LIBRARY	LIBRARYNAME	BAXTER MEMORIAL LIBRARY
DYER LIBRARY	LIBRARYNAME	DYER LIBRARY
FALMOUTH MEMORIAL LIBRARY	LIBRARYNAME	FALMOUTH MEMORIAL LIBRARY
SCARBOROUGH PUBLIC LIBRARY	LIBRARYNAME	SCARBOROUGH PUBLIC LIBRARY
SKIDOMPHA PUBLIC LIBRARY	LIBRARYNAME	SKIDOMPHA PUBLIC LIBRARY
ELLSWORTH PUBLIC LIBRARY	LIBRARYNAME	ELLSWORTH PUBLIC LIBRARY
LOUIS B. GOODALL MEMORIAL LIBRARY	LIBRARYNAME	LOUIS B. GOODALL MEMORIAL LIBRARY
UNIVERSITY LIBRARY OF TüBINGEN	LIBRARYNAME	UNIVERSITäTSBIBLIOTHEK TüBINGEN
TOY TRAIN REFERENCE LIBRARY	LIBRARYNAME	TOY TRAIN REFERENCE LIBRARY
DAVID LUBIN MEMORIAL LIBRARY	LIBRARYNAME	DAVID LUBIN MEMORIAL LIBRARY
BORDEAUX MUNICIPAL LIBRARY	LIBRARYNAME	BORDEAUX MUNICIPAL LIBRARY
ALOHA COMMUNITY LIBRARY	LIBRARYNAME	ALOHA COMMUNITY LIBRARY
TIGARD PUBLIC LIBRARY	LIBRARYNAME	TIGARD PUBLIC LIBRARY
TUALATIN PUBLIC LIBRARY	LIBRARYNAME	TUALATIN PUBLIC LIBRARY
PAUL J. GUTMAN LIBRARY	LIBRARYNAME	PAUL J. GUTMAN LIBRARY
ANGUS LIBRARY AND ARCHIVE	LIBRARYNAME	ANGUS LIBRARY
SACRAMENTO STATE UNIVERSITY LIBRARY	LIBRARYNAME	SACRAMENTO STATE UNIVERSITY LIBRARY
UNIVERSITY OF MANCHESTER LIBRARY	LIBRARYNAME	THE UNIVERSITY OF MANCHESTER LIBRARY
WILLESDEN GREEN LIBRARY CENTRE	LIBRARYNAME	WILLESDEN GREEN LIBRARY CENTRE
ALMA JORDAN LIBRARY	LIBRARYNAME	THE ALMA JORDAN LIBRARY
NATIONAL AND UNIVERSITY LIBRARY %22ST. KLIMENT OF OHRID%22	LIBRARYNAME	Национална и универзитетска библиотека „Св. Климент Охридски“-Скопје
JAMES B. HUNT JR. LIBRARY	LIBRARYNAME	JAMES B. HUNT JR. LIBRARY
PUBLIC LIBRARY OF VALENCIA	LIBRARYNAME	PUBLIC LIBRARY OF VALENCIA
GANDER PUBLIC LIBRARY	LIBRARYNAME	GANDER PUBLIC LIBRARY
LLOYD SEALY LIBRARY	LIBRARYNAME	LLOYD GEORGE SEALY LIBRARY
KIRKWOOD PUBLIC LIBRARY	LIBRARYNAME	KIRKWOOD PUBLIC LIBRARY
UNIVERSITY OF CENTRAL FLORIDA LIBRARIES	LIBRARYNAME	UNIVERSITY OF CENTRAL FLORIDA LIBRARIES
MINOT PUBLIC LIBRARY	LIBRARYNAME	MINOT PUBLIC LIBRARY
NATIONAL LIBRARY OF HAITI	LIBRARYNAME	NATIONAL LIBRARY OF HAITI
BADEN STATE LIBRARY	LIBRARYNAME	BADISCHE LANDESBIBLIOTHEK
THE POETRY LIBRARY	LIBRARYNAME	THE POETRY LIBRARY
NATIONAL LIBRARY OF ALEPPO	LIBRARYNAME	NATIONAL LIBRARY OF ALEPPO
NATIONAL LIBRARY OF ALEPPO	LIBRARYNAME	دار الكتب الوطنية
NATIONAL LIBRARY OF TURKMENISTAN	LIBRARYNAME	STATE LIBRARY OF TURKMENISTAN
MAKERERE UNIVERSITY LIBRARY	LIBRARYNAME	MAKERERE UNIVERSITY LIBRARY
PIONEER LIBRARY SYSTEM	LIBRARYNAME	PIONEER LIBRARY SYSTEM
KHNKO APER CHILDREN'S LIBRARY	LIBRARYNAME	NATIONAL CHILDREN'S LIBRARY NAMED AFTER KHNKO APER
KHNKO APER CHILDREN'S LIBRARY	LIBRARYNAME	Խնկո-Ապոր Անվան Ազգային Մանկական Գրադարան
LARGO PUBLIC LIBRARY	LIBRARYNAME	LARGO PUBLIC LIBRARY
BRUTON MEMORIAL LIBRARY	LIBRARYNAME	BRUTON MEMORIAL LIBRARY
ALLAHABAD PUBLIC LIBRARY	LIBRARYNAME	ALLAHABAD PUBLIC LIBRARAY
MORAVIAN LIBRARY	LIBRARYNAME	MORAVIAN LIBRARY
SEOUL METROPOLITAN LIBRARY	LIBRARYNAME	SEOUL METROPOLITAN LIBRARY
WAUKEGAN PUBLIC LIBRARY	LIBRARYNAME	WAUKEGAN PUBLIC LIBRARY
PEARL RIVER COUNTY LIBRARY SYSTEM	LIBRARYNAME	PEARL RIVER COUNTY LIBRARY SYSTEM
JEAN AND ALEXANDER HEARD LIBRARY	LIBRARYNAME	JEAN AND ALEXANDER HEARD LIBRARY\NVANDERBILT UNIVERSITY
UNIVERSITY AND STATE LIBRARY DüSSELDORF	LIBRARYNAME	UNIVERSITY AND STATE LIBRARY DüSSELDORF
MONTGOMERY COUNTY PUBLIC LIBRARIES	LIBRARYNAME	MONTGOMERY COUNTY PUBLIC LIBRARIES
ORLANDO EAST PUBLIC LIBRARY	LIBRARYNAME	ORLANDO EAST PUBLIC LIBRARY
BIBLIOTECA NACIONAL %22MIGUEL OBREGóN LIZANO%22	LIBRARYNAME	LA BIBLIOTECA NACIONAL “MIGUEL OBREGON LIZANO”
LEóN DE GREIFF LIBRARY	LIBRARYNAME	LEóN DE GREIFF LIBRARY
CORNELIUS PUBLIC LIBRARY	LIBRARYNAME	CORNELIUS PUBLIC LIBRARY
SACRAMENTO PUBLIC LIBRARY	LIBRARYNAME	SACRAMENTO PUBLIC LIBRARY
HEALTH SCIENCES LIBRARY	LIBRARYNAME	HEALTH SCIENCES LIBRARY
BIBLIOTHèQUE INTERUNIVERSITAIRE DE SANTé	LIBRARYNAME	BIBLIOTHèQUE INTERUNIVERSITAIRE DE SANTé
CHAMPAIGN PUBLIC LIBRARY	LIBRARYNAME	CHAMPAIGN PUBLIC LIBRARY
SPAIN LIBRARY	LIBRARYNAME	SPAIN LIBRARY PARK
BETHLEHEM LIBRARY	LIBRARYNAME	BETHLEHEM LIBRARY PARK
DOUGLAS COUNTY LIBRARIES	LIBRARYNAME	DOUGLAS COUNTY LIBRARIES
LA QUINTANA	LIBRARYNAME	TOMáS CARRASQUILLA
SAN JAVIER LIBRARY	LIBRARYNAME	PRESBíTERO JOSé LUIS ARROYAVE RESTREPO
MANGUINHOS LIBRARY PARK	LIBRARYNAME	MANGUINHOS LIBRARY PARK
GUELPH PUBLIC LIBRARY	LIBRARYNAME	GUELPH PUBLIC LIBRARY
MATERNAL AND CHILD HEALTH LIBRARY	LIBRARYNAME	MATERNAL AND CHILD HEALTH LIBRARY
JONES LIBRARY	LIBRARYNAME	JONES LIBRARY
NEWMARKET PUBLIC LIBRARY	LIBRARYNAME	NEWMARKET PUBLIC LIBRARY
WALTER LIBRARY	LIBRARYNAME	WALTER LIBRARY
MONTGOMERY CITY-COUNTY PUBLIC LIBRARY	LIBRARYNAME	MONTGOMERY CITY-COUNTY PUBLIC LIBRARY
AMIR-UD-DAULA PUBLIC LIBRARY	LIBRARYNAME	AMIR-UD-DAULA PUBLIC LIBRARY
AMIR-UD-DAULA PUBLIC LIBRARY	LIBRARYNAME	अमीर-उद-दौला पब्लिक लाइब्रेरी
AMIR-UD-DAULA PUBLIC LIBRARY	LIBRARYNAME	امیر الدولہ پبلک لائبریری
GUSTAV LANDAUER LIBRARY WITTEN	LIBRARYNAME	GUSTAV-LANDAUER-BIBLIOTHEK WITTEN
WUHAN UNIVERSITY LIBRARY	LIBRARYNAME	WUHAN UNIVERSITY LIBRARY
MARY LIBRARY	LIBRARYNAME	MARY DISTRICT LIBRARY
SIR KENNETH GREEN LIBRARY	LIBRARYNAME	SIR KENNETH GREEN LIBRARY
NATIONAL LIBRARY OF THE DEMOCRATIC REPUBLIC OF CONGO	LIBRARYNAME	BIBLIOTHEQUE NATIONALE DE LA REPUBLIQUE DEMOCRATIQUE DU CONGO
ALBIN O. KUHN LIBRARY & GALLERY	LIBRARYNAME	ALBIN OWINGS KUHN
ALBIN O. KUHN LIBRARY & GALLERY	LIBRARYNAME	LIBRARY & GALLERY
BOULDER PUBLIC LIBRARY	LIBRARYNAME	BOULDER PUBLIC LIBRARY
REMUERA LIBRARY	LIBRARYNAME	REMUERA LIBRARY
FRIEDRICH-VON-RAUMER-BIBLIOTHEK	LIBRARYNAME	FRIEDRICH-VON-RAUMER-BIBLIOTHEK
OWEN SOUND & NORTH GREY UNION PUBLIC LIBRARY	LIBRARYNAME	OWEN SOUND & NORTH GREY UNION PUBLIC LIBRARY
AMERICAN LIBRARY IN PARIS	LIBRARYNAME	AMERICAN LIBRARY IN PARIS
MOTHER IRENE GILL MEMORIAL LIBRARY	LIBRARYNAME	MOTHER IRENE GILL MEMORIAL LIBRARY
UNIVERSITY LIBRARY OF WUPPERTAL	LIBRARYNAME	UNIVERSITY LIBRARY WUPPERTAL
BEIT ARIELA	LIBRARYNAME	ספריית שער צין בית אריאלה
HELSINKI METROPOLITAN AREA LIBRARIES	LIBRARYNAME	HELSINKI METROPOLITAN AREA LIBRARIES
WEST LINN PUBLIC LIBRARY	LIBRARYNAME	WEST LINN PUBLIC LIBRARY
THE BALME LIBRARY	LIBRARYNAME	THE BALME LIBRARY
ISLAMIC STUDIES LIBRARY	LIBRARYNAME	ISLAMIC STUDIES LIBRARY
NATIONAL LIBRARY OF KOSOVO	LIBRARYNAME	NATIONAL LIBRARY OF KOSOVO
CABARRUS COUNTY PUBLIC LIBRARY	LIBRARYNAME	CABARRUS COUNTY PUBLIC LIBRARY
JESSIE STREET NATIONAL WOMEN'S LIBRARY	LIBRARYNAME	JESSIE STREET NATIONAL WOMEN'S LIBRARY
METROPOLITAN LIBRARY SERVICE AGENCY	LIBRARYNAME	METROPOLITAN LIBRARY SERVICE AGENCY
COLLIER COUNTY PUBLIC LIBRARY	LIBRARYNAME	COLLIER COUNTY PUBLIC LIBRARY
SOEMAN HS LIBRARY	LIBRARYNAME	SOEMAN H.S LIBRARY
TEMPLE TERRACE PUBLIC LIBRARY	LIBRARYNAME	TEMPLE TERRACE PUBLIC LIBRARY
AUBURN AVENUE RESEARCH LIBRARY ON AFRICAN AMERICAN CULTURE AND HISTORY	LIBRARYNAME	AUBURN AVENUE RESEARCH LIBRARY ON AFRICAN AMERICAN CULTURE AND HISTORY
JAMES WELDON JOHNSON COMMUNITY LIBRARY	LIBRARYNAME	JAMES WELDON JOHNSON COMMUNITY LIBRARY
PAVELLó DE LA REPúBLICA CRAI LIBRARY	LIBRARYNAME	CRAI BIBLIOTECA PAVELLó DE LA REPúBLICA
DELRAY BEACH PUBLIC LIBRARY	LIBRARYNAME	DELRAY BEACH PUBLIC LIBRARY
UMEå UNIVERSITY LIBRARY	LIBRARYNAME	UMEå UNIVERSITY LIBRARY
WASAGA BEACH PUBLIC LIBRARY	LIBRARYNAME	WASAGA BEACH PUBLIC LIBRARY
SINHA LIBRARY	LIBRARYNAME	SINHA LIBRARY
SUPREME COURT OF PAKISTAN LIBRARY	LIBRARYNAME	SUPREME COURT OF PAKISTAN LIBRARY
MAHARAJA HARENDRA KISHORE PUBLIC LIBRARY, BETTIAH	LIBRARYNAME	MAHARAJA HARENDRA KISHORE PUBLIC LIBRARY
ERNAKULAM PUBLIC LIBRARY	LIBRARYNAME	ERNAKULAM PUBLIC LIBRARY
ELOOR LENDING LIBRARY ERNAKULAM	LIBRARYNAME	ELOOR LENDING LIBRARY ERNAKULAM
STRANDFONTEIN LIBRARY	LIBRARYNAME	STRANDFONTEIN LIBRARY
FISH HOEK LIBRARY	LIBRARYNAME	FISH HOEK LIBRARY
CENTRAL LIBRARY CAPE TOWN	LIBRARYNAME	CENTRAL LIBRARY CAPE TOWN
RONDEBOSCH LIBRARY	LIBRARYNAME	RONDEBOSCH LIBRARY
UNIVERSITY OF CAPE TOWN LIBRARIES	LIBRARYNAME	UNIVERSITY OF CAPE TOWN LIBRARIES
SELBY PUBLIC LIBRARY	LIBRARYNAME	SELBY PUBLIC LIBRARY
MOLDENHAUER ARCHIVES	LIBRARYNAME	THE MOLDENHAUER ARCHIVES
MOLDENHAUER ARCHIVES	LIBRARYNAME	LIBRARY OF CONGRESS
LIBRARIES OF THE ROYAL MELBOURNE INSTITUTE OF TECHNOLOGY	LIBRARYNAME	LIBRARIES OF THE ROYAL MELBOURNE INSTITUTE OF TECHNOLOGY
MUNICIPAL LIBRARY CONSORTIUM OF ST. LOUIS COUNTY	LIBRARYNAME	MUNICIPAL LIBRARY CONSORTIUM OF ST. LOUIS COUNTY
BRONX COMMUNITY COLLEGE LIBRARY	LIBRARYNAME	BRONX COMMUNITY COLLEGE LIBRARY
MOUNTAIN WEST DIGITAL LIBRARY	LIBRARYNAME	MOUNTAIN WEST DIGITAL LIBRARY
DR ZAKIR HUSAIN LIBRARY	LIBRARYNAME	DR ZAKIR HUSAIN LIBRARY
KYOTO PREFECTURAL LIBRARY	LIBRARYNAME	京都府立図書館
WESTON BRANCH LIBRARY	LIBRARYNAME	WESTON BRANCH LIBRARY
BRENTWOOD PUBLIC LIBRARY	LIBRARYNAME	BRENTWOOD PUBLIC LIBRARY
ROCK HILL PUBLIC LIBRARY	LIBRARYNAME	ROCK HILL PUBLIC LIBRARY
RICHMOND HEIGHTS MEMORIAL LIBRARY	LIBRARYNAME	RICHMOND HEIGHTS MEMORIAL LIBRARY
MAPLEWOOD PUBLIC LIBRARY	LIBRARYNAME	MAPLEWOOD PUBLIC LIBRARY
VALLEY PARK COMMUNITY LIBRARY	LIBRARYNAME	VALLEY PARK COMMUNITY PUBLIC LIBRARY
WILLIAM AND ANITA NEWMAN LIBRARY	LIBRARYNAME	WILLIAM AND ANITA NEWMAN LIBRARY
KNUST LIBRARY	LIBRARYNAME	KNUST LIBRARY
IHLIA LGBT HERITAGE	LIBRARYNAME	IHLIA LGBT HERITAGE
NEW ROCHELLE PUBLIC LIBRARY	LIBRARYNAME	NEW ROCHELLE PUBLIC LIBRARY
SILVER SPRING LIBRARY	LIBRARYNAME	SILVER SPRING LIBRARY
REACHING ACROSS ILLINOIS LIBRARY SYSTEM	LIBRARYNAME	REACHING ACROSS ILLINOIS LIBRARY SYSTEM
TORONTO TOOL LIBRARY	LIBRARYNAME	TORONTO TOOL LIBRARY AND MAKERSPACE
VANCOUVER TOOL LIBRARY	LIBRARYNAME	VANCOUVER TOOL LIBRARY AND MAKERSPACE
HALIFAX TOOL LIBRARY	LIBRARYNAME	HALIFAX TOOL LIBRARY
CALGARY TOOL LIBRARY	LIBRARYNAME	CALGARY TOOL LIBRARY AND MAKERSPACE
CORNWALL TOOL LIBRARY	LIBRARYNAME	CORNWALL TOOL LIBRARY
OTTAWA TOOL LIBRARY	LIBRARYNAME	OTTAWA TOOL LIBRARY
MCMASTER UNIVERSITY LIBRARY	LIBRARYNAME	MCMASTER UNIVERSITY LIBRARY
KATARINA JEE	LIBRARYNAME	RAAMATUKOGUBUSS KATARINA JEE
OLD LESBIAN ORAL HERSTORY PROJECT	LIBRARYNAME	OLD LESBIAN ORAL HERSTORY PROJECT
GEORGETOWN UNIVERSITY LIBRARY	LIBRARYNAME	GEORGETOWN UNIVERSITY LIBRARY
AURORA PUBLIC LIBRARY	LIBRARYNAME	AURORA PUBLIC LIBRARY
MADISON PUBLIC LIBRARY	LIBRARYNAME	MADISON PUBLIC LIBRARY
UNIVERSITY OF TEXAS AT SAN ANTONIO LIBRARIES	LIBRARYNAME	UTSA LIBRARIES
EASTBOURNE LIBRARY	LIBRARYNAME	EASTBOURNE COMMUNITY LIBRARY
RHODES UNIVERSITY LIBRARY	LIBRARYNAME	RHODES UNIVERSITY LIBRARIES
SIR EDMUND HILLARY LIBRARY	LIBRARYNAME	SIR EDMUND HILLARY LIBRARY
WESTON LIBRARY	LIBRARYNAME	WESTON LIBRARY
UTAH STATE LIBRARY	LIBRARYNAME	UTAH STATE LIBRARY
SANTI PRACHA DHAMMA LIBRARY	LIBRARYNAME	SANTI PRACHA DHAMMA LIBRARY
BEAVERTON CITY LIBRARY	LIBRARYNAME	BEAVERTON CITY LIBRARY
BANKS PUBLIC LIBRARY	LIBRARYNAME	BANKS PUBLIC LIBRARY
FOREST GROVE CITY LIBRARY	LIBRARYNAME	FOREST GROVE CITY LIBRARY
NEW YORK UNIVERSITY LIBRARY	LIBRARYNAME	NEW YORK UNIVERSITY LIBRARY
MARGARITA RUDOMINO ALL-RUSSIA STATE LIBRARY FOR FOREIGN LITERATURE	LIBRARYNAME	MARGARITA RUDOMINO ALL-RUSSIA STATE LIBRARY FOR FOREIGN LITERATURE
OLIVE KETTERING LIBRARY	LIBRARYNAME	OLIVE KETTERING LIBRARY
SHERWOOD PUBLIC LIBRARY	LIBRARYNAME	SHERWOOD PUBLIC LIBRARY
HART MEMORIAL CENTRAL LIBRARY	LIBRARYNAME	HART MEMORIAL CENTRAL LIBRARY
ANDERSEN LIBRARY	LIBRARYNAME	ANDERSEN LIBRARY
SEDONA PUBLIC LIBRARY	LIBRARYNAME	SEDONA PUBLIC LIBRARY
MEADOWRIDGE LIBRARY	LIBRARYNAME	MEADOWRIDGE LIBRARY
CITY OF HIALEAH PUBLIC LIBRARY	LIBRARYNAME	CITY OF HIALEAH PUBLIC LIBRARY
BURLINGTON PUBLIC LIBRARY	LIBRARYNAME	BURLINGTON PUBLIC LIBRARY
JAMES PRENDERGAST LIBRARY	LIBRARYNAME	JAMES PRENDERGAST LIBRARY
RICHMOND PUBLIC LIBRARY	LIBRARYNAME	RICHMOND PUBLIC LIBRARY
MUNICIPAL LIBRARY OF PRAGUE	LIBRARYNAME	MUNICIPAL LIBRARY OF PRAGUE
MUNICIPAL LIBRARY OF PRAGUE	LIBRARYNAME	(MěSTSKá KNIHOVNA V PRAZE)
PLUNGė DISTRICT MUNICIPAL PUBLIC LIBRARY	LIBRARYNAME	PLUNGė DISTRICT MUNICIPAL PUBLIC LIBRARY
DANISH NATIONAL ART LIBRARY	LIBRARYNAME	DANMARKS KUNSTBIBLIOTEK
KENDALL YOUNG PUBLIC LIBRARY	LIBRARYNAME	KENDALL YOUNG PUBLIC LIBRARY
STATE AND UNIVERSITY LIBRARY, DENMARK	LIBRARYNAME	STATSBIBLIOTEKET
DRAKE PUBLIC LIBRARY	LIBRARYNAME	DRAKE PUBLIC LIBRARY
BLOOMFIELD PUBLIC LIBRARY	LIBRARYNAME	BLOOMFIELD PUBLIC LIBRARY
ERICSON PUBLIC LIBRARY	LIBRARYNAME	ERICSON PUBLIC LIBRARY
GEORGE AND MARY FOSTER ANTHROPOLOGY LIBRARY	LIBRARYNAME	THE GEORGE AND MARY FOSTER ANTHROPOLOGY LIBRARY
RED OAK PUBLIC LIBRARY	LIBRARYNAME	RED OAK PUBLIC LIBRARY
GROSSMAN LIBRARY	LIBRARYNAME	GROSSMAN LIBRARY
MéDIATHèQUES DE SAINT-ÉTIENNE	LIBRARYNAME	''
GORDON W. PRANGE COLLECTION	LIBRARYNAME	GORDON W. PRANGE COLLECTION
NATIONAL LIBRARY OF GUINEA-BISSAU	LIBRARYNAME	PUBLIC LIBRARY OF THE INEP
NATIONAL LIBRARY OF GUINEA-BISSAU	LIBRARYNAME	BIBLIOTECA PúBLICA DO INEP
NATIONAL LIBRARY OF EAST TIMOR	LIBRARYNAME	NATIONAL LIBRARY OF EAST TIMOR
NATIONAL LIBRARY OF EAST TIMOR	LIBRARYNAME	BIBLIOTECA NACIONAL DE TIMOR-LESTE
NATIONAL LIBRARY OF EAST TIMOR	LIBRARYNAME	BIBLIOTEKA NASIONáL NO ARKIVU TIMOR-LESTE NIAN
THONOTOSASSA PUBLIC LIBRARY	LIBRARYNAME	THONOTOSASSA BRANCH LIBRARY
HEILONGJIANG PROVINCIAL LIBRARY	LIBRARYNAME	HEILONGJIANG PROVINCIAL LIBRARY
HEILONGJIANG PROVINCIAL LIBRARY	LIBRARYNAME	黑龙江省图书馆
SULLIVAN COUNTY PUBLIC LIBRARY	LIBRARYNAME	SULLIVAN COUNTY PUBLIC LIBRARY
ROMAIN ROLLAND LIBRARY	LIBRARYNAME	ROMAIN ROLLAND LIBRARY
ROMAIN ROLLAND LIBRARY	LIBRARYNAME	(ரோமன் ரோலண்ட் நூலகம்)
ANAS CENTRAL LIBRARY OF SCIENCE	LIBRARYNAME	CENTRAL SCIENTIFIC LIBRARY
SIR DUNCAN RICE LIBRARY	LIBRARYNAME	SIR DUNCAN RICE LIBRARY
NATIONAL POLICE LIBRARY	LIBRARYNAME	NATIONAL POLICE LIBRARY
FRANSES TAPESTRY ARCHIVE	LIBRARYNAME	FRANSES TAPESTRY ARCHIVE
BIBLIOGRAPHIC ASSOCIATION OF THE RED RIVER	LIBRARYNAME	BIBLIOGRAPHIC ASSOCIATION OF THE RED RIVER
ELYACHAR CENTRAL LIBRARY	LIBRARYNAME	ELYACHAR CENTRAL LIBRARY
ANDREWS LIBRARY	LIBRARYNAME	ANDREWS LIBRARY
NANPURA PARSI LIBRARY	LIBRARYNAME	NANPURA PARSI LIBRARY AND READING ROOM
