TOUR DE FRANCE	LOCALNAMES	LE TOUR DE FRANCE
GIRO D'ITALIA	LOCALNAMES	GIRO D'ITALIA
PARIS–ROUBAIX	LOCALNAMES	PARIS–ROUBAIX
VUELTA A ESPAñA	LOCALNAMES	VUELTA CICLISTA A ESPAñA
LIèGE–BASTOGNE–LIèGE	LOCALNAMES	LIèGE–BASTOGNE–LIèGE
TOUR OF BRITAIN	LOCALNAMES	THE TOUR
PEACE RACE	LOCALNAMES	FRIEDENSFAHRT
PEACE RACE	LOCALNAMES	ZáVOD MíRU
PEACE RACE	LOCALNAMES	PRETEKY MIERU
PEACE RACE	LOCALNAMES	WYśCIG POKOJU
PEACE RACE	LOCALNAMES	COURSE DE LA PAIX
TOUR OF THE BASQUE COUNTRY	LOCALNAMES	VUELTA AL PAíS VASCO
TOUR OF THE BASQUE COUNTRY	LOCALNAMES	EUSKAL HERRIKO ITZULIA
MILAN–SAN REMO	LOCALNAMES	MILANO–SANREMO
GIRO DI LOMBARDIA	LOCALNAMES	GIRO DI LOMBARDIA
GIRO DI LOMBARDIA	LOCALNAMES	IL LOMBARDIA
CRITéRIUM DU DAUPHINé	LOCALNAMES	CRITéRIUM DU DAUPHINé
CLáSICA DE SAN SEBASTIáN	LOCALNAMES	CLáSICA DE SAN SEBASTIáN
CLáSICA DE SAN SEBASTIáN	LOCALNAMES	DONOSTIA-DONOSTIA KLASIKOA
LA FLèCHE WALLONNE	LOCALNAMES	LA FLèCHE WALLONNE
GENT–WEVELGEM	LOCALNAMES	GENT–WEVELGEM
BORDEAUX–PARIS	LOCALNAMES	BORDEAUX–PARIS
GRAND PRIX DES NATIONS	LOCALNAMES	GRAND PRIX DES NATIONS
OMLOOP HET NIEUWSBLAD	LOCALNAMES	OMLOOP HET NIEUWSBLAD
TOUR DE SUISSE	LOCALNAMES	TOUR DE SUISSE
HERALD SUN TOUR	LOCALNAMES	JAYCO HERALD SUN TOUR
ZüRI-METZGETE	LOCALNAMES	ZüRI-METZGETE
ZüRI-METZGETE	LOCALNAMES	MEISTERSCHAFT VON ZüRICH
TOUR DE POLOGNE	LOCALNAMES	WYśCIG DOOKOłA POLSKI
ARNHEM–VEENENDAAL CLASSIC	LOCALNAMES	ARNHEM–VEENENDAAL CLASSIC
CRITéRIUM INTERNATIONAL	LOCALNAMES	CRITéRIUM INTERNATIONAL
DEUTSCHLAND TOUR	LOCALNAMES	DEUTSCHLAND TOUR
DANMARK RUNDT	LOCALNAMES	DANMARK RUNDT
VOLTA A CATALUNYA	LOCALNAMES	VUELTA A CATALUñA \NVOLTA A CATALUNYA
MILANO–TORINO	LOCALNAMES	MILANO–TORINO
E3 HARELBEKE	LOCALNAMES	E3 HARELBEKE
TOUR DE ROMANDIE	LOCALNAMES	TOUR DE ROMANDIE
TOUR DE L'AVENIR	LOCALNAMES	TOUR DE L'AVENIR
PARIS–BOURGES	LOCALNAMES	PARIS–BOURGES
SCHELDEPRIJS	LOCALNAMES	SCHELDEPRIJS
TIRRENO–ADRIATICO	LOCALNAMES	TIRRENO–ADRIATICO
BRETAGNE CLASSIC	LOCALNAMES	BRETAGNE CLASSIC OUEST-FRANCE
KUURNE–BRUSSELS–KUURNE	LOCALNAMES	KUURNE–BRUSSEL–KUURNE
SHENANDOAH 100	LOCALNAMES	SHENANDOAH 100
FOUR DAYS OF DUNKIRK	LOCALNAMES	QUATRE JOURS DE DUNKERQUE
PHILADELPHIA INTERNATIONAL CYCLING CLASSIC	LOCALNAMES	TD BANK PHILADELPHIA INTERNATIONAL CHAMPIONSHIP
SUBIDA A URKIOLA	LOCALNAMES	SUBIDA A URKIOLA
SUBIDA A URKIOLA	LOCALNAMES	URKIOLA IGOERA
THREE DAYS OF DE PANNE	LOCALNAMES	DRIEDAAGSE VAN
THREE DAYS OF DE PANNE	LOCALNAMES	DE PANNE-KOKSIJDE
TOUR OF BELGIUM	LOCALNAMES	RONDE VAN BELGIë
TOUR OF BELGIUM	LOCALNAMES	TOUR DE BELGIQUE
CROSS COUNTRY CYCLING CLASSIC	LOCALNAMES	CROSS COUNTRY
MEGAVALANCHE	LOCALNAMES	MEGA
TOUR OF UTAH	LOCALNAMES	THE TOUR
ESCALADA A MONTJUïC	LOCALNAMES	L'ESCALADA A MONTJUïC
ESCALADA A MONTJUïC	LOCALNAMES	LA ESCALADA A MONTJUIC
BPOST BANK TROPHY	LOCALNAMES	BPOST BANK TROFEE
JAPAN CUP	LOCALNAMES	ジャパンカップサイクルロードレース
SIX DAYS OF GHENT	LOCALNAMES	ZESDAAGSE VLAANDEREN-GENT
TOUR OF ERITREA	LOCALNAMES	ዙር ኤርትራ
GRAND PRIX SVEN NYS	LOCALNAMES	GROTE PRIJS SVEN NYS
GRAND PRIX DE STER SINT-NIKLAAS	LOCALNAMES	GROTE PRIJS DE STER
VUELTA AL TáCHIRA	LOCALNAMES	VUELTA CICLISTA AL TáCHIRA
JELAJAH MALAYSIA	LOCALNAMES	JELAJAH MALAYSIA
VUELTA A SAN JUAN	LOCALNAMES	VUELTA A SAN JUAN
PEOPLE'S CHOICE CLASSIC	LOCALNAMES	CANCER COUNCIL HELPLINE CLASSIC
ZIKLOKROSS IGORRE	LOCALNAMES	ZIKLOKROSS IGORRE
CYCLO-CROSS KOPPENBERG	LOCALNAMES	KOPPENBERGCROSS
SUPERPRESTIGE DIEGEM	LOCALNAMES	INTERNATIONALE VELDRIT DIEGEM
TOUR OF SIAM	LOCALNAMES	ทัวร์ ออฟ สยาม
VUELTA A MURCIA	LOCALNAMES	VUELTA CICLISTICA A LA REGION DI MURCIA
TOUR OF SWEDEN	LOCALNAMES	POSTGIROT OPEN
VUELTA A PERú	LOCALNAMES	VUELTA A PERú
SEA OTTER CLASSIC	LOCALNAMES	SEA OTTER
VUELTA A ANDALUCíA	LOCALNAMES	VUELTA A ANDALUCíA
VUELTA A MALLORCA	LOCALNAMES	VOLTA A MALLORCA
VUELTA A MALLORCA	LOCALNAMES	VUELTA A MALLORCA
GRAN PREMIO DELLA COSTA ETRUSCHI	LOCALNAMES	GP DELLA COSTA ETRUSCHI
TOUR MéDITERRANéEN	LOCALNAMES	TOUR MéDITERRANéEN
VOLTA AO ALGARVE	LOCALNAMES	VOLTA AO ALGARVE
TROFEO LAIGUEGLIA	LOCALNAMES	TROFEO LAIGUEGLIA
ÉTOILE DE BESSèGES	LOCALNAMES	ÉTOILE DE BESSèGES
TOUR DU HAUT VAR	LOCALNAMES	TOUR DU HAUT-VAR
CLáSICA DE ALMERíA	LOCALNAMES	CLáSICA DE ALMERíA
GP MIGUEL INDURAIN	LOCALNAMES	GRAN PREMIO MIGUEL INDURAIN
VOLTA A LA COMUNITAT VALENCIANA	LOCALNAMES	VOLTA A LA COMUNITAT VALENCIANA
VOLTA A LA COMUNITAT VALENCIANA	LOCALNAMES	VUELTA A LA COMUNIDAD VALENCIANA
BRABANTSE PIJL	LOCALNAMES	BRABANTSE PIJL
BRABANTSE PIJL	LOCALNAMES	LA FLèCHE BRABANçONNE
VUELTA A COLOMBIA	LOCALNAMES	VUELTA A COLOMBIA'''
VUELTA CICLISTA POR UN CHILE LIDER	LOCALNAMES	VUELTA CICLISTA POR UN CHILE LIDER
TOUR DE TAIWAN	LOCALNAMES	國際自由車環台公路大賽
DWARS DOOR VLAANDEREN	LOCALNAMES	DWARS DOOR VLAANDEREN
VUELTA A CASTILLA Y LEóN	LOCALNAMES	VUELTA A CASTILLA Y LEóN
GRAND PRIX DE LA VILLE DE TUNIS	LOCALNAMES	GRAND PRIX DE LA VILLE DE TUNIS
TOUR OF FLANDERS FOR WOMEN	LOCALNAMES	RONDE VAN VLAANDEREN VOOR VROUWEN
GP DE PLOUAY – BRETAGNE	LOCALNAMES	GRAND PRIX DE PLOUAY – BRETAGNE
TOUR OF QINGHAI LAKE	LOCALNAMES	环青海湖国际公路自行车赛
RONDE VAN DRENTHE	LOCALNAMES	RONDE VAN DRENTHE
GRAND PRIX DU MIDI LIBRE	LOCALNAMES	GRAND PRIX DU MIDI LIBRE
VUELTA A BURGOS	LOCALNAMES	VUELTA A BURGOS
GIRO DEL TRENTINO	LOCALNAMES	GIRO DEL TRENTINO
TOUR OF IRELAND	LOCALNAMES	NISSAN CLASSIC
TOUR OF IRELAND	LOCALNAMES	TOUR OF IRELAND 2007–09
VOLTA A LLEIDA	LOCALNAMES	VOLTA A LLEIDA
TOUR DE WALLONIE	LOCALNAMES	TOUR DE WALLONIE
SETMANA CATALANA DE CICLISME	LOCALNAMES	SEMANA CATALANA DE CICLISMO \NSETMANA CATALANA DE CICLISME
EUSKAL BIZIKLETA	LOCALNAMES	EUSKAL BIZIKLETA KIROL ELKARTEA
EUSKAL BIZIKLETA	LOCALNAMES	BICICLETA VASCA
CLASSIQUE DES ALPES	LOCALNAMES	CLASSIQUE DES ALPES ÉLITES
GRAND PRIX OF AARGAU CANTON	LOCALNAMES	GROSSER PREIS DES KANTONS AARGAU
GRAN PREMIO DI LUGANO	LOCALNAMES	GRAN PREMIO DI LUGANO
GRAND PRIX DES AMéRIQUES	LOCALNAMES	GRAND PRIX DES AMéRIQUES
TRO-BRO LéON	LOCALNAMES	TOUR DU PAYS LéONARD
TRO-BRO LéON	LOCALNAMES	TRO-BRO LéON
LE SAMYN	LOCALNAMES	LE SAMYN DES PROS
LE SAMYN	LOCALNAMES	LE SAMYN DES DAMES
GRAN PREMIO DI CHIASSO	LOCALNAMES	GRAN PREMIO DI CHIASSO
NOKERE KOERSE	LOCALNAMES	NOKERE KOERSE
SUBIDA AL NARANCO	LOCALNAMES	SUBIDA AL NARANCO
GIRO D'ORO	LOCALNAMES	GIRO D'ORO
GIRO DELL'EMILIA	LOCALNAMES	GIRO DELL'EMILIA
CLáSICO RCN	LOCALNAMES	CLáSICO RCN
CHOLET-PAYS DE LOIRE	LOCALNAMES	GRAND PRIX CHOLET-PAYS DE LA LOIRE
NATIONALE SLUITINGSPRIJS	LOCALNAMES	NATIONALE SLUITINGPRIJS
PARIS–CAMEMBERT	LOCALNAMES	PARIS–CAMEMBERT TROPHéE LEPETIT
SAN FRANCISCO GRAND PRIX	LOCALNAMES	SAN FRANCISCO GRAND PRIX
VOLTA AO DISTRITO DE SANTARéM	LOCALNAMES	VOLTA AO DISTRITO DE SANTARéM
RONDE VAN HET GROENE HART	LOCALNAMES	RONDE VAN HET GROENE HART
PORTO–LISBOA	LOCALNAMES	PORTO–LISBOA
GRAND PRIX D'OUVERTURE LA MARSEILLAISE	LOCALNAMES	GRAND PRIX D'OUVERTURE LA MARSEILLAISE
TOUR DE L'AIN	LOCALNAMES	TOUR DE L'AIN
TOUR DE L'AIN	LOCALNAMES	PRIX DE L'AMITIé
TOUR OF AUSTRIA	LOCALNAMES	INTERNATIONALE ÖSTERREICH RUNDFAHRT
STER ZLM TOER	LOCALNAMES	STER ZLM TOER
COLLIERS CLASSIC	LOCALNAMES	COLLIERS CLASSIC
RUND UM KöLN	LOCALNAMES	RUND UM KöLN
VUELTA A LA RIOJA	LOCALNAMES	VUELTA A LA RIOJA
VUELTA A ASTURIAS	LOCALNAMES	VUELTA A ASTURIAS
CIRCUITO DE GETXO	LOCALNAMES	CIRCUITO DE GETXO DE CICLISMO - MEMORIAL RICARDO OTXOA , GETXOKO TXIRRINDULARITZA ZIRKUITUA - RICARDO OTXOA MEMORIALA
RUND UM BERLIN	LOCALNAMES	RUND UM BERLIN
ROUTE DU SUD	LOCALNAMES	LA ROUTE DU SUD CYCLISTE
REGIO-TOUR	LOCALNAMES	REGIO-TOUR
CLáSICA A LOS PUERTOS DE GUADARRAMA	LOCALNAMES	CLáSICA A LOS PUERTOS DE GUADARRAMA
KLASIKA PRIMAVERA	LOCALNAMES	KLASIKA PRIMAVERA
KLASIKA PRIMAVERA	LOCALNAMES	GRAN PREMIO DE PRIMAVERA
CLáSICA INTERNACIONAL DE ALCOBENDAS	LOCALNAMES	CLáSICA INTERNACIONAL DE ALCOBENDAS
GIRO DEL LAZIO	LOCALNAMES	GIRO DEL LAZIO, ROMA MAXIMA
TRE VALLI VARESINE	LOCALNAMES	TRE VALLI VARESINE
VUELTA A ARAGóN	LOCALNAMES	VUELTA A ARAGóN
PARIS–CORRèZE	LOCALNAMES	PARIS–CORRèZE
GIRO DELL'APPENNINO	LOCALNAMES	GIRO DELL'APPENNINO
GIRO DEL PIEMONTE	LOCALNAMES	GIRO DEL PIEMONTE OR GRAN PIEMONTE
GRAND PRIX DE FOURMIES	LOCALNAMES	GRAND PRIX DE FOURMIES
GIRO DEL VENETO	LOCALNAMES	GIRO DEL VENETO
BAYERN-RUNDFAHRT	LOCALNAMES	BAYERN RUNDFAHRT
COPPA PLACCI	LOCALNAMES	COPPA PLACCI
SETTIMANA INTERNAZIONALE DI COPPI E BARTALI	LOCALNAMES	SETTIMANA INTERNAZIONALE DI COPPI E BARTALI
PARIS–LUXEMBOURG	LOCALNAMES	PARIS–LUXEMBOURG
GRAND PRIX EDDY MERCKX	LOCALNAMES	GRAND PRIX EDDY MERCKX
GRAND PRIX D'ISBERGUES	LOCALNAMES	GRAND PRIX D'ISBERGUES
GIRO DELLA ROMAGNA	LOCALNAMES	GIRO DELLA ROMAGNA
CLASSIC HARIBO	LOCALNAMES	CLASSIC HARIBO
ROUTE ADéLIE	LOCALNAMES	ROUTE ADéLIE DE VITRé
POLYNORMANDE	LOCALNAMES	POLYNORMANDE
TROPHéE DES GRIMPEURS	LOCALNAMES	TROPHéE DES GRIMPEURS
CHâTEAUROUX CLASSIC	LOCALNAMES	CHâTEAUROUX CLASSIC DE L'INDRE TROPHéE FENIOUX
GRAND PRIX DE DENAIN	LOCALNAMES	GRAND PRIX DE DENAIN
TOUR DE VENDéE	LOCALNAMES	TOUR DE VENDéE
TOUR DU FINISTèRE	LOCALNAMES	TOUR DU FINISTèRE
GRAND PRIX DE PLUMELEC-MORBIHAN	LOCALNAMES	GRAND PRIX DE PLUMELEC-MORBIHAN
TOUR DE KOREA	LOCALNAMES	투르 드 코리아
PRUEBA VILLAFRANCA DE ORDIZIA	LOCALNAMES	CLáSICA DE ORDIZIA
PRUEBA VILLAFRANCA DE ORDIZIA	LOCALNAMES	ORDIZIAKO KLASIKA
GRAND PRIX DE WALLONIE	LOCALNAMES	GRAND PRIX DE WALLONIE
TOUR DU LIMOUSIN	LOCALNAMES	TOUR DU LIMOUSIN
TOUR OF SLOVENIA	LOCALNAMES	DIRKA PO SLOVENIJI
COPPA UGO AGOSTONI	LOCALNAMES	COPPA UGO AGOSTONI
RUND UM DIE HAINLEITE	LOCALNAMES	RUND UM DIE HAINLEITE
GIRO DI SARDEGNA	LOCALNAMES	GIRO DI SARDEGNA
COPPA BERNOCCHI	LOCALNAMES	COPPA BERNOCCHI
MEMORIAL MARCO PANTANI	LOCALNAMES	MEMORIAL MARCO PANTANI
BRIXIA TOUR	LOCALNAMES	BRIXIA TOUR
SACHSEN TOUR	LOCALNAMES	SACHSEN-TOUR INTERNATIONAL
SETTIMANA CICLISTICA LOMBARDA	LOCALNAMES	SETTIMANA CICLISTICA LOMBARDA
CIRCUIT DE LA SARTHE	LOCALNAMES	CIRCUIT DE LA SARTHE
GP CTT CORREIOS DE PORTUGAL	LOCALNAMES	GP CTT CORREIOS DE PORTUGAL
VOLTA AO ALENTEJO	LOCALNAMES	VOLTA AO ALENTEJO
TROFéU JOAQUIM AGOSTINHO	LOCALNAMES	TROFéU JOAQUIM AGOSTINHO
GRAND PRIX DE VILLERS-COTTERêTS	LOCALNAMES	GRAND PRIX DE VILLERS-COTTERêTS
GIRO DI TOSCANA	LOCALNAMES	GIRO DI TOSCANA
COURSE DE LA SOLIDARITé OLYMPIQUE	LOCALNAMES	WYśCIG SOLIDARNOśCI I OLIMPIJCZYKóW
CHRONO DES NATIONS	LOCALNAMES	CHRONO DES NATIONS - LES HERBIERS VENDéE
GRAND PRIX PINO CERAMI	LOCALNAMES	GRAND PRIX PINO CERAMI
KAMPIOENSCHAP VAN VLAANDEREN	LOCALNAMES	KAMPIOENSCHAP VAN VLAANDEREN
GP HERNING	LOCALNAMES	GLS EXPRESS GRAND PRIX I HERNING
MEMORIAL RIK VAN STEENBERGEN	LOCALNAMES	MEMORIAL RIK VAN STEENBERGEN
GP TRIBERG-SCHWARZWALD	LOCALNAMES	GP TRIBERG-SCHWARZWALD
GROTE PRIJS JEF SCHERENS	LOCALNAMES	GROTE PRIJS JEF SCHERENS
GROTE PRIJS JEF SCHERENS	LOCALNAMES	GROTE PRIJS POESKE SCHERENS
HALLE–INGOOIGEM	LOCALNAMES	HALLE–INGOOIGEM
TROFEO MATTEOTTI	LOCALNAMES	TROFEO MATTEOTTI
TROFEO MELINDA	LOCALNAMES	TROFEO MELINDA
GP KRANJ	LOCALNAMES	GP KRANJ
SPARKASSEN GIRO BOCHUM	LOCALNAMES	SPARKASSEN GIRO BOCHUM
COPPA SABATINI	LOCALNAMES	COPPA SABATINI
DRUIVENKOERS OVERIJSE	LOCALNAMES	DRUIVENKOERS OVERIJSE
RHEINLAND-PFALZ RUNDFAHRT	LOCALNAMES	INTERNATIONAL RHEINLAND-PFALZ RUNDFAHRT
3-LäNDER-TOUR	LOCALNAMES	3
HEL VAN HET MERGELLAND	LOCALNAMES	HEL VAN HET MERGELLAND
GRAN PREMIO DE LLODIO	LOCALNAMES	GRAN PREMIO INTERNACIONAL DE LLODIO
GRAN PREMIO DE LLODIO	LOCALNAMES	LAUDIOKO NAZIOARTEKO SARI NAGUSIA
GRAND PRIX DE RENNES	LOCALNAMES	GRAND PRIX CYCLISTE DE LA VILLE DE RENNES
GROTE PRIJS GERRIE KNETEMANN	LOCALNAMES	GROTE PRIJS GERRIE KNETEMANN
TOUR DU DOUBS	LOCALNAMES	TOUR DU DOUBS
BOUCLES DE L'AULNE	LOCALNAMES	BOUCLES DE L'AULNE
NIEDERSACHSEN-RUNDFAHRT	LOCALNAMES	NIEDERSACHSEN-RUNDFAHRT
DWARS DOOR WEST-VLAANDEREN	LOCALNAMES	DWARS DOOR WEST-VLAANDEREN
NEUSEEN CLASSICS	LOCALNAMES	NEUSEEN CLASSICS
CIRCUIT DE LORRAINE	LOCALNAMES	CIRCUIT DE LORRAINE
TOUR DE PICARDIE	LOCALNAMES	TOUR DE PICARDIE
TOUR DE RIJKE	LOCALNAMES	TOUR DE RIJKE
SHAY ELLIOTT MEMORIAL RACE	LOCALNAMES	SHAY ELLIOTT MEMORIAL RACE
GP INTERNACIONAL PAREDES ROTA DOS MóVEIS	LOCALNAMES	GP INTERNACIONAL PAREDES ROTA DOS MóVEIS
GP INDUSTRIA & ARTIGIANATO DI LARCIANO	LOCALNAMES	GP INDUSTRIA & ARTIGIANATO DI LARCIANO
SZLAKIEM GRODóW PIASTOWSKICH	LOCALNAMES	SZLAKIEM GRODóW PIASTOWSKICH
DELTA PROFRONDE	LOCALNAMES	DELTA PROFRONDE
PROFRONDE VAN FRYSLAN	LOCALNAMES	PROFRONDE VAN FRYSLAN
GRAN PREMIO CITTà DI CAMAIORE	LOCALNAMES	GRAN PREMIO CITTà DI CAMAIORE
TOUR DU POITOU-CHARENTES	LOCALNAMES	TOUR DU POITOU-CHARENTES
GROTE PRIJS STAD ZOTTEGEM	LOCALNAMES	GROTE PRIJS STAD ZOTTEGEM
MEMORIAł HENRYKA ŁASAKA	LOCALNAMES	MEMORIAł IM. HENRYKA ŁASAKA
GRAN PREMIO NOBILI RUBINETTERIE	LOCALNAMES	GRAN PREMIO NOBILI RUBINETTERIE
SCHAAL SELS	LOCALNAMES	SCHAAL SELS-MERKSEM
VUELTA CICLISTA A LEóN	LOCALNAMES	LA VUELTA LEóN
GRAN PREMIO CITTà DI MISANO – ADRIATICO	LOCALNAMES	GRAN PREMIO CITTà DI MISANO - ADRIATICO
GRAN PREMIO INDUSTRIA E COMMERCIO ARTIGIANATO CARNAGHESE	LOCALNAMES	GRAN PREMIO INDUSTRIA E COMMERCIO ARTIGIANATO CARNAGHESE
GRAN PREMIO INDUSTRIA E COMMERCIO DI PRATO	LOCALNAMES	GRAN PREMIO INDUSTRIA E COMMERCIO DI PRATO
FIRENZE–PISTOIA	LOCALNAMES	FIRENZE–PISTOIA
TROFEO LUIS PUIG	LOCALNAMES	TROFEO LUIS PUIG
GIRO DELLA PROVINCIA DI REGGIO CALABRIA	LOCALNAMES	GIRO DELLA PROVINCIA DI REGGIO CALABRIA
GIRO DELLA PROVINCIA DI LUCCA	LOCALNAMES	GIRO DELLA PROVINCIA DI LUCCA
GRAND PRIX RUDY DHAENENS	LOCALNAMES	GRAND PRIX RUDY DHAENENS
TROFEO PANTALICA	LOCALNAMES	TROFEO PANTALICA
LUK CHALLENGE CHRONO	LOCALNAMES	LUK CHALLENGE CHRONO
STAUSEE-RUNDFAHRT KLINGNAU	LOCALNAMES	STAUSEE-RUNDFAHRT KLINGNAU
OMLOOP VAN DE VLAAMSE SCHELDEBOORDEN	LOCALNAMES	OMLOOP VAN DE VLAAMSE SCHELDEBOORDEN
EUROMéTROPOLE	LOCALNAMES	CIRCUIT FRANCO-BELGE
MEMORIAL CIMURRI	LOCALNAMES	MEMORIAL CIMURRI
MüNSTERLAND GIRO	LOCALNAMES	MüNSTERLAND GIRO
OMLOOP VAN HET HOUTLAND	LOCALNAMES	OMLOOP VAN HET HOUTLAND
CIRCUITO MONTAñéS	LOCALNAMES	CIRCUITO MONTAñéS
STRADE BIANCHE	LOCALNAMES	STRADE BIANCHE - EROICA PRO
GRAN PREMIO BRUNO BEGHELLI	LOCALNAMES	GRAN PREMIO BRUNO BEGHELLI
MILANO–VIGNOLA	LOCALNAMES	MILANO–VIGNOLA
VUELTA CICLISTA A COSTA RICA	LOCALNAMES	VUELTA A COSTA RICA
VLAAMSE DRUIVENVELDRIT OVERIJSE	LOCALNAMES	OVERIJSE
GIRO DELLA PROVINCIA DI GROSSETO	LOCALNAMES	GIRO DELLA PROVINCIA DI GROSSETO
TOUR OF BELIZE	LOCALNAMES	TOUR OF BELIZE
DAIRYLAND DARE	LOCALNAMES	DAIRYLAND DARE
RUTLAND–MELTON INTERNATIONAL CICLE CLASSIC	LOCALNAMES	CICLE CLASSIC
PRESIDENTIAL CYCLING TOUR OF TURKEY	LOCALNAMES	CUMHURBAşKANLığı BISIKLET TURU
TOUR DE BRETAGNE CYCLISTE	LOCALNAMES	TOUR DE BRETAGNE TROPHéE DES GRANITIERS
TOUR DE BRETAGNE CYCLISTE	LOCALNAMES	RUBAN GRANITIER BRETON
OLYMPIA'S TOUR	LOCALNAMES	OLYMPIA'S TOUR
TOUR DE L'ABITIBI	LOCALNAMES	TOUR DE L'ABITIBI
PRESBYTERIAN HOSPITAL INVITATIONAL CRITERIUM	LOCALNAMES	CHARLOTTE CRITERIUM
TOUR OF IRAN	LOCALNAMES	تور دوچرخه‌سواری بین‌المللی آذربایجان
TOUR DO BRASIL	LOCALNAMES	VOLTA DE CICLISMO INTERNACIONAL DO ESTADO DE SãO PAULO
DUO NORMAND	LOCALNAMES	DUO NORMAND
TOUR OF JAPAN	LOCALNAMES	ツアー・オブ・ジャパン
TOUR DE HOKKAIDO	LOCALNAMES	ツール・ド・北海道
GRAN PREMIO DELL'INSUBRIA-LUGANO	LOCALNAMES	GRAN PREMIO DELL'INSUBRIA-LUGANO
DE VLAAMSE PIJL	LOCALNAMES	FLèCHE FLAMANDE
GRAND PRIX DE LA VILLE DE LILLERS	LOCALNAMES	GRAND PRIX DE LA VILLE DE LILLERS
TOUR OF THAILAND	LOCALNAMES	ทัวร์ ออฟ ไทยแลนด์
CLASSIC LOIRE ATLANTIQUE	LOCALNAMES	CLASSIC LOIRE ATLANTIQUE
POREC TROPHY	LOCALNAMES	TROFEJ POREč
GRAND PRIX ELSY JACOBS	LOCALNAMES	GRAND PRIX ELSY JACOBS
LA ROUE TOURANGELLE	LOCALNAMES	LA ROUE TOURANGELLE
TROFEO FRANCO BALESTRA	LOCALNAMES	TROFEO FRANCO BALESTRA
OMLOOP VAN HET WAASLAND	LOCALNAMES	OMLOOP VAN HET WAASLAND
THüRINGEN RUNDFAHRT DER U23	LOCALNAMES	THüRINGEN RUNDFAHRT
ISTRIAN SPRING TROPHY	LOCALNAMES	ISTARSKO PROLJEćE
SIX DAYS OF GRENOBLE	LOCALNAMES	SIX JOURS DE GRENOBLE
VUELTA CICLISTA DE CHILE	LOCALNAMES	VUELTA CICLISTA DE CHILE
GIRO DI PUGLIA	LOCALNAMES	GIRO DI PUGLIA
MOLDOVA PRESIDENT'S CUP	LOCALNAMES	CUPA PREşEDINTELUI LA CICLISM
TRIPTYQUE DES MONTS ET CHâTEAUX	LOCALNAMES	LE TRIPTYQUE DES MONTS ET CHâTEAUX
GRAND PRIX CYCLISTE DE MONTRéAL	LOCALNAMES	GRAND PRIX CYCLISTE DE MONTRéAL
GRAND PRIX CYCLISTE DE QUéBEC	LOCALNAMES	GRAND PRIX CYCLISTE DE QUéBEC
CLASSICA SARDA	LOCALNAMES	CLASSICA SARDA
CLASSIC SUD-ARDèCHE	LOCALNAMES	CLASSIC SUD-ARDèCHE
PARIS–TROYES	LOCALNAMES	PARIS–TROYES
RUND UM DüREN	LOCALNAMES	RUND UM DüREN
RONDE VAN NOORD-HOLLAND	LOCALNAMES	RONDE VAN NOORD-HOLLAND
VUELTA A LA COMUNIDAD DE MADRID	LOCALNAMES	VUELTA A LA COMUNIDAD DE MADRID
TOUR OF ROMANIA	LOCALNAMES	TURUL ROMâNIEI, MICA BUCLă
GIRO DELLA VALLE D'AOSTA	LOCALNAMES	GIRO DELLA VALLE D'AOSTA
STADSPRIJS GERAARDSBERGEN	LOCALNAMES	STADSPRIJS GERAARDSBERGEN
TOUR OF HAINAN	LOCALNAMES	环海南岛国际公路自行车赛
HOFBRAU CUP	LOCALNAMES	HOFBRAU CUP
BINCHE–CHIMAY–BINCHE	LOCALNAMES	BINCHE–CHIMAY–BINCHE
BINCHE–CHIMAY–BINCHE	LOCALNAMES	MEMORIAL FRANK VANDENBROUCKE
GIROBIO	LOCALNAMES	GIRO CICLISTICO D'ITALIA DILETTANTI UNDER 27
TOUR OF SOUTH CHINA SEA	LOCALNAMES	中国南海之旅
VUELTA A BOLIVIA	LOCALNAMES	VUELTA A BOLIVIA
VUELTA A PARAGUAY	LOCALNAMES	VUELTA A PARAGUAY
VOLTA A PORTUGAL	LOCALNAMES	VOLTA A PORTUGAL
KATTEKOERS	LOCALNAMES	KATTEKOERS
HANDZAME CLASSIC	LOCALNAMES	HANDZAME CLASSIC
FLèCHE D'EMERAUDE	LOCALNAMES	FLèCHE D'EMERAUDE
TOUR OF GREECE	LOCALNAMES	Γύρος Ελλάδος
ZELLIK–GALMAARDEN	LOCALNAMES	ZELLIK-GALMAARDEN
DOOKOłA MAZOWSZA	LOCALNAMES	WYśCIG DOOKOłA MAZOWSZA
TOUR OF GALICIA	LOCALNAMES	VUELTA A GALICIA
TOUR OF GALICIA	LOCALNAMES	VOLTA A GALICIA
BAłTYK–KARKONOSZE TOUR	LOCALNAMES	WYśCIG BAłTYK–KARKONOSZE
COUPE DES CARPATHES	LOCALNAMES	PUCHAR UZDROWISK KARPACKICH
TOUR OF MAłOPOLSKA	LOCALNAMES	MAłOPOLSKI WYśCIG GóRSKI
RHôNE-ALPES ISèRE TOUR	LOCALNAMES	RHôNE-ALPES ISèRE TOUR
TOUR OF CHONGMING ISLAND	LOCALNAMES	崇明岛之旅
SCANDINAVIAN RACE UPPSALA	LOCALNAMES	SKANDISLOPPET
TOUR OF BULGARIA	LOCALNAMES	Обиколка на България
TOUR OF BEIJING	LOCALNAMES	环北京职业公路自行车赛
RED BULL ROAD RAGE	LOCALNAMES	RED BULL ROAD RAGE
TOUR DE SERBIE	LOCALNAMES	Трка кроз Србију
TOUR DE HONGRIE	LOCALNAMES	MAGYAR KöRVERSENY
TOUR OF SZEKLERLAND	LOCALNAMES	TURUL CICLIST AL TINUTULUI SECUIESC
PUCHAR MINISTRA OBRONY NARODOWEJ	LOCALNAMES	PUCHAR MINISTRA OBRONY NARODOWEJ
GIRO DI PADANIA	LOCALNAMES	GIRO DI PADANIA, MONVISO-VENEZIA — IL PADANIA
TOUR DE SINGKARAK	LOCALNAMES	TOUR OF SINGKARAK
CHRONO CHAMPENOIS	LOCALNAMES	CHRONO CHAMPENOIS
TOUR OF FAROE ISLANDS	LOCALNAMES	KRING FøROYAR
RONDE VAN VLAANDEREN U23	LOCALNAMES	RONDE VAN VLAANDEREN BELOFTEN
DWARS DOOR DRENTHE	LOCALNAMES	DWARS DOOR DRENTHE
RONDE VAN LIMBURG	LOCALNAMES	RONDE VAN LIMBURG
RONDE VAN LIMBURG	LOCALNAMES	RONDE VAN LIMBURG
TOUR OF ALANYA	LOCALNAMES	ULUSLARARASı ALANYA BISIKLET TURU
TOUR OF TRAKYA	LOCALNAMES	ULUSLARARASı TRAKYA BISIKLET TURU
TOUR OF MARMARA	LOCALNAMES	ULUSLARARASı MARMARA BISIKLET TURU
THüRINGEN RUNDFAHRT DER FRAUEN	LOCALNAMES	THüRINGEN RUNDFAHRT DER FRAUEN
TOUR OF CAPPADOCIA	LOCALNAMES	ULUSLARARASı KAPADOKYA BISIKLET TURU
DELTA TOUR ZEELAND	LOCALNAMES	DELTA TOUR ZEELAND
TOUR DE GUADELOUPE	LOCALNAMES	• TOUR CYCLISTE INTERNATIONAL DE LA GUADELOUPE
TOUR DE GUADELOUPE	LOCALNAMES	• INTERNATIONAL CYCLING TOUR OF GUADELOUPE
TOBAGO CYCLING CLASSIC	LOCALNAMES	TOBAGO CYCLING CLASSIC
TOUR OF CHINA	LOCALNAMES	环中国国际公路自行车赛
GP IMPANIS-VAN PETEGEM	LOCALNAMES	GROTE PRIJS IMPANIS-VAN PETEGEM
GIRO DEL CAPO	LOCALNAMES	GIRO DEL CAPO
CYCLO-CROSS NAMUR	LOCALNAMES	* CYCLO-CROSS DE LA CITADELLE
CYCLO-CROSS NAMUR	LOCALNAMES	* CITADELCROSS
GRAND PRIX ERIK DE VLAEMINCK	LOCALNAMES	GROTE PRIJS ERIC DE VLAEMINCK
NOORDZEECROSS	LOCALNAMES	NOORDZEECROSS
RONDE VAN ZEELAND SEAPORTS	LOCALNAMES	RONDE VAN ZEELAND SEAPORTS
TOUR OF ALBERTA	LOCALNAMES	THE TOUR
TOUR D'AZERBAïDJAN	LOCALNAMES	TOUR D'AZERBAïDJAN
TOUR DE BORNEO	LOCALNAMES	JELAJAH BORNEO
MELAKA GOVERNOR'S CUP	LOCALNAMES	JELAJAH PIALA GABENOR MELAKA
PAREL VAN DE VELUWE	LOCALNAMES	WOMEN MEMORIAL CONNIE MEYER TROFEE
PROFRONDE VAN ALMELO	LOCALNAMES	PROFRONDE VAN ALMELO
PROFRONDE VAN STIPHOUT	LOCALNAMES	PROFRONDE VAN STIPHOUT
ACHT VAN CHAAM	LOCALNAMES	ACHT VAN CHAAM
DRAAI VAN DE KAAI	LOCALNAMES	DRAAI VAN DE KAAI
OMLOOP DER KEMPEN	LOCALNAMES	OMLOOP DER KEMPEN
PROFRONDE VAN OOSTVOORNE	LOCALNAMES	PROFRONDE VAN OOSTVOORNE
GROTE 1-MEIPRIJS	LOCALNAMES	1
SIBIU CYCLING TOUR	LOCALNAMES	TURUL CICLIST AL SIBIULUI
HADSTEN GRAND PRIX	LOCALNAMES	DET NYE LøB
PROFRONDE VAN TIEL	LOCALNAMES	PROFRONDE VAN TIEL
STEENBERGCROSS	LOCALNAMES	STEENBERGCROSS
LEVI LEIPHEIMER'S KING RIDGE GRANFONDO	LOCALNAMES	LEVI'S GRANFONDO
SIX DAYS OF AMSTERDAM	LOCALNAMES	ZESDAAGSE VAN AMSTERDAM
TOUR ALSACE	LOCALNAMES	TOUR ALSACE, TOUR D'ALSACE
TOUR DE INDIA	LOCALNAMES	CYCLOTHON
TOUR OF YUGOSLAVIA	LOCALNAMES	UTRKA KROZ JUGOSLAVIJU
VUELTA INTERNACIONAL FEMENINA A COSTA RICA	LOCALNAMES	VUELTA A COSTA RICA
RONDE VAN OVERIJSSEL	LOCALNAMES	RONDE VAN OVERIJSSEL
TOUR CYCLISTE FéMININ INTERNATIONAL DE L'ARDèCHE	LOCALNAMES	TOUR DE L'ARDèCHE
MEMORIAL VAN CONINGSLOO	LOCALNAMES	MEMORIAL VAN CONINGSLOO
BEAUMONT TROPHY	LOCALNAMES	VIRGIN MONEY CYCLONE
GRAND PRIX LEENDE	LOCALNAMES	GROTE PRIJS LEENDE
TOUR OF ALMATY	LOCALNAMES	Тур Алматы
GP MARIO DE CLERCQ	LOCALNAMES	HOTONDCROSS, GP MARIO DE CLERCQ
BOUCLES DE LA MAYENNE	LOCALNAMES	BOUCLES DE LA MAYENNE
DUTCH HEADWIND CYCLING CHAMPIONSHIPS	LOCALNAMES	NK TEGENWINDFIETSEN
TOUR OF ÇANAKKALE	LOCALNAMES	ÇANAKKALE BISIKLET TURU
HIMMERLAND RUNDT	LOCALNAMES	HIMMERLAND RUNDT
GRAND PRIX CRIQUIELION	LOCALNAMES	GP CRIQUIELION
ÉTOILE DES ESPOIRS	LOCALNAMES	ÉTOILE DES ESPOIRS
STRADE BIANCHE DONNE	LOCALNAMES	STRADE BIANCHE DONNE
GP INTERNACIONAL DO GUADIANA	LOCALNAMES	TROFéU ALPENDRE INTERNACIONAL DO GUADIANA
GP LIBERTY SEGUROS	LOCALNAMES	GP LIBERTY SEGUROS-TROFéU SUDOESTE ALENTEJANO E COSTA VICENTINA
GP LIBERTY SEGUROS	LOCALNAMES	VOLTA A COSTA VICENTINA
GP LIBERTY SEGUROS	LOCALNAMES	GP LIBERTY SEGUROS-TROFEU ALPRENDRE
VOLTA A PORTUGAL DO FUTURO	LOCALNAMES	VOLTA A PORTUGAL DO FUTURO / LIBERTY SEGUROS
SANTOS WOMEN'S TOUR	LOCALNAMES	RENDITION HOMES-SANTOS WOMEN'S CUP
SANTOS WOMEN'S TOUR	LOCALNAMES	SANTOS WOMEN'S CUP
HEISTSE PIJL	LOCALNAMES	HEISTSE PIJL
ROMA–NAPOLI–ROMA	LOCALNAMES	ROMA–NAPOLI–ROMA
ADANA MTB CUP	LOCALNAMES	ULUSLARARASı ADANA DAğ BISIKLETI YARışı
TOUR DE LIèGE	LOCALNAMES	RONDE VAN LUIK
TOUR OF BIHOR	LOCALNAMES	TURUL CICLIST AL BIHORULUI
TOUR DES PYRéNéES	LOCALNAMES	TOUR DES PYRéNéES
TOUR DES PYRéNéES	LOCALNAMES	VUELTA A LOS PIRINEOS
