AUSCHWITZ CONCENTRATION CAMP	MAPCAPTION	LOCATION OF AUSCHWITZ IN CONTEMPORARY POLAND
WESTERBORK TRANSIT CAMP	MAPCAPTION	LOCATION OF THE CAMP IN THE NETHERLANDS
BERGEN-BELSEN CONCENTRATION CAMP	MAPCAPTION	LOCATION OF BERGEN-BELSEN IN LOWER SAXONY
NATZWEILER-STRUTHOF	MAPCAPTION	NATZWILLER
NATZWEILER-STRUTHOF	MAPCAPTION	FRANCE
NEUENGAMME CONCENTRATION CAMP	MAPCAPTION	LOCATION OF NEUENGAMME IN GERMANY
DACHAU CONCENTRATION CAMP	MAPCAPTION	LOCATION OF DACHAU IN UPPER BAVARIA
OHRDRUF CONCENTRATION CAMP	MAPCAPTION	LOCATION OF OHRDRUF IN GERMANY
VILLA BAVIERA	MAPCAPTION	LOCATION OF VILLA BAVIERA IN CHILE
FORT BREENDONK	MAPCAPTION	LOCATION OF THE CAMP IN BELGIUM
VILINA VLAS	MAPCAPTION	LOCATION OF VIšEGRAD IN BOSNIA AND HERZEGOVINA
FANNREM CONCENTRATION CAMP	MAPCAPTION	LOCATION IN SøR-TRøNDELAG
VILLA GRIMALDI	MAPCAPTION	LOCATION OF VILLA GRIMALDI IN CONTEMPORARY CHILE
BANJICA CONCENTRATION CAMP	MAPCAPTION	LOCATION OF BANJICA WITHIN OCCUPIED YUGOSLAVIA
SAJMIšTE CONCENTRATION CAMP	MAPCAPTION	LOCATION OF SAJMIšTE WITHIN OCCUPIED YUGOSLAVIA
OMARSKA CAMP	MAPCAPTION	LOCATION OF OMARSKA IN BOSNIA AND HERZEGOVINA
MONOWITZ CONCENTRATION CAMP	MAPCAPTION	LOCATION OF MONOWITZ WITHIN POLAND.
CRVENI KRST CONCENTRATION CAMP	MAPCAPTION	LOCATION OF CRVENI KRST IN CONTEMPORARY SERBIA
AMERSFOORT CONCENTRATION CAMP	MAPCAPTION	LOCATION OF THE CAMP IN THE NETHERLANDS
HERZOGENBUSCH CONCENTRATION CAMP	MAPCAPTION	LOCATION OF THE CAMP IN THE NETHERLANDS
BEREZA KARTUSKA PRISON	MAPCAPTION	LOCATION IN MODERN DAY BELARUS
KAMP SCHOORL	MAPCAPTION	LOCATION OF THE CAMP IN THE NETHERLANDS
TOPOVSKE ŠUPE CONCENTRATION CAMP	MAPCAPTION	LOCATION OF TOPOVSKE ŠUPE WITHIN OCCUPIED YUGOSLAVIA
MECHELEN TRANSIT CAMP	MAPCAPTION	LOCATION OF THE CAMP IN BELGIUM
FERRAMONTI DI TARSIA	MAPCAPTION	LOCATION OF FERRAMONTI IN ITALY
JANOWSKA CONCENTRATION CAMP	MAPCAPTION	LOCATION OF JANOWSKA CAMP IN MODERN UKRAINE
ZASłAW CONCENTRATION CAMP	MAPCAPTION	LOCATION OF ZASLAW CAMP IN MODERN POLAND
VALPOVO WORK CAMP	MAPCAPTION	LOCATION OF VALPOVO WITHIN YUGOSLAVIA
IZBICA GHETTO	MAPCAPTION	LOCATION OF FORMER IZBICA GHETTO IN MODERN POLAND
DEIR EZ-ZOR CAMPS	MAPCAPTION	LOCATION OF DEIR EZ-ZOR IN CONTEMPORARY SYRIA
JADOVNO CONCENTRATION CAMP	MAPCAPTION	LOCATION OF JADOVNO WITHIN THE INDEPENDENT STATE OF CROATIA
ŁACHWA GHETTO	MAPCAPTION	LOCATION IN MODERN DAY BELARUS
JASTREBARSKO CONCENTRATION CAMP	MAPCAPTION	LOCATION OF JASTREBARSKO IN THE INDEPENDENT STATE OF CROATIA
KAMP ERIKA	MAPCAPTION	LOCATION OF THE CAMP IN THE NETHERLANDS
KEMNA CONCENTRATION CAMP	MAPCAPTION	LOCATION OF CAMP IN CONTEMPORARY GERMANY
GARAVICE	MAPCAPTION	LOCATION OF GARAVICE IN BOSNIA AND HERCEGOVINA
MITTELSTEINE	MAPCAPTION	LOCATION OF MITTELSTEINE IN PRESENT-DAY POLAND
GRAFENORT CONCENTRATION CAMP	MAPCAPTION	LOCATION OF GRAFENORT IN PRESENT-DAY POLAND
NATIONAL INTERNMENT CAMP FOR WOMEN IN HOVEDøYA	MAPCAPTION	LOCATION OF HOVEDøYA WITHIN OSLO
PIńSK GHETTO	MAPCAPTION	LOCATION OF PIńSK GHETTO IN MODERN DAY BELARUS
AGFA-COMMANDO	MAPCAPTION	LOCATION OF THE AGFA SUBCAMP IN MUNICH
VENDA SEXY	MAPCAPTION	LOCATION OF VENDA SEXY IN CONTEMPORARY CHILE
