ATHENS	MAYOR	GIORGOS KAMINIS
ABENSBERG	MAYOR	UWE BRANDL
AALEN	MAYOR	MARTIN GERLACH
BORDEAUX	MAYOR	ALAIN JUPPé
BAYONNE	MAYOR	JEAN GRENET
BAMBERG	MAYOR	ANDREAS STARKE
BASEL	MAYOR	GUY MORIN
COLOGNE	MAYOR	HENRIETTE REKER
DACHAU	MAYOR	FLORIAN HARTMANN
ERFURT	MAYOR	ANDREAS BAUSEWEIN
FRANKFURT	MAYOR	PETER FELDMANN
FLORENCE	MAYOR	DARIO NARDELLA
GHENT	MAYOR	DANIëL TERMONT
GENEVA	MAYOR	ESTHER ALDER
HANOVER	MAYOR	STEFAN SCHOSTOK
LEIPZIG	MAYOR	BURKHARD JUNG
LAUSANNE	MAYOR	DANIEL BRéLAZ
MUNICH	MAYOR	DIETER REITER
MAINZ	MAYOR	MICHAEL EBLING
MONTAUBAN	MAYOR	BRIGITTE BARèGES
NUREMBERG	MAYOR	ULRICH MALY
NUORO	MAYOR	ANDREA SODDU
PARIS	MAYOR	ANNE HIDALGO
STUTTGART	MAYOR	FRITZ KUHN
TüBINGEN	MAYOR	BORIS PALMER
VENICE	MAYOR	LUIGI BRUGNARO
MILAN	MAYOR	GIUSEPPE SALA
DRESDEN	MAYOR	DIRK HILBERT
STRASBOURG	MAYOR	ROLAND RIES
AUGSBURG	MAYOR	KURT GRIBL
PLZEň	MAYOR	MARTIN ZRZAVECKý
AVIGNON	MAYOR	CéCILE HELLE
PERPIGNAN	MAYOR	JEAN-MARC PUJOL
PALERMO	MAYOR	LEOLUCA ORLANDO
OLDENBURG	MAYOR	JüRGEN KROGMANN
WIESBADEN	MAYOR	SVEN GERICH
SASSARI	MAYOR	NICOLA SANNA
TOULOUSE	MAYOR	JEAN-LUC MOUDENC
FERRARA	MAYOR	TIZIANO TAGLIANI
RENNES	MAYOR	NATHALIE APPéRé
NICE	MAYOR	PHILIPPE PRADAL
WEIMAR	MAYOR	STEFAN WOLF
GRAZ	MAYOR	SIEGFRIED NAGL
ROUEN	MAYOR	YVON ROBERT
MARATHON, GREECE	MAYOR	ILIAS PSINAKIS
BERN	MAYOR	ALEXANDER TSCHäPPäT
LILLE	MAYOR	MARTINE AUBRY
PADUA	MAYOR	MASSIMO BITONCI
GRENOBLE	MAYOR	ÉRIC PIOLLE
TOULON	MAYOR	HUBERT FALCO
VICHY	MAYOR	CLAUDE MALHURET
POITIERS	MAYOR	ALAIN CLAEYS
ALBANY, NEW YORK	MAYOR	KATHY SHEEHAN
ASHKELON	MAYOR	ITAMAR SHIMONI
HAIFA	MAYOR	YONA YAHAV
ACRE, ISRAEL	MAYOR	SHIMON LANKRI
LINZ	MAYOR	KLAUS LUGER
NAPLES	MAYOR	LUIGI DE MAGISTRIS
MONS	MAYOR	ELIO DI RUPO
OLOMOUC	MAYOR	ANTONíN STANěK
DOVER, DELAWARE	MAYOR	ROBIN R. CHRISTIANSEN
ZUG	MAYOR	DOLFI MüLLER
KIEL	MAYOR	ULF KäMPFER
EISENACH	MAYOR	KATJA WOLF
RA'ANANA	MAYOR	ZE'EV BIELSKI
MODENA	MAYOR	GIANCARLO MUZZARELLI
DüSSELDORF	MAYOR	THOMAS GEISEL
EILAT	MAYOR	MEIR YITZHAK HALEVI
NANTES	MAYOR	JOHANNA ROLLAND
MOL, BELGIUM	MAYOR	PAUL ROTTHIER
CHAPEL HILL, NORTH CAROLINA	MAYOR	PAM HEMMINGER
BENEVENTO	MAYOR	CLEMENTE MASTELLA
LEUVEN	MAYOR	LOUIS TOBBACK
AIX-EN-PROVENCE	MAYOR	MARYSE JOISSAINS-MASINI
KLAGENFURT	MAYOR	MARIA-LUISE MATHIASCHITZ
CANNES	MAYOR	DAVID LISNARD UMP
AMIENS	MAYOR	BRIGITTE FOURé
CLERMONT-FERRAND	MAYOR	OLIVIER BIANCHI
ORANGE, VAUCLUSE	MAYOR	JACQUES BOMPARD
LITITZ, PENNSYLVANIA	MAYOR	RONALD G. OETTEL, JR.
CALAIS	MAYOR	NATACHA BOUCHART
CARCASSONNE	MAYOR	JEAN-CLAUDE PEREZ
LANGRES	MAYOR	SOPHIE DELONG
FLENSBURG	MAYOR	SIMON FABER
CAEN	MAYOR	JOëL BRUNEAU
VITERBO	MAYOR	LEONARDO MICHELINI
RENDSBURG	MAYOR	PIERRE GILGENAST
KONSTANZ	MAYOR	ULRICH BURCHARDT
PIRAEUS	MAYOR	IOANNIS MORALIS
DIJON	MAYOR	FRANçOIS REBSAMEN
DAVOS	MAYOR	TARZISIUS CAVIEZEL
FRENCH QUARTER	MAYOR	MITCH LANDRIEU
CAMBRAI	MAYOR	FRANçOIS-XAVIER VILLAIN
PORTO	MAYOR	RUI MOREIRA
TROYES	MAYOR	FRANçOIS BAROIN
FREIBURG IM BREISGAU	MAYOR	DIETER SALOMON
NARBONNE	MAYOR	JACQUES BASCOU
NîMES	MAYOR	JEAN-PAUL FOURNIER
PAU, PYRéNéES-ATLANTIQUES	MAYOR	FRANçOIS BAYROU
LA ROCHELLE	MAYOR	JEAN-FRANçOIS FOUNTAINE
SCHWERIN	MAYOR	ANGELIKA GRAMKOW
BELVIDERE, ILLINOIS	MAYOR	MIKE CHAMBERLAIN
WHEELING, ILLINOIS	MAYOR	VILLAGEPRESIDENT.ASP
AURORA, ILLINOIS	MAYOR	TOM WEISNER
NAPERVILLE, ILLINOIS	MAYOR	STEVE CHIRICO
WOOD DALE, ILLINOIS	MAYOR	MAYOR
FIELDON, ILLINOIS	MAYOR	BETTY DUGGAN
BRIGHTON, ILLINOIS	MAYOR	WAYNE SCHAFER
ELSAH, ILLINOIS	MAYOR	CYRUS BUNTING
GRAFTON, ILLINOIS	MAYOR	TOM THOMPSON
JERSEYVILLE, ILLINOIS	MAYOR	WILLIAM BILLY RUSSEL
MANTENO, ILLINOIS	MAYOR	TIMOTHY NUGENT
JOLIET, ILLINOIS	MAYOR	BOB O'DEKIRK
METTAWA, ILLINOIS	MAYOR	CASEY URLACHER
CARLINVILLE, ILLINOIS	MAYOR	DEANNA DEMUZIO
PEORIA, ILLINOIS	MAYOR	JIM ARDIS
SHILOH, ILLINOIS	MAYOR	JAMES A. VERNIER II
NEW LENOX, ILLINOIS	MAYOR	TIMOTHY BALDERMANN
WEST MONROE, LOUISIANA	MAYOR	DAVE NORRIS
WATERVLIET, NEW YORK	MAYOR	MICHAEL MANNING
COHOES, NEW YORK	MAYOR	GEORGE E. PRIMEAU
MIDDLETOWN, ORANGE COUNTY, NEW YORK	MAYOR	JOSEPH M. DESTEFANO
RENSSELAER, NEW YORK	MAYOR	DANIEL J. DWYER
TROY, NEW YORK	MAYOR	PATRICK MADDEN
BOULOGNE-SUR-MER	MAYOR	FRéDéRIC CUVILLIER
AVALON, PENNSYLVANIA	MAYOR	DAVID HASLETT
CASTLE SHANNON, PENNSYLVANIA	MAYOR	DONALD J. BAUMGARTEN
DOWNINGTOWN, PENNSYLVANIA	MAYOR	JOSH MAXWELL
DREXEL HILL, PENNSYLVANIA	MAYOR	DONNIE MCCLURKIN
CHESTER, PENNSYLVANIA	MAYOR	THADDEUS KIRKLAND
RIDLEY PARK, PENNSYLVANIA	MAYOR	HANK EBERLE JR.
SWARTHMORE, PENNSYLVANIA	MAYOR	TIM KEARNEY
ERIE, PENNSYLVANIA	MAYOR	JOSEPH E. SINNOTT
DELAWARE WATER GAP, PENNSYLVANIA	MAYOR	ROBERT GALLAGHER
MOUNT POCONO, PENNSYLVANIA	MAYOR	FREDERICK T. COURTRIGHT
CONSHOHOCKEN, PENNSYLVANIA	MAYOR	ROBERT FROST
NANCY, FRANCE	MAYOR	LAURENT HéNART
BOULOGNE-BILLANCOURT	MAYOR	PIERRE-CHRISTOPHE BAGUET
DORTMUND	MAYOR	ULLRICH SIERAU
CELLE	MAYOR	DIRK-ULRICH MENDE
SAINT-JOSSE-TEN-NOODE	MAYOR	EMIR KIR
WOLUWE-SAINT-PIERRE	MAYOR	WILLEM DRAPS
ANDERLECHT	MAYOR	GAëTAN VAN GOIDSENHOVEN
KOEKELBERG	MAYOR	PHILIPPE PIVIN
GANSHOREN	MAYOR	HERVé GILLARD
ETTERBEEK	MAYOR	VINCENT DE WOLF
EVERE	MAYOR	RUDI VERVOORT
BEERNEM	MAYOR	JOHAN DE RYCKE
JABBEKE	MAYOR	DANIëL VANHESSCHE
DAMME	MAYOR	JOACHIM COENS
ZEDELGEM	MAYOR	HILAIRE VERHEGGE
TORHOUT	MAYOR	HILDE CREVITS
OOSTKAMP	MAYOR	LUC VANPARYS
KOEKELARE	MAYOR	PATRICK LANSENS
ROESELARE	MAYOR	KRIS DECLERCQ
GISTEL	MAYOR	BART HALEWYCK
STADEN	MAYOR	FRANCESCO VANDERJEUGD
DE PANNE	MAYOR	ANN VANHESTE
MEULEBEKE	MAYOR	DIRK VERWILST
WINGENE	MAYOR	HENDRIK VERKEST
PITTEM	MAYOR	IVAN DELAERE
TIELT	MAYOR	ELS DERAMMELAERE
OSTEND	MAYOR	JOHAN VANDE LANOTTE
KOKSIJDE	MAYOR	MARC VANDEN BUSSCHE
WERVIK	MAYOR	YOURO CASIER
YPRES	MAYOR	JAN DURNEZ
WOLFENBüTTEL	MAYOR	THOMAS PINK
LEBBEKE	MAYOR	FRANçOIS SAEYS
DENDERMONDE	MAYOR	PIET BUYSE
LAARNE	MAYOR	IGNACE DE BAERDEMAECKER
HAMME	MAYOR	HERMAN VIJT
BERLARE	MAYOR	KATJA GABRIëLS
GERAARDSBERGEN	MAYOR	GUIDO DE PADT
NINOVE	MAYOR	TANIA DE JONGE
AALST, BELGIUM	MAYOR	CHRISTOPH D'HAESE
DENDERLEEUW	MAYOR	JO FONCK
ZELE	MAYOR	PATRICK POPPE
WETTEREN	MAYOR	ALAIN PARDAEN
WAASMUNSTER	MAYOR	RIK DAELMAN
AALTER	MAYOR	PIETER DE CREM
DE PINTE	MAYOR	HILDE CLAEYS
MOERBEKE	MAYOR	ROBBY DE CALUWé
BRAKEL	MAYOR	HERMAN DE CROO
ZWALM	MAYOR	BRUNO TUYBENS
SINT-GILLIS-WAAS	MAYOR	REMI AUDENAERT
BEVEREN	MAYOR	MARC VAN DE VIJVE
TEMSE	MAYOR	LUC DE RYCK
LOKEREN	MAYOR	FILIP ANTHUENIS
SINT-NIKLAAS	MAYOR	LIEVEN DEHANDSCHUTTER
BOECHOUT	MAYOR	KOEN T'SIJEN
BRASSCHAAT	MAYOR	KOEN VERBERCK
AARTSELAAR	MAYOR	SOPHIE DE WIT
WILLEBROEK	MAYOR	EDDY BEVERS
MECHELEN	MAYOR	BART SOMERS
BALEN	MAYOR	JOHAN LEYSEN
DESSEL	MAYOR	KRIS VAN DIJCK
ARENDONK	MAYOR	NEST BUIJS
HULSHOUT	MAYOR	MARK VERHAEGEN
OLEN, BELGIUM	MAYOR	MARCEL BELLENS
OUD-TURNHOUT	MAYOR	JEF KERSEMANS
RAVELS	MAYOR	WALTER LUYTEN
LAAKDAL	MAYOR	TINE GIELIS
TURNHOUT	MAYOR	ERIC VOS
WESTERLO	MAYOR	GUY VAN HIRTUM
VOSSELAAR	MAYOR	JOSEE HEYKANTS-JANSSENS
HERSELT	MAYOR	LUC PEETERMANS
RIJKEVORSEL	MAYOR	DORIEN CUYLAERTS
LENNIK	MAYOR	IRINA DE KNOP
KRAAINEM	MAYOR	VéRONIQUE CAPRASSE
KRAAINEM	MAYOR	MAYOR
ASSE	MAYOR	KOEN VAN ELSEN
BEERSEL	MAYOR	HUGO VANDAELE
DILBEEK	MAYOR	WILLY SEGERS
WEMMEL	MAYOR	MARCEL VAN LANGENHOVE
VILVOORDE	MAYOR	HANS BONTE
SINT-PIETERS-LEEUW	MAYOR	LUC DECONINCK
ZAVENTEM	MAYOR	FRANCIS VERMEIREN
AARSCHOT	MAYOR	ANDRé PEETERS
BERTEM	MAYOR	ALBERT MEES
DIEST	MAYOR	JAN LAURYS
HERENT	MAYOR	MARLEEN SCHOUTEDEN
KORTENAKEN	MAYOR	PATRICK VANDIJCK
LANDEN	MAYOR	CHRIS COLSOUL
LUBBEEK	MAYOR	THEO FRANCKEN
TIENEN	MAYOR	KATRIEN PARTYKA
TERVUREN	MAYOR	JAN SPOOREN N-VA
ROTSELAAR	MAYOR	DIRK CLAES
BEAUCAIRE, GARD	MAYOR	JULIEN SANCHEZ
LA SPEZIA	MAYOR	MASSIMO FEDERICI
BOTHEL, LOWER SAXONY	MAYOR	ERIKA SCHMIDT
FRIBOURG	MAYOR	PIERRE-ALAIN CLéMENT
ORISTANO	MAYOR	GUIDO TENDAS
HALLE, BELGIUM	MAYOR	DIRK PIETERS
BERINGEN, BELGIUM	MAYOR	(MAURICE WEBERS )
GENK	MAYOR	WIM DRIES
HALEN	MAYOR	ERIK VAN ROELEN
HAM, BELGIUM	MAYOR	DIRK DE VIS
HEUSDEN-ZOLDER	MAYOR	MARIO BORREMANS
SINT-TRUIDEN	MAYOR	VEERLE HEEREN
ZONHOVEN	MAYOR	JOHNY DERAEVE
BILZEN	MAYOR	FRIEDA BREPOELS
FLOBECQ	MAYOR	PHILIPPE METTENS
VOEREN	MAYOR	HUUB BROERS
BELœIL	MAYOR	ALAIN CARION
TONGEREN	MAYOR	PATRICK DEWAEL
ATH	MAYOR	JEAN-PIERRE DENIS
FARCIENNES	MAYOR	HUGUES BAYET
MONTIGNY-LE-TILLEUL	MAYOR	MARIE-HéLèNE KNOOPS
JURBISE	MAYOR	JACQUELINE GALANT
CHARLEROI	MAYOR	PAUL MAGNETTE
MONT-DE-L'ENCLUS	MAYOR	THIERRI GOURDIN
ESTAIMPUIS	MAYOR	DANIEL SENESAEL
ITTRE	MAYOR	FERDINAND JOLLY
COURT-SAINT-ÉTIENNE	MAYOR	MICHAëL GOBLET D'ALVIELLA
JODOIGNE	MAYOR	JEAN-PAUL WAHL
LEUZE-EN-HAINAUT	MAYOR	JEAN-POL RENARD
NIVELLES	MAYOR	PIERRE HUART
TUBIZE	MAYOR	RAYMOND LANGENDRIES
TOURNAI	MAYOR	RUDY DEMOTTE
WATERLOO, BELGIUM	MAYOR	FLORENCE REUTER
WAVRE	MAYOR	CHARLES MICHEL
ROCHEFORT, BELGIUM	MAYOR	FRANçOIS BELLOT
WANZE	MAYOR	CLAUDE PARMENTIER
ANTHISNES	MAYOR	MARC TARABELLA
AMAY	MAYOR	JEAN-MICHEL JAVAUX
BURDINNE	MAYOR	LUC GUSTIN
SAMBREVILLE	MAYOR	.
SAMBREVILLE	MAYOR	DENIS LISéLéLé \NDENIS LISéLéLé
LA BRUYèRE, BELGIUM	MAYOR	ROBERT CAPPE
VRESSE-SUR-SEMOIS	MAYOR	BRUNO TELLIER
ANS	MAYOR	STéPHANE MOREAU
DISON	MAYOR	YVAN YLIEFF
VISé	MAYOR	MARCEL NEVEN
LONTZEN	MAYOR	ALFRED LECERF
EUPEN	MAYOR	KARL-HEINZ KLINKENBERG
KELMIS	MAYOR	LOUIS GOEBBELS
BERLOZ	MAYOR	MICHEL JADOUL
VERVIERS	MAYOR	MARC ELSEN
ARLON	MAYOR	VINCENT MAGNUS
SORA, LAZIO	MAYOR	ROBERTO DE DONATIS
LEVERKUSEN	MAYOR	UWE RICHRATH
JENA	MAYOR	ALBRECHT SCHRöTER
JUDENBURG	MAYOR	HANNES DOLLESCHALL
LUCERNE	MAYOR	BEAT ZüSLI
FUNCHAL	MAYOR	PAULO CAFôFO
BRAMSCHE	MAYOR	HEINER PAHLMANN
ULM	MAYOR	TREVAR SCHMIDT
DIEPPE	MAYOR	SéBASTIEN JUMEL
TAORMINA	MAYOR	ELIGIO GIARDINA
PETAH TIKVA	MAYOR	ITZIK BRAVERMAN
ERLANGEN	MAYOR	FLORIAN JANIK
COLMAR	MAYOR	GILBERT MEYER
HOLON	MAYOR	MOTI SASSON
LINDAU	MAYOR	DR. GERHARD ECKER
GERA	MAYOR	VIOLA HAHN
LIBEREC	MAYOR	:CZ:TIBOR BATTHYáNY
SCHAERBEEK	MAYOR	BERNARD CLERFAYT
FORT-DE-FRANCE	MAYOR	DIDIER LAGUERRE
CANANDAIGUA	MAYOR	ELLEN POLIMENI
NEWBURGH, NEW YORK	MAYOR	JUDY KENNEDY
BéZIERS	MAYOR	ROBERT MéNARD
VERONA	MAYOR	FLAVIO TOSI
LIéVIN	MAYOR	JEAN-PIERRE KUCHEIDA
ASHDOD	MAYOR	YEHIEL LASRI
BELFORT	MAYOR	DAMIEN MESLOT
RENENS	MAYOR	MARIANNE HUGUENIN
ÉVRY, ESSONNE	MAYOR	FRANCIS CHOUAT
ARGENTEUIL	MAYOR	GEORGES MOTHRON
LUGANO	MAYOR	MARCO BORRADORI
ANNONAY	MAYOR	OLIVIER DUSSOPT
GORIZIA	MAYOR	ETTORE ROMOLI
KOZANI	MAYOR	LIST OF MAYORS OF KOZANI
IOANNINA	MAYOR	THOMAS BEGAS
ARAD, ISRAEL	MAYOR	NISAN BEN HEMO
KOšICE	MAYOR	RICHARD RAšI
ŽILINA	MAYOR	IGOR CHOMA
GIVATAYIM	MAYOR	RAN KUNIK
RAMAT GAN	MAYOR	YISRAEL ZINGER
RISHON LEZION	MAYOR	DOV TZUR
BEERSHEBA	MAYOR	RUVIK DANILOVICH
BASSE-TERRE	MAYOR	MARIE-LUCE PENCHARD
BAT YAM	MAYOR	YOSSI BACHAR
BNEI BRAK	MAYOR	HANOCH ZEIBERT
VILLERS-COTTERêTS	MAYOR	FRANCK BRIFFAUT
AIX-LES-BAINS	MAYOR	DOMINIQUE DORD
RAMLA	MAYOR	YOEL LAVI
OR AKIVA	MAYOR	YAAKOV EDRI
UMM AL-FAHM	MAYOR	KHALED AGHBARIYYA
HADERA	MAYOR	ZVI GENDELMAN
BEIT SHEMESH	MAYOR	MOSHE ABUTBUL
YEHUD	MAYOR	YAELA MACHLIS
MA'ALE ADUMIM	MAYOR	BENNY KASHRIEL
MA'ALOT-TARSHIHA	MAYOR	SHLOMO BOHBOT
NETANYA	MAYOR	MIRIAM FEIRBERG
KIRYAT MALAKHI	MAYOR	ELIYAHU ZOHAR
KIRYAT MOTZKIN	MAYOR	HAIM ZURI
ROSH HAAYIN	MAYOR	SHALOM BEN MOSHE
KIRYAT GAT	MAYOR	AVIRAM DAHARI
REHOVOT	MAYOR	RAHAMIM MALUL
FURANO, HOKKAIDO	MAYOR	YOSHIAKI NOTO
SHIBETSU, HOKKAIDO	MAYOR	MAKINO YUJI
ISHIKARI, HOKKAIDO	MAYOR	KATSUSUKE TAOKA
KITAHIROSHIMA, HOKKAIDO	MAYOR	MASAMI UENO
KUSHIRO, HOKKAIDO	MAYOR	EBINA HIROYA
SUZU, ISHIKAWA	MAYOR	IZUMIYA MASUHIRO
WAJIMA, ISHIKAWA	MAYOR	FUMIAKI KAJI
IIYAMA, NAGANO	MAYOR	MASATO ISHIDA
ŌMACHI, NAGANO	MAYOR	TōRU USHIKOSHI
KUSATSU, SHIGA	MAYOR	WATARU HASHIKAWA
IKEDA, OSAKA	MAYOR	KAORU KURATA
TOYONAKA, OSAKA	MAYOR	KEIICHIRō ASARI
IZUMISANO, OSAKA	MAYOR	HIROYASU CHIYOMATSU
TONDABAYASHI, OSAKA	MAYOR	TOSHIKI TADA
KAWACHINAGANO, OSAKA	MAYOR	KEIJI SHIBATA
HIGASHIōSAKA	MAYOR	JUNZō NAGAO
AMAGASAKI	MAYOR	KAZUMI INAMURA
ITAMI, HYōGO	MAYOR	YASUYUKI FUJIWARA
TAKASAGO, HYōGO	MAYOR	YUKIHITO NOBORI
TAKARAZUKA, HYōGO	MAYOR	TOMOKO NAKAGAWA
SANDA, HYōGO	MAYOR	HIDEAKI TAKEUCHI
SUMOTO, HYōGO	MAYOR	MICHIHIRO TAKEUCHI
HASHIMOTO, WAKAYAMA	MAYOR	YOSHIYUKI KINOSHITA
TANABE, WAKAYAMA	MAYOR	MITSUTOSHI MANAGO
SAKAIMINATO, TOTTORI	MAYOR	KATSUJI NAKAMURA
GōTSU, SHIMANE	MAYOR	MASUJI TANAKA
HIGASHIHIROSHIMA	MAYOR	YOSHIO KURATA
HATSUKAICHI, HIROSHIMA	MAYOR	KATSUHIRO SHINNO
ANAN, TOKUSHIMA	MAYOR	YOSHIHITO IWASA
MIHARA, HIROSHIMA	MAYOR	SHO TENMA
HAMADA, SHIMANE	MAYOR	TETSUO UZU
SAKAIDE, KAGAWA	MAYOR	TOSHIAKI MATSUURA
MARUGAME, KAGAWA	MAYOR	TETSUJI ARAI
AKI, KōCHI	MAYOR	KENJI MATSUMOTO
CHIKUSHINO, FUKUOKA	MAYOR	SHIRō HIRABARU
KASUGA, FUKUOKA	MAYOR	SUMIKAZU INOUE
ŌNOJō	MAYOR	MUNEJI IMOTO
IIZUKA, FUKUOKA	MAYOR	MORICHIKA SAITō
MUNAKATA, FUKUOKA	MAYOR	HIROMI TANII
MINAMATA, KUMAMOTO	MAYOR	KATSUAKI MIYAMOTO
TAMANA, KUMAMOTO	MAYOR	TETSUYA TAKASAKI
SAIKI, ŌITA	MAYOR	YASUYOSHI NISHIJIMA
HITOYOSHI, KUMAMOTO	MAYOR	NOBUTAKA TANAKA
HITA, ŌITA	MAYOR	YōICHI SATō
SATSUMASENDAI, KAGOSHIMA	MAYOR	HIDEO IWAKIRI
IZUMI, OSAKA	MAYOR	YOSHIYUKI ISAKA
MAKURAZAKI, KAGOSHIMA	MAYOR	YOSHIAKI SETOGUCHI
SAINT-DENIS, RéUNION	MAYOR	GILBERT ANNETTE
KOTO, TOKYO	MAYOR	TAKAAKI YAMAZAKI
SETAGAYA	MAYOR	NOBUTO HOSAKA
SUHL	MAYOR	JENS TRIEBEL
LANDSHUT	MAYOR	HANS RAMPF
KAISERSLAUTERN	MAYOR	KLAUS WEICHEL
NITRA	MAYOR	JOZEF DVONč
DESHAIES	MAYOR	JEANNY MARC
MULHOUSE	MAYOR	JEAN ROTTNER
ST JOHANN IM PONGAU	MAYOR	GüNTHER MITTERER
NEUKöLLN	MAYOR	HEINZ BUSCHKOWSKY
MILLY-LA-FORêT	MAYOR	FRANçOIS ORCEL
BEDBURG	MAYOR	SASCHA SOLBACH
CHūō, TOKYO	MAYOR	YOSHIHIDE YADA
CARVIN	MAYOR	PHILIPPE KEMEL
HéNIN-BEAUMONT	MAYOR	STEEVE BRIOIS (FN)
BAD GANDERSHEIM	MAYOR	FRANZISKA SCHWARZ
NüRTINGEN	MAYOR	OTMAR HEIRICH
NOUMéA	MAYOR	SONIA LAGARDE
LOOS-EN-GOHELLE	MAYOR	JEAN-FRANçOIS CARON
KITZBüHEL	MAYOR	KLAUS WINKLER
MEUDON	MAYOR	HERVé MARSEILLE
EISENSTADT	MAYOR	ANDREA FRAUNSCHIEL
VINCENNES	MAYOR	LAURENT LAFON
TARAMA, OKINAWA	MAYOR	MASAAKI SHIMOJI
YONAGUNI, OKINAWA	MAYOR	SHUKICHI HOKAMA
TAKETOMI, OKINAWA	MAYOR	TAKESHI ŌMORI
CERDON, AIN	MAYOR	SYLVIE GOY-CHAVENT
LöRRACH	MAYOR	JöRG LUTZ
XANTHI	MAYOR	CHARALAMBOS DIMARCHOPOULOS
PATRAS	MAYOR	KOSTAS PELETIDIS
OGASAWARA, TOKYO	MAYOR	KAZUO MORISHITA
CRéTEIL	MAYOR	LAURENT CATHALA
TULLE	MAYOR	BERNARD COMBES
PAPEETE	MAYOR	MICHEL BUILLARD
VALENCIENNES	MAYOR	DOMINIQUE RIQUET
NEUCHâTEL	MAYOR	THOMAS FACCHINETTI
CARPENTRAS	MAYOR	FRANCIS ADOLPHE
MAROUSI	MAYOR	GIοRGOS PATOULIS (ND)
INTERLAKEN	MAYOR	URS GRAF
DRANCY	MAYOR	JEAN-CHRISTOPHE LAGARDE
MONTREUIL, SEINE-SAINT-DENIS	MAYOR	PATRICE BESSAC
ANNECY	MAYOR	JEAN-LUC RIGAUT
OBERURSEL	MAYOR	HANS-GEORG BRUM
BORA BORA	MAYOR	GASTON TONG SANG
BOOM, BELGIUM	MAYOR	JEROEN BAERT
BAD HOMBURG VOR DER HöHE	MAYOR	ALEXANDER HETJES
AGEN	MAYOR	JEAN DIONIS DU SéJOUR
TARBES	MAYOR	GéRARD TRéMèGE
RUEIL-MALMAISON	MAYOR	PATRICK OLLIER
LAUPHEIM	MAYOR	RAINER KAPELLEN
VIENNE, ISèRE	MAYOR	THIERRY KOVACS
VILLENEUVE-D'ASCQ	MAYOR	GéRARD CAUDRON
GüSSING	MAYOR	PETER VADASZ
TSUWANO, SHIMANE	MAYOR	HIROYUKI SHITAMORI
PFORZHEIM	MAYOR	GERT HAGER
ÉVIAN-LES-BAINS	MAYOR	MARC FRANCINA
GLYFADA	MAYOR	GIORGOS PAPANIKOLAOU
SèTE	MAYOR	FRANçOIS COMMEINHES
LE RAINCY	MAYOR	JEAN-MICHEL GENESTIER
INE, KYOTO	MAYOR	YOSHIMOTO HIDEKI
KōKA, SHIGA	MAYOR	TAKESHI NAKAJIMA
CITY OF BRUSSELS	MAYOR	YVAN MAYEUR
BIEBRICH	MAYOR	WOLFGANG GORES
ARIEL	MAYOR	ELIYAHU SHAVIRO
SAINT-GILLES, BELGIUM	MAYOR	CHARLES PICQUé
FRITZLAR	MAYOR	KARL-WILHELM LANGE
ST ANTON AM ARLBERG	MAYOR	HELMUT MALL
MINAMIMAKI, NAGANO	MAYOR	YUKIHIKO KIKUCHI
MIYOTA, NAGANO	MAYOR	MOTEKI YUJI
HéROUVILLE-SAINT-CLAIR	MAYOR	RODOLPHE THOMAS
HUMENNé	MAYOR	JANA VAľOVá
LIMOURS	MAYOR	JEAN-RAYMOND HUGONET
ÉVREUX	MAYOR	GUY LEFRAND
REGGIO EMILIA	MAYOR	LUCA VECCHI
MARTIGUES	MAYOR	GABY CHARROUX
HOF, BAVARIA	MAYOR	DR. HARALD FICHTNER
BAD GODESBERG	MAYOR	SIMONE STEIN-LüCKE
MâCON	MAYOR	JEAN-PATRICK COURTOIS
LINT, BELGIUM	MAYOR	HARRY DEBRABANDERE
MANTES-LA-VILLE	MAYOR	CYRIL NAUTH FRONT NATIONAL
GOTHA	MAYOR	KNUT KREUCH
VANNES	MAYOR	DAVID ROBO
KATERINI	MAYOR	SAVVAS CHIONIDIS
LECCE	MAYOR	PAOLO PERRONE
VESOUL	MAYOR	ALAIN CHRéTIEN
HUAHINE	MAYOR	MARCELIN LISAN
TAHA'A	MAYOR	ISMAëL TUAHU
BAD GOISERN AM HALLSTäTTERSEE	MAYOR	PETER ELLMER
PROVINS	MAYOR	CHRISTIAN JACOB
SCHLANGEN	MAYOR	ULRICH KNORR
YERUHAM	MAYOR	MICHAEL BITTON
FATU HIVA	MAYOR	HENRI TUIEINUI
CHAMBéRY	MAYOR	MICHEL DANTIN
ROANNE	MAYOR	YVES NICOLIN
CASTRES	MAYOR	PASCAL BUGIS
MEAUX	MAYOR	JEAN-FRANçOIS COPé
STEYR	MAYOR	GERALD HACKL
MARTIN, SLOVAKIA	MAYOR	ANDREJ HRNčIAR
POVAžSKá BYSTRICA	MAYOR	KAROL JANAS
BLEIBURG	MAYOR	ŠTEFAN VISOCNIK
MARIáNSKé LáZNě	MAYOR	PETR TřEšňáK
LODèVE	MAYOR	MARIE-CHRISTINE BOUSQUET
RUMOI, HOKKAIDO	MAYOR	SADATOSHI TAKAHASHI
ELNE	MAYOR	NICOLAS GARCIA
MONTEREAU-FAULT-YONNE	MAYOR	YVES JéGO
MONHEIM AM RHEIN	MAYOR	DANIEL ZIMMERMANN
AGDE	MAYOR	GILLES D'ETTORE
CHâTELLERAULT	MAYOR	JEAN-PIERRE ABELIN
WIENER NEUSTADT	MAYOR	KLAUS SCHNEEBERGER
LE BOURGET	MAYOR	VINCENT CAPO-CANELLAS
PESARO	MAYOR	LUCA CERISCIOLI
THONON-LES-BAINS	MAYOR	JEAN DENAIS
ZLATé MORAVCE	MAYOR	
ČáSLAV	MAYOR	JAROMíR STRNAD
SALON-DE-PROVENCE	MAYOR	NICOLAS ISNARD
HARZGERODE	MAYOR	JüRGEN BENTZIUS
VöLKERMARKT	MAYOR	VALENTIN BLASCHITZ
MOULINS, ALLIER	MAYOR	PIERRE-ANDRé PéRISSOL
MüHLHAUSEN	MAYOR	DR. JOHANNES BRUNS
PUTEAUX	MAYOR	JOëLLE CECCALDI-RAYNAUD
COURBEVOIE	MAYOR	JACQUES KOSSOWSKI
ANTONY, HAUTS-DE-SEINE	MAYOR	JEAN-YVES SéNANT
BAGNEUX, HAUTS-DE-SEINE	MAYOR	MARIE-HéLèNE AMIABLE
BIERSTADT	MAYOR	REINHOLD HEPP
KEHL	MAYOR	TONI VETRANO
CHâTENAY-MALABRY	MAYOR	GEORGES SIFFREDI
CHâTILLON, HAUTS-DE-SEINE	MAYOR	JEAN-PIERRE SCHOSTECK
CHAUMONT, HAUTE-MARNE	MAYOR	CHRISTINE GUILLEMY
RODEZ	MAYOR	CHRISTIAN TEYSSèDRE
SCHöNBRUNN	MAYOR	JAN FREY
BAD VöSLAU	MAYOR	CHRISTOPH PRINZ
LONGWY	MAYOR	ÉDOUARD JACQUE
CALHETA DE NESQUIM	MAYOR	MáRIO MANUEL DA SILVEIRA FERREIRA
ISSY-LES-MOULINEAUX	MAYOR	ANDRé SANTINI
WEIDEN AN DER MARCH	MAYOR	JOSEF DIENST
LEVALLOIS-PERRET	MAYOR	PATRICK BALKANY
ROHRAU, AUSTRIA	MAYOR	HERBERT SPECKL
LE PLESSIS-ROBINSON	MAYOR	PHILIPPE PEMEZEC
ÜBERLINGEN	MAYOR	SABINE BECKER
HARTENBERG-MüNCHFELD	MAYOR	KARIN TRAUTWEIN
APT, VAUCLUSE	MAYOR	OLIVIER CUREL
SPITTAL AN DER DRAU	MAYOR	GERHARD PIRIH
CASTELNAUDARY	MAYOR	PATRICK MAUGARD
OKUSHIRI, HOKKAIDO	MAYOR	TAKUMI SHIMMURA
NISEKO, HOKKAIDO	MAYOR	KENYA KATAYAMA
SHINTOTSUKAWA, HOKKAIDO	MAYOR	MITSURU UEDA
BIEI, HOKKAIDO	MAYOR	SATOSHI HAMADA
BIRATORI, HOKKAIDO	MAYOR	YOSHITERU NAKAMICHI
URAKAWA, HOKKAIDO	MAYOR	KōICHIRō TANIKAWA
HALLEIN	MAYOR	CHRISTIAN STöCKL
VITRé, ILLE-ET-VILAINE	MAYOR	PIERRE MéHAIGNERIE
UA PU	MAYOR	JOSEPH KAIHA
BREUILLET, ESSONNE	MAYOR	BERNARD SPROTTI
FELTRE	MAYOR	PAOLO PERENZIN
MIKULOV	MAYOR	ROSTISLAV KOšTIAL
HURA	MAYOR	DR. MUHAMMAD AL-NABARI
ZEHLENDORF	MAYOR	NORBERT KOPP
FILSUM	MAYOR	GEORG GATHEN
WOLFSBERG, CARINTHIA	MAYOR	HANS-PETER SCHLAGHOLZ
KLINGENBACH	MAYOR	JOHANN FRANK  SPÖ
GROßHöFLEIN	MAYOR	HEINZ HEIDENREICH SPÖ
GMUNDEN	MAYOR	STEFAN KRAPF
PILSBACH	MAYOR	ALOIS GRUBER
TAHUATA	MAYOR	TEAIKI FéLIX BARSINAS
NOVE	MAYOR	MANUELE BOZZETTO
TARVISIO	MAYOR	RENATO CARLANTONI
ZOFINGEN	MAYOR	HANS-RUEDI HOTTIGER
KAPFENBERG	MAYOR	MANFRED WEGSCHEIDER
RHEINFELDEN	MAYOR	FRANCO MAZZI
NORDERNEY	MAYOR	FRANK ULRICHS
FRéJUS	MAYOR	DAVID RACHLINE
COBURG	MAYOR	NORBERT TESSMER
MANTEL	MAYOR	JOSEF WITTMANN
UETENDORF	MAYOR	ALBERT RöSTI
YERRES	MAYOR	NICOLAS DUPONT-AIGNAN
RAPONE	MAYOR	PATRIZIA GAMMA ( ELECTED 2004-06-13)
MOLSHEIM	MAYOR	LAURENT FURST
FELLBACH	MAYOR	CHRISTOPH PALM
ST. JOHANN IN TIROL	MAYOR	STEFAN SEIWALD
OUVéA	MAYOR	BONIFACE OUNOU
BAD MUSKAU	MAYOR	ANDREAS BäNDER
TAVERNY	MAYOR	FLORENCE PORTELLI
OPOčNO	MAYOR	ZDENěK FILIP
PříBRAM	MAYOR	JINDřICH VAřEKA
MASSY, ESSONNE	MAYOR	VINCENT DELAHAYE
CONCHES-EN-OUCHE	MAYOR	ALFRED RECOURS
ATTON	MAYOR	GéRARD LIGER
EMBRUN, HAUTES-ALPES	MAYOR	CHANTAL EYMéOUD
PINKAFELD	MAYOR	KURT MACZEK
DEUTSCH SCHüTZEN-EISENBERG	MAYOR	FRANZ WACHTER
LIMOUX	MAYOR	JEAN-PAUL DUPRé
FOREST, BELGIUM	MAYOR	MARC-JEAN GHYSSELS
IXELLES	MAYOR	DOMINIQUE DUFOURNY
UCCLE	MAYOR	ARMAND DE DECKER
ZELL AM SEE	MAYOR	PETER PADOUREK
OFFENBURG	MAYOR	EDITH SCHREINER
CREMA, LOMBARDY	MAYOR	STEFANIA BONALDI
MANZAT	MAYOR	ALAIN ESCURE
HAKUSAN, ISHIKAWA	MAYOR	MITSUO KADO
HOSTIVICE	MAYOR	JAROSLAV KRATOCHVíL
CHOLET	MAYOR	GILLES BOURDOULEIX
STOLBERG	MAYOR	TIM GRüTTEMEIER
VöCKLABRUCK	MAYOR	HERBERT WALTER BRUNSTEINER
BEAUSOLEIL, ALPES-MARITIMES	MAYOR	GéRARD SPINELLI
ANNECY-LE-VIEUX	MAYOR	BERNARD ACCOYER
MAMOUDZOU	MAYOR	MOHAMED MAJANI
SAINT-PIERRE, SAINT PIERRE AND MIQUELON	MAYOR	KARINE CLAIREAUX
QUILLAN	MAYOR	MAURICE ARAGOU
RIVE-DE-GIER	MAYOR	JEAN-CLAUDE CHARVIN
ČERVENá VODA	MAYOR	PAEDDR. MILOš HARNYCH
SAINT-GEORGES, FRENCH GUIANA	MAYOR	GEORGES ELFORT
SAINT-LAURENT-DU-MARONI	MAYOR	LéON BERTRAND
GROßLOBMING	MAYOR	HERIBERT BOGENSPERGER
KNITTELFELD	MAYOR	LABG. ING. GERALD SCHMID
SECKAU	MAYOR	SIMON PLETZ
CHODOV	MAYOR	PATRIK PIZINGER
VENCE	MAYOR	RéGIS LEBIGRE
RIED IM INNKREIS	MAYOR	ALBERT ORTIG
ZEDLITZ	MAYOR	CHRISTA HOFBAUER
SARREGUEMINES	MAYOR	CéLESTE LETT
LIFOU	MAYOR	NéKO HNEPEUNE
STRAUSBERG	MAYOR	ELKE STADELER
THOUARS	MAYOR	PATRICE PINEAU
CACHAN	MAYOR	JEAN-YVES LE BOUILLONNEC
VILLE-D'AVRAY	MAYOR	DENIS BADRé
MARVILLE, MEUSE	MAYOR	CLAUDE BIWER
SAINT-AVOLD	MAYOR	ANDRé WOJCIECHOWSKI
DRAVEIL	MAYOR	GEORGES TRON
PRéMEYZEL	MAYOR	JOëL THOMASSIER
SAINT-DIDIER-SUR-CHALARONNE	MAYOR	MURIEL LUGA-GIRAUD
HAYANGE	MAYOR	FABIEN ENGELMANN
PONTEDERA	MAYOR	SIMONE MILLOZZI ,
MEERBUSCH	MAYOR	ANGELIKA MIELKE-WESTERLAGE
TIRSCHENREUTH	MAYOR	FRANZ STAHL
SAN GIORGIO A CREMANO	MAYOR	DOMENICO GIORGIANO
ARGENTON-SUR-CREUSE	MAYOR	MICHEL SAPIN
VILLEFRANCHE-SUR-SAôNE	MAYOR	BERNARD PERRUT
DEUTSCH-WAGRAM	MAYOR	FRIEDRICH QUIRGST
UA HUKA	MAYOR	NESTOR OHU
MARCQ-EN-BARœUL	MAYOR	BERNARD GéRARD
BRéTIGNY-SUR-ORGE	MAYOR	BERNARD DECAUX
GEDERA	MAYOR	YOEL GAMLIEL
BERNAY, EURE	MAYOR	HERVé MAUREY
HEM, NORD	MAYOR	FRANCIS VERCAMER
RILLIEUX-LA-PAPE	MAYOR	ALEXANDRE VINCENDET
VILLIERS-LE-BEL	MAYOR	JEAN-LOUIS MARSAC
VAULX-EN-VELIN	MAYOR	HéLèNE GEOFFROY
FRONTIGNAN	MAYOR	PIERRE BOULDOIRE
SAINT-PAUL, RéUNION	MAYOR	JOSEPH SINIMALé
SAINT-BENOîT, RéUNION	MAYOR	JEAN-CLAUDE FRUTEAU
SAINT-PIERRE, RéUNION	MAYOR	MICHEL FONTAINE
SAINT-AFFRIQUE	MAYOR	ALAIN FAUCONNIER
PARTHENAY	MAYOR	XAVIER ARGENTON
BEZONS	MAYOR	DOMINIQUE LESPARRE
CORDES-SUR-CIEL	MAYOR	PAUL QUILèS
LAMALOU-LES-BAINS	MAYOR	MARCEL ROQUES
LE MONT-DORE	MAYOR	ÉRIC GAY
NIEDERBRONN-LES-BAINS	MAYOR	FRéDéRIC REISS
GMüND, CARINTHIA	MAYOR	JOSEF JURY
MELDORF	MAYOR	ANKE CORNELIUS-HEIDE
CHAMPENOUX	MAYOR	HENRI-PHILIPPE GUIMONT
LANNEMEZAN	MAYOR	BERNARD PLANO
CAGNES-SUR-MER	MAYOR	LOUIS NèGRE
LE CHESNAY	MAYOR	PHILIPPE BRILLAULT
DEMBENI	MAYOR	AMBDI HAMADA
HALL IN TIROL	MAYOR	EVA-MARIA POSCH
BZENEC	MAYOR	PAVEL ČEJKA
SAN'Yō-ONODA	MAYOR	HIROFUMI SHIRAI
FAAA	MAYOR	OSCAR TEMARU
FAAA	MAYOR	1983
BANDRABOUA	MAYOR	FAHARDINE AHAMED
BOUéNI	MAYOR	ALI HADHUIRI HAMADA
BANDRéLé	MAYOR	MOUSSA MADI
CHICONI	MAYOR	SOUF ABDALLAH
TSINGONI	MAYOR	ALI SOUFFOU
M'TSANGAMOUJI	MAYOR	IBRAHIMA SAID MAANRIFA
PAMANDZI	MAYOR	SAïD ISSIHAKA
KANI-KéLI	MAYOR	AHMED SOILIHI
SADA, MAYOTTE	MAYOR	AHAMADI DAHALANI
ACOUA	MAYOR	KOUTOUBOU ABAL HASSANE
KOUNGOU	MAYOR	SAïD AHAMADI
CHIRONGUI	MAYOR	MOHAMED ABDOU
OUANGANI	MAYOR	CHANRANI DAOUDOU
BUSSY-SAINT-GEORGES	MAYOR	CHANTAL BRUNEL
KANDERN	MAYOR	CHRISTIAN RENKERT
BRICQUEBEC	MAYOR	HENRI-LOUIS VéDIE
TöGING AM INN	MAYOR	HORST KREBES
VARALLO SESIA	MAYOR	ERALDO BOTTA( )
LOMME	MAYOR	ROGER VICOT
HALTERN AM SEE	MAYOR	BODO KLIMPEL
MANDELIEU-LA-NAPOULE	MAYOR	HENRI LEROY (UMP)
TO-SHIMA, TOKYO	MAYOR	KAZUHISA UMEDA
GIV'AT SHMUEL	MAYOR	YOSSI BRODNY
FRAUENKIRCHEN	MAYOR	JOSEF ZINIEL
SöGEL	MAYOR	GüNTER WIGBERS
WERLTE	MAYOR	WERNER GERDES
LATHEN	MAYOR	KARL-HEINZ WEBER
BELEP	MAYOR	JEAN-BAPTISTE MOILOU
OMER, ISRAEL	MAYOR	PINI BADASH
DAHN	MAYOR	ALEXANDER FUHR
CANALA	MAYOR	GILBERT TYUIENON
DUMBéA	MAYOR	GEORGES NATUREL
FARINO	MAYOR	GHISLAINE ARLIE
HOUAïLOU	MAYOR	LIONEL WEIRI
HIENGHèNE	MAYOR	DANIEL GOA
KONé, NEW CALEDONIA	MAYOR	JOSEPH GOROMIDO
KOUAOUA	MAYOR	KARAïMIA PWëPWë MEREATU
KAALA-GOMEN	MAYOR	ALAIN LEVANT
LA FOA	MAYOR	CORINNE VOISIN
PONéRIHOUEN	MAYOR	ANDRé GOPéA
MOINDOU	MAYOR	FRANçOIS BURCK
POUéBO	MAYOR	JOSEPH PADA
OUéGOA	MAYOR	CéZELIN TCHOEAOUA
KOUMAC	MAYOR	ROBERT FROUIN
POUEMBOUT	MAYOR	JEAN NAOUNA
PAïTA	MAYOR	HAROLD MARTIN
POUM	MAYOR	HENRIETTE TIDJINE éP. HMAE
POYA, NEW CALEDONIA	MAYOR	GUYèDRE WAMEDJO
POINDIMIé	MAYOR	PAUL NéAOUTYINE
SARRAMéA	MAYOR	ANTOINE NEMEBREUX
THIO, NEW CALEDONIA	MAYOR	THIERRY SONG
TOUHO	MAYOR	ALPHONSE POININE
YATé	MAYOR	ADOLPHE KAMéBO DIGOUé
GURK, CARINTHIA	MAYOR	SIEGFRIED KAMPL
BOULOUPARI	MAYOR	ALAIN LAZARE
BROME, GERMANY	MAYOR	INGRID KLOPP
L'ÎLE-DES-PINS	MAYOR	HILARION VENDEGOU
FRANZENSFESTE	MAYOR	THOMAS KLAPFER SVP
SEEVETAL	MAYOR	GüNTER SCHWARZ, SPD
MARé ISLAND	MAYOR	BASILE CITRE
GENTILLY, NEW ORLEANS	MAYOR	MITCH LANDRIEU
KöNIGS WUSTERHAUSEN	MAYOR	STEFAN LUDWIG
MILLSTATT	MAYOR	JOHANN SCHUSTER
DONNERSKIRCHEN	MAYOR	JOHANNES MEZGOLITS ÖVP
WäCHTERSBACH	MAYOR	ANDREAS WEIHER
UTUROA	MAYOR	SYLVIANE TEROOATEA
WöRGL	MAYOR	HEDI WECHNER
AMSTETTEN, LOWER AUSTRIA	MAYOR	URSULA PUCHEBNER
WENNIGSEN	MAYOR	CHRISTOPH MEINEKE
IMIZU, TOYAMA	MAYOR	MOTOSHI NATSUNO
LOURDIOS-ICHèRE	MAYOR	JEAN LASSALLE
SANKT GEORGEN AN DER GUSEN	MAYOR	ERICH WAHL
FERLACH	MAYOR	INGO APPé
OISSEL	MAYOR	THIERRY FOUCAUD
MAHINA, FRENCH POLYNESIA	MAYOR	ÉMILE VERNAUDON
PAEA	MAYOR	JACQUIE GRAFFE
ARUE, FRENCH POLYNESIA	MAYOR	PHILIP SCHYLE
ARUE, FRENCH POLYNESIA	MAYOR	2003
PAPARA	MAYOR	BRUNO SANDRAS
TEVA I UTA	MAYOR	VICTOR DOOM
HITIAA O TE RA	MAYOR	DOMINGO DAUPHIN
TAIARAPU-EST	MAYOR	SYLVE PERRY
TAIARAPU-OUEST	MAYOR	ROGER DOOM
TUMARAA	MAYOR	CYRIL TETUANUI
TAPUTAPUATEA	MAYOR	THOMAS MOUTAME
PRéMONTRé	MAYOR	CLAUDE VENANT
FALKENSTEIN, SAXONY-ANHALT	MAYOR	KLAUS WYCISK
EVEN YEHUDA	MAYOR	ABRAHAM HARARI
MARSEILLAN, HéRAULT	MAYOR	YVES MICHEL
CORTEMAGGIORE	MAYOR	GIANLUIGI REPETTI
SCHKOPAU	MAYOR	ANDREJ HAUFE
LA BARRE, HAUTE-SAôNE	MAYOR	BERNARD PELCY
EL'AD	MAYOR	ISRAEL  PORUSH
SAINT-SéBASTIEN-SUR-LOIRE	MAYOR	JOëL GUERRIAU
JOUé-LèS-TOURS	MAYOR	PHILIPPE LE BRETON
DéCINES-CHARPIEU	MAYOR	LAURENCE FAUTRA
OULLINS	MAYOR	FRANçOIS-NOëL BUFFET
MEYZIEU	MAYOR	MICHEL FORISSIER
SAINT-PRIEST, RHôNE	MAYOR	GILLES GASCON
MONTIGNY-LèS-METZ	MAYOR	JEAN-LUC BOHL
LAMBERSART	MAYOR	MARC-PHILIPPE DAUBRESSE
SOTTEVILLE-LèS-ROUEN	MAYOR	PIERRE BOURGUIGNON
NUSCO	MAYOR	CIRIACO DE MITA
RIVESALTES	MAYOR	ANDRé BASCOU
CHAVENAY	MAYOR	DENIS FLAMANT
SAINT-JOSEPH, RéUNION	MAYOR	PATRICK LEBRETON
SAINT-LEU, RéUNION	MAYOR	THIERRY ROBERT
LA POSSESSION	MAYOR	VANESSA MIRANVILLE
REICHENAU AN DER RAX	MAYOR	JOHANN LEOPOLD LEDOLTER
KELKHEIM	MAYOR	ALBRECHT KüNDIGER
DOURDAN	MAYOR	MARYVONNE BOQUET
LE LUC	MAYOR	PHILIPPE DE LA GRANGE
RUDERSBERG	MAYOR	MARTIN KAUFMANN
MODI'IN-MACCABIM-RE'UT	MAYOR	HAIM BIBAS
AMMERBUCH	MAYOR	CHRISTEL HALM
RAMSAU AM DACHSTEIN	MAYOR	RAINER ANGERER
MAUER	MAYOR	JOHN EHRET
SEEBODEN	MAYOR	WOLFGANG KLINAR
CERNUSCO SUL NAVIGLIO	MAYOR	EUGENIO COMINCINI
PREMNITZ	MAYOR	ROY WALLENTA
PLATANIA	MAYOR	SINDACO.ASP
EDELSTAL	MAYOR	ANTON MORITZ
HAINA	MAYOR	DOLLY P. DAVID
ISOLA DELLE FEMMINE	MAYOR	STEFANO BOLOGNA
PONTECAGNANO FAIANO	MAYOR	ERNESTO SICA
GOUMENISSA	MAYOR	STYLIANOS PAPAPANAGIOTOU
GRIGNAN	MAYOR	BRUNO DURIEUX
PODENZANO	MAYOR	A. GHISONI
ALTENMARKT IM PONGAU	MAYOR	RUPERT WINTER
EVERGREEN CEMETERY	MAYOR	1854
EVERGREEN CEMETERY	MAYOR	1869
EVERGREEN CEMETERY	MAYOR	1880
EVERGREEN CEMETERY	MAYOR	1885
EVERGREEN CEMETERY	MAYOR	…
STYLIDA	MAYOR	APOSTOLOS GLETSOS
KISO, NAGANO	MAYOR	TANAKA KATSUMI
TRIMBACH, SWITZERLAND	MAYOR	KARL TANNER
MATOURY	MAYOR	GABRIEL SERVILLE
GRUGLIASCO	MAYOR	ROBERTO MONTà
COURSAN	MAYOR	GILBERT PLA
SOSSANO	MAYOR	GIUSEPPE CAVALLARO
RATSCHINGS	MAYOR	SEBASTIAN HELFER
RASEN-ANTHOLZ	MAYOR	THOMAS SCHUSTER
TERLAN	MAYOR	KLAUS RUNER
FOLGARIA	MAYOR	MAURIZIO TOLLER
ROBURENT	MAYOR	BRUNO VALLEPIANO
CERRINA MONFERRATO	MAYOR	ALDO VISCA
CONZANO	MAYOR	FRANCESCO IMARISIO
SAN SALVATORE MONFERRATO	MAYOR	CORRADO TAGLIABUE
ODALENGO PICCOLO	MAYOR	CAROLA TRIVERI
VARAZZE	MAYOR	GIOVANNI DELFINO
SKALNá	MAYOR	MGR. RITA SKALOVá
LEITHAPRODERSDORF	MAYOR	MARTIN RADATZ ÖVP
CASNATE CON BERNATE	MAYOR	FABIO BULGHERONI
TREMEZZO	MAYOR	MAURO GUERRA
INZAGO	MAYOR	BENIGNO CALVI
NOVA MILANESE	MAYOR	ROSARIA LONGONI
BUDčA	MAYOR	FRANTIšEK MORAVEC
RIGNANO SULL'ARNO	MAYOR	DANIELE LORENZINI
TERRANUOVA BRACCIOLINI	MAYOR	MAURO AMERIGHI
PRESEľANY	MAYOR	JURAJ TRSťAN
MONASTERACE	MAYOR	MARIA CARMELA LANZETTA
SAPPORO	MAYOR	KATSUHIRO AKIMOTO
UBE, YAMAGUCHI	MAYOR	KIMIKO KUBOTA
HōFU	MAYOR	MASATO MATSUURA
IWAKUNI	MAYOR	YOSHIHIKO FUKUDA
NOBEOKA, MIYAZAKI	MAYOR	MASAHARU SUDō
TAKAMATSU, KAGAWA	MAYOR	HIDETO ŌNISHI
MATSUYAMA, EHIME	MAYOR	KATSUHITO NOSHI
NIIGATA, NIIGATA	MAYOR	AKIRA SHINODA
KITAKYUSHU	MAYOR	KENJI KITAHASHI
CASTELLETTO CERVO	MAYOR	RENZO SELVA
BOGNANCO	MAYOR	--06-07
PREMOSELLO-CHIOVENDA	MAYOR	GIUSEPPE MONTI
OLLASTRA	MAYOR	GIOVANNINO ANGELO CIANCIOTTO
ROSICE	MAYOR	JAROSLAV SVěTLíK
SOLOšNICA	MAYOR	ANNA ČERMáKOVá
HOLLABRUNN	MAYOR	ERWIN BERNREITER
WESENDORF	MAYOR	WALTER PENSHORN
ČíčOV	MAYOR	CSABA FöLDES
SAINT-JULIEN-DE-BOURDEILLES	MAYOR	BERNARD MAZOUAUD
FRANKENFELS	MAYOR	FRANZ GRößBACHER
LOUDENVIELLE	MAYOR	NOëL LACAZE
WATTENS	MAYOR	FRANZ TROPPMAIR
SAALBACH-HINTERGLEMM	MAYOR	ALOIS HASENAUER
AMAKUSA, KUMAMOTO	MAYOR	KIMIHIRO YASUDA
BRETEJOVCE	MAYOR	MILENA BIREšOVá
PODOLíNEC	MAYOR	IVETA BACHLEDOVá
PONTA DELGADA	MAYOR	ANTóNIO BORGES COUTINHO
PETRONELL-CARNUNTUM	MAYOR	INGRID SCHEUMBAUER
LE PONTET, VAUCLUSE	MAYOR	JORIS HéBRARD
HORNí JIřETíN	MAYOR	VLADIMíR BUřT
MOMBACH	MAYOR	DR. ELEONORE LOSSEN-GEIßLER
TULLN AN DER DONAU	MAYOR	PETER EISENSCHENK
LYON	MAYOR	GéRARD COLLOMB
WIESBADEN-FRAUENSTEIN	MAYOR	ADOLF LUPP
POLIčKA	MAYOR	JAROSLAV MARTINů
BAD KLEINKIRCHHEIM	MAYOR	MATTHIAS KRENN
BRAS-PANON	MAYOR	DANIEL GONTHIER
ATTNANG-PUCHHEIM	MAYOR	PETER GROIß
FLAGG TOWNSHIP, OGLE COUNTY, ILLINOIS	MAYOR	SUSAN PLUMLEY
LEAF RIVER TOWNSHIP, OGLE COUNTY, ILLINOIS	MAYOR	LEONARD HAGEMANN
FORRESTON TOWNSHIP, OGLE COUNTY, ILLINOIS	MAYOR	STEVEN GREENFIELD
LYNNVILLE TOWNSHIP, OGLE COUNTY, ILLINOIS	MAYOR	MARILYN SCHLAF
MARION TOWNSHIP, OGLE COUNTY, ILLINOIS	MAYOR	THOMAS WEBBER
MONROE TOWNSHIP, OGLE COUNTY, ILLINOIS	MAYOR	THOMAS LICHTY
PINE ROCK TOWNSHIP, OGLE COUNTY, ILLINOIS	MAYOR	DONALD HUNTLEY
ROCKVALE TOWNSHIP, OGLE COUNTY, ILLINOIS	MAYOR	JEFF TREMBLE
SCOTT TOWNSHIP, OGLE COUNTY, ILLINOIS	MAYOR	ROBERT L. HORN
TAYLOR TOWNSHIP, OGLE COUNTY, ILLINOIS	MAYOR	JO ANN REYNOLDS
WHITE ROCK TOWNSHIP, OGLE COUNTY, ILLINOIS	MAYOR	JOHN GREENFIELD
ROCKFORD TOWNSHIP, WINNEBAGO COUNTY, ILLINOIS	MAYOR	MICHAEL J. GORAL
PINSDORF	MAYOR	DIETER HELMS
ALLAUCH	MAYOR	ROLAND POVINELLI
GéMENOS	MAYOR	ROLAND GIBERTI
EPE, NORTH RHINE-WESTPHALIA	MAYOR	KARL-HEINZ HOLTWISCH
GMüND, LOWER AUSTRIA	MAYOR	OTTO OPELKA
BREMEN	MAYOR	CARSTEN SIELING
FELDKIRCHEN IN KäRNTEN	MAYOR	MARTIN TREFFNER
SANKT VEIT AN DER GLAN	MAYOR	GERHARD MOCK
BAD VIGAUN	MAYOR	FRIEDRICH HOLZTRATTNER
OSSIACH	MAYOR	JOHANN HUBER
FRIESACH	MAYOR	JOSEF KRONLECHNER
OBERHARMERSBACH	MAYOR	SIEGFRIED HUBER
MüHLHAUSEN	MAYOR	KARL KLEIN
MAINASCHAFF	MAYOR	HORST ENGLER
ZEDERHAUS	MAYOR	ALFRED PFEIFENBERGER
AMPFING	MAYOR	OTTMAR WIMMER
FLOß	MAYOR	GUENTER STICH
LEINBURG	MAYOR	JOACHIM LANG
HOHENZELL	MAYOR	THOMAS PRIEWASSER
NEUHOFEN IM INNKREIS	MAYOR	JOSEF HANGLER
MEHRNBACH	MAYOR	PETER BAHN
BODENMAIS	MAYOR	MICHAEL ADAM
SALZ, BAVARIA	MAYOR	BERNHARD MüLLER
FUCHSMüHL	MAYOR	WOLFGANG BRAUN
BREITENBRUNN, AUSTRIA	MAYOR	JOSEF TRöLLINGER SPÖ
HORNSTEIN, AUSTRIA	MAYOR	HERBERT WORSCHITZ SPÖ
MöRBISCH AM SEE	MAYOR	JüRGEN MARX
LORETTO, AUSTRIA	MAYOR	MARKUS NITZKY ÖVP
MüLLENDORF	MAYOR	WERNER HUF )
NEUFELD AN DER LEITHA	MAYOR	MICHAEL LAMPEL
SIEGENDORF	MAYOR	MAG RAINER PORICS
STEINBRUNN	MAYOR	KLAUS MEZGOLITS
WIMPASSING AN DER LEITHA	MAYOR	JOSEF WOLOWIEC
WULKAPRODERSDORF	MAYOR	HANS RUDOLF HALLER
GüTTENBACH	MAYOR	LEO RADAKOVITS
DEUTSCH KALTENBRUNN	MAYOR	ERWIN HAFNER
DEUTSCH JAHRNDORF	MAYOR	REINHOLD REIF
WALLERN IM BURGENLAND	MAYOR	HELMUT HUBER
STADTSCHLAINING	MAYOR	HERBERT DIENSTL
ALBECK, CARINTHIA	MAYOR	ANNA ZARRE
LESACHTAL	MAYOR	FRANZ GUGGENBERGER
DELLACH	MAYOR	JOHANNES LENZHOFER
REICHENAU, CARINTHIA	MAYOR	KARL LESSIAK
FEISTRITZ IM ROSENTAL	MAYOR	SONYA FEINIG
KRUMPENDORF	MAYOR	HILDE GAGGL
MARIA WöRTH	MAYOR	ADOLF STARK
MARIA SAAL	MAYOR	ANTON SCHMIDT
MOOSBURG, AUSTRIA	MAYOR	HERBERT GAGGL
PöRTSCHACH AM WöRTHERSEE	MAYOR	FRANZ ARNOLD
GLöDNITZ	MAYOR	JOHANN FUGGER
ZELL, CARINTHIA	MAYOR	ENGELBERT WASSNER
SCHIEFLING AM SEE	MAYOR	VALENTIN ANDREAS HAPPE
DEUTSCH-GRIFFEN	MAYOR	HANS PRODINGER
MöLBLING	MAYOR	FRANZ RAINER
SANKT GEORGEN AM LäNGSEE	MAYOR	KONRAD SEUNIG
BALDRAMSDORF	MAYOR	HEINRICH GERBER
GREIFENBURG	MAYOR	FRANZ MANDL
HEILIGENBLUT AM GROßGLOCKNER	MAYOR	JOSEF SCHACHNER
LATERNS	MAYOR	HEINZ LUDESCHER\NWEBSITE                  = HTTP://WWW.LATERNS.AT
WASQUEHAL	MAYOR	STéPHANIE DUCRET
KREMS, CARINTHIA	MAYOR	JOHANN WINKLER
LENDORF	MAYOR	GOTTFRIED WILLEGGER
LURNFELD	MAYOR	RUDOLF HARTLIEB
MALLNITZ	MAYOR	GüNTHER NOVAK
MüHLDORF, CARINTHIA	MAYOR	ERWIN ANGERER
OBERDRAUBURG	MAYOR	HUBERT SCHNEDL
OBERVELLACH	MAYOR	ANITA GöSSNITZER
RADENTHEIN	MAYOR	MARTIN HIPP
RENNWEG AM KATSCHBERG	MAYOR	FRANZ EDER
WEISSENSEE, AUSTRIA	MAYOR	JOHANN WEICHSLER
AFRITZ AM SEE	MAYOR	MAXIMILIAN LINDER
ARRIACH	MAYOR	KARL-GERFRIED MüLLER
FERNDORF	MAYOR	JOSEF HALLER
HOHENTHURN	MAYOR	FLORIAN TSCHINDERLE
FRESACH	MAYOR	WALTER BERNSTEINER
PATERNION	MAYOR	ALFONS ARNOLD
STOCKENBOI	MAYOR	HANS-JöRG KERSCHBAUMER
VELDEN AM WöRTHER SEE	MAYOR	FERDINAND VOUK
WERNBERG	MAYOR	FRANZ ZWöLBAR
EBERNDORF	MAYOR	GOTTFRIED WEDENIG
GRIFFEN, AUSTRIA	MAYOR	JOSEF MüLLER
PREITENEGG	MAYOR	FRANZ KOGLER
KOTTINGBRUNN	MAYOR	CHRISTIAN MACHO ] ÖVP
EBREICHSDORF	MAYOR	WOLFGANG KOCEVAR
BERNDORF, LOWER AUSTRIA	MAYOR	HERMANN KOZLIK, SPÖ
TRAISKIRCHEN	MAYOR	ANDREAS BABLER
TRIBUSWINKEL	MAYOR	INGRID NACHTELBERGER
TRAUTMANNSDORF AN DER LEITHA	MAYOR	ANDREAS MAURER
WOLFSTHAL	MAYOR	GERHARD SCHöDINGER
GöTZENDORF AN DER LEITHA	MAYOR	JOHANN ACKERMANN\NWEBSITE = WWW.GOETZENDORF.COM
ANDLERSDORF	MAYOR	JOHANN GREINER
ANGERN AN DER MARCH	MAYOR	ROBERT MEIßL
DüRNKRUT, AUSTRIA	MAYOR	HERBERT BAUCH
ENGELHARTSTETTEN	MAYOR	JOHANN FEIGL
GROß-ENZERSDORF	MAYOR	HUBERT TOMSIC
PARBASDORF	MAYOR	WILHELM ISER
PALTERNDORF-DOBERMANNSDORF	MAYOR	HERBERT NOWOHRADSKY
ORTH AN DER DONAU	MAYOR	JOHANN MAYOR
OBERSIEBENBRUNN	MAYOR	ANDREAS SINNHUBER
MATZEN-RAGGENDORF	MAYOR	LEONHARD HELM
MARKGRAFNEUSIEDL	MAYOR	ERWIN HRABAL
SULZ IM WEINVIERTEL	MAYOR	FRANZ FURHERR
SPANNBERG	MAYOR	HERBERT STIPANITZ
RINGELSDORF-NIEDERABSDORF	MAYOR	WOLFGANG WEIGERT
SCHöNKIRCHEN-REYERSDORF	MAYOR	PETER HOFINGER
WEITRA	MAYOR	RAIMUND FUCHS
MAILHAC	MAYOR	GéRARD SCHIVARDI
LéSIGNY, SEINE-ET-MARNE	MAYOR	GéRARD RUFFIN
HARDEGG	MAYOR	HERIBERT DONNERBAUER, ÖVP
MAISSAU	MAYOR	JOSEF KLEPP
GEDERSDORF	MAYOR	FRANZ BRANDL
PöCHLARN	MAYOR	ALFRED BERGNER
KREUTTAL	MAYOR	MARKUS KOLLER
ACHAU	MAYOR	JOSEF BRUNNER
PERCHTOLDSDORF	MAYOR	MARTIN SCHUSTER
WIENER NEUDORF	MAYOR	CHRISTIAN WöHRLEITNER
BREITENAU, LOWER AUSTRIA	MAYOR	HELMUT MAIER\NWEBSITE = WWW.GEMEINDE-BREITENAU.AT
SCHWARZAU AM STEINFELD	MAYOR	GüNTER WOLF
GLEISDORF	MAYOR	CHRISTOPH STARK
VOITSBERG	MAYOR	ERNST MEIXNER
BöHEIMKIRCHEN	MAYOR	JOHANN HELL
ASPERHOFEN	MAYOR	KATHARINA WOLK
BRAND-LAABEN	MAYOR	HELMUT LINTNER
ALTLENGBACH	MAYOR	MICHAEL GöSCHELBAUER
ANCINNES	MAYOR	JEAN-YVES POTTIER
RODENBERG	MAYOR	GEORG HUDALLA
KöFLACH	MAYOR	MAG. HELMUT LINHART
SUō-ŌSHIMA	MAYOR	TOMIO NAKAMOTO
PRéCY-SUR-MARNE	MAYOR	YVES DUTEIL
TRAUNKIRCHEN	MAYOR	CHRISTOPH SCHRAGL
BURGBROHL	MAYOR	
ZEUTHEN	MAYOR	BEATE BURGSCHWEIGER
SONNENBERG	MAYOR	RALF WöLLER
LES PENNES-MIRABEAU	MAYOR	MICHEL AMIEL
CHAMBOURCY	MAYOR	PIERRE MORANGE
VILLEMER, SEINE-ET-MARNE	MAYOR	ALAIN HOUDRY
HALLE, BENTHEIM	MAYOR	GERRT BECKHUIS
WILSUM, GERMANY	MAYOR	HEINRICH MARDINK
SCHNEGA	MAYOR	WILHELM VON GOTTBERG
BROMBACHTAL	MAYOR	WILLI KREDEL
BRETNIG-HAUSWALDE	MAYOR	KATRIN PRESCHER
ARNSDORF	MAYOR	MARTINA ANGERMANN
PEUERBACH	MAYOR	WOLFGANG OBERLEHNER
WATTENBERG, TYROL	MAYOR	JOHANN GEIßLER
LA CANOURGUE	MAYOR	JACQUES BLANC
BELLEVILLE, RHôNE	MAYOR	BERNARD FIALAIRE
KITZECK IM SAUSAL	MAYOR	KARL SCHAUER
LE BARCARèS	MAYOR	ALAIN FERRAND
VOGüé	MAYOR	GENEVIèVE LAURENT
FOURNELS	MAYOR	PIERRE MOREL-A-L'HUISSIER
SHINHIDAKA, HOKKAIDO	MAYOR	YOSHIHIDE SAKAI
ERGNY	MAYOR	PAUL%20DELCLOY
FRESSIN	MAYOR	CHRISTIAN DUFLOS
DEESEN	MAYOR	FRANZ BENDEL
HEIMBORN	MAYOR	WILFRIED SCHNEIDER
SAINT-OMER-CAPELLE	MAYOR	CLAUDE BOCQUELET
OBERTRAUN	MAYOR	EGON HöLL
MAUPITI	MAYOR	PAUL ROPITEAU
GOUDARGUES	MAYOR	MARTIAL BONNEFOND
LEBRADE	MAYOR	KURT BOCK
CLOYES-SUR-LE-LOIR	MAYOR	PHILIPPE VIGIER
EFERDING	MAYOR	SEVERIN MAIR
NOBITZ	MAYOR	HENDRIK LäBE
L'ISLE-ADAM, VAL-D'OISE	MAYOR	AXEL PONIATOWSKI
REINSDORF, THURINGIA	MAYOR	OLAF SCHMIDT
TRUDERING-RIEM	MAYOR	DIETER REITER
PODLUžANY, BáNOVCE NAD BEBRAVOU DISTRICT	MAYOR	PAVEL MIKSA
ZLATNO, ZLATé MORAVCE DISTRICT	MAYOR	RóBERT ŠLEHOBR
CRéMIEU	MAYOR	ALAIN MOYNE-BRESSAND
BOží DAR	MAYOR	JAN HORNíK
JISH	MAYOR	ELIAS ELIAS
MARIA LANKOWITZ	MAYOR	JOSEF RIEMER
MILOVICE	MAYOR	MILAN POUR
ALTHEIM, AUSTRIA	MAYOR	FRANZ WEINBERGER
EHRENHAUSEN	MAYOR	MARTIN WRATSCHKO
LéZIGNAN-CORBIèRES	MAYOR	MICHEL MAïQUE
SAINT-ANDRé-LEZ-LILLE	MAYOR	OLIVIER HENNO
SAINT-CYPRIEN, PYRéNéES-ORIENTALES	MAYOR	THIERRY DEL POSO
SOURNIA	MAYOR	PAUL BLANC
PLéNéE-JUGON	MAYOR	GéRARD LE CAM
TOURRETTES-SUR-LOUP	MAYOR	JOSé BERTAINA
SAINT-JEAN-LE-VIEUX, AIN	MAYOR	CHRISTIAN BATAILLY
SAINT-FéLICIEN, ARDèCHE	MAYOR	JEAN-PAUL CHAUVIN
SAINT-ANDRé-DE-CRUZIèRES	MAYOR	JEAN-MANUEL GARRIDO
NéBIAS	MAYOR	ALAIN BONNéRY
PORT-LA-NOUVELLE	MAYOR	HENRI MARTIN
TRèBES	MAYOR	CLAUDE BANIS
GUMBRECHTSHOFFEN	MAYOR	FERNAND FEIG
LE PERTRE	MAYOR	DOMINIQUE DE LEGGE
SAINT-MAURICE, BAS-RHIN	MAYOR	JEAN-MARC RIEBEL
WISCHES	MAYOR	ALAIN FERRY
ALLY, CANTAL	MAYOR	JEAN-YVES BONY
YAKUSHIMA, KAGOSHIMA	MAYOR	TONAO HIDAKA
SAVINES-LE-LAC	MAYOR	VICTOR BéRENGUEL
SAINT-ANDRé-D'EMBRUN	MAYOR	MARC ZANETTO
VENAREY-LES-LAUMES	MAYOR	PATRICK MOLINOZ
BOUTERVILLIERS	MAYOR	FRANCIS TASSIN
CREST, DRôME	MAYOR	HERVé MARITON
CASTELNAU-LE-LEZ	MAYOR	JEAN-PIERRE GRAND
SAINT-JEAN-DE-VéDAS	MAYOR	ISABELLE GUIRAUD
JUVIGNAC	MAYOR	DANIèLE ANTOINE-SANTONJA
ITTEVILLE	MAYOR	ALEXANDRE SPADA
VERT-LE-GRAND	MAYOR	JEAN-CLAUDE QUINTARD
MARCHAUX	MAYOR	BRIGITTE VIONNET
SEIGNOSSE	MAYOR	LADISLAS DE HOYOS
SAVASSE	MAYOR	RENé VECCHIATO
SEGONZAC, DORDOGNE	MAYOR	PIERRE AUBERT
EAUCOURT-SUR-SOMME	MAYOR	HENRI SANNIER
RANSPACH-LE-BAS	MAYOR	CATHERINE TROENDLE
VAIGES	MAYOR	MARC BERNIER
MAIZIèRES-LèS-METZ	MAYOR	GéRARD TERRIER
JOUY-AUX-ARCHES	MAYOR	PATRICK BOLAY
WOIPPY	MAYOR	FRANçOIS GROSDIDIER
VITRY-SUR-ORNE	MAYOR	LUC CORRADI
FREYMING-MERLEBACH	MAYOR	PIERRE LANG
BéVILLE-LE-COMTE	MAYOR	DOMINIQUE LEBLOND
JANVILLE, EURE-ET-LOIR	MAYOR	JEAN-LOUIS BAUDRON
TOURY	MAYOR	LAURENT LECLERCQ
LIGARDES	MAYOR	PIERRE DULONG
MARSAN	MAYOR	AYMERI DE MONTESQUIOU
MAUROUX, GERS	MAYOR	PAUL DUBARRY
SAINTE-EULALIE, GIRONDE	MAYOR	HUBERT LAPORTE
HéGENHEIM	MAYOR	PATRICIA SCHILLINGER
WATTWILLER	MAYOR	JACQUES MULLER
PRéMANON	MAYOR	NOLWENN MARCHAND
LOUVEMONT	MAYOR	JACQUES DELMOTTE
VAUX-SOUS-AUBIGNY	MAYOR	CHARLES GUENé
NARCY, HAUTE-MARNE	MAYOR	ETIENNETTE RAUSCHER
MARNAZ	MAYOR	LOïC HERVé
MEYTHET	MAYOR	SYLVIE GILLET DE THOREY
COUZEIX	MAYOR	JEAN-MARC GABOUTY
AVEZAC-PRAT-LAHITTE	MAYOR	ALBERT BéGUé
SèRE-EN-LAVEDAN	MAYOR	LOUIS AGUILLON
MONTASTRUC, HAUTES-PYRéNéES	MAYOR	CLAUDE GAYE
BEAUDéAN	MAYOR	JACQUES BRUNE
CAMPISTROUS	MAYOR	JEAN-CLAUDE CLARENS
POUMAROUS	MAYOR	ANDRé FOURCADE
ESCAUNETS	MAYOR	PAUL LAGRAVE
HèRES	MAYOR	JOSEPH LATAPIE
LARREULE, HAUTES-PYRéNéES	MAYOR	CLAUDE LAFFONTA
OUEILLOUX	MAYOR	DANIEL BORDES
SAZOS	MAYOR	DANIEL BORDEROLLE
SARP	MAYOR	ROBERT FORASTE
LAU-BALAGNAS	MAYOR	MARYSE CARRèRE
TOURNAY, HAUTES-PYRéNéES	MAYOR	JOSETTE FOURCADE
SOST, HAUTES-PYRéNéES	MAYOR	YVES IBOS
SAINT-AUNèS	MAYOR	MARIE-THéRèSE BRUGUIèRE
BUZANçAIS	MAYOR	RéGIS BLANCHET
RICHELIEU, INDRE-ET-LOIRE	MAYOR	HERVé NOVELLI
VILLEFONTAINE	MAYOR	RAYMOND FEYSSAGUET
ROVON	MAYOR	BéATRICE GENIN
LA CHAUSSéE-SAINT-VICTOR	MAYOR	JACQUELINE GOURAULT
MARCHENOIR	MAYOR	MARC FESNEAU
MONT-PRèS-CHAMBORD	MAYOR	GILLES CLéMENT
APINAC	MAYOR	PHILIPPE BRANSIET
FARNAY	MAYOR	GéRARD COUTURIER
DéBATS-RIVIèRE-D'ORPRA	MAYOR	AGNèS TARIT
SEVELINGES	MAYOR	MICHEL BONNEFOND
MARCLOPT	MAYOR	CHRISTIAN BERNARD
PRéFAILLES	MAYOR	JEAN-LUC LE BRIGAND
ASCOUX	MAYOR	MARC GAUDET
VAYRAC	MAYOR	STING
CHAMPIGNé	MAYOR	PAUL JEANNETEAU
DISTRé	MAYOR	ERIC TOURON
COGOLIN	MAYOR	MARC-ÉTIENNE LANSADE
COTIGNAC	MAYOR	JEAN-PIERRE VERAN
REMILLY-SUR-LOZON	MAYOR	PHILIPPE GOSSELIN
JULLOUVILLE	MAYOR	LOUIS FORGET
TOURLAVILLE	MAYOR	ANDRé ROUXEL
LORETTE, LOIRE	MAYOR	GéRARD TARDY
CHAMERY	MAYOR	PHILIPPE FENEUIL
VANAULT-LES-DAMES	MAYOR	CHARLES DE COURSON
WITRY-LèS-REIMS	MAYOR	YVES DéTRAIGNE
ENTRAMMES	MAYOR	JEAN BODIN
CERVILLE	MAYOR	GISèLE FROMAGET
CHAMPIGNEULLES	MAYOR	CLAUDE HARTMANN
COSNES-ET-ROMAIN	MAYOR	ANDRé FERRARI
LANFROICOURT	MAYOR	JACQUES FLORENTIN
MAXéVILLE	MAYOR	HENRI BéGORRE
MONCEL-SUR-SEILLE	MAYOR	ENNIO BAZZARA
RéHON	MAYOR	JEAN-CLAUDE GUILLAUME
PULNOY	MAYOR	GéRARD ROYER
TOMBLAINE	MAYOR	HERVé FéRON
TRIEUX	MAYOR	CHRISTIAN ECKERT
NONSARD-LAMARCHE	MAYOR	SYLVAIN DENOYELLE
BLIES-GUERSVILLER	MAYOR	ROLAND ROTH
BRUCH, LOT-ET-GARONNE	MAYOR	ALAIN LORENZELLI
TERVILLE	MAYOR	PATRICK LUXEMBOURGER
VALLEROY, MEURTHE-ET-MOSELLE	MAYOR	CHRISTIAN LAMORLETTE
MAING	MAYOR	PHILIPPE BAUDRIN
SAINT-SAULVE	MAYOR	CéCILE GALLEZ
CHANTELOUP-LES-VIGNES	MAYOR	PIERRE CARDO
BUCHELAY	MAYOR	DOMINIQUE BRAYE
LAUZERTE	MAYOR	BERNARD REY
PéROY-LES-GOMBRIES	MAYOR	JEAN-CLAUDE NAU
PUY-GUILLAUME	MAYOR	MICHEL CHARASSE
SAINT-GEORGES-SUR-FONTAINE	MAYOR	RENé NORMAND
MONT-SAINT-VINCENT	MAYOR	JEAN GIRARDON
SAINT-POINT	MAYOR	PHILIPPE MIGNOT
CHAPPES, PUY-DE-DôME	MAYOR	CLAUDE BOILON
CHâTEL-GUYON	MAYOR	FRéDéRIC BONNICHON
COUDES	MAYOR	JEAN-PAUL BACQUET
LAPEYROUSE, PUY-DE-DôME	MAYOR	JEAN MICHEL
LA LONDE-LES-MAURES	MAYOR	FRANçOIS DE CANSON
BELLEVILLE-SUR-VIE	MAYOR	RéGIS PLISSON
SAINT-GILLES-CROIX-DE-VIE	MAYOR	PATRICK NAYL
SAINT-PIERRE-DE-CHEVILLé	MAYOR	BéATRICE PAVY
LANCIé	MAYOR	JACKY MENICHON
CHAPONNAY	MAYOR	RAYMOND DURAND
CHAMPAGNE-AU-MONT-D'OR	MAYOR	BERNARD DEJEAN
LONGESSAIGNE	MAYOR	MICHEL RAMPON
PIERRE-BéNITE	MAYOR	JéRôME MOROGE
SAINT-GENIS-LAVAL	MAYOR	ROLAND CRIMIER
LE MESNIL-ESNARD	MAYOR	SERGE CRAMOISAN
GRUCHET-LE-VALASSE	MAYOR	DIDIER PERALTA
LES HERBIERS	MAYOR	MARCEL ALBERT
VILLENEUVE-DE-LA-RAHO	MAYOR	JACQUELINE IRLES
LE SOLER	MAYOR	FRANçOIS CALVET
TORREILLES	MAYOR	LOUIS CARLES
SAINT-NAZAIRE, PYRéNéES-ORIENTALES	MAYOR	JEAN-CLAUDE TORRENS
SAINT-ESTèVE	MAYOR	ROBERT VILA
LA MAILLERAYE-SUR-SEINE	MAYOR	CHRISTIAN MIGRAINE
POLLESTRES	MAYOR	DANIEL MACH
MONTVILLE, SEINE-MARITIME	MAYOR	PASCAL MARTIN
STöCKHEIM-LEIFERDE	MAYOR	MATTHIAS DISTERHEFT
CASTELMORON-SUR-LOT	MAYOR	BERNARD GENESTOU
FRANCESCAS	MAYOR	RAYMOND SOUCARET
PONT-DU-CASSE	MAYOR	GILBERT FONGARO
PRAYSSAS	MAYOR	ALAIN MERLY
SAINT-SYLVESTRE-SUR-LOT	MAYOR	JEAN-PIERRE LORENZON
VILLERéAL	MAYOR	PIERRE-HENRI ARNSTAM
MORAVSKý ŽIžKOV	MAYOR	JOSEF OSIčKA
BLEVICE	MAYOR	VáCLAV ČERMáK
PFEDDERSHEIM	MAYOR	ALFRED HAAG
VíTKOVICE	MAYOR	PETR DLABAL
NUKU-HIVA	MAYOR	BENOîT KAUTAI
HIVA-OA	MAYOR	TEIIHEIATAATA ETIENNE TEHAAMOANA
NEMEA	MAYOR	EVAGELOS ANDRIANAKOS
BRATISLAVA	MAYOR	IVO NESROVNAL
WIESBADEN-SONNENBERG	MAYOR	DR. WERNER JOPP
SCHIERSTEIN	MAYOR	URBAN EGERT
WIESBADEN-DOTZHEIM	MAYOR	MANFRED ERNST
IGSTADT	MAYOR	GEORG STEITZ
WIESBADEN-KLOPPENHEIM	MAYOR	ERIKA MILKE-FRENZ
BOLOGNA	MAYOR	VIRGINIO MEROLA
KLARENTHAL	MAYOR	GUNTHER LUDWIG
PRAGUE 10	MAYOR	MILAN RICHTER
AUDERGHEM	MAYOR	DIDIER GOSUIN
KORTRIJK	MAYOR	VINCENT VAN QUICKENBORNE
DIVáKY	MAYOR	LIBOR VEVERKA (ČSSD)
HLOHOVEC	MAYOR	JANA VLKOVá
ČESKý KRUMLOV	MAYOR	DALIBOR CARDA
RANGIROA	MAYOR	TEINA MARAEURA
SAINT-ANDRé, RéUNION	MAYOR	JEAN-PAUL VIRAPOULLé
DRAIS	MAYOR	NORBERT SOLBACH
HUDSON, NEW YORK	MAYOR	TIFFANY MARTIN HAMILTON
LIèGE	MAYOR	WILLY DEMEYER
GONSENHEIM	MAYOR	SABINE FLEGEL
WOLUWE-SAINT-LAMBERT	MAYOR	OLIVIER MAINGAIN
ANTWERP	MAYOR	BART DE WEVER
GRENOBLE FLOOD 1859	MAYOR	ÉRIC PIOLLE
LOSSATAL	MAYOR	WWW.UWE-WEIGELT.DE
WIESBADEN-MITTE	MAYOR	ROLAND PRESBER
WIESBADEN-WESTEND	MAYOR	MICHAEL BISCHOFF
WIESBADEN-SüDOST	MAYOR	ANDREAS KNüTTEL
WIESBADEN-NORDOST	MAYOR	SIEGFRIED GRAFFY
WIESBADEN-RHEINGAUVIERTEL	MAYOR	ANGELIKA KOPP
ÖSTLICHES RINGGEBIET	MAYOR	UWE JORDAN
WABE-SCHUNTER-BEBERBACH	MAYOR	GERHARD STüLTEN
INNENSTADT	MAYOR	INES WERNER
BROITZEM	MAYOR	MEIKE RUPP-NAUJOK
HEIDBERG-MELVERODE	MAYOR	HANS-DIETER OSSWALD
BRUGES	MAYOR	RENAAT LANDUYT
HONDELAGE	MAYOR	JöRG GILLE
RüNINGEN	MAYOR	JüRGEN BUCHHEISTER
ZüRICH	MAYOR	CORINE MAUCH
MARSEILLE	MAYOR	JEAN-CLAUDE GAUDIN
SAINT-DENIS, SEINE-SAINT-DENIS	MAYOR	DIDIER PAILLARD
SAN BENEDETTO DEL QUERCETO	MAYOR	GIUSEPPE VENTURI
THIZY-LES-BOURGS	MAYOR	MICHEL MERCIER
GENOA	MAYOR	MARCO DORIA
MUNICIPALITY OF THESSALONIKI	MAYOR	YIANNIS BOUTARIS
