ADRENAL GLAND	MESHNAME	ADRENAL+GLANDS
BONE	MESHNAME	BONE
CERVIX	MESHNAME	CERVIX+UTERI
CLITORIS	MESHNAME	CLITORIS
CENTRAL NERVOUS SYSTEM	MESHNAME	197
ENDOMETRIUM	MESHNAME	ENDOMETRIUM
ENTORHINAL CORTEX	MESHNAME	ENTORHINAL+CORTEX
FOOT	MESHNAME	FOOT
GLOTTIS	MESHNAME	GLOTTIS
HAIR	MESHNAME	HAIR
KIDNEY	MESHNAME	KIDNEY
NERVOUS SYSTEM	MESHNAME	NERVOUS+SYSTEM
OVARY	MESHNAME	OVARY
PARANASAL SINUSES	MESHNAME	PARANASAL+SINUSES
SKELETON	MESHNAME	SKELETON
SPERMATOZOON	MESHNAME	SPERMATOZOA
SKIN	MESHNAME	DERMIS
THYROID	MESHNAME	THYROID+GLAND
UTERUS	MESHNAME	UTERUS
URETHRA	MESHNAME	URETHRA
URINARY BLADDER	MESHNAME	BLADDER
VAGINA	MESHNAME	VAGINA
VOCAL FOLDS	MESHNAME	VOCAL+FOLDS
HEART	MESHNAME	HEART
LUNG	MESHNAME	LUNG
VAGUS NERVE	MESHNAME	VAGUS+NERVE
FINGER	MESHNAME	FINGERS
PUTAMEN	MESHNAME	PUTAMEN
PANCREAS	MESHNAME	PANCREAS
MESODERM	MESHNAME	MESODERM
HUMAN LEG	MESHNAME	LEG
STOMACH	MESHNAME	STOMACH
PERITONEUM	MESHNAME	PERITONEUM
SPLEEN	MESHNAME	SPLEEN
RIB	MESHNAME	RIBS
SUBSTANTIA NIGRA	MESHNAME	SUBSTANTIA+NIGRA
RETINA	MESHNAME	RETINA
LARYNX	MESHNAME	LARYNX
MELANOCYTE	MESHNAME	MELANOCYTES
ARM	MESHNAME	ARM
FACE	MESHNAME	FACE
HIPPOCAMPUS	MESHNAME	HIPPOCAMPUS
PROSTATE	MESHNAME	PROSTATE
MIDDLE EAR	MESHNAME	MIDDLE+EAR
INNER EAR	MESHNAME	INNER+EAR
OUTER EAR	MESHNAME	EXTERNAL+EAR
TONGUE	MESHNAME	TONGUE
THYMUS	MESHNAME	THYMUS+GLAND
CIRCULATORY SYSTEM	MESHNAME	CARDIOVASCULAR+SYSTEM
PITUITARY GLAND	MESHNAME	PITUITARY+GLAND
HYPOTHALAMUS	MESHNAME	HYPOTHALAMUS
OPTIC CHIASM	MESHNAME	OPTIC+CHIASM
CARPAL BONES	MESHNAME	CARPAL+BONES
ABDOMINAL CAVITY	MESHNAME	ABDOMINAL+CAVITY
HUMAN TOOTH	MESHNAME	TOOTH
MUCOUS MEMBRANE	MESHNAME	MUCOSA
DUODENUM	MESHNAME	DUODENUM
TRACHEA	MESHNAME	TRACHE
THALAMUS	MESHNAME	THALAMUS
HYMEN	MESHNAME	HYMEN
INCUS	MESHNAME	INCUS
STAPES	MESHNAME	STAPES
MALLEUS	MESHNAME	MALLEUS
OSSICLES	MESHNAME	EAR+OSSICLES
BLOOD–BRAIN BARRIER	MESHNAME	BLOOD-BRAIN+BARRIER
IRIS	MESHNAME	IRIS
BASAL GANGLIA	MESHNAME	BASAL+GANGLIA
CECUM	MESHNAME	CECUM
JEJUNUM	MESHNAME	JEJUNUM
APPENDIX	MESHNAME	APPENDIX
SMALL INTESTINE	MESHNAME	SMALL+INTESTINE
OVAL WINDOW	MESHNAME	OVAL+WINDOW
EARDRUM	MESHNAME	TYMPANIC+MEMBRANE
COCHLEA	MESHNAME	COCHLEA
AMYGDALA	MESHNAME	AMYGDALA
CORONARY CIRCULATION	MESHNAME	CORONARY+VESSELS
OPTIC NERVE	MESHNAME	OPTIC+NERVE
NEUROLEMMA	MESHNAME	A08.561.600
BARTHOLIN'S GLAND	MESHNAME	BARTHOLIN'S+GLANDS
ESOPHAGUS	MESHNAME	ESOPHAGUS
PALATINE UVULA	MESHNAME	UVULA
PALATE	MESHNAME	PALATE
BULBOURETHRAL GLAND	MESHNAME	BULBOURETHRAL+GLANDS
AMNION	MESHNAME	AMNION
URETER	MESHNAME	URETER
CLAVICLE	MESHNAME	CLAVICLE
ACETABULUM	MESHNAME	ACETABULUM
FEMUR	MESHNAME	FEMUR
KNEE	MESHNAME	KNEE
SYMPATHETIC NERVOUS SYSTEM	MESHNAME	SYMPATHETIC+NERVOUS+SYSTEM
THUMB	MESHNAME	THUMB
PLEURAL CAVITY	MESHNAME	PLEURAL+CAVITY
BONE MARROW	MESHNAME	BONE+MARROW
OLFACTORY NERVE	MESHNAME	OLFACTORY+NERVE
GALLBLADDER	MESHNAME	GALLBLADDER
CANINE TOOTH	MESHNAME	CUSPID
TEMPOROMANDIBULAR JOINT	MESHNAME	TEMPOROMANDIBULAR+JOINT
MEDULLA OBLONGATA	MESHNAME	MEDULLA+OBLONGATA
INTERVERTEBRAL DISC	MESHNAME	INTERVERTEBRAL+DISK
ULNA	MESHNAME	ULNA
SCAPULA	MESHNAME	SCAPULA
COCCYX	MESHNAME	COCCYX
NEPHRON	MESHNAME	NEPHRONS
ABDUCENS NERVE	MESHNAME	ABDUCENS+NERVE
FACIAL NERVE	MESHNAME	FACIAL+NERVE
SUBARACHNOID SPACE	MESHNAME	SUBARACHNOID+SPACE
HUMERUS	MESHNAME	HUMERUS
RADIAL NERVE	MESHNAME	RADIAL+NERVE
EXTRACELLULAR MATRIX	MESHNAME	EXTRACELLULAR+MATRIX
PONS	MESHNAME	PONS
NAVEL	MESHNAME	UMBILICUS
MEDIAN NERVE	MESHNAME	MEDIAN+NERVE
BRACHIAL ARTERY	MESHNAME	BRACHIAL+ARTERY
BRACHIAL PLEXUS	MESHNAME	BRACHIAL+PLEXUS
XIPHOID PROCESS	MESHNAME	XIPHOID+BONE
SACRUM	MESHNAME	SACRUM
SCLERA	MESHNAME	SCLERA
BRAINSTEM	MESHNAME	BRAIN+STEM
EUSTACHIAN TUBE	MESHNAME	EUSTACHIAN+TUBE
WRIST	MESHNAME	WRIST+JOINT
PORTAL VEIN	MESHNAME	PORTAL+VEIN
TRICUSPID VALVE	MESHNAME	TRICUSPID+VALVE
MITRAL VALVE	MESHNAME	MITRAL+VALVE
FOREARM	MESHNAME	FOREARM
BRACHIOCEPHALIC ARTERY	MESHNAME	BRACHIOCEPHALIC+VEINS
FEMORAL ARTERY	MESHNAME	FEMORAL+ARTERY
GREAT SAPHENOUS VEIN	MESHNAME	SAPHENOUS+VEIN
CAUDA EQUINA	MESHNAME	CAUDA+EQUINA
SPINAL NERVE	MESHNAME	SPINAL+NERVES
ULNAR NERVE	MESHNAME	ULNAR+NERVE
BRACHIOCEPHALIC VEIN	MESHNAME	BRACHIOCEPHALIC+VEINS
SUPERIOR VENA CAVA	MESHNAME	VENA+CAVA,+SUPERIOR
INFERIOR VENA CAVA	MESHNAME	VENA+CAVA,+INFERIOR
MAXILLA	MESHNAME	MAXILLA
CUBOID BONE	MESHNAME	CUBOID+BONE
TRAPEZOID BONE	MESHNAME	TRAPEZOID+BONE
TRAPEZIUM	MESHNAME	TRAPEZIUM+BONE
HYPOGLOSSAL NERVE	MESHNAME	HYPOGLOSSAL+NERVE
VESTIBULOCOCHLEAR NERVE	MESHNAME	VESTIBULOCOCHLEAR+NERVE
TRIGEMINAL NERVE	MESHNAME	TRIGEMINAL+NERVE
GLOSSOPHARYNGEAL NERVE	MESHNAME	GLOSSOPHARYNGEAL+NERVE
OCULOMOTOR NERVE	MESHNAME	OCULOMOTOR+NERVE
ACCESSORY NERVE	MESHNAME	ACCESSORY+NERVE
TROCHLEAR NERVE	MESHNAME	TROCHLEAR+NERVE
CIRCLE OF WILLIS	MESHNAME	CIRCLE+OF+WILLIS
TIBIA	MESHNAME	TIBIA
PERICARDIUM	MESHNAME	PERICARDIUM
HYOID BONE	MESHNAME	HYOID+BONE
MACULA OF RETINA	MESHNAME	MACULA+LUTEA
CORPUS CALLOSUM	MESHNAME	CORPUS+CALLOSUM
VENTRICULAR SYSTEM	MESHNAME	CEREBRAL+VENTRICLES
FORAMEN MAGNUM	MESHNAME	FORAMEN+MAGNUM
PINEAL GLAND	MESHNAME	PINEAL+GLAND
PARATHYROID GLAND	MESHNAME	PARATHYROID+GLANDS
SUBCLAVIAN ARTERY	MESHNAME	SUBCLAVIAN+ARTERY
DELTA CELL	MESHNAME	D+CELLS
SOFT PALATE	MESHNAME	SOFT+PALATE
TASTE BUD	MESHNAME	TASTE+BUDS
THORACIC DUCT	MESHNAME	THORACIC+DUCT
SEMICIRCULAR CANALS	MESHNAME	SEMICIRCULAR+CANALS
MANDIBULAR NERVE	MESHNAME	MANDIBULAR+NERVE
LENS	MESHNAME	CRYSTALLINE+LENS
SHOULDER	MESHNAME	SHOULDER
BRONCHUS	MESHNAME	BRONCHI
PATELLA	MESHNAME	PATELLA
ETHMOID BONE	MESHNAME	ETHMOID+BONE
MAMMARY GLAND	MESHNAME	A01.236.249
SPHENOID BONE	MESHNAME	SPHENOID+BONE
CORNEA	MESHNAME	CORNEA
PALATINE BONE	MESHNAME	PALATINE+BONE
FRONTAL BONE	MESHNAME	FRONTAL+BONE
PARIETAL BONE	MESHNAME	PARIETAL+BONE
MESOTHELIUM	MESHNAME	MESOTHELIUM
ECTODERM	MESHNAME	ECTODERM
ENDODERM	MESHNAME	ENDODERM
THORACIC DIAPHRAGM	MESHNAME	DIAPHRAGM
VOMER	MESHNAME	VOMER
FIBULA	MESHNAME	FIBULA
METATARSAL BONES	MESHNAME	METATARSUS
METACARPAL BONES	MESHNAME	METACARPUS
CHORION	MESHNAME	CHORION
INCISOR	MESHNAME	INCISOR
PAROTID GLAND	MESHNAME	PAROTID+GLAND
ANTERIOR PITUITARY	MESHNAME	ANTERIOR+PITUITARY+GLAND
ANKLE	MESHNAME	ANKLE+JOINT
GAP JUNCTION	MESHNAME	GAP+JUNCTIONS
EPIGLOTTIS	MESHNAME	EPIGLOTTIS
SEMINAL VESICLE	MESHNAME	SEMINAL+VESICLES
NERVE FIBER	MESHNAME	NERVE+FIBERS
DENTATE GYRUS	MESHNAME	DENTATE+GYRUS
ACHILLES TENDON	MESHNAME	ACHILLES+TENDON
MENINGES	MESHNAME	MENINGES
EPIDIDYMIS	MESHNAME	EPIDIDYMIS
VAS DEFERENS	MESHNAME	VAS+DEFERENS
EJACULATORY DUCT	MESHNAME	EJACULATORY+DUCTS
SPERMATIC CORD	MESHNAME	SPERMATIC+CORD
FOREHEAD	MESHNAME	FOREHEAD
EXTERNAL CAROTID ARTERY	MESHNAME	CAROTID+ARTERY,+EXTERNAL
CINGULATE CORTEX	MESHNAME	GYRUS+CINGULI
EPIPHYSIS	MESHNAME	EPIPHYSES
MYOFIBRIL	MESHNAME	MYOFIBRILS
INGUINAL CANAL	MESHNAME	INGUINAL+CANAL
EYEBROW	MESHNAME	EYEBROWS
SCAPHOID BONE	MESHNAME	SCAPHOID+BONE
BLASTOCYST	MESHNAME	BLASTOCYST
LEYDIG CELL	MESHNAME	LEYDIG+CELLS
CAUDATE NUCLEUS	MESHNAME	CAUDATE+NUCLEUS
NASAL CAVITY	MESHNAME	NASAL+CAVITY
PIA MATER	MESHNAME	PIA+MATER
CAPITATE BONE	MESHNAME	CAPITATE+BONE
LUNATE BONE	MESHNAME	LUNATE+BONE
HAMATE BONE	MESHNAME	HAMATE+BONE
OLFACTORY BULB	MESHNAME	OLFACTORY+BULB
SEBACEOUS GLAND	MESHNAME	SEBACEOUS+GLANDS
PARIETAL LOBE	MESHNAME	PARIETAL+LOBE
TEMPORAL LOBE	MESHNAME	TEMPORAL+LOBE
FRONTAL LOBE	MESHNAME	FRONTAL+LOBE
OCCIPITAL LOBE	MESHNAME	OCCIPITAL+LOBE
COLLECTING DUCT SYSTEM	MESHNAME	KIDNEY+COLLECTING+DUCTS
EXTRAPYRAMIDAL SYSTEM	MESHNAME	EXTRAPYRAMIDAL+TRACTS
GLOBUS PALLIDUS	MESHNAME	GLOBUS+PALLIDUS
MIDBRAIN	MESHNAME	MESENCEPHALON
CEREBRUM	MESHNAME	TELENCEPHALON
NEOCORTEX	MESHNAME	NEOCORTEX
CEREBRAL PEDUNCLE	MESHNAME	CEREBRAL+PEDUNCLE
RHINENCEPHALON	MESHNAME	RHINENCEPHALON
HUMAN BRAIN	MESHNAME	BRAIN
BOWMAN'S CAPSULE	MESHNAME	BOWMAN+CAPSULE
DISTAL CONVOLUTED TUBULE	MESHNAME	DISTAL+KIDNEY+TUBULE
RAPHE NUCLEI	MESHNAME	RAPHE+NUCLEI
BASILAR MEMBRANE	MESHNAME	BASILAR+MEMBRANE
ADENOID	MESHNAME	ADENOID
CALCANEUS	MESHNAME	CALCANEUS
PULMONARY ARTERY	MESHNAME	PULMONARY+ARTERY
NEUROGLIA	MESHNAME	GLIA
INTERNAL CAROTID ARTERY	MESHNAME	CAROTID+ARTERY,+INTERNAL
POSTERIOR PITUITARY	MESHNAME	PITUITARY+GLAND,+POSTERIOR
MAMMILLARY BODY	MESHNAME	MAMILLARY+BODIES
CHOROID PLEXUS	MESHNAME	CHOROID+PLEXUS
NASAL CONCHA	MESHNAME	CONCHAE+NASALES
SACCULE	MESHNAME	SACCULE+AND+UTRICLE
CHOROID	MESHNAME	CHOROID
FORNIX	MESHNAME	FORNIX+
LOOP OF HENLE	MESHNAME	LOOP+OF+HENLE
NUCLEUS ACCUMBENS	MESHNAME	NUCLEUS+ACCUMBENS
SCALP	MESHNAME	SCALP
CLAUSTRUM	MESHNAME	CLAUSTRUM
RENAL CALYX	MESHNAME	KIDNEY+CALICES
OOCYTE	MESHNAME	OOCYTES
FASCIA	MESHNAME	FASCIA
ORGAN OF CORTI	MESHNAME	ORGAN+OF+CORTI
ORBIT	MESHNAME	ORBIT
POSTERIOR CRUCIATE LIGAMENT	MESHNAME	POSTERIOR+CRUCIATE+LIGAMENT
SEMINIFEROUS TUBULE	MESHNAME	SEMINIFEROUS+TUBULES
RADIUS	MESHNAME	RADIUS
RENAL MEDULLA	MESHNAME	KIDNEY+MEDULLA
SINOATRIAL NODE	MESHNAME	SINOATRIAL+NODE
PYRAMIDAL TRACTS	MESHNAME	PYRAMIDAL+TRACTS
PULMONARY VEIN	MESHNAME	PULMONARY+VEINS
NOTOCHORD	MESHNAME	NOTOCHORD
SUPRAOPTIC NUCLEUS	MESHNAME	SUPRAOPTIC+NUCLEUS
PARAVENTRICULAR NUCLEUS OF HYPOTHALAMUS	MESHNAME	PARAVENTRICULAR+HYPOTHALAMIC+NUCLEUS
SUPRACHIASMATIC NUCLEUS	MESHNAME	SUPRACHIASMATIC+NUCLEUS
OXYPHIL CELL	MESHNAME	OXYPHIL+CELLS
SERTOLI CELL	MESHNAME	SERTOLI+CELLS
HARD PALATE	MESHNAME	HARD+PALATE
PULMONARY VALVE	MESHNAME	PULMONARY+VALVE
CEREBRAL AQUEDUCT	MESHNAME	CEREBRAL+AQUEDUCT
PISIFORM BONE	MESHNAME	PISIFORM+BONE
TRIQUETRAL BONE	MESHNAME	TRIQUETRUM+BONE
CELIAC PLEXUS	MESHNAME	CELIAC+PLEXUS
DURA MATER	MESHNAME	DURA+MATER
MESENTERY	MESHNAME	MESENTERY
OLFACTORY EPITHELIUM	MESHNAME	OLFACTORY+MUCOSA
SUBMANDIBULAR GLAND	MESHNAME	SUBMANDIBULAR+GLAND
GLOMERULUS	MESHNAME	KIDNEY+GLOMERULUS
PARIETAL CELL	MESHNAME	GASTRIC+PARIETAL+CELLS
PULVINAR NUCLEI	MESHNAME	PULVINAR
UPPER LIMB	MESHNAME	UPPER EXTREMITY
RENAL CORTEX	MESHNAME	KIDNEY+CORTEX
RENAL PELVIS	MESHNAME	KIDNEY+PELVIS
SOLITARY NUCLEUS	MESHNAME	SOLITARY+NUCLEUS
AZYGOS VEIN	MESHNAME	AZYGOS+VEIN
RADIAL ARTERY	MESHNAME	RADIAL+ARTERY
DUCTUS ARTERIOSUS	MESHNAME	DUCTUS+ARTERIOSUS
MIDBRAIN TEGMENTUM	MESHNAME	TEGMENTUM+MESENCEPHALI
MYENTERIC PLEXUS	MESHNAME	MYENTERIC+PLEXUS
ENTEROCYTE	MESHNAME	ENTEROCYTES
DERMIS	MESHNAME	DERMIS
CHEEK	MESHNAME	CHEEK
UMBILICAL ARTERY	MESHNAME	UMBILICAL+ARTERIES
BOWMAN'S MEMBRANE	MESHNAME	BOWMAN+MEMBRANE
ARCUATE NUCLEUS	MESHNAME	ARCUATE+NUCLEUS
DIENCEPHALON	MESHNAME	DIENCEPHALON
AXILLA	MESHNAME	AXILLA
TACTILE CORPUSCLE	MESHNAME	MECHANORECEPTORS
EAR	MESHNAME	EAR
PARAMESONEPHRIC DUCT	MESHNAME	MULLERIAN+DUCTS
OVARIAN FOLLICLE	MESHNAME	OVARIAN+FOLLICLE
EYELID	MESHNAME	EYELIDS
SPINAL CANAL	MESHNAME	SPINAL+CANAL
EYELASH	MESHNAME	EYELASHES
NASOLACRIMAL DUCT	MESHNAME	NASOLACRIMAL+DUCT
CONJUNCTIVA	MESHNAME	CONJUNCTIVA
DENTIN	MESHNAME	DENTIN
DIAPHYSIS	MESHNAME	DIAPHYSES
GUMS	MESHNAME	GINGIVA
POPLITEAL ARTERY	MESHNAME	POPLITEAL+ARTERY
TROPHOBLAST	MESHNAME	TROPHOBLASTS
GLYCOCALYX	MESHNAME	GLYCOCALYX
ENDOLYMPH	MESHNAME	ENDOLYMPH
UVEA	MESHNAME	UVEA
FOURTH VENTRICLE	MESHNAME	FOURTH+VENTRICLE
ABDOMINAL AORTA	MESHNAME	AORTA,+ABDOMINAL
KUPFFER CELL	MESHNAME	KUPFFER+CELLS
SEPTUM PELLUCIDUM	MESHNAME	SEPTUM+PELLUCIDUM
SUBLINGUAL GLAND	MESHNAME	SUBLINGUAL+GLAND
NASAL SEPTUM	MESHNAME	NASAL+SEPTUM
SOMITE	MESHNAME	SOMITES
CILIARY BODY	MESHNAME	CILIARY+BODY
OPTIC DISC	MESHNAME	OPTIC+DISK
SUBCUTANEOUS TISSUE	MESHNAME	SUBCUTANEOUS+TISSUE
SPERMATID	MESHNAME	SPERMATIDS
HUMAN EYE	MESHNAME	EYE
ZONA PELLUCIDA	MESHNAME	ZONA+PELLUCIDA
INFERIOR COLLICULUS	MESHNAME	INFERIOR+COLLICULUS
SUPERIOR COLLICULUS	MESHNAME	SUPERIOR+COLLICULUS
RETE TESTIS	MESHNAME	RETE+TESTIS
MEDIAN EMINENCE	MESHNAME	MEDIAN+EMINENCE
ALLANTOIS	MESHNAME	ALLANTOIS
PULP	MESHNAME	DENTAL+PULP
YOLK SAC	MESHNAME	YOLK SAC
EPENDYMA	MESHNAME	EPENDYMA
DORSAL ROOT GANGLION	MESHNAME	SPINAL+GANGLIA
CAROTID SINUS	MESHNAME	CAROTID+SINUS
CERVICAL VERTEBRAE	MESHNAME	CERVICAL+VERTEBRAE
THORACIC VERTEBRAE	MESHNAME	THORACIC+VERTEBRAE
SUBTHALAMIC NUCLEUS	MESHNAME	SUBTHALAMIC+NUCLEUS
JUGULAR VEIN	MESHNAME	JUGULAR+VEINS
LAMELLAR CORPUSCLE	MESHNAME	PACINIAN+CORPUSCLES
SWEAT GLAND	MESHNAME	SWEAT+GLANDS
AORTIC BODY	MESHNAME	AORTIC+BODIES
PREMOLAR	MESHNAME	PENENEEEEE
SEROUS MEMBRANE	MESHNAME	SEROUS+MEMBRANE
EPITHALAMUS	MESHNAME	EPITHALAMUS
RHYTIDECTOMY	MESHNAME	RHYTIDOPLASTY
RENAL ARTERY	MESHNAME	RENAL+ARTERY
PERIAQUEDUCTAL GRAY	MESHNAME	PERIAQUEDUCTAL+GRAY
LATERAL VENTRICLES	MESHNAME	LATERAL+VENTRICLES
RETICULAR FORMATION	MESHNAME	RETICULAR+FORMATION
INTERNAL JUGULAR VEIN	MESHNAME	JUGULAR+VEINS
EXTERNAL JUGULAR VEIN	MESHNAME	JUGULAR+VEINS
OLIVARY BODY	MESHNAME	OLIVARY+NUCLEUS
INFERIOR OLIVARY NUCLEUS	MESHNAME	OLIVARY+NUCLEUS
RENAL VEIN	MESHNAME	RENAL+VEINS
TRABECULAR MESHWORK	MESHNAME	TRABECULAR+MESHWORK
RECTO-UTERINE POUCH	MESHNAME	DOUGLAS'+POUCH
BASILAR ARTERY	MESHNAME	BASILAR+ARTERY
VERTEBRAL ARTERY	MESHNAME	SUBCLAVIAN+ARTERY
INTERVENTRICULAR FORAMINA	MESHNAME	FORAMEN+OF+MONRO
ENTEROCHROMAFFIN-LIKE CELL	MESHNAME	ENTEROCHROMAFFIN-LIKE+CELLS
SYNAPTOSOME	MESHNAME	SYNAPTOSOMES
CELIAC ARTERY	MESHNAME	CELIAC+ARTERY
INTRATHECAL ADMINISTRATION	MESHNAME	SUBARACHNOID+SPACE
ANAL CANAL	MESHNAME	ANAL+CANAL
STELLATE GANGLION	MESHNAME	STELLATE+GANGLION
SPERMATOGONIUM	MESHNAME	SPERMATOGONIA
DESCENDING AORTA	MESHNAME	AORTA,+THORACIC
ACROMIOCLAVICULAR JOINT	MESHNAME	ACROMIOCLAVICULAR+JOINT
SUPERIOR MESENTERIC ARTERY	MESHNAME	MESENTERIC+ARTERY,+SUPERIOR
POSTERIOR CRANIAL FOSSA	MESHNAME	CRANIAL+FOSSA,+POSTERIOR
CHORDAE TENDINEAE	MESHNAME	CHORDAE+TENDINAE
SYNOVIAL BURSA	MESHNAME	BURSA,+SYNOVIAL
EPINEURIUM	MESHNAME	EPINEURIUM
PREFRONTAL CORTEX	MESHNAME	PREFRONTAL+CORTEX
POPLITEAL VEIN	MESHNAME	POPLITEAL+VEIN
DENTAL ALVEOLUS	MESHNAME	TOOTH+SOCKET
ANTERIOR CEREBRAL ARTERY	MESHNAME	ANTERIOR+CEREBRAL+ARTERY
ENTEROCHROMAFFIN CELL	MESHNAME	ENTEROCHROMAFFIN+CELLS
CRICOID CARTILAGE	MESHNAME	CRICOID+CARTILAGE
FEMORAL VEIN	MESHNAME	FEMORAL+VEIN
RED NUCLEUS	MESHNAME	RED+NUCLEUS
OTOLITH	MESHNAME	OTOLITHIC+MEMBRANE
THYROID CARTILAGE	MESHNAME	THYROID+CARTILAGE
SUBFORNICAL ORGAN	MESHNAME	SUBFORNICAL+ORGAN
LIP	MESHNAME	LIP
DENTAL PAPILLA	MESHNAME	DENTAL+PAPILLA
ULTIMOPHARYNGEAL BODY	MESHNAME	ULTIMOBRANCHIAL+BODY
PANCREATIC DUCT	MESHNAME	PANCREATIC+DUCTS
MEIBOMIAN GLAND	MESHNAME	MEIBOMIAN+GLANDS
SUBCLAVIAN VEIN	MESHNAME	SUBCLAVIAN+VEIN
CHORDA TYMPANI	MESHNAME	CHORDA+TYMPANI+NERVE
CENTRAL RETINAL ARTERY	MESHNAME	RETINAL+ARTERY
OPHTHALMIC ARTERY	MESHNAME	OPHTHALMIC+ARTERY
PITUITARY STALK	MESHNAME	PITUITARY+STALK
LENTIFORM NUCLEUS	MESHNAME	CORPUS+STRIATUM
HIP	MESHNAME	HIP
BRUCH'S MEMBRANE	MESHNAME	BRUCH+MEMBRANE
ULNAR ARTERY	MESHNAME	ULNAR+ARTERY
AXILLARY ARTERY	MESHNAME	AXILLARY+ARTERY
INTERNAL THORACIC ARTERY	MESHNAME	MAMMARY+ARTERIES
INFERIOR MESENTERIC ARTERY	MESHNAME	MESENTERIC+ARTERY,+INFERIOR
SPLENIC ARTERY	MESHNAME	SPLENIC+ARTERY
SPLENIC VEIN	MESHNAME	SPLENIC+VEIN
MAXILLARY SINUS	MESHNAME	MAXILLARY+SINUS
AXILLARY VEIN	MESHNAME	AXILLARY+VEIN
OOGONIUM	MESHNAME	OOGONIA
MYELENCEPHALON	MESHNAME	MYELENCEPHALON
HINDBRAIN	MESHNAME	RHOMBENCEPHALON
METENCEPHALON	MESHNAME	METENCEPHALON
PEDUNCULOPONTINE NUCLEUS	MESHNAME	PEDUNCULOPONTINE+TEGMENTAL+NUCLEUS
SUBICULUM	MESHNAME	SUBICULUM
PARAHIPPOCAMPAL GYRUS	MESHNAME	PARAHIPPOCAMPAL+GYRUS
TUNICA INTIMA	MESHNAME	TUNICA+INTIMA
TUNICA MEDIA	MESHNAME	TUNICA+MEDIA
ARYTENOID CARTILAGE	MESHNAME	ARYTENOID+CARTILAGE
CISTERNA MAGNA	MESHNAME	CISTERNA+MAGNA
TIBIAL NERVE	MESHNAME	TIBIAL+NERVE
MEDIAL COLLATERAL LIGAMENT	MESHNAME	MEDIAL+COLLATERAL+LIGAMENT,+KNEE
COMMON CAROTID ARTERY	MESHNAME	CAROTID+ARTERY,+COMMON
LESSER OMENTUM	MESHNAME	OMENTUM
SUBTHALAMUS	MESHNAME	SUBTHALAMUS
CORPORA QUADRIGEMINA	MESHNAME	CORPORA+QUADRIGEMINA
FORAMEN OVALE	MESHNAME	FORAMEN+OVALE
HABENULA	MESHNAME	HABENULA
ARACHNOID MATER	MESHNAME	ARACHNOID
FRENULUM OF TONGUE	MESHNAME	LINGUAL+FRENUM
DORSAL ROOT OF SPINAL NERVE	MESHNAME	DORSAL+ROOTS
VENTRAL ROOT OF SPINAL NERVE	MESHNAME	VENTRAL+ROOTS
INTERVENTRICULAR SEPTUM	MESHNAME	HEART+SEPTUM
PAROTID DUCT	MESHNAME	STENSEN'S+DUCT
TALUS BONE	MESHNAME	TALUS
SHOULDER JOINT	MESHNAME	GLENOHUMERAL+JOINT
ETHMOID SINUS	MESHNAME	ETHMOID+SINUS
VENTROMEDIAL NUCLEUS OF THE HYPOTHALAMUS	MESHNAME	VENTROMEDIAL+HYPOTHALAMIC+NUCLEUS
AMPULLA OF VATER	MESHNAME	AMPULLA+OF+VATER
INTERATRIAL SEPTUM	MESHNAME	HEART+SEPTUM
POSTERIOR CEREBRAL ARTERY	MESHNAME	POSTERIOR+CEREBRAL+ARTERY
THORACIC AORTA	MESHNAME	AORTA,+THORACIC
INTERCOSTAL NERVES	MESHNAME	INTERCOSTAL+NERVES
COCHLEAR NERVE	MESHNAME	COCHLEAR+NERVE
VESTIBULAR NERVE	MESHNAME	VESTIBULAR+NERVE
CAVERNOUS SINUS	MESHNAME	CRANIAL+SINUSES
MESONEPHROS	MESHNAME	MESONEPHROS
OPHTHALMIC NERVE	MESHNAME	OPHTHALMIC+NERVE
MAXILLARY NERVE	MESHNAME	MAXILLARY+NERVE
PHARYNGEAL ARCH	MESHNAME	BRANCHIAL+ARCHES
LESSER SAC	MESHNAME	LESSER+SAC
FRONTAL SINUS	MESHNAME	FRONTAL+SINUS
DECIDUA	MESHNAME	DECIDUA
INTERNAL ILIAC ARTERY	MESHNAME	ILIAC+ARTERY
ILIUM	MESHNAME	ILIUM
METACARPOPHALANGEAL JOINT	MESHNAME	METACARPOPHALANGEAL+JOINT
TYMPANIC DUCT	MESHNAME	SCALA+TYMPANI
COCHLEAR DUCT	MESHNAME	COCHLEAR+DUCT
CORTICAL REACTION	MESHNAME	ZONA+PELLUCIDA
LIST OF THALAMIC NUCLEI	MESHNAME	THALAMIC+NUCLEI
AORTIC ARCH	MESHNAME	AORTIC+ARCH
SYNCYTIOTROPHOBLAST	MESHNAME	SYNCYTIOTROPHOBLASTS
FEMORAL NERVE	MESHNAME	FEMORAL+NERVE
DURAL VENOUS SINUSES	MESHNAME	CRANIAL+SINUSES
OCCIPITAL SINUS	MESHNAME	CRANIAL+SINUSES
CONFLUENCE OF SINUSES	MESHNAME	CRANIAL+SINUSES
STRAIGHT SINUS	MESHNAME	CRANIAL+SINUSES
SUPERIOR PETROSAL SINUS	MESHNAME	CRANIAL+SINUSES
INFERIOR PETROSAL SINUS	MESHNAME	CRANIAL+SINUSES
INFERIOR SAGITTAL SINUS	MESHNAME	CRANIAL+SINUSES
SUPERIOR SAGITTAL SINUS	MESHNAME	CRANIAL+SINUSES
SUBTALAR JOINT	MESHNAME	SUBTALAR+JOINT
LUMBAR PLEXUS	MESHNAME	LUMBOSACRAL+PLEXUS
ISCHIUM	MESHNAME	ISCHIUM
PUBIS	MESHNAME	PUBIC+BONE
ILEOCECAL VALVE	MESHNAME	ILEOCECAL+VALVE
ROUND LIGAMENT OF UTERUS	MESHNAME	ROUND+LIGAMENT
LINGUAL NERVE	MESHNAME	LINGUAL+NERVE
ROUND WINDOW	MESHNAME	ROUND+WINDOW
PRIMITIVE STREAK	MESHNAME	PRIMITIVE+STREAK
CYTOTROPHOBLAST	MESHNAME	TROPHOBLASTS
SURAL NERVE	MESHNAME	SURAL+NERVE
SPHENOIDAL SINUS	MESHNAME	SPHENOID+SINUS
TROCHLEAR NUCLEUS	MESHNAME	N_11
TRIGEMINAL NERVE NUCLEI	MESHNAME	TRIGEMINAL+NUCLEI
SPINAL TRIGEMINAL NUCLEUS	MESHNAME	TRIGEMINAL+NUCLEUS,+SPINAL
TRIGEMINAL MOTOR NUCLEUS	MESHNAME	TRIGEMINAL+NUCLEI
ADRENAL ADENOMA	MESHNAME	ADRENAL+GLANDS
FIRST METACARPAL BONE	MESHNAME	METACARPAL+BONES
FOURTH METACARPAL BONE	MESHNAME	METACARPAL+BONES
SECOND METACARPAL BONE	MESHNAME	METACARPAL+BONES
FIFTH METACARPAL BONE	MESHNAME	METACARPAL+BONES
THIRD METACARPAL BONE	MESHNAME	METACARPAL+BONES
SIGMOID SINUS	MESHNAME	CRANIAL+SINUSES
POSTERIOR EXTERNAL JUGULAR VEIN	MESHNAME	JUGULAR+VEINS
ANTERIOR JUGULAR VEIN	MESHNAME	JUGULAR+VEINS
INTERCAVERNOUS SINUSES	MESHNAME	CRANIAL+SINUSES
TRANSVERSE SINUSES	MESHNAME	CRANIAL+SINUSES
VITELLINE DUCT	MESHNAME	VITELLINE+DUCT
PANETH CELL	MESHNAME	PANETH+CELLS
MIDDLE COLIC ARTERY	MESHNAME	A_61
LAMINA TERMINALIS	MESHNAME	LAMINA+TERMINALIS
TUBER CINEREUM	MESHNAME	TUBER+CINEREUM
TRIGEMINAL GANGLION	MESHNAME	SEMILUNAR+GANGLION
SUPERIOR CERVICAL GANGLION	MESHNAME	SUPERIOR+CERVICAL+GANGLION
SUBMANDIBULAR DUCT	MESHNAME	WHARTON+DUCT
SUPERIOR SALIVARY NUCLEUS	MESHNAME	N_11
CHORIONIC VILLI	MESHNAME	CHORIONIC+VILLI
GREATER OMENTUM	MESHNAME	OMENTUM
DESCENDING COLON	MESHNAME	COLON,+DESCENDING
SUPERIOR HYPOGASTRIC PLEXUS	MESHNAME	HYPOGASTRIC+PLEXUS
CELIAC GANGLIA	MESHNAME	CELIAC+GANGLIA
METATHALAMUS	MESHNAME	METATHALAMUS
STERNOCLAVICULAR JOINT	MESHNAME	STERNOCLAVICULAR+JOINT
CENTRAL GELATINOUS SUBSTANCE OF SPINAL CORD	MESHNAME	SUBSTANTIA+GELATINOSA
SUBSTANTIA GELATINOSA OF ROLANDO	MESHNAME	SUBSTANTIA+GELATINOSA
LIGAMENTA FLAVA	MESHNAME	LIGAMENTUM+FLAVUM
BILE CANALICULUS	MESHNAME	BILE+CANALICULI
ATLANTO-AXIAL JOINT	MESHNAME	ATLANTO-AXIAL+JOINT
ATLANTO-OCCIPITAL JOINT	MESHNAME	ATLANTO-OCCIPITAL+JOINT
SUPERFICIAL EPIGASTRIC ARTERY	MESHNAME	EPIGASTRIC+ARTERIES
AREA POSTREMA	MESHNAME	AREA+POSTREMA
SUBSTANTIA INNOMINATA	MESHNAME	SUBSTANTIA+INNOMINATA
SPIRAL GANGLION	MESHNAME	SPIRAL+GANGLION
INFERIOR GANGLION OF VAGUS NERVE	MESHNAME	NODOSE+GANGLION
MEDIAL FOREBRAIN BUNDLE	MESHNAME	MEDIAL+FOREBRAIN+BUNDLE
LUMBOSACRAL PLEXUS	MESHNAME	LUMBOSACRAL+PLEXUS
SUBMUCOUS PLEXUS	MESHNAME	SUBMUCOUS+PLEXUS
DIAGONAL BAND OF BROCA	MESHNAME	DIAGONAL+BAND+OF+BROCA
THORACIC SPLANCHNIC NERVES	MESHNAME	SPLANCHNIC+NERVES
URACHUS	MESHNAME	URACHUS
VITELLINE MEMBRANE	MESHNAME	VITELLINE+MEMBRANE
ISLANDS OF CALLEJA	MESHNAME	ISLANDS+OF+CALLEJA
CORNEAL EPITHELIUM	MESHNAME	EPITHELIUM,+CORNEAL
TECTORIAL MEMBRANE	MESHNAME	TECTORIAL+MEMBRANE
OSSEOUS SPIRAL LAMINA	MESHNAME	SPIRAL+LAMINA
STRIA VASCULARIS OF COCHLEAR DUCT	MESHNAME	STRIA+VASCULARIS
VESTIBULAR AQUEDUCT	MESHNAME	VESTIBULAR+AQUEDUCT
ENDOLYMPHATIC SAC	MESHNAME	ENDOLYMPHATIC+SAC
BLOOD–AIR BARRIER	MESHNAME	BLOOD-AIR+BARRIER
VAGOVAGAL REFLEX	MESHNAME	ENTEROCHROMAFFIN-LIKE+CELLS
CHIN	MESHNAME	CHIN
INTERTARSAL JOINTS	MESHNAME	TARSAL+JOINTS
INTERCARPAL JOINTS	MESHNAME	INTERCARPAL+JOINTS
PATELLAR LIGAMENT	MESHNAME	PATELLAR+LIGAMENT
DORSOMEDIAL HYPOTHALAMIC NUCLEUS	MESHNAME	DORSOMEDIAL+HYPOTHALAMIC+NUCLEUS
ANTERIOR HYPOTHALAMIC NUCLEUS	MESHNAME	ANTERIOR+HYPOTHALAMIC+NUCLEUS
PREOPTIC AREA	MESHNAME	PREOPTIC+AREA
LATERAL HYPOTHALAMUS	MESHNAME	LATERAL+HYPOTHALAMIC+AREA
TRUNCUS ARTERIOSUS	MESHNAME	TRUNCUS+ARTERIOSUS
TRIANGULAR FIBROCARTILAGE	MESHNAME	TRIANGULAR+FIBROCARTILAGE
FEMUR NECK	MESHNAME	FEMUR+NECK
FEMORAL HEAD	MESHNAME	FEMUR+HEAD
PERINEURIUM	MESHNAME	PERINEURIUM
ENDONEURIUM	MESHNAME	ENDONEURIUM
APOCRINE SWEAT GLAND	MESHNAME	APOCRINE+GLANDS
ECCRINE SWEAT GLAND	MESHNAME	ECCRINE+GLANDS
FACET JOINT	MESHNAME	ZYGAPOPHYSEAL+JOINT
ENTEROENDOCRINE CELL	MESHNAME	ENTEROENDOCRINE+CELLS
CLOACA	MESHNAME	CLOACA
GLOMERULAR BASEMENT MEMBRANE	MESHNAME	GLOMERULAR+BASEMENT+MEMBRANE
COSTAMERE	MESHNAME	COSTAMERES
MEDIAL DORSAL NUCLEUS	MESHNAME	MEDIODORSAL+THALAMIC+NUCLEUS
HUMAN NOSE	MESHNAME	NOSE
CHIASMAL SYNDROME	MESHNAME	OPTIC+CHIASM
MESENCEPHALIC NUCLEUS OF TRIGEMINAL NERVE	MESHNAME	TRIGEMINAL+NUCLEI
PRINCIPAL SENSORY NUCLEUS OF TRIGEMINAL NERVE	MESHNAME	TRIGEMINAL+NUCLEI
SUBCOMMISSURAL ORGAN	MESHNAME	SUBCOMMISSURAL+ORGAN
ANTERIOR NUCLEI OF THALAMUS	MESHNAME	ANTERIOR+THALAMIC+NUCLEI
MIDLINE NUCLEAR GROUP	MESHNAME	MIDLINE+NUCLEAR+GROUP
LATERAL NUCLEAR GROUP	MESHNAME	LATERAL+NUCLEAR+GROUP
VENTRAL NUCLEAR GROUP	MESHNAME	VENTRAL+NUCLEAR+GROUP
INTRALAMINAR NUCLEI OF THALAMUS	MESHNAME	INTRALAMINAR+THALAMIC+NUCLEI
HIP POINTER	MESHNAME	ILIUM
VOCAL PEDAGOGY	MESHNAME	VOCAL+CORDS
HUMAN PENIS	MESHNAME	PENIS
CENTRAL RETINAL VEIN	MESHNAME	CENTRAL+RETINAL+VEIN
ASTRAGALECTOMY	MESHNAME	TALUS
ABDOMINOPELVIC CAVITY	MESHNAME	ABDOMINOPELVIC+CAVITY
BUTTOCKS	MESHNAME	BUTTOCKS
LIVER	MESHNAME	LIVER
SCROTUM	MESHNAME	SCROTUM
HAND	MESHNAME	HAND
RECTUM	MESHNAME	RECTUM
ELBOW	MESHNAME	ELBOW+JOINT
MUSCLE	MESHNAME	MUSCLES
PHARYNX	MESHNAME	PHARYNX
PRIMARY MOTOR CORTEX	MESHNAME	MOTOR+CORTEX
FALLOPIAN TUBE	MESHNAME	FALLOPIAN+TUBES
GLOBE	MESHNAME	GLOBE
OROPHARYNGEAL CANCER	MESHNAME	PHARYNX
CHORIOALLANTOIC MEMBRANE	MESHNAME	CHORIOALLANTOIC+MEMBRANE
WHITE BLOOD CELL	MESHNAME	LEUKOCYTES
VULVA	MESHNAME	VULVA
FORESKIN	MESHNAME	FORESKIN
NUCLEUS BASALIS OF MEYNERT	MESHNAME	BASAL+NUCLEUS+OF+MEYNERT
STERNUM	MESHNAME	STERNUM
MANDIBLE	MESHNAME	MANDIBLE
INTERPEDUNCULAR NUCLEUS	MESHNAME	INTERPEDUNCULAR+NUCLEUS
ACUTE HAEMORRHAGIC CONJUNCTIVITIS IN GHANA	MESHNAME	CONJUNCTIVA
RHOMBIC LIP	MESHNAME	METENCEPHALON
VENAE CAVAE	MESHNAME	VENAE+CAVAE
SACCULAR ACOUSTIC SENSITIVITY	MESHNAME	SACCULE+AND+UTRICLE
HUMAN MOUTH	MESHNAME	ORAL+CAVITY
PREORBITAL GLAND	MESHNAME	LACRIMAL APPARATUS
ORIGIN OF SPEECH	MESHNAME	HYOID+BONE
EPINEURIAL REPAIR	MESHNAME	EPINEURIUM
RETICULAR MEMBRANE	MESHNAME	RETICULAR+MEMBRANE
HUMAN DIGESTIVE SYSTEM	MESHNAME	DIGESTIVE+SYSTEM
SPHINCTER OF ODDI	MESHNAME	ODDI'S+SPHINCTER
