AOZORA BUNKO	NAMEEN	AOZORA BUNKO
BIBLIOTHèQUE NATIONALE DE FRANCE	NAMEEN	NATIONAL LIBRARY OF FRANCE
BIBLIOTHECA ALEXANDRINA	NAMEEN	THE NEW LIBRARY OF ALEXANDRIA
NATIONAL DIET LIBRARY	NAMEEN	NATIONAL DIET LIBRARY
NATIONAL LIBRARY OF SWEDEN	NAMEEN	NATIONAL LIBRARY OF SWEDEN
ROYAL LIBRARY, DENMARK	NAMEEN	THE ROYAL LIBRARY, THE NATIONAL LIBRARY OF DENMARK AND THE COPENHAGEN UNIVERSITY LIBRARY
VATICAN LIBRARY	NAMEEN	VATICAN APOSTOLIC LIBRARY
NATIONAL LIBRARY OF SOUTH AFRICA	NAMEEN	STAATS-BIBLIOTHEEK DER ZUID-AFRIKAANSCHE REPUBLIEK
NATIONAL LIBRARY OF WALES	NAMEEN	THE NATIONAL LIBRARY OF WALES
SS. CYRIL AND METHODIUS NATIONAL LIBRARY	NAMEEN	SS. CYRIL AND METHODIUS NATIONAL LIBRARY
RUSSIAN STATE LIBRARY	NAMEEN	RUSSIAN STATE LIBRARY
NATIONAL LIBRARY OF SERBIA	NAMEEN	NATIONAL LIBRARY OF SERBIA
BAVARIAN STATE LIBRARY	NAMEEN	BAVARIAN STATE LIBRARY
NATIONAL LIBRARY OF THE NETHERLANDS	NAMEEN	NATIONAL LIBRARY OF THE NETHERLANDS
NATIONAL LIBRARY OF ROMANIA	NAMEEN	NATIONAL LIBRARY OF ROMANIA
NATIONAL LIBRARY OF PERU	NAMEEN	NATIONAL LIBRARY OF PERU
GERMAN NATIONAL LIBRARY	NAMEEN	GERMAN NATIONAL LIBRARY
NATIONAL LIBRARY OF RUSSIA	NAMEEN	THE NATIONAL LIBRARY OF RUSSIA
NATIONAL AND UNIVERSITY LIBRARY OF SLOVENIA	NAMEEN	NATIONAL AND UNIVERSITY LIBRARY OF SLOVENIA
GöTTINGEN STATE AND UNIVERSITY LIBRARY	NAMEEN	GöTTINGEN STATE AND UNIVERSITY LIBRARY
BIBLIOTECA NACIONAL DE ESPAñA	NAMEEN	NATIONAL LIBRARY OF SPAIN
CENTRAL CATHOLIC LIBRARY	NAMEEN	CENTRAL CATHOLIC LIBRARY
NATIONAL LIBRARY OF COLOMBIA	NAMEEN	NATIONAL LIBRARY OF COLOMBIA
NATIONAL LIBRARY OF BELARUS	NAMEEN	NATIONAL LIBRARY OF BELARUS
ROYAL LIBRARY OF BELGIUM	NAMEEN	ROYAL LIBRARY OF BELGIUM
NATIONAL LIBRARY OF POLAND	NAMEEN	NATIONAL LIBRARY OF POLAND
SWISS NATIONAL LIBRARY	NAMEEN	SWISS NATIONAL LIBRARY
NATIONAL LIBRARY OF MEXICO	NAMEEN	NATIONAL LIBRARY OF MEXICO
CHEKHOV LIBRARY	NAMEEN	THE CENTRAL MUNICIPAL PUBLIC LIBRARY NAMED AFTER ANTON CHEKHOV
MADAN PURASKAR PUSTAKALAYA	NAMEEN	MADAN PURASKAR PUSTAKALAYA
NATIONAL LIBRARY OF NORWAY	NAMEEN	THE NATIONAL LIBRARY OF NORWAY
NATIONAL LIBRARY OF ISRAEL	NAMEEN	THE NATIONAL LIBRARY OF ISRAEL
WüRTTEMBERGISCHE LANDESBIBLIOTHEK	NAMEEN	STATE LIBRARY OF WüRTTEMBERG
BUFFALO & ERIE COUNTY PUBLIC LIBRARY	NAMEEN	BUFFALO & ERIE COUNTY PUBLIC LIBRARY
CHARLOTTE MECKLENBURG LIBRARY	NAMEEN	PUBLIC LIBRARY OF CHARLOTTE AND MECKLENBURG COUNTY
JAGIELLONIAN LIBRARY	NAMEEN	JAGIELLONIAN LIBRARY
NATIONAL LIBRARY OF GREECE	NAMEEN	NATIONAL LIBRARY OF GREECE
NATIONAL LIBRARY OF BHUTAN	NAMEEN	NATIONAL LIBRARY OF BHUTAN
VERNADSKY NATIONAL LIBRARY OF UKRAINE	NAMEEN	VERNADSKY NATIONAL LIBRARY OF UKRAINE
BIBLIOTECA NACIONAL DE PORTUGAL	NAMEEN	NATIONAL LIBRARY OF PORTUGAL
OPENBARE BIBLIOTHEEK AMSTERDAM	NAMEEN	AMSTERDAM PUBLIC LIBRARY
NATIONAL AND UNIVERSITY LIBRARY IN ZAGREB	NAMEEN	NATIONAL AND UNIVERSITY LIBRARY IN ZAGREB
NATIONAL LIBRARY OF FINLAND	NAMEEN	NATIONAL LIBRARY OF FINLAND
ANDORRA NATIONAL LIBRARY	NAMEEN	ANDORRA NATIONAL LIBRARY
NATIONAL LIBRARY OF ESTONIA	NAMEEN	NATIONAL LIBRARY OF ESTONIA
GHENT UNIVERSITY LIBRARY	NAMEEN	GHENT UNIVERSITY LIBRARY
ZEELAND LIBRARY	NAMEEN	ZEELAND LIBRARY
BIBLIOTECA WILLIAM MULLOY	NAMEEN	WILLIAM MULLOY LIBRARY
NORTHERN TERRITORY LIBRARY	NAMEEN	NORTHERN TERRITORY LIBRARY
NATIONAL LIBRARY OF BANGLADESH	NAMEEN	NATIONAL LIBRARY OF BANGLADESH
NATIONAL LIBRARY OF KAZAKHSTAN	NAMEEN	NATIONAL LIBRARY OF THE REPUBLIC OF KAZAKHSTAN
NATIONAL LIBRARY OF MALAYSIA	NAMEEN	NATIONAL LIBRARY OF MALAYSIA
NATIONAL LIBRARY OF BURKINA FASO	NAMEEN	NATIONAL LIBRARY OF BURKINA FASO
CYPRUS LIBRARY	NAMEEN	CYPRUS LIBRARY
NATIONAL LIBRARY OF ALBANIA	NAMEEN	NATIONAL LIBRARY OF ALBANIA
GREIFSWALD UNIVERSITY LIBRARY	NAMEEN	GREIFSWALD UNIVERSITY LIBRARY
BIBLIOTECA PALATINA, PARMA	NAMEEN	PALATINA LIBRARY
STADSBIBLIOTHEEK HAARLEM	NAMEEN	HAARLEM PUBLIC LIBRARY
NATIONAL LIBRARY OF CAPE VERDE	NAMEEN	NATIONAL LIBRARY OF CAPE VERDE
PATMA LIBRARY	NAMEEN	PATMA LIBRARY
FAYETTEVILLE PUBLIC LIBRARY	NAMEEN	FAYETTEVILLE PUBLIC LIBRARY
TCHAIKOVSKY HOUSE IN TAGANROG	NAMEEN	THE MUSIC DEPARTMENT OF THE CENTRAL MUNICIPAL PUBLIC LIBRARY NAMED AFTER ANTON CHEKHOV AND THE CONCERT HALL
BIBLIOTHèQUE INGUIMBERTINE	NAMEEN	FR
GOTHENBURG UNIVERSITY LIBRARY	NAMEEN	GOTHENBURG UNIVERSITY LIBRARY
BELGRADE UNIVERSITY LIBRARY	NAMEEN	BELGRADE UNIVERSITY LIBRARY
NATIONAL LIBRARY OF INDONESIA	NAMEEN	NATIONAL LIBRARY OF INDONESIA
WARSAW PUBLIC LIBRARY	NAMEEN	WARSAW PUBLIC LIBRARY
WARSAW UNIVERSITY LIBRARY	NAMEEN	WARSAW UNIVERSITY LIBRARY
TSURUMA CENTRAL LIBRARY	NAMEEN	NAGOYA TSURUMA CENTRAL LIBRARY
COLOGNE PUBLIC LIBRARY	NAMEEN	COLOGNE PUBLIC LIBRARY
NATIONAL LIBRARY OF MONGOLIA	NAMEEN	THE NATIONAL LIBRARY OF MONGOLIA
NATIONAL LIBRARY OF LIBYA	NAMEEN	NATIONAL LIBRARY OF LIBYA
OULU CITY LIBRARY	NAMEEN	OULU CITY LIBRARY
PONCE MUNICIPAL LIBRARY	NAMEEN	MARIANA SUáREZ DE LONGO MUNICIPAL LIBRARY
PROSVJETA	NAMEEN	CENTRAL LIBRARY OF SERBS OF CROATIA
BERMUDA NATIONAL LIBRARY	NAMEEN	BERMUDA NATIONAL LIBRARY
NATIONAL LIBRARY OF VIETNAM	NAMEEN	NATIONAL LIBRARY OF VIETNAM
BAMBERG STATE LIBRARY	NAMEEN	BAMBERG STATE LIBRARY
NATIONAL LIBRARY OF ARUBA	NAMEEN	NATIONAL LIBRARY OF ARUBA
INFORMATION CENTRE FOR FOREIGN LANGUAGE RESEARCH	NAMEEN	INFORMATION CENTRE FOR FOREIGN LANGUAGE RESEARCH
LONGUEUIL PUBLIC LIBRARIES NETWORK	NAMEEN	LONGUEUIL PUBLIC LIBRARIES NETWORK
REPUBLICAN SCIENTIFIC MEDICAL LIBRARY	NAMEEN	REPUBLICAN SCIENTIFIC MEDICAL LIBRARY
NATIONAL AND UNIVERSITY LIBRARY OF THE REPUBLIKA SRPSKA	NAMEEN	NATIONAL AND UNIVERSITY LIBRARY OF THE REPUBLIC OF SRPSKA
BERLIN CENTRAL AND REGIONAL LIBRARY	NAMEEN	BERLIN CENTRAL AND REGIONAL LIBRARY
HESSIAN STATE LIBRARY	NAMEEN	HESSIAN STATE LIBRARY
KURSK STATE UNIVERSITY LIBRARY	NAMEEN	KURSK STATE UNIVERSITY LIBRARY
CITY AND UNIVERSITY LIBRARY IN OSIJEK	NAMEEN	CITY AND UNIVERSITY LIBRARY OF OSIJEK
NATIONAL LIBRARY OF MONTENEGRO	NAMEEN	NATIONAL LIBRARY OF MONTENEGRO \
NATIONAL LIBRARY OF MADAGASCAR	NAMEEN	NATIONAL LIBRARY OF MADAGASCAR
NATIONAL LIBRARY OF MAURITANIA	NAMEEN	NATIONAL LIBRARY OF MAURITANIA
UNIVERSITY LIBRARY OF TüBINGEN	NAMEEN	UNIVERSITY LIBRARY OF TüBINGEN
NATIONAL AND UNIVERSITY LIBRARY %22ST. KLIMENT OF OHRID%22	NAMEEN	NATIONAL AND UNIVERSITY LIBRARY \
BADEN STATE LIBRARY	NAMEEN	BADEN STATE LIBRARY
BIBLIOTHèQUE NATIONALE DU ROYAUME DU MAROC	NAMEEN	NATIONAL LIBRARY OF THE KINGDOM OF MOROCCO
GOWTHAMI GRANDHALAYAM	NAMEEN	SRI GOWTHAMI REGIONAL LIBRARY
LA QUINTANA	NAMEEN	LA QUINTANA LIBRARY PARK
SAN JAVIER LIBRARY	NAMEEN	SAN JAVIER LIBRARY
GUSTAV LANDAUER LIBRARY WITTEN	NAMEEN	GUSTAV LANDAUER LIBRARY WITTEN
LIBRARY OF LODZ UNIVERSITY OF TECHNOLOGY	NAMEEN	LIBRARY OF THE LODZ UNIVERSITY OF TECHNOLOGY
NATIONAL LIBRARY OF THE DEMOCRATIC REPUBLIC OF CONGO	NAMEEN	NATIONAL LIBRARY OF THE DEMOCRATIC REPUBLIC OF CONGO
FRIEDRICH-VON-RAUMER-BIBLIOTHEK	NAMEEN	FRIEDRICH VON RAUMER LIBRARY
BEIT ARIELA	NAMEEN	BEIT ARIELA SHAAR ZION LIBRARY
KYOTO PREFECTURAL LIBRARY	NAMEEN	KYOTO PREFECTURAL LIBRARY
KUMANOVO LIBRARY	NAMEEN	LIBRARY TANE GEORGIEVSKI KUMANOVO
KATARINA JEE	NAMEEN	KATARINA JEE MOBILE LIBRARY
THE HELLENIC LIBRARY OF THE ONASSIS FOUNDATION	NAMEEN	THE HELLENIC LIBRARY OF THE ONASSIS FOUNDATION
ARQUIVO PúBLICO DO ESTADO DE SãO PAULO	NAMEEN	PUBLIC ARCHIVES OF THE STATE OF SãO PAULO
INTERNATIONAL CIVIC LIBRARY	NAMEEN	INTERNATIONAL CIVIC LIBRARY
D.S. SENANAYAKE MEMORIAL PUBLIC LIBRARY	NAMEEN	D.S. SENANAYAKE MEMORIAL PUBLIC LIBRARY
DANISH NATIONAL ART LIBRARY	NAMEEN	DANISH NATIONAL ART LIBRARY
STATE AND UNIVERSITY LIBRARY, DENMARK	NAMEEN	STATE AND UNIVERSITY LIBRARY
SARASWATA NIKETANAM	NAMEEN	SARASWATA NIKETANAM LIBRARY
MéDIATHèQUES DE SAINT-ÉTIENNE	NAMEEN	SAINT-ETIENNE PUBLIC LIBRARIES
MANNHEIM UNIVERSITY LIBRARY	NAMEEN	MANNHEIM UNIVERSITY LIBRARY
