ATHENS	NAMELOCAL	Αθήνα
AMPHIPOLIS	NAMELOCAL	Αμφίπολη
AEGINA	NAMELOCAL	Αίγινα
ABDERA, THRACE	NAMELOCAL	Άβδηρα
DELPHI	NAMELOCAL	Δελφοί
CHIOS	NAMELOCAL	Χίος
LARISSA	NAMELOCAL	Λάρισα
MEGARA	NAMELOCAL	Μέγαρα
SANTORINI	NAMELOCAL	Σαντορίνη / Θήρα
MEISSEN	NAMELOCAL	MEIßEN
DODONI	NAMELOCAL	Δωδώνη
CORFU	NAMELOCAL	Κέρκυρα
PYLOS	NAMELOCAL	Πύλος
MARATHON, GREECE	NAMELOCAL	Μαραθώνας
CHANIA	NAMELOCAL	Χανιά
THEBES, GREECE	NAMELOCAL	Θήβα
ARGOS	NAMELOCAL	Άργος
HYDRA	NAMELOCAL	Ύδρα
ELEUSIS	NAMELOCAL	Ελευσίνα
PATMOS	NAMELOCAL	Πάτμος
MESSENE	NAMELOCAL	Αρχαία Μεσσήνη
SAMOTHRACE	NAMELOCAL	Σαμοθράκη
LEMNOS	NAMELOCAL	Λήμνος
SALAMIS ISLAND	NAMELOCAL	Σαλαμίνα
VARI	NAMELOCAL	Βάρη
PIRAEUS	NAMELOCAL	Πειραιάς
CHAERONEA	NAMELOCAL	Χαιρώνεια
CHALCIS	NAMELOCAL	Χαλκίς
MYTILENE	NAMELOCAL	Μυτιλήνη
PAROS	NAMELOCAL	Πάρος
MILOS	NAMELOCAL	Μήλος
IOS	NAMELOCAL	Ίος
ICARIA	NAMELOCAL	Ικαρία
LAURIUM	NAMELOCAL	Λαύριο
KAVALA	NAMELOCAL	Καβάλα
GROßRäSCHEN	NAMELOCAL	RAń
LEFKADA	NAMELOCAL	Λευκάδα
KOS	NAMELOCAL	Κως
FOLEGANDROS	NAMELOCAL	Φολέγανδρος
MANTINEIA	NAMELOCAL	Μαντίνεια
KASTELLORIZO	NAMELOCAL	Καστελλόριζο
POROS	NAMELOCAL	Πόρος
MYSTRAS	NAMELOCAL	Μυστράς
GREVENA	NAMELOCAL	Γρεβενά
DRAMA, GREECE	NAMELOCAL	Δράμα
KASTORIA	NAMELOCAL	Καστοριά
SERRES	NAMELOCAL	Σέρρες
KOZANI	NAMELOCAL	Κοζάνη
TRIKALA	NAMELOCAL	Τρίκαλα
PREVEZA	NAMELOCAL	Πρέβεζα
IOANNINA	NAMELOCAL	Ιωάννινα
EPIDAURUS	NAMELOCAL	Επίδαυρος
PAXI	NAMELOCAL	Παξοί
KYTHIRA	NAMELOCAL	Κύθηρα
LECHAINA	NAMELOCAL	Λεχαινά
VOUPRASIA	NAMELOCAL	Βουπρασία
ANDRAVIDA	NAMELOCAL	Ανδραβίδα
MYRSINI	NAMELOCAL	Μυρσίνη
MEGALOPOLIS, GREECE	NAMELOCAL	Μεγαλόπολη
VERGINA	NAMELOCAL	Βεργίνα
LINDOS	NAMELOCAL	Λίνδος
KASTRO-KYLLINI	NAMELOCAL	Κάστρο-Κυλλήνη
ERETRIA	NAMELOCAL	Ερέτρια
BAUTZEN	NAMELOCAL	BUDYšIN
HERSONISSOS	NAMELOCAL	Χερσόνησος
HERSONISSOS	NAMELOCAL	CHERSóNISOS
SYMI	NAMELOCAL	Σύμη
MALIA, CRETE	NAMELOCAL	Μάλια
SKYROS	NAMELOCAL	Σκύρος
AMALIADA	NAMELOCAL	Αμαλιάδα
VOIES	NAMELOCAL	Βοιές
MONEMVASIA	NAMELOCAL	Μονεμβασία
OVRYA	NAMELOCAL	Οβρυά
VOLOS	NAMELOCAL	Βόλος
KARPATHOS	NAMELOCAL	Κάρπαθος
TANAGRA	NAMELOCAL	Τανάγρα
SERVIA, GREECE	NAMELOCAL	Σέρβια
XANTHI	NAMELOCAL	Ξάνθη
PATRAS	NAMELOCAL	Πάτρα
XYLOKASTRO	NAMELOCAL	Ξυλόκαστρο
KIFISSIA	NAMELOCAL	Κηφισιά
AGIA PARASKEVI	NAMELOCAL	Αγία Παρασκευή
CHALANDRI	NAMELOCAL	Χαλάνδρι
ELLINIKO	NAMELOCAL	Ελληνικό
PSYCHIKO	NAMELOCAL	Ψυχικό
KORYDALLOS	NAMELOCAL	Κορυδαλλός
NEA IONIA	NAMELOCAL	Νέα Ιωνία
YMITTOS	NAMELOCAL	Υμηττός
VRILISSIA	NAMELOCAL	Βριλήσσια
TRIPOLI, GREECE	NAMELOCAL	Τρίπολη
TEGEA	NAMELOCAL	Τεγέα
MAROUSI	NAMELOCAL	Μαρούσι
PORTARIA	NAMELOCAL	Πορταριά
ARGALASTI	NAMELOCAL	Αργαλαστή
ZAGORA, GREECE	NAMELOCAL	Ζαγορά
MAKRINITSA	NAMELOCAL	Μακρινίτσα
ALMYROS	NAMELOCAL	Αλμυρός
PAIANIA	NAMELOCAL	Παιανία
LAMIA	NAMELOCAL	Λαμία
SITIA	NAMELOCAL	Σητεία
KYPARISSIA	NAMELOCAL	Κυπαρισσία
AIGALEO	NAMELOCAL	Αιγάλεω
RIO, GREECE	NAMELOCAL	Ρίο
AIGIO	NAMELOCAL	Αίγιο
DAPHNOULA	NAMELOCAL	Δαφνούλα
PRENZLAUER BERG	NAMELOCAL	O-L-I-V-E-R
GLYFADA	NAMELOCAL	Γλυφάδα
ARNA, GREECE	NAMELOCAL	Άρνα
AGIOI THEODOROI	NAMELOCAL	Άγιοι Θεόδωροι
ASPROPYRGOS	NAMELOCAL	Ασπρόπυργος
KALLITHEA	NAMELOCAL	Καλλιθέα
PERAMA	NAMELOCAL	Πέραμα
VOULIAGMENI	NAMELOCAL	Βουλιαγμένη
ACHARNES	NAMELOCAL	Αχαρνές
GARCHING BEI MüNCHEN	NAMELOCAL	GARCHING BEI MüNCHEN
DEMENIKA	NAMELOCAL	Δεμένικα
MINTILOGLI	NAMELOCAL	Μιντιλόγλι
PERISTERI	NAMELOCAL	Περιστέρι
VRACHNAIIKA	NAMELOCAL	Βραχναίικα
ANAVYSSOS	NAMELOCAL	Ανάβυσσος
SARAVALI	NAMELOCAL	Σαράβαλι
ROITIKA	NAMELOCAL	Ροΐτικα
GASTOUNI	NAMELOCAL	Γαστούνη
VARTHOLOMIO	NAMELOCAL	Βαρθολομιό
LAMPEIA	NAMELOCAL	Λάμπεια
KATAKOLO	NAMELOCAL	Κατάκολο
SFAKIA	NAMELOCAL	Σφακιά
PSARA	NAMELOCAL	Ψαρά
KATERINI	NAMELOCAL	Κατερίνη
NAFPAKTOS	NAMELOCAL	Ναύπακτος
OLYMPIADA, KOZANI	NAMELOCAL	Ολυμπιάδα
BAD CANNSTATT	NAMELOCAL	BAD CANNSTATT
METSOVO	NAMELOCAL	Μέτσοβο
MESSATIDA	NAMELOCAL	Μεσσάτιδα
KALAMATA	NAMELOCAL	Καλαμάτα
ERMIONI	NAMELOCAL	Ερμιόνη
GERONTHRES	NAMELOCAL	Γερόνθρες
ARGOSTOLI	NAMELOCAL	Αργοστόλι
GAVDOS	NAMELOCAL	Γαύδος
NISYROS	NAMELOCAL	Νίσυρος
FILOTHEI	NAMELOCAL	Φιλοθέη
PYRGOS, ELIS	NAMELOCAL	Πύργος
NAFPLIO	NAMELOCAL	Ναύπλιο
STROPONES	NAMELOCAL	Στρόπωνες
LEVIDI	NAMELOCAL	Λεβίδι
MARKOPOULO, CEPHALONIA	NAMELOCAL	Μαρκόπουλο
DIMITRA, ELIS	NAMELOCAL	Δήμητρα
STYRA	NAMELOCAL	Στύρα
KAVASILA, ELIS	NAMELOCAL	Καβάσιλα
SAVALIA	NAMELOCAL	Σαβάλια
LEROS	NAMELOCAL	Λέρος
AGIOS PANTELEIMONAS	NAMELOCAL	Άγιος Παντελεήμωνας
MACHOS	NAMELOCAL	Μάχος
MELISSA, ELIS	NAMELOCAL	Μέλισσα
KOURTESI	NAMELOCAL	Κουρτέσι
LARISSOS	NAMELOCAL	Λαρίσσος
SAGEIKA	NAMELOCAL	Σαγέικα
DYMI, ACHAEA	NAMELOCAL	Δύμη
ALISSOS	NAMELOCAL	Αλισσός
ANAVRYTO	NAMELOCAL	Αναβρυτό
ROUTSI	NAMELOCAL	Ρούτσι
GOMOSTO	NAMELOCAL	Γομοστό
POSEIDONIA	NAMELOCAL	Ποσειδωνία
PASTRA	NAMELOCAL	Πάστρα
SPETSES	NAMELOCAL	Σπέτσες
AMPELOKAMPOS	NAMELOCAL	Αμπελόκαμπος
AGRINIO	NAMELOCAL	Αγρίνιο
KOROIVOS	NAMELOCAL	Κόροιβος
AGIA MAVRA, ELIS	NAMELOCAL	Άγια Μάυρα
ROUPAKI	NAMELOCAL	Ρουπάκι
AFGEIO	NAMELOCAL	Αυγείο
GARGALIANOI	NAMELOCAL	Γαργαλιάνοι
FILIATRA	NAMELOCAL	Φιλιατρά
NIFOREIKA	NAMELOCAL	Νιφορέικα
KARDIAKAFTI	NAMELOCAL	Καρδιακαύτι
AGIOS GEORGIOS, PYRGOS	NAMELOCAL	Άγιος Γεώργιος
AGIA EIRINI, CEPHALONIA	NAMELOCAL	Άγια Ειρήνη
OINOUSSES	NAMELOCAL	Οινούσσες
TZANATA	NAMELOCAL	Τζανάτα
SKILLOUNTA	NAMELOCAL	Σκιλλούντα
VYTINA	NAMELOCAL	Βυτίνα
LANGADIA, ARCADIA	NAMELOCAL	Λαγκάδια
DIMITSANA	NAMELOCAL	Δημητσάνα
TRIKOLONOI	NAMELOCAL	Τρικόλωνοι
STROUSI	NAMELOCAL	Στρούσι
IERAPETRA	NAMELOCAL	Ιεράπετρα
LIMNOCHORI, ACHAEA	NAMELOCAL	Λιμνοχώρι
LAKKOPETRA	NAMELOCAL	Λακκόπετρα
KAPELI	NAMELOCAL	Κάπελη
SOSTI, ELIS	NAMELOCAL	Σώστι
ANTIPAROS	NAMELOCAL	Αντίπαρος
KARDAMAS	NAMELOCAL	Καρδαμάς
ARETI, ELIS	NAMELOCAL	Αρετή
AIGEIRA	NAMELOCAL	Αιγείρα
NEA MANOLADA	NAMELOCAL	Νέα Μανολάδα
PANAGITSA, ARCADIA	NAMELOCAL	Παναγίτσα
ANDRITSAINA	NAMELOCAL	Ανδρίτσαινα
ZACHARO	NAMELOCAL	Ζαχάρω
KALLIKOMO	NAMELOCAL	Καλλίκωμο
MEROPI	NAMELOCAL	Μερόπη
DOUNEIKA	NAMELOCAL	Δουναίικα
PINEIA	NAMELOCAL	Πηνεία
KAMPOS, ELIS	NAMELOCAL	Κάμπος
EXAMILIA	NAMELOCAL	Εξαμίλια
NEOCHORI, ZACHARO	NAMELOCAL	Νεοχώρι
VELO, GREECE	NAMELOCAL	Βέλο
LECHAIO	NAMELOCAL	Λέχαιο
DARA, GREECE	NAMELOCAL	Δάρα
KAPSAS	NAMELOCAL	Κάψας
ANTIRRIO	NAMELOCAL	Αντίρριο
ASTAKOS	NAMELOCAL	Αστακός
STAMNA, GREECE	NAMELOCAL	Σταμνά
MYKINES, GREECE	NAMELOCAL	Μυκήνες
SOULI, ARCADIA	NAMELOCAL	Σούλι
EVROSTINA	NAMELOCAL	Ευρωστίνα
TRIPOTAMO, ARCADIA	NAMELOCAL	Τριπόταμο
KALLITHEA, ACHAEA	NAMELOCAL	Καλλιθέα
LEONTARI, ARCADIA	NAMELOCAL	Λεοντάρι
PERIVOLIA, ARCADIA	NAMELOCAL	Περιβόλια
KALYVES	NAMELOCAL	Καλύβες
POLYGYROS	NAMELOCAL	Πολύγυρος
MAKRYSI	NAMELOCAL	Μακρύσι
ZYGOVISTI	NAMELOCAL	Ζυγοβίστι
MISSOLONGHI	NAMELOCAL	Μεσολόγγι
LANGENBERG	NAMELOCAL	GERMAN NAME
METOCHI, LARISSOS	NAMELOCAL	Μετόχι
KAMINIA, ACHAEA	NAMELOCAL	Καμίνια
KIATO	NAMELOCAL	Κιάτο
RAPSOMMATI	NAMELOCAL	Ραψομμάτη
OLENI	NAMELOCAL	Ωλένη
ELLINIKO, ARCADIA	NAMELOCAL	Ελληνικό
FOLOI	NAMELOCAL	Φολόη
FARRES	NAMELOCAL	Φαρρές
KALAVRYTA	NAMELOCAL	Καλάβρυτα
MYLOI, ARGOLIS	NAMELOCAL	Μύλοι
ALIFEIRA	NAMELOCAL	Αλίφειρα
GYTHEIO	NAMELOCAL	Γύθειο
NEA KIOS	NAMELOCAL	Νέα Κίος
PORTO CHELI	NAMELOCAL	Πορτοχέλι
PETALIDI	NAMELOCAL	Πεταλίδι
SKIATHOS	NAMELOCAL	Σκιάθος
DIMINI	NAMELOCAL	Διμήνι
SESKLO	NAMELOCAL	Σέσκλο
TSOUKALAIIKA, ACHAEA	NAMELOCAL	Τσουκαλαίικα
ROVIATA	NAMELOCAL	Ροβιάτα
DYSTOS	NAMELOCAL	Δύστος
KRANIDI	NAMELOCAL	Κρανίδι
KERAMIDIA	NAMELOCAL	Κεραμιδιά
AMPELAKIA	NAMELOCAL	Αμπελάκια
DAFNIOTISSA	NAMELOCAL	Δαφνιώτισσα
PANORAMA, THESSALONIKI	NAMELOCAL	Πανόραμα
KALYVIA ILIDOS	NAMELOCAL	Καλύβια Ήλιδος
IKLAINA	NAMELOCAL	Πύλος
AGIA TRIADA, ELIS	NAMELOCAL	Αγία Τριάδα
LASIONA, ELIS	NAMELOCAL	Λασιώνα
ASTROS, GREECE	NAMELOCAL	Άστρος
KONITSA	NAMELOCAL	Κόνιτσα
KEA	NAMELOCAL	Κέα
VARVASAINA	NAMELOCAL	Σκουροχώρι
AGIOS NIKOLAOS, CRETE	NAMELOCAL	Άγιος Νικόλαος
GALATSI	NAMELOCAL	Γαλάτσι
PALAIOCHORA	NAMELOCAL	Παλαιόχωρα
LASTEIKA	NAMELOCAL	Λαστέικα
KARYSTOS	NAMELOCAL	Κάρυστος
ZOGRAFOU	NAMELOCAL	Ζωγράφου
ARAXOS	NAMELOCAL	Άραξος
SYMVOLI	NAMELOCAL	Συμβολή
KAISARIANI	NAMELOCAL	Καισαριανή
AITOLIKO	NAMELOCAL	Αιτωλικό
KEFALOVRYSO, IOANNINA	NAMELOCAL	Κεφαλόβρυσο
ARACHOVA	NAMELOCAL	Αράχωβα
PTOLEMAIDA	NAMELOCAL	Πτολεμαΐδα
OINOUNTAS	NAMELOCAL	Οινούντας
KONDARIOTISSA	NAMELOCAL	Κονταριώτισσα
CHILIOMODI	NAMELOCAL	Χιλιομόδι
GALAXIDI	NAMELOCAL	Γαλαξίδι
NEA SMYRNI	NAMELOCAL	Νέα Σμύρνη
PARGA	NAMELOCAL	Πάργα
ITEA, PHOCIS	NAMELOCAL	Ιτέα
METHANA	NAMELOCAL	Μέθανα
TAVROS	NAMELOCAL	Ταύρος
TRAGANO	NAMELOCAL	Τραγανό
AGIOS IOANNIS RENTIS	NAMELOCAL	Άγιος Ιωάννης Ρέντης
MEGALOCHORI, METHANA	NAMELOCAL	Μεγαλοχώρι
AGIOI THEODOROI, ELIS	NAMELOCAL	Άγιοι Θεόδωροι
VOLISSOS	NAMELOCAL	Βολισσός
KAMATERO	NAMELOCAL	Καματερό
GORTYNA, ARCADIA	NAMELOCAL	Γόρτυνα
AGIOI ANARGYROI	NAMELOCAL	Άγιοι Ανάργυροι
TRIPOTAMIA	NAMELOCAL	Τριποταμιά
NEA CHALKIDONA	NAMELOCAL	Νέα Χαλκηδόνα
KENTRO, ELIS	NAMELOCAL	Κέντρο
NEA FILADELFEIA	NAMELOCAL	Νέα Φιλαδέλφεια
AGIOS ILIAS, AMALIADA	NAMELOCAL	Άγιος Ηλίας
KARDITSA	NAMELOCAL	Καρδίτσα
AGIOS DIMITRIOS, ELIS	NAMELOCAL	Άγιος Δημήτριος
NEO PSYCHIKO	NAMELOCAL	Νέο Ψυχικό
ERINEOS	NAMELOCAL	Ερινεός
PAPAGOU	NAMELOCAL	Παπάγου
LONGOS, ACHAEA	NAMELOCAL	Λόγγος
VYRONAS	NAMELOCAL	Βύρωνας
AGIOS VASILEIOS, ACHAEA	NAMELOCAL	Άγιος Βασίλειος
ILIOUPOLI	NAMELOCAL	Ηλιούπολη
SIFNOS	NAMELOCAL	Σίφνος
ARACHOVITIKA	NAMELOCAL	Αραχοβίτικα
AGIOS DIMITRIOS	NAMELOCAL	Άγιος Δημήτριος
PSATHOPYRGOS	NAMELOCAL	Ψαθόπυργος
PALAIO FALIRO	NAMELOCAL	Παλαιό Φάληρο
ANO KASTRITSI	NAMELOCAL	Άνω Καστρίτσι
KATO KASTRITSI	NAMELOCAL	Κάτω Καστρίτσι
MOSCHATO	NAMELOCAL	Μοσχάτο
CHRISSO, PHOCIS	NAMELOCAL	Χρισσό
DRAPETSONA	NAMELOCAL	Δραπετσώνα
LAVARA	NAMELOCAL	Λάβαρα
AKRATA	NAMELOCAL	Ακράτα
KERATSINI	NAMELOCAL	Κερατσίνι
KARDITSOMAGOULA	NAMELOCAL	Καρδιτσομαγούλα
AROANIA	NAMELOCAL	Αροάνια
NIKAIA, ATTICA	NAMELOCAL	Νίκαια
ATHANI, GREECE	NAMELOCAL	Αθάνι
AGIOS FLOROS	NAMELOCAL	Άγιος Φλώρος
MATI, GREECE	NAMELOCAL	Mάτι
AGIA VARVARA	NAMELOCAL	Αγία Βαρβάρα
SKARAMAGAS	NAMELOCAL	Σκαραμαγκάς
ELOS	NAMELOCAL	Έλος
CHAIDARI	NAMELOCAL	Χαϊδάρι
AMORGOS	NAMELOCAL	Αμοργός
VOLAKAS, ELIS	NAMELOCAL	Βώλακας
PALEKASTRO	NAMELOCAL	Παλαίκαστρο
ZAGORI	NAMELOCAL	Ζαγόρι
VITSA	NAMELOCAL	Βίτσα
PETROUPOLI	NAMELOCAL	Πετρούπολη
IARDANOS	NAMELOCAL	Ιάρδανος
ILION, GREECE	NAMELOCAL	Ίλιον
DAFNI, AMALIADA	NAMELOCAL	Δάφνη
PYTHIO	NAMELOCAL	Πύθιο
LEIPSOI	NAMELOCAL	Λειψοί
ANO LIOSIA	NAMELOCAL	Άνω Λιόσια
ZEFYRI	NAMELOCAL	Ζεφύρι
DAVLEIA	NAMELOCAL	Δαύλεια
SKOPELOS	NAMELOCAL	Σκόπελος
TILOS	NAMELOCAL	Τήλος
BORSI, GREECE	NAMELOCAL	Μπόρσι
LYKOVRYSI	NAMELOCAL	Λυκόβρυση
ALONNISOS	NAMELOCAL	Αλόννησος
METAMORFOSI	NAMELOCAL	Μεταμόρφωση
ZONI, ARCADIA	NAMELOCAL	Ζώνη
FLORINA	NAMELOCAL	Φλώρινα
DIDYMOTEICHO	NAMELOCAL	Διδυμότειχο
IRAKLEIO, ATTICA	NAMELOCAL	Ηράκλειο
OROPOS	NAMELOCAL	Ωρωπός
EKALI	NAMELOCAL	Εκάλη
KORINOS	NAMELOCAL	Κορινός
PEFKI	NAMELOCAL	Πεύκη
GERAKAS	NAMELOCAL	Γέρακας
ORCHOMENUS	NAMELOCAL	Ορχομενός
VLACHATA	NAMELOCAL	Βλαχάτα
GLYKA NERA	NAMELOCAL	Γλυκά Νερά
KASTANIES	NAMELOCAL	Καστανιές
BAMPINI	NAMELOCAL	Μπαμπίνη
KOROPI	NAMELOCAL	Κορωπί
KROPIA	NAMELOCAL	Κρωπία
VASILIKOS, ZAKYNTHOS	NAMELOCAL	Βασιλικός
ARGYROUPOLI	NAMELOCAL	Αργυρούπολη
ALIMOS	NAMELOCAL	Άλιμος
FYLI	NAMELOCAL	Φυλή
ALONISTAINA	NAMELOCAL	Αλωνίσταινα
SIATISTA	NAMELOCAL	Σιάτιστα
ALEXANDROUPOLI	NAMELOCAL	Αλεξανδρούπολη
IALYSOS	NAMELOCAL	Ιαλυσός
NEA ERYTHRAIA	NAMELOCAL	Νέα Ερυθραία
GIANNITSOCHORI	NAMELOCAL	Γιαννιτσοχώρι
NEA PENTELI	NAMELOCAL	Νέα Πεντέλη
FALAISIA	NAMELOCAL	Φαλαισία
MELISSIA	NAMELOCAL	Μελίσσια
SOULI	NAMELOCAL	Σούλι
ANEMODOURI	NAMELOCAL	Ανεμοδούρι
KRYA VRYSI, PELLA	NAMELOCAL	Κρύα Βρύση
OINOFYTA	NAMELOCAL	Οινόφυτα
EFYRA	NAMELOCAL	Εφύρα
PALLINI	NAMELOCAL	Παλλήνη
POROS, CEPHALONIA	NAMELOCAL	Πόρος
SERIFOS	NAMELOCAL	Σέριφος
SPATA	NAMELOCAL	Σπάτα
ILIOCHORI	NAMELOCAL	Ηλιοχώρι
TROEZEN	NAMELOCAL	Τροιζήνα
VEVI	NAMELOCAL	Βεύη
NEA ANCHIALOS	NAMELOCAL	Νέα Αγχίαλος
KOMOTINI	NAMELOCAL	Κομοτηνή
KINETA	NAMELOCAL	Κινέτα
CHAVRIATA	NAMELOCAL	Χαβριάτα
AGIOS PAVLOS, CHALKIDIKI	NAMELOCAL	Άγιος Παύλος
NEA PERAMOS	NAMELOCAL	Νέα Πέραμος
BAD MUSKAU	NAMELOCAL	MUžAKOW
THRAKOMAKEDONES	NAMELOCAL	Θρακομακεδόνες
FISKARDO	NAMELOCAL	Φισκάρδο
VARYMPOMPI	NAMELOCAL	Βαρυμπόμπη
LITOCHORO	NAMELOCAL	Λιτόχωρο
KAVOS	NAMELOCAL	Κάβος
NEA MOUDANIA	NAMELOCAL	Νέα Μουδανιά
PARALIA, PIERIA	NAMELOCAL	Παραλία
AKROTIRI, CRETE	NAMELOCAL	Ακρωτήρι
DOLIANA	NAMELOCAL	Δολιανά
RIOLOS	NAMELOCAL	Ρίολος
AMORIO, EVROS	NAMELOCAL	Αμόριο
KAREIKA	NAMELOCAL	Καρέικα
AGIOS VASILEIOS, CORINTHIA	NAMELOCAL	Άγιος Βασίλειος
EORDAIA	NAMELOCAL	Εορδαία
PYDNA	NAMELOCAL	Πύδνα
MITHYMNA	NAMELOCAL	Μήθυμνα
PETRA, LESBOS	NAMELOCAL	Πέτρα
POGONIANI	NAMELOCAL	Πωγωνιανή
DROSIA	NAMELOCAL	Δροσιά
ANIXI	NAMELOCAL	Άνοιξη
DIONYSOS, GREECE	NAMELOCAL	Διόνυσος
KRINIDES	NAMELOCAL	Κρηνίδες
KARYOCHORI	NAMELOCAL	Καρυοχώρι
RODOPOLI	NAMELOCAL	Ροδόπολη
NEA IONIA, MAGNESIA	NAMELOCAL	Νεα Ίωνια
VYRONEIA	NAMELOCAL	Βυρώνεια
AREOPOLI	NAMELOCAL	Αρεόπολη
SKOUTARI, LACONIA	NAMELOCAL	Σκουτάρι
PARASYROS	NAMELOCAL	Παρασυρός
HARSEFELD	NAMELOCAL	HARSFELD ()
HIMMELPFORTEN	NAMELOCAL	HIMMELPOORTEN ()
PALAMAS	NAMELOCAL	Παλαμάς
DROSOPIGI, LACONIA	NAMELOCAL	Δροσοπηγή
TENEA	NAMELOCAL	Τενέα
NIGRITA	NAMELOCAL	Νιγρίτα
NESTANI	NAMELOCAL	Νεστάνη
SOFADES	NAMELOCAL	Σοφάδες
PAPINGO	NAMELOCAL	Πάπιγκο
TRIANDRIA	NAMELOCAL	Τριανδρία
AGIA PARASKEVI, LESBOS	NAMELOCAL	Αγία Παρασκευή
MARMARI	NAMELOCAL	Μαρμάρι
AGIOS STEFANOS, ATTICA	NAMELOCAL	Άγιος Στέφανος
AMANI, GREECE	NAMELOCAL	Αμανή
STOUPA	NAMELOCAL	Στούπα
ORESTIADA	NAMELOCAL	Ορεστιάδα
AGRIA	NAMELOCAL	Αγριά
APOKORONAS	NAMELOCAL	Αποκόρωνας
VAMOS	NAMELOCAL	Βάμος
GEORGIOUPOLI	NAMELOCAL	Γεωργιούπολη
SOUDA	NAMELOCAL	Σούδα
EAST MANI	NAMELOCAL	Ανατολική Μάνη
DAFNI, ATTICA	NAMELOCAL	Δάφνη
KELEFA	NAMELOCAL	Κελεφά
SITHONIA	NAMELOCAL	Σιθωνία
PYRRICHOS	NAMELOCAL	Πύρριχος
OITYLO	NAMELOCAL	Οίτυλο
OMIROUPOLI	NAMELOCAL	Ομηρούπολη
NEAPOLI, CRETE	NAMELOCAL	Νεάπολη
AFIDNES	NAMELOCAL	Αφίδνες
ANTIKYTHERA	NAMELOCAL	Αντικύθηρα
FARSALA	NAMELOCAL	Φάρσαλα
PAROREIO	NAMELOCAL	Παρόρειο
AMYKLES	NAMELOCAL	Αμύκλες
KALAMARIA	NAMELOCAL	Καλαμαριά
RAFINA	NAMELOCAL	Ραφήνα
ARCHANGELOS, RHODES	NAMELOCAL	Αρχάγγελος
AMFISSA	NAMELOCAL	Άμφισσα
ELAFONISOS	NAMELOCAL	Ελαφόνησος
HALKI	NAMELOCAL	Χάλκη
RAVENI	NAMELOCAL	Ραβενή
KOUKOUNARIES	NAMELOCAL	Κουκουναριές
NEA MAKRI	NAMELOCAL	Νέα Μάκρη
SAPES	NAMELOCAL	Σάπες
EVOSMOS	NAMELOCAL	Εύοσμος
DONOUSA	NAMELOCAL	Δονούσα
KALAMOS	NAMELOCAL	Κάλαμος
GRAMMATIKO	NAMELOCAL	Γραμματικό
GORTYN	NAMELOCAL	Γόρτυνα
SARONIDA	NAMELOCAL	Σαρωνίδα
KATO VERMIO	NAMELOCAL	Κάτω Βέρμιο
MOUSSATA	NAMELOCAL	Μουσάτα
ARTEMIDA, ATTICA	NAMELOCAL	Αρτέμιδα
PLATARIA	NAMELOCAL	Πλαταριά
MANDRA	NAMELOCAL	Μάνδρα
VELVENTOS	NAMELOCAL	Βελβεντός
ARTA, GREECE	NAMELOCAL	Άρτα
LIVADEIA	NAMELOCAL	Λιβαδειά
IGOUMENITSA	NAMELOCAL	Ηγουμενίτσα
KARPENISI	NAMELOCAL	Καρπενήσι
AGIA EFTHYMIA	NAMELOCAL	Αγία Ευθυμία
HOLARGOS	NAMELOCAL	Χολαργός
WEIßWASSER	NAMELOCAL	BěłA WODA
KERAMOTI, NAXOS	NAMELOCAL	Κεραμωτή
MARKOPOULO MESOGAIAS	NAMELOCAL	Μαρκόπουλο Μεσογαίας
HOHENHEIM	NAMELOCAL	HOHENHEIM
LOUTRAKI-PERACHORA	NAMELOCAL	Λουτράκι-Περαχώρα
PERACHORA	NAMELOCAL	Περαχώρα
PERISTERA, ACHAEA	NAMELOCAL	Περιστέρα
RHODES	NAMELOCAL	Ρόδος
PERATATA	NAMELOCAL	Περατάτα
NEA ARTAKI	NAMELOCAL	Νέα Αρτάκη
VATHEIA	NAMELOCAL	Βαθειά
KALYVIA, LACONIA	NAMELOCAL	Καλύβια
PERAIA, THESSALONIKI	NAMELOCAL	Περαία
SYLIVAINIOTIKA	NAMELOCAL	Συλιβαινιώτικα
KALYVIA THORIKOU	NAMELOCAL	Καλύβια Θορικού
PIGI, TRIKALA	NAMELOCAL	Πηγή
LEFKASIO	NAMELOCAL	Λευκάσιο
AGIOS EFSTRATIOS	NAMELOCAL	Άγιος Ευστράτιος
NEA SINASOS	NAMELOCAL	Νέα Σινασός
VORDONIA	NAMELOCAL	Βορδόνια
PENTELI, GREECE	NAMELOCAL	Πεντέλη
VOULA	NAMELOCAL	Βούλα
MENIDI, AETOLIA-ACARNANIA	NAMELOCAL	Μενίδι
KOMPOTI	NAMELOCAL	Κομπότι
VARKIZA	NAMELOCAL	Βάρκιζα
PLATY, IMATHIA	NAMELOCAL	Πλατύ
APOLLONIA, THESSALONIKI	NAMELOCAL	Απολλωνία
VERMIO, KOZANI	NAMELOCAL	Βέρμιο
FOURNOI KORSEON	NAMELOCAL	Φούρνοι Κορσέων
KAPANDRITI	NAMELOCAL	Καπανδρίτι
PORTO RAFTI	NAMELOCAL	Πόρτο Ράφτη
ELATOCHORI	NAMELOCAL	Ελατοχώρι
CHARAKI	NAMELOCAL	Χαράκι
KATO NEVROKOPI	NAMELOCAL	Κάτω Νευροκόπι
PROSOTSANI	NAMELOCAL	Προσοτσάνη
DOXATO	NAMELOCAL	Δοξάτο
SERGOULA BEACH	NAMELOCAL	Παραλία Σεργούλας
KIMOLOS	NAMELOCAL	Κίμωλος
TRIKORFO, GREVENA	NAMELOCAL	Τρίκορφο
PALAIA FOKAIA	NAMELOCAL	Παλαιά Φώκαια
MANTZAVINATA	NAMELOCAL	Μαντζαβινάτα
ANTHOUSA	NAMELOCAL	Ανθούσα
LOUROS	NAMELOCAL	Λούρος
PETROTO, ACHAEA	NAMELOCAL	Πετρωτό
ZEVGOLATEIO	NAMELOCAL	Ζευγολατειό
AGIOS THOMAS, BOEOTIA	NAMELOCAL	Άγιος Θωμάς
ELASSONA	NAMELOCAL	Ελασσόνα
MAKRAKOMI	NAMELOCAL	Μακρακώμη
GOUVES, GREECE	NAMELOCAL	Γούβες
MARKOPOULO OROPOU	NAMELOCAL	Μαρκόπουλο Ωρωπού
KOUVARAS	NAMELOCAL	Κουβαράς
MALAKASA	NAMELOCAL	Μαλακάσα
NEA PALATIA	NAMELOCAL	Νέα Παλάτια
AGIOS KONSTANTINOS, EAST ATTICA	NAMELOCAL	Άγιος Κωνσταντίνος
LAVREOTIKI	NAMELOCAL	Λαυρεωτική
KERATEA	NAMELOCAL	Κερατέα
KRYONERI, ATTICA	NAMELOCAL	Κρυονέρι
POLYDENDRI	NAMELOCAL	Πολυδένδρι
PIKERMI	NAMELOCAL	Πικέρμι
SKALA OROPOU	NAMELOCAL	Σκάλα Ωρωπού
SYKAMINO	NAMELOCAL	Συκάμινο
STAMATA	NAMELOCAL	Σταμάτα
VARNAVAS	NAMELOCAL	Βαρνάβας
ERYTHRES	NAMELOCAL	Ερυθρές
VILIA	NAMELOCAL	Βίλια
OINOI	NAMELOCAL	Οινόη
MAGOULA, ATTICA	NAMELOCAL	Μαγούλα
AXIOUPOLI	NAMELOCAL	Αξιούπολη
MAVRODENDRI	NAMELOCAL	Μαυροδένδρι
SMILA, GREECE	NAMELOCAL	Σμίλα
LAGONISI	NAMELOCAL	Λαγονήσι
GERA, LESBOS	NAMELOCAL	Γέρα
TROIANATA	NAMELOCAL	Τρωιανάτα
PLATANIAS	NAMELOCAL	Πλατανιάς
EVDILOS	NAMELOCAL	Εύδηλος
FARMAKONISI	NAMELOCAL	Φαρμακονήσι
DORIO	NAMELOCAL	Δώριο
ANO DORIO	NAMELOCAL	Άνω Δώριο
ALEVRADA	NAMELOCAL	Αλευράδα
TRIKLINO	NAMELOCAL	Τρίκλινο
AGIOS NIKOLAOS, MESSENIA	NAMELOCAL	Άγιος Νικόλαος
MICHATA	NAMELOCAL	Μιχάτα
KALAMPAKI	NAMELOCAL	Καλαμπάκι
GAZI, CRETE	NAMELOCAL	Γάζι
AVDELLA	NAMELOCAL	Αβδέλλα
ZAKYNTHOS	NAMELOCAL	Ζάκυνθος
LEFKADA	NAMELOCAL	Πόλη της Λευκάδας
CORFU	NAMELOCAL	Κέρκυρα
KYTHNOS	NAMELOCAL	Κύθνος
ASPROKAMPOS	NAMELOCAL	Ασπρόκαμπος
SKLITHRO, FLORINA	NAMELOCAL	Σκλήθρο
EPANOCHORI, CEPHALONIA	NAMELOCAL	Επανωχώρι
KITTA	NAMELOCAL	Κοίτα
ELEFTHERIOS VENIZELOS, CRETE	NAMELOCAL	Ελευθέριος Βενιζέλος
STRATOS, GREECE	NAMELOCAL	Στράτος
ARKALOCHORI	NAMELOCAL	Αρκαλοχώρι
ACHARAVI	NAMELOCAL	Αχαράβη
TYLISSOS	NAMELOCAL	Τύλισος
VALSAMATA	NAMELOCAL	Βαλσαμάτα
VATHY, SAMOS	NAMELOCAL	Βαθύ
ERMOUPOLI	NAMELOCAL	Ερμούπολη
CHIOS	NAMELOCAL	Χίος
KYPSELI, METHANA	NAMELOCAL	Κυψέλη
ATSICHOLOS	NAMELOCAL	Ατσίχολος
AMPELOKIPOI, THESSALONIKI	NAMELOCAL	Αμπελόκηποι
NEAPOLI, THESSALONIKI	NAMELOCAL	Νεάπολη
STAVROUPOLI	NAMELOCAL	Σταυρούπολη
SYKIES	NAMELOCAL	Συκιές
POLICHNI	NAMELOCAL	Πολίχνη
VOUNARGO	NAMELOCAL	Βούναργο
SIMOPOULO	NAMELOCAL	Σιμόπουλο
KRESTENA	NAMELOCAL	Κρέστενα
EPITALIO	NAMELOCAL	Επιτάλιο
VARDA, GREECE	NAMELOCAL	Βάρδα
KATO ACHAIA	NAMELOCAL	Κάτω Αχαΐα
CHALANDRITSA	NAMELOCAL	Χαλανδρίτσα
KLEITORIA	NAMELOCAL	Κλειτορία
SELLASIA	NAMELOCAL	Σελλασία
LAGANAS	NAMELOCAL	Λαγανάς
CHALASTRA	NAMELOCAL	Χαλάστρα
KARYTAINA	NAMELOCAL	Καρύταινα
STEMNITSA	NAMELOCAL	Στεμνίτσα
APESOKARI	NAMELOCAL	Απεσωκάρι
STOMIO, LARISSA	NAMELOCAL	Στόμιο
KOPANAKI	NAMELOCAL	Κοπανάκι
LEIVATHO	NAMELOCAL	Λειβαθώ
DOLOI	NAMELOCAL	Δολοί
ARCHANES	NAMELOCAL	Αρχάνες
PALIKI	NAMELOCAL	Παλική
SKALA, CEPHALONIA	NAMELOCAL	Σκάλα
ASI GONIA	NAMELOCAL	Ασή Γωνιά
AMMOUDIA, PREVEZA	NAMELOCAL	Αμμουδιά
RIZOMA	NAMELOCAL	Ρίζωμα
STALIDA	NAMELOCAL	Σταλίδα
ARMENOI	NAMELOCAL	Αρμένοι
KALAMOS, ATTICA	NAMELOCAL	Κάλαμος
ASTYPALAIA	NAMELOCAL	Αστυπάλαια
AMMOULIANI	NAMELOCAL	Αμμουλιανή
LIXOURI	NAMELOCAL	Ληξούρι
KASTANIA, PIERIA	NAMELOCAL	Καστανιά
KOUFALIA	NAMELOCAL	Κουφάλια
PYLAROS	NAMELOCAL	Πύλαρος
KILELER	NAMELOCAL	Κιλελέρ
AGIOS NIKOLAOS, CHALKIDIKI	NAMELOCAL	Άγιος Νικόλαος
ANO FANARI	NAMELOCAL	Άνω Φανάρι
NISAKI	NAMELOCAL	Νησάκι
LEFKOCHORI	NAMELOCAL	Λευκοχώρι
LOUTROPOLI THERMIS	NAMELOCAL	Λουτρόπολη Θερμής
KALLONI	NAMELOCAL	Καλλονή
AGIASOS	NAMELOCAL	Αγιάσος
PLOMARI	NAMELOCAL	Πλωμάρι
KERKINI	NAMELOCAL	Κερκίνη
TSARITSANI	NAMELOCAL	Τσαριτσάνη
PELLANA	NAMELOCAL	Πελλάνα
STRONGYLI MEGISTIS	NAMELOCAL	Στρογγυλή Μεγίστης
AGATHONISI	NAMELOCAL	Αγαθονήσι
OTHONOI	NAMELOCAL	Οθωνοί
MEGANISI	NAMELOCAL	Μεγανήσι
EREIKOUSSA	NAMELOCAL	Ερείκουσα
KASTOS	NAMELOCAL	Καστός
SCHOINOUSA	NAMELOCAL	Σχοινούσα
ANAFI	NAMELOCAL	Ανάφη
SIKINOS	NAMELOCAL	Σίκινος
KOUNOUPITSA	NAMELOCAL	Κουνουπίτσα
FARAKLATA	NAMELOCAL	Φαρακλάτα
DORIDA	NAMELOCAL	Δωρίδα
GIANNITSA	NAMELOCAL	Γιαννιτσά
KASOS	NAMELOCAL	Κάσος
DILINATA	NAMELOCAL	Διλινάτα
METHONI, MESSENIA	NAMELOCAL	Μεθώνη
DAVGATA	NAMELOCAL	Δαυγάτα
ALEXANDREIA, GREECE	NAMELOCAL	Αλεξάνδρεια
KARAVOSTAMO	NAMELOCAL	Καραβόσταμο
FARSA, GREECE	NAMELOCAL	Φάρσα
AVLONAS, ATTICA	NAMELOCAL	Αυλώνας
MAGOULA	NAMELOCAL	Μαγούλα
EVANGELISMOS, MESSENIA	NAMELOCAL	Ευαγγελισμός
KATO ASITES	NAMELOCAL	Kάτω Ασίτες
STAFIDOKAMPOS	NAMELOCAL	Σταφιδόκαμπος
NAOUSA, IMATHIA	NAMELOCAL	Νάουσα
SENFTENBERG	NAMELOCAL	ZłY KOMOROW
KAPELETO	NAMELOCAL	Καπελέτο
ALIVERI	NAMELOCAL	Αλιβέρι
TAMINAIOI	NAMELOCAL	Ταμιναίοι
MIAMOU	NAMELOCAL	Μιαμού
LADAS, MESSENIA	NAMELOCAL	Λαδάς
KERAMEIES	NAMELOCAL	Κεραμειές
ANTIKALAMOS	NAMELOCAL	Αντικάλαμος
LYSSAREA	NAMELOCAL	Λυσσαρέα
ELATEIA	NAMELOCAL	Ελάτεια
ZUFFENHAUSEN	NAMELOCAL	ZUFFENHAUSEN
SYRRAKO	NAMELOCAL	Συρράκο
ELEFTHERIO-KORDELIO	NAMELOCAL	Ελευθέριο-Κορδελιό
SOUROTI	NAMELOCAL	Σουρωτή
AGIOS SERAFIM	NAMELOCAL	Άγιος Σεραφείμ
EKKARA	NAMELOCAL	Εκκάρα
ALEXANDROS, GREECE	NAMELOCAL	Αλέξανδρος
AGIOS PETROS, LEFKADA	NAMELOCAL	Άγιος Πέτρος
AGIOS NIKITAS	NAMELOCAL	Άγιος Νικήτας
AGIOS ILIAS, LEFKADA	NAMELOCAL	Άγιος Ηλίας
ALIKANAS	NAMELOCAL	Αλικανάς
ELSTRA	NAMELOCAL	HALšTROW
ATALANTI	NAMELOCAL	Αταλάντη
KöNIGSBRüCK	NAMELOCAL	KINSPORK
LAUTA	NAMELOCAL	ŁUTY
KLEINO	NAMELOCAL	Κλεινό
PALOUMPA	NAMELOCAL	Παλούμπα
IRAIA	NAMELOCAL	Ηραία
CHRYSO, EVRYTANIA	NAMELOCAL	Χρύσω
PYLAIA	NAMELOCAL	Πυλαία
SCHROZBERG	NAMELOCAL	SHROZBERG
PALAIOCHORI, ELIS	NAMELOCAL	Παλαιοχώρι
PERAMA, IOANNINA	NAMELOCAL	Πέραμα
ANGELOKASTRO, AETOLIA-ACARNANIA	NAMELOCAL	Αγγελόκαστρο
ALYZIA	NAMELOCAL	Αλυζία
AMFILOCHIA	NAMELOCAL	Αμφιλοχία
ANAKTORIO	NAMELOCAL	Ανακτόριο
APODOTIA	NAMELOCAL	Αποδοτία
ARAKYNTHOS	NAMELOCAL	Αράκυνθος
THERMO, GREECE	NAMELOCAL	Θέρμο
THESTIEIS	NAMELOCAL	Θεστιείς
INACHOS, GREECE	NAMELOCAL	Ίναχος
CHALKEIA	NAMELOCAL	Χάλκεια
MAKRYNEIA	NAMELOCAL	Μακρυνεία
MEDEON	NAMELOCAL	Μεδεών
PANAITOLIKO	NAMELOCAL	Παναιτωλικό
NEAPOLI, AETOLIA-ACARNANIA	NAMELOCAL	Νεάπολη
PARAVOLA	NAMELOCAL	Παραβόλα
OINIADES	NAMELOCAL	Οινιάδες
PLATANOS, AETOLIA-ACARNANIA	NAMELOCAL	Πλάτανος
PYLLINI	NAMELOCAL	Πυλλήνη
FYTEIES	NAMELOCAL	Φυτείες
PARAKAMPYLIA	NAMELOCAL	Παρακαμπύλια
KOUTSOPODI	NAMELOCAL	Κουτσοπόδι
ASKLIPIEIO	NAMELOCAL	Ασκληπιείο
ASINI	NAMELOCAL	Ασίνη
LYRKEIA	NAMELOCAL	Λυρκεία
MIDEA, GREECE	NAMELOCAL	Μιδέα
NEA TIRYNTHA	NAMELOCAL	Νέα Τίρυνθα
ALEA, ARGOLIS	NAMELOCAL	Αλέα
ACHLADOKAMPOS	NAMELOCAL	Αχλαδόκαμπος
VALTETSI	NAMELOCAL	Βαλτέτσι
SKYRITIDA	NAMELOCAL	Σκιρίτιδα
LEONIDIO	NAMELOCAL	Λεωνίδιο
KORYTHIO	NAMELOCAL	Κορύθιο
TROPAIA	NAMELOCAL	Τρόπαια
KONTOVAZAINA	NAMELOCAL	Κοντοβάζαινα
KLEITOR	NAMELOCAL	Κλείτωρ
FALANTHOS	NAMELOCAL	Φάλανθος
NORTH KYNOURIA	NAMELOCAL	Βόρεια Κυνουρία
KOSMAS, GREECE	NAMELOCAL	Κοσμάς
AGNANTA	NAMELOCAL	Άγναντα
ATHAMANIA, ARTA	NAMELOCAL	Δήμος Αθαμανίας
AMVRAKIKOS	NAMELOCAL	Αμβρακικός
ARACHTHOS	NAMELOCAL	Άραχθος
VLACHERNA	NAMELOCAL	Βλαχέρνα
GEORGIOS KARAISKAKIS	NAMELOCAL	Γεώργιος Καραϊσκάκης
IRAKLEIA, ARTA	NAMELOCAL	Ηράκλεια
XIROVOUNI	NAMELOCAL	Ξηροβούνι
PETA, GREECE	NAMELOCAL	Πέτα
TETRAFYLIA	NAMELOCAL	Τετραφυλία
FILOTHEI, ARTA	NAMELOCAL	Φιλοθέη
KOMMENO	NAMELOCAL	Κομμένο
THEODORIANA	NAMELOCAL	Θεοδώριανα
MELISSOURGOI	NAMELOCAL	Μελισσουργοί
EXAMILI	NAMELOCAL	Εξαμίλι
DIAKOPTO	NAMELOCAL	Διακοπτό
MOVRI	NAMELOCAL	Μόβρη
PAION	NAMELOCAL	Παΐων
SYMPOLITEIA	NAMELOCAL	Συμπολιτεία
TRITAIA	NAMELOCAL	Τριταία
KALENTZI	NAMELOCAL	Καλέντζι
OLENIA	NAMELOCAL	Ωλενία
LEONTIO	NAMELOCAL	Λεόντιο
AKRAIFNIA	NAMELOCAL	Ακραιφνία
ALIARTOS	NAMELOCAL	Αλίαρτος
VAGIA	NAMELOCAL	Βάγια
DERVENOCHORIA	NAMELOCAL	Δερβενοχώρια
DISTOMO	NAMELOCAL	Δίστομο
THESPIES	NAMELOCAL	Θεσπιές
THISVI	NAMELOCAL	Θίσβη
KORONEIA, BOEOTIA	NAMELOCAL	Κορώνεια
PLATAIES	NAMELOCAL	Πλαταιές
SCHIMATARI	NAMELOCAL	Σχηματάρι
ANTIKYRA	NAMELOCAL	Αντίκυρα
KYRIAKI	NAMELOCAL	Κυριάκι
VENTZIO	NAMELOCAL	Βέντζιο
GORGIANI	NAMELOCAL	Γόργιανη
IRAKLEOTES	NAMELOCAL	Ηρακλεώτες
DESKATI	NAMELOCAL	Δεσκάτη
THEODOROS ZIAKAS	NAMELOCAL	Θεόδωρος Ζιάκας
CHASIA, GREVENA	NAMELOCAL	Χάσια
AGIOS KOSMAS	NAMELOCAL	Άγιος Κοσμάς
DOTSIKO	NAMELOCAL	Δοτσικό
MESOLOURI	NAMELOCAL	Μεσολούρι
PERIVOLI, GREVENA	NAMELOCAL	Περιβόλι
SAMARINA	NAMELOCAL	Σαμαρίνα
SMIXI	NAMELOCAL	Σμίξη
FILIPPAIOI	NAMELOCAL	Φιλιππαίοι
NIKIFOROS	NAMELOCAL	Νικηφόρος
SITAGROI	NAMELOCAL	Σιταγροί
PARANESTI	NAMELOCAL	Παρανέστι
SIDIRONERO	NAMELOCAL	Σιδηρόνερο
ATTAVYROS	NAMELOCAL	Αττάβυρος
AFANTOU	NAMELOCAL	Αφάντου
DIKAIOS, KOS	NAMELOCAL	Δίκαιος
IRAKLEIDES	NAMELOCAL	Ηρακλείδες
KALLITHEA, RHODES	NAMELOCAL	Καλλιθέα
SOUTH RHODES	NAMELOCAL	Νότια Ρόδος
PETALOUDES	NAMELOCAL	Πεταλούδες
OLYMPOS, KARPATHOS	NAMELOCAL	Όλυμπος
VYSSA	NAMELOCAL	Βύσσα
FERES, EVROS	NAMELOCAL	Φέρες
TRIGONO	NAMELOCAL	Τρίγωνο
TYCHERO	NAMELOCAL	Τυχερό
TRAIANOUPOLI	NAMELOCAL	Τραϊανούπολη
SOUFLI	NAMELOCAL	Σουφλί
ORFEAS	NAMELOCAL	Ορφέας
AIDIPSOS	NAMELOCAL	Αιδηψός
METAXADES	NAMELOCAL	Μεταξάδες
KYPRINOS	NAMELOCAL	Κυπρίνος
AMARYNTHOS	NAMELOCAL	Αμάρυνθος
ANTHIDONA	NAMELOCAL	Ανθηδόνα
ARTEMISIO	NAMELOCAL	Αρτεμίσιο
AVLIDA	NAMELOCAL	Αυλίδα
AVLON, EUBOEA	NAMELOCAL	Αυλών
DIRFYS	NAMELOCAL	Δίρφυς
ELYMNIOI	NAMELOCAL	Ελύμνιοι
ISTIAIA	NAMELOCAL	Ιστιαία
KIREAS	NAMELOCAL	Κηρέας
KONISTRES	NAMELOCAL	Κονίστρες
LILANTIA	NAMELOCAL	Ληλάντια
MESSAPIA, GREECE	NAMELOCAL	Μεσσάπια
NILEAS	NAMELOCAL	Νηλέας
OREOI	NAMELOCAL	Ωρεοί
KAFIREAS	NAMELOCAL	Καφηρέας
LICHADA	NAMELOCAL	Λιχάδα
APERANTIA	NAMELOCAL	Απεραντία
ASPROPOTAMOS, EVRYTANIA	NAMELOCAL	Ασπροπόταμος
VINIANI	NAMELOCAL	Βίνιανη
FOURNA	NAMELOCAL	Φουρνά
PROUSOS	NAMELOCAL	Προυσός
FRAGKISTA	NAMELOCAL	Φραγκίστα
POTAMIA, EVRYTANIA	NAMELOCAL	Ποταμιά
KTIMENIA	NAMELOCAL	Κτημένια
DOMNISTA	NAMELOCAL	Δομνίστα
ALYKES	NAMELOCAL	Αλυκές
ARKADIOI	NAMELOCAL	Αρκάδιοι
ARTEMISIA, ZAKYNTHOS	NAMELOCAL	Αρτεμισία
ELATIA	NAMELOCAL	Ελάτια
FIGALEIA	NAMELOCAL	Φιγαλεία
ANTHEMIA	NAMELOCAL	Ανθέμια
APOSTOLOS PAVLOS	NAMELOCAL	Απόστολος Παύλος
ANTIGONIDES	NAMELOCAL	Αντιγονίδες
MAKEDONIDA	NAMELOCAL	Μακεδονίδα
DOVRAS	NAMELOCAL	Δοβράς
EIRINOUPOLI	NAMELOCAL	Ειρηνούπολη
MELIKI	NAMELOCAL	Μελίκη
ASTEROUSIA	NAMELOCAL	Αστερούσια
AGIA VARVARA, HERAKLION	NAMELOCAL	Αγία Βαρβάρα
VIANNOS	NAMELOCAL	Βιάννος
GORGOLAINIS	NAMELOCAL	Γοργολαΐνης
EPISKOPI, HERAKLION	NAMELOCAL	Επισκοπή
ZAROS	NAMELOCAL	Ζαρός
THRAPSANO	NAMELOCAL	Θραψανό
KASTELLI, HERAKLION	NAMELOCAL	Καστέλλι
KOFINAS	NAMELOCAL	Κόφινας
KROUSONAS	NAMELOCAL	Κρουσώνας
MOIRES	NAMELOCAL	Μοίρες
ROUVAS	NAMELOCAL	Ρούβας
NIKOS KAZANTZAKIS	NAMELOCAL	Νίκος Καζαντζάκης
NEA ALIKARNASSOS	NAMELOCAL	Νέα Αλικαρνασσός
TEMENOS, GREECE	NAMELOCAL	Τέμενος
PALIANI	NAMELOCAL	Παλιανή
TYMPAKI	NAMELOCAL	Τυμπάκι
ACHERONTAS	NAMELOCAL	Αχέροντας
MARGARITI	NAMELOCAL	Μαργαρίτι
PARAPOTAMOS	NAMELOCAL	Παραπόταμος
PARAMYTHIA	NAMELOCAL	Παραμυθιά
SAGIADA	NAMELOCAL	Σαγιάδα
SYVOTA	NAMELOCAL	Σύβοτα
PERDIKA	NAMELOCAL	Πέρδικα
FILIATES	NAMELOCAL	Φιλιάτες
AGIOS ATHANASIOS, THESSALONIKI	NAMELOCAL	Άγιος Αθανάσιος
AGIOS GEORGIOS, THESSALONIKI	NAMELOCAL	Άγιος Γεώργιος
AGIOS PAVLOS, THESSALONIKI	NAMELOCAL	Άγιος Παύλος
AXIOS, THESSALONIKI	NAMELOCAL	Αξιός
ARETHOUSA	NAMELOCAL	Αρέθουσα
ASSIROS	NAMELOCAL	Άσσηρος
EGNATIA, THESSALONIKI	NAMELOCAL	Εγνατία
EPANOMI	NAMELOCAL	Επανομή
VERTISKOS	NAMELOCAL	Βερτίσκος
ECHEDOROS	NAMELOCAL	Εχέδωρος
VASILIKA, THESSALONIKI	NAMELOCAL	Βασιλικά
THERMAIKOS	NAMELOCAL	Θερμαϊκός
THERMI	NAMELOCAL	Θέρμη
KALLITHEA, THESSALONIKI	NAMELOCAL	Καλλιθέα
KALLINDOIA	NAMELOCAL	Καλλίνδοια
KORONEIA, THESSALONIKI	NAMELOCAL	Κορώνεια
PEFKA	NAMELOCAL	Πεύκα
EFKARPIA	NAMELOCAL	Ευκαρπία
CHORTIATIS	NAMELOCAL	Χορτιάτης
CHALKIDONA	NAMELOCAL	Χαλκηδόνα
ORAIOKASTRO	NAMELOCAL	Ωραιόκαστρο
SOCHOS	NAMELOCAL	Σοχός
RENTINA, THESSALONIKI	NAMELOCAL	Ρεντίνα
MIKRA, THESSALONIKI	NAMELOCAL	Μίκρα
MYGDONIA, THESSALONIKI	NAMELOCAL	Μυγδονία
MADYTOS	NAMELOCAL	Μάδυτος
LACHANAS	NAMELOCAL	Λαχανάς
MICHANIONA	NAMELOCAL	Μηχανιώνα
MENEMENI	NAMELOCAL	Μενεμένη
LANGADAS	NAMELOCAL	Λαγκαδάς
ANATOLI	NAMELOCAL	Ανατολή
ANO KALAMAS	NAMELOCAL	Άνω Καλαμάς
EAST ZAGORI	NAMELOCAL	Ανατολικό Ζαγόρι
AGIOS DIMITRIOS, IOANNINA	NAMELOCAL	Άγιος Δημήτριος
ANO POGONI	NAMELOCAL	Άνω Πωγώνι
LAKKA SOULIOU	NAMELOCAL	Λάκκα Σουλίου
DELVINAKI	NAMELOCAL	Δελβινάκι
EKALI, IOANNINA	NAMELOCAL	Εκάλη
EGNATIA, IOANNINA	NAMELOCAL	Εγνατία
EVRYMENES, IOANNINA	NAMELOCAL	Ευρυμενές
PASARONAS	NAMELOCAL	Πασαρώνας
PAMVOTIDA	NAMELOCAL	Παμβώτιδα
BIZANI	NAMELOCAL	Μπιζάνι
MOLOSSOI	NAMELOCAL	Μολοσσοί
MASTOROCHORIA	NAMELOCAL	Μαστοροχώρια
KALPAKI	NAMELOCAL	Καλπάκι
CENTRAL ZAGORI	NAMELOCAL	Κεντρικό Ζαγόρι
KATSANOCHORIA	NAMELOCAL	Κατσανοχώρια
ZITSA	NAMELOCAL	Ζίτσα
PRAMANTA	NAMELOCAL	Πράμαντα
SELLES, GREECE	NAMELOCAL	Σέλλες
TZOUMERKA	NAMELOCAL	Τζουμέρκα
VATHYPEDO	NAMELOCAL	Βαθύπεδο
AETOMILITSA	NAMELOCAL	Αετομηλίτσα
VOVOUSA	NAMELOCAL	Βωβούσα
DISTRATO	NAMELOCAL	Δίστρατο
KALARITES	NAMELOCAL	Καλαρίτες, CăLăREțI
MATSOUKI	NAMELOCAL	Ματσούκι
IOANNINA ISLAND	NAMELOCAL	Νήσος Ιωαννίνων
LAVDANI	NAMELOCAL	Λάβδανη
MILEA, IOANNINA	NAMELOCAL	Μηλέα
FILIPPOI	NAMELOCAL	Φίλιπποι
ORFANI	NAMELOCAL	Ορφάνι
PANGAIO	NAMELOCAL	Παγγαίο
PIEREIS	NAMELOCAL	Πιερείς
KERAMOTI	NAMELOCAL	Κεραμωτή
OREINO	NAMELOCAL	Ορεινό
ELEFTHERES	NAMELOCAL	Ελευθερές
ELEFTHEROUPOLI	NAMELOCAL	Ελευθερούπολη
CHRYSOUPOLI	NAMELOCAL	Χρυσούπολη
ARGITHEA	NAMELOCAL	Αργιθέα
ARNI, KARDITSA	NAMELOCAL	Άρνη
ACHELOOS	NAMELOCAL	Αχελώος
ITHOMI, KARDITSA	NAMELOCAL	Ιθώμη
ITAMOS	NAMELOCAL	Ίταμος
KALLIFONI	NAMELOCAL	Καλλιφώνι
KAMPOS, KARDITSA	NAMELOCAL	Κάμπος
MENELAIDA	NAMELOCAL	Μενελαΐδα
NEVROPOLI AGRAFON	NAMELOCAL	Νευρόπολη Αγράφων
PAMISOS	NAMELOCAL	Πάμισος
PLASTIRAS	NAMELOCAL	Πλαστήρας
RENTINA, KARDITSA	NAMELOCAL	Ρεντίνα
MITROPOLI	NAMELOCAL	Μητρόπολη
SELLANA	NAMELOCAL	Σέλλανα
MOUZAKI	NAMELOCAL	Μουζάκι
TAMASIO	NAMELOCAL	Ταμάσιο
FYLLO	NAMELOCAL	Φύλλο
ANATOLIKI ARGITHEA	NAMELOCAL	Ανατολική Αργιθέα
AGIA TRIADA, KASTORIA	NAMELOCAL	Αγία Τριάδα
AGIOI ANARGYROI, KASTORIA	NAMELOCAL	Άγιοι Ανάργυροι
AKRITES, KASTORIA	NAMELOCAL	Ακρίτες
MESOPOTAMIA, GREECE	NAMELOCAL	Μεσοποταμία
VITSI	NAMELOCAL	Βίτσι
KLEISOURA, KASTORIA	NAMELOCAL	Κλεισούρα
ION DRAGOUMIS	NAMELOCAL	Ίων Δραγούμης
KORESTIA	NAMELOCAL	Κορεστία
MAKEDNOI	NAMELOCAL	Μακεδνοί
NESTORIO	NAMELOCAL	Νεστόριο
ORESTIDA	NAMELOCAL	Ορεστίδα
ARRENES	NAMELOCAL	Αρρένες
GRAMOS, GREECE	NAMELOCAL	Γράμος
KASTRAKI, KASTORIA	NAMELOCAL	Καστρακί
ACHILLEIO	NAMELOCAL	Αχίλλειο
AGIOS GEORGIOS, CORFU	NAMELOCAL	Άγιος Γεώργιος
ESPERIES	NAMELOCAL	Εσπερίες
THINALI	NAMELOCAL	Θινάλι
KASSOPAIA	NAMELOCAL	Κασσωπαία
KORISSIA	NAMELOCAL	Κορισσία
LEFKIMMI	NAMELOCAL	Λευκίμμη
MELITEIEIS	NAMELOCAL	Μελιτειείς
PARELIOI	NAMELOCAL	Παρέλιοι
PALAIOKASTRITSA	NAMELOCAL	Δημοτικό Διαμέρισμα Παλαιοκαστριτών
FAIAKES	NAMELOCAL	Φαίακες
PHALASARNA	NAMELOCAL	Φαλάσαρνα
ELEIOS-PRONNOI	NAMELOCAL	Ελειός-Πρόννοι
ERISOS	NAMELOCAL	Έρισος
SAMI, CEPHALONIA	NAMELOCAL	Σάμη
OMALA, GREECE	NAMELOCAL	Ομαλά
GALLIKOS	NAMELOCAL	Γαλλικός
EVROPOS	NAMELOCAL	Ευρωπός
DOIRANI	NAMELOCAL	Δοϊράνη
GOUMENISSA	NAMELOCAL	Γουμένισσα
KROUSSA	NAMELOCAL	Κρούσσα
MOURIES	NAMELOCAL	Μουριές
PIKROLIMNI	NAMELOCAL	Πικρολίμνη
POLYKASTRO	NAMELOCAL	Πολύκαστρο
CHERSO	NAMELOCAL	Χέρσο
LIVADIA, KILKIS	NAMELOCAL	Λιβάδια
AGIA PARASKEVI, KOZANI	NAMELOCAL	Αγία Παρασκευή
AIANI	NAMELOCAL	Αιανή
ASKIO, KOZANI	NAMELOCAL	Άσκιο
DIMITRIOS YPSILANTIS	NAMELOCAL	Δημήτριος Υψηλάντης
ELIMEIA	NAMELOCAL	Ελιμεία
KAMVOUNIA	NAMELOCAL	Καμβούνια
ELLISPONTOS	NAMELOCAL	Ελλήσποντος
MOURIKI	NAMELOCAL	Μουρίκι
NEAPOLI, KOZANI	NAMELOCAL	Νεάπολη
LIVADERO	NAMELOCAL	Λιβαδερό
PENTALOFOS, KOZANI	NAMELOCAL	Πεντάλοφος
TSOTYLI	NAMELOCAL	Τσοτύλι
VLASTI	NAMELOCAL	Βλάστη
ASSOS-LECHAIO	NAMELOCAL	Άσσος-Λέχαιο
DERVENI, CORINTHIA	NAMELOCAL	Δερβένι
VOCHA	NAMELOCAL	Βόχα
SARONIKOS, CORINTHIA	NAMELOCAL	Σαρωνικός
SIKYONA	NAMELOCAL	Σικυώνα
SOLYGEIA	NAMELOCAL	Σολυγεία
STYMFALIA	NAMELOCAL	Στυμφαλία
FENEOS	NAMELOCAL	Φενεός
ANO SYROS	NAMELOCAL	Άνω Σύρος
DRYMALIA	NAMELOCAL	Δρυμαλία
EXOMVOURGO	NAMELOCAL	Εξώμβουργο
KORTHIO	NAMELOCAL	Κόρθιο
YDROUSA	NAMELOCAL	Υδρούσα
IRAKLEIA	NAMELOCAL	Ηρακλειά
KOUFONISIA	NAMELOCAL	Κουφονήσια
OIA, GREECE	NAMELOCAL	Οία
ASOPOS	NAMELOCAL	Ασωπός
ZARAKAS	NAMELOCAL	Ζάρακας
THERAPNES	NAMELOCAL	Θεράπνες
KROKEES	NAMELOCAL	Κροκεές
MOLAOI	NAMELOCAL	Μολάοι
NIATA	NAMELOCAL	Νιάτα
SKALA, LACONIA	NAMELOCAL	Σκάλα
SMYNOS	NAMELOCAL	Σμύνος
FARIS	NAMELOCAL	Φάρις
KARYES	NAMELOCAL	Καρυές
AGIA, LARISSA	NAMELOCAL	Αγιά
AMPELONAS	NAMELOCAL	Αμπελώνας
ARMENIO	NAMELOCAL	Αρμένιο
ANTICHASIA, GREECE	NAMELOCAL	Αντιχάσια
GIANNOULI	NAMELOCAL	Γιάννουλη
GONNOI	NAMELOCAL	Γόννοι
ENIPPEAS	NAMELOCAL	Ενιππέας
EVRYMENES, LARISSA	NAMELOCAL	Ευρυμενές
KATO OLYMPOS	NAMELOCAL	Κάτω Όλυμπος
KOILADA	NAMELOCAL	Κοιλάδα
KRANNONAS	NAMELOCAL	Κραννώνας
LAKEREIA	NAMELOCAL	Λακέρεια
LIVADI	NAMELOCAL	Λιβάδι
MAKRYCHORI	NAMELOCAL	Μακρυχώρι
NARTHAKI	NAMELOCAL	Ναρθάκι
MELIVOIA	NAMELOCAL	Μελίβοια
NIKAIA, LARISSA	NAMELOCAL	Νίκαια
NESSONAS	NAMELOCAL	Νέσσωνας
PLATYKAMPOS	NAMELOCAL	Πλατύκαμπος
OLYMPOS, LARISSA	NAMELOCAL	Όλυμπος
POLYDAMANTAS	NAMELOCAL	Πολυδάμαντας
POTAMIA, ELASSONA	NAMELOCAL	Ποταμιά
SARANTAPORO	NAMELOCAL	Σαραντάπορο
TYRNAVOS	NAMELOCAL	Τύρναβος
AMPELAKIA, LARISSA	NAMELOCAL	Αμπελάκια
VERDIKOUSA	NAMELOCAL	Βερδικούσα
KARYA, LARISSA	NAMELOCAL	Καρυά
LEFKI, LASITHI	NAMELOCAL	Λεύκη
ITANOS	NAMELOCAL	Ίτανος
MAKRY GIALOS	NAMELOCAL	Μακρύ Γιαλός
LASITHI PLATEAU	NAMELOCAL	Οροπέδιο Λασιθίου
ATSIKI	NAMELOCAL	Ατσική
EVERGETOULAS	NAMELOCAL	Ευεργέτουλας
MANTAMADOS	NAMELOCAL	Μανταμάδος
ERESOS-ANTISSA	NAMELOCAL	Ερεσός-Άντισσα
MOUDROS	NAMELOCAL	Μούδρος
NEA KOUTALI	NAMELOCAL	Νέα Κούταλη
POLICHNITOS	NAMELOCAL	Πολίχνιτος
APOLLONIOI	NAMELOCAL	Απολλώνιοι
ELLOMENOS	NAMELOCAL	Ελλομένος
KARYA, LEFKADA	NAMELOCAL	Καρυά
SFAKIOTES	NAMELOCAL	Σφακιώτες
AISONIA	NAMELOCAL	Αισωνία
ARTEMIDA, MAGNESIA	NAMELOCAL	Αρτέμιδα
AFETES	NAMELOCAL	Αφέτες
KARLA, GREECE	NAMELOCAL	Κάρλα
MOURESI	NAMELOCAL	Μουρέσι
PTELEOS	NAMELOCAL	Πτελεός
SIPIADA	NAMELOCAL	Σηπιάδα
FERES, MAGNESIA	NAMELOCAL	Φερές
SOURPI	NAMELOCAL	Σούρπη
ANAVRA	NAMELOCAL	Ανάβρα
KERAMIDI	NAMELOCAL	Κεραμίδι
TRIKERI	NAMELOCAL	Τρίκερι
AETOS, MESSENIA	NAMELOCAL	Αετός
AVIA, MESSENIA	NAMELOCAL	Αβία
AIPEIA	NAMELOCAL	Αίπεια
ANDANIA	NAMELOCAL	Ανδανία
ANDROUSA	NAMELOCAL	Ανδρούσα
ARISTOMENIS	NAMELOCAL	Αριστομένης
ARIS, MESSENIA	NAMELOCAL	Άρις
ARFARA	NAMELOCAL	Αρφαρά
AVLONAS, MESSENIA	NAMELOCAL	Αυλώνας
VOUFRADES	NAMELOCAL	Βουφράδες
EIRA, MESSENIA	NAMELOCAL	Είρα
ITHOMI, MESSENIA	NAMELOCAL	Ιθώμη
MELIGALAS	NAMELOCAL	Μελιγαλάς
LEFKTRO	NAMELOCAL	Λεύκτρο
KORONI	NAMELOCAL	Κορώνη
NESTORAS	NAMELOCAL	Δήμος Νέστορος
OICHALIA, MESSENIA	NAMELOCAL	Οιχαλία
PAPAFLESSAS, MESSENIA	NAMELOCAL	Παπαφλέσσας
CHILIOCHORIA	NAMELOCAL	Χιλιοχώρια
TRIKORFO, MESSENIA	NAMELOCAL	Τρίκορφο
TRIPYLA	NAMELOCAL	Τριπύλα
SELERO	NAMELOCAL	Σέλερο
SATRES	NAMELOCAL	Σάτρες
KOTYLI	NAMELOCAL	Κοτύλη
THERMES	NAMELOCAL	Θέρμες
TOPEIROS	NAMELOCAL	Τόπειρος
STAVROUPOLI, XANTHI	NAMELOCAL	Σταυρούπολη
MYKI, GREECE	NAMELOCAL	Μύκη
VISTONIDA	NAMELOCAL	Βιστωνίδα
VEGORITIDA	NAMELOCAL	Βεγορίτιδα
ARIDAEA	NAMELOCAL	Αριδαία
EXAPLATANOS	NAMELOCAL	Εξαπλάτανος
KYRROS	NAMELOCAL	Κύρρος
MEGAS ALEXANDROS, PELLA	NAMELOCAL	Μέγας Αλέξανδρος
MENIIDA	NAMELOCAL	Μενηίδα
SKYDRA	NAMELOCAL	Σκύδρα
EAST OLYMPOS	NAMELOCAL	Ανατολικός Όλυμπος
AIGINIO	NAMELOCAL	Αιγίνιο
ELAFINA	NAMELOCAL	Ελαφίνα
METHONI, PIERIA	NAMELOCAL	Μεθώνη
PETRA, PIERIA	NAMELOCAL	Πέτρα
PIERIOI	NAMELOCAL	Πιέριοι
ANOGEIO	NAMELOCAL	Ανώγειο
ZALONGO	NAMELOCAL	Ζάλογγο
THESPROTIKO	NAMELOCAL	Θεσπρωτικό
FANARI, PREVEZA	NAMELOCAL	Φανάρι
FILIPPIADA	NAMELOCAL	Φιλιππιάδα
KRANEA	NAMELOCAL	Κρανέα
ANOGEIA	NAMELOCAL	Ανώγεια
ARKADI	NAMELOCAL	Αρκάδι
GEROPOTAMOS	NAMELOCAL	Γεροπόταμος
KOULOUKONAS	NAMELOCAL	Κουλούκωνας
LAMPI	NAMELOCAL	Λάμπη
KOURITES	NAMELOCAL	Κουρήτες
LAPPA, RETHYMNO	NAMELOCAL	Λάππα
NIKIFOROS FOKAS	NAMELOCAL	Νικηφόρος Φωκάς
SYVRITOS	NAMELOCAL	Σύβριτος
FOINIKAS, CRETE	NAMELOCAL	Φοίνικας
AIGEIROS	NAMELOCAL	Αίγειρος
IASMOS	NAMELOCAL	Ίασμος
ARRIANA	NAMELOCAL	Αρριανά
NEO SIDIROCHORI	NAMELOCAL	Νέο Σιδηροχώρι
MARONEIA	NAMELOCAL	Μαρώνεια
FILLYRA	NAMELOCAL	Φιλλύρα
AMAXADES	NAMELOCAL	Αμαξάδες
SOSTIS	NAMELOCAL	Σώστης
KECHROS	NAMELOCAL	Κέχρος
ORGANI	NAMELOCAL	Οργάνη
EDESSA, GREECE	NAMELOCAL	Έδεσσα
PYTHAGOREIO	NAMELOCAL	Πυθαγόρειο
MARATHOKAMPOS	NAMELOCAL	Μαραθόκαμπος
KARLOVASI	NAMELOCAL	Καρλόβασι
AGIOS KIRYKOS	NAMELOCAL	Άγιος Κήρυκος
RACHES	NAMELOCAL	Ράχες
GRAVIA	NAMELOCAL	Γραβιά
LEPTOKARYA	NAMELOCAL	Λεπτοκαρυά
ALISTRATI	NAMELOCAL	Αλιστράτη
ACHINOS, SERRES	NAMELOCAL	Αχινός
VISALTIA	NAMELOCAL	Βισαλτία
KAPETAN MITROUSI	NAMELOCAL	Καπετάν Μητρούσι
IRAKLEIA, SERRES	NAMELOCAL	Ηράκλεια
EMMANOUIL PAPPAS	NAMELOCAL	Εμμανουήλ Παππάς
KORMISTA	NAMELOCAL	Κορμίστα
LEFKONAS	NAMELOCAL	Λευκώνας
NEA ZICHNI	NAMELOCAL	Νέα Ζίχνη
PETRITSI	NAMELOCAL	Πετρίτσι
PROTI, SERRES	NAMELOCAL	Πρώτη
RODOLIVOS	NAMELOCAL	ΡοδOλίβος
SIDIROKASTRO	NAMELOCAL	Σιδηρόκαστρο
SKOUTARI, SERRES	NAMELOCAL	Σκουτάρι
STRYMONIKO	NAMELOCAL	Στρυμονικό
STRYMONAS	NAMELOCAL	Στρυμώνας
TRAGILOS	NAMELOCAL	Τράγιλος
AGKISTRO	NAMELOCAL	Άγκιστρο
ACHLADOCHORI, SERRES	NAMELOCAL	Αχλαδοχώρι
OREINI, SERRES	NAMELOCAL	Ορεινή
PROMACHONAS	NAMELOCAL	Προμαχώνας
ANO VRONTOU	NAMELOCAL	Άνω Βροντού
GARDIKI, TRIKALA	NAMELOCAL	Γαρδίκι
AITHIKES	NAMELOCAL	Αίθηκες
VASILIKI, TRIKALA	NAMELOCAL	Βασιλική
GOMFOI	NAMELOCAL	Γόμφοι
ESTIAIOTIDA	NAMELOCAL	Εστιαιώτιδα
KALABAKA	NAMELOCAL	Καλαμπάκα
KALLIDENDRO	NAMELOCAL	Καλλίδενδρο
KASTANIA, TRIKALA	NAMELOCAL	Καστανιά
KOZIAKAS	NAMELOCAL	Κόζιακας
MALAKASI	NAMELOCAL	Μαλακάσι
MEGALA KALYVIA	NAMELOCAL	Μεγάλα Καλύβια
OICHALIA, TRIKALA	NAMELOCAL	Οιχαλία
PALIOKASTRO, TRIKALA	NAMELOCAL	Παληόκαστρο
PARALITHAIOI	NAMELOCAL	Παραληθαίοι
PELINNAIOI	NAMELOCAL	Πελινναίοι
PIALEIA	NAMELOCAL	Πιαλεία
PYLI	NAMELOCAL	Πύλη
PINDOS	NAMELOCAL	Δήμος Πινδαίων
TYMFAIA	NAMELOCAL	Τυμφαία
FALOREIA	NAMELOCAL	Φαλωρεία
CHASIA, TRIKALA	NAMELOCAL	Χάσια
FARKADONA	NAMELOCAL	Φαρκαδόνα
MYROFYLLO	NAMELOCAL	Μυρόφυλλο
ASPROPOTAMOS, TRIKALA	NAMELOCAL	Ασπροπόταμος
NERAIDA, TRIKALA	NAMELOCAL	Νεράιδα
AGIOS GEORGIOS TYMFRISTOU	NAMELOCAL	Άγιος Γεώργιος Τυμφρηστού
AGIOS KONSTANTINOS, PHTHIOTIS	NAMELOCAL	Άγιος Κωνσταντίνος
AMFIKLEIA	NAMELOCAL	Αμφίκλεια
GORGOPOTAMOS	NAMELOCAL	Γοργοπόταμος
DAFNOUSIA	NAMELOCAL	Δαφνούσια
DOMOKOS	NAMELOCAL	Δομοκός
ECHINAIOI	NAMELOCAL	Εχιναίοι
THESSALIOTIDA	NAMELOCAL	Θεσσαλιώτιδα
KAMENA VOURLA	NAMELOCAL	Καμένα Βούρλα
LEIANOKLADI	NAMELOCAL	Λειανοκλάδι
MALESINA	NAMELOCAL	Μαλεσίνα
MOLOS	NAMELOCAL	Μώλος
OPOUNTIA	NAMELOCAL	Οπουντία
XYNIADA	NAMELOCAL	Ξυνιάδα
SPERCHEIADA	NAMELOCAL	Σπερχειάδα
PELASGIA, PHTHIOTIS	NAMELOCAL	Πελασγία
PAVLIANI	NAMELOCAL	Παύλιανη
STYLIDA	NAMELOCAL	Στυλίδα
TYMFRISTOS, GREECE	NAMELOCAL	Τυμφρηστός
TITHOREA	NAMELOCAL	Τιθορέα
YPATI	NAMELOCAL	Υπάτη
ZYGOS	NAMELOCAL	Ζυγός
NEOCHORI, MAGNESIA	NAMELOCAL	Νεοχώρι
GANOCHORA	NAMELOCAL	Γανόχωρα
VRONTADOS	NAMELOCAL	Βροντάδος
PERDIKAKI	NAMELOCAL	Περδικάκι
EAST SELINO	NAMELOCAL	Ανατολικό Σέλινο
NEA KYDONIA	NAMELOCAL	Νέα Κυδωνία
KRYONERIDA	NAMELOCAL	Κρυονερίδα
FRES	NAMELOCAL	Φρες
PELEKANOS	NAMELOCAL	Πελεκάνος
INNACHORI	NAMELOCAL	Ινναχώρι
KISSAMOS	NAMELOCAL	Κίσσαμος
KANDANOS	NAMELOCAL	Κάνδανος
MOUSOUROI	NAMELOCAL	Μουσούροι
KASSIOPI	NAMELOCAL	Κασσιόπη
KASSANDRA, CHALKIDIKI	NAMELOCAL	Κασσάνδρα
KERAMIA	NAMELOCAL	Κεραμιά
KOLYMVARI	NAMELOCAL	Κολυμβάρι
THERISO	NAMELOCAL	Θέρισο
VOUKOLIES	NAMELOCAL	Βουκολιές
MYTHIMNA	NAMELOCAL	Μύθημνα
AETOS, FLORINA	NAMELOCAL	Αετός
AMYNTAIO	NAMELOCAL	Αμύνταιο
KATO KLEINES	NAMELOCAL	Κάτω Κλεινές
MELITI	NAMELOCAL	Μελίτη
PERASMA	NAMELOCAL	Πέρασμα
PRESPES	NAMELOCAL	Δήμος Πρεσπών
FILOTAS	NAMELOCAL	Φιλώτας
VARIKO	NAMELOCAL	Βαρικό
KRYSTALLOPIGI	NAMELOCAL	Κρυσταλλοπηγή
LECHOVO	NAMELOCAL	Λέχοβο
NYMFAIO	NAMELOCAL	Νυμφαίο
NEA KALLIKRATIA	NAMELOCAL	Καλλικράτεια
ARNAIA	NAMELOCAL	Αρναία
ZERVOCHORIA	NAMELOCAL	Ζερβοχώρια
ANTHEMOUNTAS	NAMELOCAL	Ανθεμούντας
TOLOFON	NAMELOCAL	Τολοφών
DESFINA	NAMELOCAL	Δεσφίνα
PARNASSOS	NAMELOCAL	Παρνασσός
LIDORIKI	NAMELOCAL	Λιδωρίκι
KALLIEIS	NAMELOCAL	Καλλιείς
EFPALIO	NAMELOCAL	Ευπάλιο
VARDOUSIA	NAMELOCAL	Βαρδούσια
KASSANDREIA	NAMELOCAL	Κασσάνδρεια
TORONI	NAMELOCAL	Τορώνη
PANAGIA, CHALKIDIKI	NAMELOCAL	Παναγία
TRIGLIA	NAMELOCAL	Τρίγλια
ORMYLIA	NAMELOCAL	Ορμύλια
PALLINI, CHALKIDIKI	NAMELOCAL	Παλλήνη
STAGIRA-AKANTHOS	NAMELOCAL	Στάγιρα-Άκανθος
MOUDANIA, GREECE	NAMELOCAL	Μουδανιά
AGIOS MINAS	NAMELOCAL	Άγιος Μηνάς
KARDAMYLA	NAMELOCAL	Καρδάμυλα
IONIA, CHIOS	NAMELOCAL	Ιωνία
KAMPOCHORA	NAMELOCAL	Καμπόχωρα
MASTICHOCHORIA	NAMELOCAL	Μαστιχοχώρια
ASKOS, SOCHOS	NAMELOCAL	Ασκός
TSAGKARADA	NAMELOCAL	Τσαγκαράδα
ELAIOCHORI, KAVALA	NAMELOCAL	Ελαιοχώρι
GRIZANO	NAMELOCAL	Γριζάνο
XORYCHTI	NAMELOCAL	Ξορύχτι
ANILIO, MAGNESIA	NAMELOCAL	Ανήλιο
MYRINA, GREECE	NAMELOCAL	Μύρινα
KISSOS	NAMELOCAL	Κισσός
AGIOI APOSTOLI	NAMELOCAL	Άγιοι Απόστολοι
AGIOS DIMITRIOS PILIOU	NAMELOCAL	Άγιος Δημήτριος Πηλίου
SKOTEINI	NAMELOCAL	Σκοτεινή
STATHAS	NAMELOCAL	Σταθάς
TSIMANDRIA	NAMELOCAL	Τσιμάνδρια
METAXATA	NAMELOCAL	Μεταξάτα
LONGOS, PAXOI	NAMELOCAL	Λογγός
LIODORA	NAMELOCAL	Λιοδώρα
NEA SKIONI	NAMELOCAL	Νέα Σκιώνη
PRINIAS	NAMELOCAL	Πρινιάς
MALESIADA	NAMELOCAL	Μαλεσιάδα
AMORGIANOI	NAMELOCAL	Αμοργιανοί
CHALKIOPOULO	NAMELOCAL	Χαλκιόπουλο
KARYES, MOUNT ATHOS	NAMELOCAL	Καρυές
AGIA PARASKEVI, CHALKIDIKI	NAMELOCAL	Αγία Παρασκευή
PALIOURI, CHALKIDIKI	NAMELOCAL	Παλιούρι
GLOSSA, SKOPELOS	NAMELOCAL	Γλώσσα
VASILIKI, LEFKADA	NAMELOCAL	Βασιλική
PATITIRI	NAMELOCAL	Πατητήρι
NYDRI	NAMELOCAL	NIDRI
XIRONOMI	NAMELOCAL	Ξηρονομή
NEA SANTA	NAMELOCAL	Νέα Σάντα
LAZARATA	NAMELOCAL	Λαζαράτα
PEFKOCHORI	NAMELOCAL	Πευκοχώρι
POLYCHRONO	NAMELOCAL	Πολύχρονο
ZARKO	NAMELOCAL	Ζάρκο
CHANIOTIS	NAMELOCAL	Χανιώτης
TSOUKKA	NAMELOCAL	Τσούκκα
KAVOUSI	NAMELOCAL	Καβούσι
VELANIDIA, LACONIA	NAMELOCAL	Βελανίδια
BOZIKAS	NAMELOCAL	Μποζικάς
ANAVRYTI, LACONIA	NAMELOCAL	Αναβρυτή
PANORMOS, TINOS	NAMELOCAL	Πάνορμος
MYRTOS BEACH	NAMELOCAL	Παραλία Μύρτου
AGIA EIRINI, CHANIA	NAMELOCAL	Αγία Ειρήνη
VONITSA	NAMELOCAL	Βόνιτσα
VARETADA	NAMELOCAL	Βαρετάδα
AGIA MARINA, CRETE	NAMELOCAL	Αγία Μαρίνα
PAPADATES, AETOLIA-ACARNANIA	NAMELOCAL	Παπαδάτες
ISARIS	NAMELOCAL	Ίσαρης
CHORTO	NAMELOCAL	Χόρτο
AETORRACHI, ELIS	NAMELOCAL	Αετορράχη
XINOVRYSI	NAMELOCAL	Ξινόβρυση
PAGOI	NAMELOCAL	Πάγοι
PLATAMON	NAMELOCAL	Πλαταμώνας
ASEA, GREECE	NAMELOCAL	Ασέα
ISOMA KARYON	NAMELOCAL	Ίσωμα Καρυών
ANO LECHONIA	NAMELOCAL	Άνω Λεχώνια
VASTAS	NAMELOCAL	Βάστας
PARADEISIA, ARCADIA	NAMELOCAL	Παραδείσια
AGIOS VLASIOS, MAGNESIA	NAMELOCAL	Άγιος Βλάσιος
IERISSOS	NAMELOCAL	Ιερισσός
ANO VLASIA	NAMELOCAL	Άνω Βλασία
CHOREMIS	NAMELOCAL	Χωρέμης
KOROPI, MAGNESIA	NAMELOCAL	Κορόπη
KATO VLASIA	NAMELOCAL	Κάτω Βλασία
AGIOS GEORGIOS NILEIAS	NAMELOCAL	Άγιος Γεώργιος Νηλείας
PLAKA, ARCADIA	NAMELOCAL	Πλάκα
KALA NERA	NAMELOCAL	Καλά Νερά
DROSATO, KILKIS	NAMELOCAL	Δροσάτο
PINAKATES	NAMELOCAL	Πινακάτες
LONGANIKOS	NAMELOCAL	Λογκανίκος
SOULOS	NAMELOCAL	Σούλος
NEA SINOPI	NAMELOCAL	Αρχάγγελος
MILIES, EUBOEA	NAMELOCAL	Μηλιές
ANTHOCHORI, ARCADIA	NAMELOCAL	Ανθοχώρι
ARNISSA	NAMELOCAL	Άρνισσα
DROSOPIGI, FLORINA	NAMELOCAL	Δροσοπηγή
GEFYRA, ARCADIA	NAMELOCAL	Γέφυρα
KALO NERO	NAMELOCAL	Καλό Νερό
KARVOUNARI	NAMELOCAL	Καρβουνάρι
ELIKI	NAMELOCAL	Ελίκη
TEMENI	NAMELOCAL	Τέμενη
LIAPADES	NAMELOCAL	Λιαπάδες
KARDAMYLI	NAMELOCAL	Καρδαμύλη
PTERI	NAMELOCAL	Πτέρη
VELIGOSTI	NAMELOCAL	Βελιγοστή
MOSCHOCHORI, FLORINA	NAMELOCAL	Μοσχοχώρι
PLATANOS, ACHAEA	NAMELOCAL	Πλάτανος
KALLITHEA ELASSONOS	NAMELOCAL	Καλλιθέα Ελασσόνος
DOBERSCHAU-GAUßIG	NAMELOCAL	DOBRUšA-HUSKA
LIMNI, EUBOEA	NAMELOCAL	Λίμνη
ANO POROIA	NAMELOCAL	Άνω Πορόια
ELLINITSA	NAMELOCAL	Ελληνίτσα
SKOTOUSSA	NAMELOCAL	Σκοτούσσα
THOKNIA	NAMELOCAL	Θωκνία
AGISTRI	NAMELOCAL	Αγκίστρι
GEORGITSI	NAMELOCAL	Γεωργίτσι
FLAMPOURO, LARISSA	NAMELOCAL	Φλάμπουρο
NAMATA, LARISSA	NAMELOCAL	Νάματα
CHALKIADES, LARISSA	NAMELOCAL	Χαλκιάδες
KATO KARYES	NAMELOCAL	Κάτω Καρυές
PELLA	NAMELOCAL	Πέλλα
RODODAFNI	NAMELOCAL	Ροδοδάφνη
MAVRIA	NAMELOCAL	Μαυριά
SYKIA, LARISSA	NAMELOCAL	Συκιά
VRESTHENA	NAMELOCAL	Βρέσθενα
DRAKOVOUNI	NAMELOCAL	Δρακοβούνι,Γλόγοβα
SELIANITIKA	NAMELOCAL	Σελιανίτικα
GAVALOU	NAMELOCAL	Γαβαλού
VRACHASI	NAMELOCAL	Βραχάσι
NEA EKKLISOULA	NAMELOCAL	Νέα Εκκλησούλα
KATO MAKRINOU	NAMELOCAL	Κάτω Μακρινού
KAMARES, ACHAEA	NAMELOCAL	Καμάρες
MAKRINOU	NAMELOCAL	Μακρινού
TRILOFO, ARCADIA	NAMELOCAL	Τρίλοφο
RODIA, ACHAEA	NAMELOCAL	Ροδιά
ANTHIRO	NAMELOCAL	Ανθηρό
VANGOS	NAMELOCAL	Βάγγος
AGIOS GEORGIOS, KARDITSA	NAMELOCAL	Άγιος Γεώργιος
GRANITSA, EVRYTANIA	NAMELOCAL	Γρανίτσα
TRAPEZA, ACHAEA	NAMELOCAL	Τράπεζα
KARATOULAS	NAMELOCAL	Καράτουλας
APIDEONAS	NAMELOCAL	Απιδεώνας
AMYGDALI, KARDITSA	NAMELOCAL	Αμυγδαλή
MATARAGKA, ACHAEA	NAMELOCAL	Ματαράγκα
PAVLIA	NAMELOCAL	Παύλια
NEAPOLI, ELIS	NAMELOCAL	Νεάπολη
GELANTHI	NAMELOCAL	Γελάνθη
DRAKOTRYPA	NAMELOCAL	Δρακότρυπα
VERGADEIKA	NAMELOCAL	Βεργαδέικα
PALAMARI	NAMELOCAL	Παλαμάρι
KRINOS, ACHAEA	NAMELOCAL	Κρίνος
SPARTA	NAMELOCAL	Σπάρτη
SCHLEIFE	NAMELOCAL	SLEPO
ELOUNDA	NAMELOCAL	Ελούντα
MALLOTA, GREECE	NAMELOCAL	Μαλλωτά
NISI, ELIS	NAMELOCAL	Νησί
OXYA, KARDITSA	NAMELOCAL	Οξυά
TRILOFO, THESSALONIKI	NAMELOCAL	Τρίλοφο
PRODROMI	NAMELOCAL	Προδρόμι
PALAIOCHOUNI	NAMELOCAL	Παλαιοχούνη
VOUTSARAS, ARCADIA	NAMELOCAL	Βουτσαράς
MANOLADA	NAMELOCAL	Μανολάδα
KRYONERI, KARDITSA	NAMELOCAL	Κρυονέρι
RODENBERG	NAMELOCAL	COLLECTIVE MUNICIPALITY
PETRINA, ARCADIA	NAMELOCAL	Πετρίνα
XENIES	NAMELOCAL	Ξενιές
BELOKOMITI	NAMELOCAL	Μπελοκομίτη
SOULARI, ARCADIA	NAMELOCAL	Σουλάρι
KASTELLOKAMPOS	NAMELOCAL	Καστελλόκαμπος
MOSCHATO, KARDITSA	NAMELOCAL	Μοσχάτο
KYPARISSI, LACONIA	NAMELOCAL	Κυπαρίσσι
POTAMIA, ARCADIA	NAMELOCAL	Ποταμιά
PROASTIO, KARDITSA	NAMELOCAL	Προάστιο
KAMARA, ARCADIA	NAMELOCAL	Καμάρα
MARATHEA, KARDITSA	NAMELOCAL	Μαραθέα
KANDILA, AETOLIA-ACARNANIA	NAMELOCAL	Κανδήλα
EVINOCHORI	NAMELOCAL	Ευηνοχώρι
AGRA, KALLONI	NAMELOCAL	Άγρα
TOURKOLEKAS	NAMELOCAL	Τουρκολέκας
PERISTERI, ELIS	NAMELOCAL	Περιστέρι
AKOVOS	NAMELOCAL	Άκοβος
GERAKI, ELIS	NAMELOCAL	Γεράκι
KASTELLIA	NAMELOCAL	Καστέλλια
CHIRADES	NAMELOCAL	Χιράδες
RAVENIA	NAMELOCAL	Ραβένια
ANTRONI	NAMELOCAL	Αντρώνι
CHRANOI	NAMELOCAL	Χράνοι
NEO SOULI	NAMELOCAL	Νέο Σούλι
TYMFI, GREECE	NAMELOCAL	Τύμφη
NEOCHORI LYKOSOURAS	NAMELOCAL	Νεοχώρι Λυκοσούρας
MOIRA, ACHAEA	NAMELOCAL	Μοίρα
AIGIALEIA	NAMELOCAL	Αιγιάλεια
AGIOS STEFANOS, ACHAEA	NAMELOCAL	Άγιος Στέφανος
KASTANOCHORI, ARCADIA	NAMELOCAL	Καστανοχώρι
FARES	NAMELOCAL	Φαρές
NEA PERAMOS, KAVALA	NAMELOCAL	Νέα Πέραμος
ISOMA, ACHAEA	NAMELOCAL	Ίσωμα
KOUROUNIOS	NAMELOCAL	Κουρουνιός
SOTIRA, TRIKALA	NAMELOCAL	Σωτήρα
KOTYLIO	NAMELOCAL	Κοτύλιο
RINGSTEDT	NAMELOCAL	RINGST ()
ZIRIA, ACHAEA	NAMELOCAL	Ζήρια
ELEKISTRA	NAMELOCAL	Ελεκίστρα
PARALIA DISTOMOU	NAMELOCAL	Παραλία Διστόμου
PETROCHORI, ACHAEA	NAMELOCAL	Πετροχώρι
VLACHORRAPTIS	NAMELOCAL	Βλαχορράπτης
AGIOVLASITIKA	NAMELOCAL	Αγιοβλασίτικα
ELAIOCHORI, ACHAEA	NAMELOCAL	Ελαιοχώρι
SARAKINI	NAMELOCAL	Σαρακίνι
ANO ACHAIA	NAMELOCAL	Άνω Αχαΐα
KRINI, TRIKALA	NAMELOCAL	Κρήνη
PEDINO, KILKIS	NAMELOCAL	Πεδινό
LOUSIKA	NAMELOCAL	Λουσικά
SKOURTA	NAMELOCAL	Σκούρτα
ELATI, KOZANI	NAMELOCAL	Ελάτη
ARDANI, TRIKALA	NAMELOCAL	Αρδάνι
RIZOSPILIA	NAMELOCAL	Ριζοσπηλιά
STAVRODROMI	NAMELOCAL	Σταυροδρόμι
KOLINDROS	NAMELOCAL	Κολινδρός
STEIRI	NAMELOCAL	Στείρι
SPATHADES	NAMELOCAL	Σπαθάδες
ZATOUNA	NAMELOCAL	Ζάτουνα
ARLA, GREECE	NAMELOCAL	Άρλα
NEA EPIDAVROS	NAMELOCAL	Νέα Επίδαυρος
DAFNI, BOEOTIA	NAMELOCAL	Δάφνη
MESOCHORA	NAMELOCAL	Μεσοχώρα
FOSTAINA	NAMELOCAL	Φώσταινα
PYLI, BOEOTIA	NAMELOCAL	Πύλη
KONISKOS	NAMELOCAL	Κονισκός
EVLALO	NAMELOCAL	Εύλαλο
ECHINOS	NAMELOCAL	Εχίνος
ECHINOS	NAMELOCAL	Шахин
GENISEA	NAMELOCAL	Γενισέα
KIMMERIA	NAMELOCAL	Κιμμέρια
MANGANA, XANTHI	NAMELOCAL	Μάγγανα
STERNA, EVROS	NAMELOCAL	Στέρνα
TOXOTES, XANTHI	NAMELOCAL	Τοξότες
ARGASSI	NAMELOCAL	Αργάσι
BOCHALI	NAMELOCAL	Μποχάλη
LAGOPODO	NAMELOCAL	Λαγώποδο
LITHAKIA	NAMELOCAL	Λιθακιά
MACHAIRADO	NAMELOCAL	Μαχαιράδο
ROMIRI	NAMELOCAL	Ρομίρι
VOLIMES	NAMELOCAL	Βολίμες
KERI, GREECE	NAMELOCAL	Κερί
KATASTARI	NAMELOCAL	Καταστάρι
KALIPADO	NAMELOCAL	Καλιπάδο
KATSIMPALIS	NAMELOCAL	Κατσίμπαλης
KAMPOS, MESSENIA	NAMELOCAL	Κάμπος
ARRAVONITSA	NAMELOCAL	Αρραβωνίτσα
KYPARISSIA, ARCADIA	NAMELOCAL	Κυπαρίσσια
ANTHOUSA, TRIKALA	NAMELOCAL	Ανθούσα
RäCKELWITZ	NAMELOCAL	WORKLECY
RALBITZ-ROSENTHAL	NAMELOCAL	RALBICY-RóžANT
PANSCHWITZ-KUCKAU	NAMELOCAL	PANčICY-KUKOW
ELSTERHEIDE	NAMELOCAL	HALšTROWSKA HOLA
CROSTWITZ	NAMELOCAL	CHRóSćICY
SANTOMERI	NAMELOCAL	Σαντομέρι
ACHAIKO	NAMELOCAL	Αχαϊκό
BOXBERG, SAXONY	NAMELOCAL	HAMOR
SYRNA	NAMELOCAL	Σύρνα
GROß DüBEN	NAMELOCAL	DźěWIN
GABLENZ, SAXONY	NAMELOCAL	JABłOńC
HOHENDUBRAU	NAMELOCAL	WYSOKA DUBRAWA
MüCKA	NAMELOCAL	MIKOW
KREBA-NEUDORF	NAMELOCAL	CHRJEBJA-NOWA WJES
KRAUSCHWITZ	NAMELOCAL	KRUšWICA
RIETSCHEN	NAMELOCAL	RěčICY
TREBENDORF	NAMELOCAL	TRJEBIN
PORTES, ACHAEA	NAMELOCAL	Πόρτες
WEIßKEIßEL	NAMELOCAL	WUSKIDź
KERYNEIA, GREECE	NAMELOCAL	Κερύνεια
LYKOCHIA	NAMELOCAL	Λυκόχια
KOUTALAS, CORINTHIA	NAMELOCAL	Κουταλάς
KREMASTI, LACONIA	NAMELOCAL	Κρεμαστή
STEFANI, BOEOTIA	NAMELOCAL	Στεφάνη
KOLLINES	NAMELOCAL	Κολλίνες
KERASTARIS	NAMELOCAL	Κεραστάρης
ANO DIAKOPTO	NAMELOCAL	Άνω Διακοπτό
MAMOUSIA	NAMELOCAL	Μαμουσιά
ELAIONAS, ACHAEA	NAMELOCAL	Ελαιώνας
MAVRIKI	NAMELOCAL	Μαυρίκι
KOUNINA	NAMELOCAL	Κουνινά
ZACHLORITIKA	NAMELOCAL	Ζαχλωρίτικα
CHATZIS, ACHAEA	NAMELOCAL	Χατζής
MARKOPOULO, ELIS	NAMELOCAL	Μαρκόπουλο
SELLADES	NAMELOCAL	Σελλάδες
MELISSIA, ACHAEA	NAMELOCAL	Μελίσσια
ATHINAIO	NAMELOCAL	Αθήναιο
PARASKEVI, ACHAEA	NAMELOCAL	Παρασκευή
NIKOLAIIKA	NAMELOCAL	Νικολαίικα
SELINOUNTAS, ACHAEA	NAMELOCAL	Σελινούς
METALLIKO, KILKIS	NAMELOCAL	Μεταλλικό
VALIMITIKA	NAMELOCAL	Βαλιμίτικα
AISYMI	NAMELOCAL	Αισύμη
SKIATHOS	NAMELOCAL	Σκιάθος
RIZOMYLOS, ACHAEA	NAMELOCAL	Ριζόμυλος
SKOPELOS	NAMELOCAL	Σκόπελος
RIZES	NAMELOCAL	Ρίζες
MAKRI, EVROS	NAMELOCAL	Μάκρη
NAXOS	NAMELOCAL	Νάξος
KORYFI, ELIS	NAMELOCAL	Κορυφή
ASPROVALTA	NAMELOCAL	Ασπροβάλτα
ERATEINI	NAMELOCAL	Ερατεινή
PYLAIA, EVROS	NAMELOCAL	Πυλαία
PAPARIS	NAMELOCAL	Πάπαρης
ALPOCHORI, ACHAEA	NAMELOCAL	Αλποχώρι
TRIKALA, IMATHIA	NAMELOCAL	Τρίκαλα
DAFNI, ARCADIA	NAMELOCAL	Δάφνη
ZACHLOROU	NAMELOCAL	Κάτω Ζαχλωρού
KALLITHEA, PHOCIS	NAMELOCAL	Καλλιθέα
AMMOVOUNO	NAMELOCAL	Αμμόβουνο
THOURIO, EVROS	NAMELOCAL	Θούριο
KATAFYGIO	NAMELOCAL	Καταφύγιο
NAFPAKTIA	NAMELOCAL	Ναυπακτία
DYRRACHIO	NAMELOCAL	Δυρράχιο
DROSIA, ACHAEA	NAMELOCAL	Δροσιά
ARTOTINA	NAMELOCAL	Αρτοτίνα
ARZOS	NAMELOCAL	Άρζος
SKAFIDIA	NAMELOCAL	Σκαφιδιά
PENTAGIOI	NAMELOCAL	Πενταγιοί
DADIA	NAMELOCAL	Δαδιά
KALFAS	NAMELOCAL	Κάλφας
KOMARA	NAMELOCAL	Κόμαρα
VERIA	NAMELOCAL	Βέροια
AGRIAKONA	NAMELOCAL	Αγριακόνα
KALOUSI	NAMELOCAL	Καλούσι
PTELEA, EVROS	NAMELOCAL	Πτελέα
ZORIANOS	NAMELOCAL	Ζοριάνος
KANALIA	NAMELOCAL	Κανάλια
SKORTSINOS	NAMELOCAL	Σκορτσινός
KATARRAKTIS	NAMELOCAL	Καταρράκτης
APOSTOLIAS	NAMELOCAL	Αποστολιάς
LAGOS, EVROS	NAMELOCAL	Λαγός
MANNA, GREECE	NAMELOCAL	Μάννα
ORMENIO	NAMELOCAL	Ορμένιο
PERAIA, PELLA	NAMELOCAL	Περαία
FOTEINO, ARTA	NAMELOCAL	Φωτεινό
TRUDERING-RIEM	NAMELOCAL	TRUDERING-RIEM
ZONIANA	NAMELOCAL	Ζωνιανά
LEPTINI	NAMELOCAL	Λεπτίνι
KALOSKOPI	NAMELOCAL	Καλοσκοπή
EVGENIKO	NAMELOCAL	Ευγενικό
FILIA, ACHAEA	NAMELOCAL	Φίλια
ANTHOUSA, PREVEZA	NAMELOCAL	Ανθούσα
DIAPOROS ISLAND	NAMELOCAL	Διάπορος
SALAMINA	NAMELOCAL	Σαλαμίνα
PELOPIO	NAMELOCAL	Πελόπιο
THEMELO	NAMELOCAL	Θέμελο
SITOCHORI, EVROS	NAMELOCAL	Σιτοχώρι
PLEVROMA	NAMELOCAL	Πλεύρωμα
GRAIKOS	NAMELOCAL	Γραικός
GIANNAIOI	NAMELOCAL	Γιανναίοι
NARKISSOS	NAMELOCAL	Νάρκισσος
PLATI, EVROS	NAMELOCAL	Πλάτη
GALATAS, TROIZINA	NAMELOCAL	Γαλατάς
PLATANOS, ELIS	NAMELOCAL	Πλάτανος
ADAMANTAS	NAMELOCAL	Αδάμαντας
NEOCHORI FALAISIAS	NAMELOCAL	Νεοχώρι Φαλαισίας
CHELIDONI	NAMELOCAL	Χελιδόνι
ANTHEIA, EVROS	NAMELOCAL	Άνθεια
PENTALOFOS, EVROS	NAMELOCAL	Πεντάλοφος
THEISOA, GREECE	NAMELOCAL	Θεισόα
KRYONERI, OLYMPIA	NAMELOCAL	Κρυονέρι
ALMOPIA	NAMELOCAL	Αλμωπία
AGROS, GREECE	NAMELOCAL	Αγρός
DIKAIA	NAMELOCAL	Δίκαια
ROVIA	NAMELOCAL	Ρόβια
MARASIA	NAMELOCAL	Μαράσια
MATESI	NAMELOCAL	Μάτεσι
KOUMANIS	NAMELOCAL	Κούμανης
VITALADES	NAMELOCAL	Βιταλάδες
NEOCHORI, CORFU	NAMELOCAL	Νεοχώρι
SPILAIO	NAMELOCAL	Σπήλαιο
EPISKEPSI	NAMELOCAL	Επίσκεψη
DOUKADES	NAMELOCAL	Δουκάδες
ELAIA, EVROS	NAMELOCAL	Ελαία
DOUKAS, ELIS	NAMELOCAL	Δούκας
ASPRA SPITIA, ELIS	NAMELOCAL	Άσπρα Σπίτια
GIANNADES	NAMELOCAL	Γιαννάδες
AGIA KYRIAKI, ELIS	NAMELOCAL	Αγία Κυριακή
KRYOVRYSI, ELIS	NAMELOCAL	Κρυόβρυση
MILIA, EVROS	NAMELOCAL	Μηλιά
THERAPEIO	NAMELOCAL	Θεραπειό
GORTYNIA	NAMELOCAL	Γορτυνία
YERAKINI	NAMELOCAL	Γερακινή
PALAIO LOUTRO	NAMELOCAL	Παλαιό Λουτρό
PARALIA, ACHAEA	NAMELOCAL	Παραλία
GOUMERO	NAMELOCAL	Γούμερο
ARGYRADES	NAMELOCAL	Αργυράδες
KLIMATIA, CORFU	NAMELOCAL	Κληματιά
KOKKINI, CORFU	NAMELOCAL	Κοκκίνι
KOUSPADES	NAMELOCAL	Κουσπάδες
NYMFES	NAMELOCAL	Νύμφες
PERIVOLI, CORFU	NAMELOCAL	Περιβόλι
AGIA ANNA, ELIS	NAMELOCAL	Αγία Άννα
PELEKAS	NAMELOCAL	Πέλεκας
ZONI, EVROS	NAMELOCAL	Ζώνη
KATO MELPEIA	NAMELOCAL	Κάτω Μέλπεια
OURANOUPOLI	NAMELOCAL	Ουρανούπολη
OREINI, ELIS	NAMELOCAL	Ορεινή
SIDARI	NAMELOCAL	Σιδάρι
VELONADES	NAMELOCAL	Βελονάδες
FOINIKOUNTA	NAMELOCAL	Φοινικούντα
SINARADES	NAMELOCAL	Σιναράδες
AVAS, GREECE	NAMELOCAL	Άβας
SETA, GREECE	NAMELOCAL	Σέτα
MILEA, LARISSA	NAMELOCAL	Μηλέα
MILEA, GREVENA	NAMELOCAL	Μηλέα
AVLONARI	NAMELOCAL	Αυλωνάρι
ARGINIA	NAMELOCAL	Αργίνια
ELLINOCHORI, EVROS	NAMELOCAL	Ελληνοχώρι
KOLIRI	NAMELOCAL	Κολίρι
PROTOKKLISI	NAMELOCAL	Πρωτοκκλήσι
KATO SAMIKO	NAMELOCAL	Κάτω Σαμικό
PORTIANOU	NAMELOCAL	Πορτιανού
SAMIKO	NAMELOCAL	Σαμικό
POLYDROSO, THESPROTIA	NAMELOCAL	Πολύδροσο
MEGA DEREIO	NAMELOCAL	Μέγα Δέρειο
ACHYRA	NAMELOCAL	Αχυρά
VRYSOCHORI	NAMELOCAL	Βρυσοχώρι
KERPINI	NAMELOCAL	Κερπινή
AGIOS PETROS, ARCADIA	NAMELOCAL	Άγιος Πέτρος
AGIOS GERMANOS	NAMELOCAL	Άγιος Γερμανός
RACHES, ELIS	NAMELOCAL	Ράχες
ATHANASIOS DIAKOS, GREECE	NAMELOCAL	Αθανάσιος Διάκος
CHOVOLI	NAMELOCAL	Χόβολη
PYRSOGIANNI	NAMELOCAL	Πυρσόγιαννη
ZARKADIA	NAMELOCAL	Ζαρκαδιά
KALAMON, DRAMA	NAMELOCAL	Καλαμών
KYRGIA	NAMELOCAL	Κύργια
GRYLLOS	NAMELOCAL	Γρύλλος
VASILIKO, IOANNINA	NAMELOCAL	Βασιλικό
SMARI	NAMELOCAL	Σμάρι
VRINA, GREECE	NAMELOCAL	Βρίνα
MIKRO DEREIO	NAMELOCAL	Μικρό Δέρειο
ANO SCHOLARI	NAMELOCAL	Άνω Σχολάρι
VISSANI	NAMELOCAL	Βήσσανη
KRATERO	NAMELOCAL	Κρατερό
GRAIKAS	NAMELOCAL	Γραίκας
GAITANI	NAMELOCAL	Γαϊτάνι
ALFEIOUSA	NAMELOCAL	Αλφειούσα
KYRIAKI, EVROS	NAMELOCAL	Κυριακή
SKILLOUNTIA	NAMELOCAL	Σκιλλουντία
SKOTANI	NAMELOCAL	Σκοτάνη
AGIA VARVARA, AKRATA	NAMELOCAL	Αγία Βαρβάρα
KTISMATA	NAMELOCAL	Κτίσματα
KERTEZI	NAMELOCAL	Κέρτεζη
MAKRISIA	NAMELOCAL	Μακρίσια
LOUTROS, EVROS	NAMELOCAL	Λουτρός
PEDINO, LEMNOS	NAMELOCAL	Πεδινό
KAVYLI	NAMELOCAL	Καβύλη
FRIXA	NAMELOCAL	Φρίξα
MESORROUGI	NAMELOCAL	Μεσορρούγι
NEA VYSSA	NAMELOCAL	Νέα Βύσσα
PLATANOUSSA	NAMELOCAL	Πλατανούσσα
PETROTA	NAMELOCAL	Πετρωτά
KALYVIA MYRTOUNTION	NAMELOCAL	Καλύβια Μυρτουντίων
PAOS	NAMELOCAL	Πάος
CHIONATA	NAMELOCAL	Χιονάτα
RIZIA	NAMELOCAL	Ρίζια
TSIVLOS	NAMELOCAL	Τσιβλός
FORTOSI	NAMELOCAL	Φορτόσι
MELITI	NAMELOCAL	Μελίτη
OTHMARSCHEN	NAMELOCAL	OTHMARSCHEN
LYGIA	NAMELOCAL	Λυγιά
KATO PEDINA	NAMELOCAL	Κάτω Πεδινά
PIANA, ARCADIA	NAMELOCAL	Μαίναλο
VALERIANOS	NAMELOCAL	Βαλεριάνος
AGRAMPELA, ACHAEA	NAMELOCAL	Αγράμπελα
KLEIDONIA	NAMELOCAL	Κλειδωνιά
IDOMENI	NAMELOCAL	Ειδομένη
AGIOS SPYRIDONAS, PIERIA	NAMELOCAL	Άγιος Σπυρίδωνας
PONTOKOMI	NAMELOCAL	Ποντοκώμη
EMPORIO, KOZANI	NAMELOCAL	Εμπόριο
AGIOS THEODOROS, KOZANI	NAMELOCAL	Άγιος Θεόδωρος
AKRINI	NAMELOCAL	Ακρινή
ANATOLIKO	NAMELOCAL	Ανατολικό
ANO KOMI	NAMELOCAL	Άνω Κώμη
AVLES	NAMELOCAL	Αυλές
CHORIGOS	NAMELOCAL	Χορηγός
DAMASKINIA	NAMELOCAL	Δαμασκηνιά
DASYLLIO	NAMELOCAL	Δασύλλιο
ERATYRA	NAMELOCAL	Εράτυρα
VATHYLAKKOS, KOZANI	NAMELOCAL	Βαθύλακκος
GALATEIA, KOZANI	NAMELOCAL	Γαλάτεια
FOUFAS	NAMELOCAL	Φούφας
AGIOS NIKOLAOS, CORFU	NAMELOCAL	Άγιος Νικόλαος
KONTIAS	NAMELOCAL	Κοντιάς
NEMEA	NAMELOCAL	Νεμέα
AVRAMIOU	NAMELOCAL	Αβραμιού
MESSINI	NAMELOCAL	Μεσσήνη
AGRIDI, ACHAEA	NAMELOCAL	Αγρίδι
THINAIA	NAMELOCAL	Θηναία
PALAIROS	NAMELOCAL	Πάλαιρος
MOLISTA	NAMELOCAL	Μόλιστα
AMPELAKIA, EVROS	NAMELOCAL	Αμπελάκια
ALESTAINA	NAMELOCAL	Αλέσταινα
MONASTIRI, IOANNINA	NAMELOCAL	Μοναστήρι
CHANDRAS	NAMELOCAL	Χανδράς
XENOPOULO	NAMELOCAL	Ξενόπουλο
IRAKLEIA, ELIS	NAMELOCAL	Ηράκλεια
DESINO	NAMELOCAL	Δεσινό
MEGALI DOXIPARA	NAMELOCAL	Μεγάλη Δοξιπάρα
ANGARIONES	NAMELOCAL	Αγγαριώνες
LEPREO	NAMELOCAL	Λέπρεο
KAMENIANOI	NAMELOCAL	Καμενιάνοι
KASTANIA, IOANNINA	NAMELOCAL	Καστανιά
NEO CHEIMONIO	NAMELOCAL	Νέο Χειμώνιο
KALLITHEA, LEMNOS	NAMELOCAL	Καλλιθέα
LECHOURI	NAMELOCAL	Λεχούρι
AGIOS DIMITRIOS, CEPHALONIA	NAMELOCAL	Άγιος Δημήτριος
PLIKATI	NAMELOCAL	Πληκάτι
NEOCHORI, EVROS	NAMELOCAL	Νεοχώρι
ARGYRA, GREECE	NAMELOCAL	Αργυρά
LIVADOCHORI, LEMNOS	NAMELOCAL	Λιβαδοχώρι
LIVARTZI	NAMELOCAL	Λιβάρτζι
KOUKOULI, IOANNINA	NAMELOCAL	Κουκούλι
GRANITSA, IOANNINA	NAMELOCAL	Γρανίτσα
KORFOS	NAMELOCAL	Κόρφος
PLAKA, ACHAEA	NAMELOCAL	Πλάκα
SELLA, GREECE	NAMELOCAL	Σελλά
MAGEIRAS	NAMELOCAL	Μάγειρας
POLYDORO	NAMELOCAL	Πολύδωρο
PITITSA	NAMELOCAL	Πιτίτσα
NYMFASIA	NAMELOCAL	Νυμφασία
VOURVOURA	NAMELOCAL	Βούρβουρα
SEIRES	NAMELOCAL	Σειρές
KIPOI, IOANNINA	NAMELOCAL	Κήποι
METHYDRIO	NAMELOCAL	Μεθύδριο
AMPELOKIPOI, ZAKYNTHOS	NAMELOCAL	Αμπελόκηποι
CHINKA, GREECE	NAMELOCAL	Χίνκα
TSEPELOVO	NAMELOCAL	Τσεπέλοβο
MONODENDRI, IOANNINA	NAMELOCAL	Μονοδένδρι
KOUPAKI, PHOCIS	NAMELOCAL	Κουπάκι
KALLIOPI, GREECE	NAMELOCAL	Καλλιόπη
PLATANI, ACHAEA	NAMELOCAL	Πλατάνι
PELAGOS	NAMELOCAL	Πέλαγος
MAGOULIANA	NAMELOCAL	Μαγούλιανα
ALTOMIRA	NAMELOCAL	Αλτομιρά
VOUTSARAS, IOANNINA	NAMELOCAL	Βουτσαράς
VROCHITSA	NAMELOCAL	Βροχίτσα
MEGALI MANTINEIA	NAMELOCAL	Μεγάλη Μαντίνεια
MIKRI MANTINEIA	NAMELOCAL	Μικρή Μαντίνεια
AGIA EFFIMIA	NAMELOCAL	Αγία Ευφημία
DIVARATA	NAMELOCAL	Διβαράτα
FISINI	NAMELOCAL	Φισίνη
VRACHATI	NAMELOCAL	Βραχάτι
SKAMNELI	NAMELOCAL	Σκαμνέλι
ZEVGOLATEIO, ARCADIA	NAMELOCAL	Ζευγολατείο
KAPESOVO	NAMELOCAL	Καπέσοβο
TYROS, GREECE	NAMELOCAL	Τυρός
ELATIA, DRAMA	NAMELOCAL	Ελατιά
DREPANO, ACHAEA	NAMELOCAL	Δρέπανο
AGIOS NIKOLAOS, THESPROTIA	NAMELOCAL	Άγιος Νικόλαος
AGIOS ALEXANDROS	NAMELOCAL	Άγιος Αλέξανδρος
ARTEMISIA, MESSENIA	NAMELOCAL	Αρτεμισία
STRIGKOS	NAMELOCAL	Στρίγκος
ILIOKALI	NAMELOCAL	Ηλιόκαλη
AGRAFA	NAMELOCAL	Άγραφα
RIZARI	NAMELOCAL	Ριζάρι
VALTOS, EVROS	NAMELOCAL	Βάλτος
MYRTIA, ELIS	NAMELOCAL	Μυρτιά
ELATOS, ARCADIA	NAMELOCAL	Έλατος
TITANI	NAMELOCAL	Τιτάνη
FTELIA, DRAMA	NAMELOCAL	Φτελιά
MAVRATA	NAMELOCAL	Μαυράτα
SYRNA	NAMELOCAL	Σύρνα
KASTRITSA	NAMELOCAL	Καστρίτσα
ASVESTADES	NAMELOCAL	Ασβεστάδες
FOURKA	NAMELOCAL	Φούρκα
SKOUROCHORI	NAMELOCAL	Σκουροχώρι
THOURIA, MESSENIA	NAMELOCAL	Θουρία
POURNARIA	NAMELOCAL	Πουρναριά
PRASINO, ARCADIA	NAMELOCAL	Πράσινο
AGIOS DIMITRIOS, ZAKYNTHOS	NAMELOCAL	Άγιος Δημήτριος
KRYOVRYSI, IOANNINA	NAMELOCAL	Κρυόβρυση
ASIMENIO	NAMELOCAL	Ασημένιο
LEVENTOCHORI, ELIS	NAMELOCAL	Λεβεντοχώρι
LOFOI	NAMELOCAL	Λόφοι
DIMITRA, ARCADIA	NAMELOCAL	Δήμητρα
SKOPOS	NAMELOCAL	Σκοπός
NEOCHORAKI, FLORINA	NAMELOCAL	Νεοχωράκι
PAPPAGIANNIS	NAMELOCAL	Παππαγιάννης
ITEA, FLORINA	NAMELOCAL	Ιτέα
STRATONI	NAMELOCAL	Στρατώνι
RAHLSTEDT	NAMELOCAL	RAHLSTEDT
VALIRA, GREECE	NAMELOCAL	Βαλύρα
ARTOPOULA	NAMELOCAL	Αρτοπούλα
KAMINIA, LEMNOS	NAMELOCAL	Καμίνια
KORAKOCHORI	NAMELOCAL	Κορακοχώρι
KANDILA, ARCADIA	NAMELOCAL	Κανδήλα
KARDARAS	NAMELOCAL	Καρδαράς
POULITHRA	NAMELOCAL	Πούλιθρα
GRIVA, KILKIS	NAMELOCAL	Γρίβα
SENIKO	NAMELOCAL	Σενίκο
KAROTI, EVROS	NAMELOCAL	Καρωτή
KALLONI, GREVENA	NAMELOCAL	Καλλονή
MONODENDRI, ACHAEA	NAMELOCAL	Μονοδένδρι
VRADETO	NAMELOCAL	Βραδέτο
LAKKOI	NAMELOCAL	Λάκκοι
KONTOPOULI	NAMELOCAL	Κοντοπούλι
THASOS	NAMELOCAL	Θάσος
SINTIKI	NAMELOCAL	Σιντική
MAVRANAIOI	NAMELOCAL	Μαυραναίοι
CHORISTI	NAMELOCAL	Χωριστή
MANDRES, KILKIS	NAMELOCAL	Μάνδρες
LAODIKINO	NAMELOCAL	Λαοδικινό
GALLIKOS KILKIS	NAMELOCAL	Γαλλικός
KAMPANIS	NAMELOCAL	Καμπάνης
PANTELEIMON, KILKIS	NAMELOCAL	Παντελεήμων
PERINTHOS, KILKIS	NAMELOCAL	Πέρινθος
PYRGOTOS	NAMELOCAL	Πυργωτός
PERISTERI, KILKIS	NAMELOCAL	Περιστέρι
FANARI, KILKIS	NAMELOCAL	Φανάρι
CHRYSOPETRA	NAMELOCAL	Χρυσόπετρα
NEA KORONI	NAMELOCAL	Νέα Κορώνη
XYLOKERA	NAMELOCAL	Ξυλοκέρα
ALPOCHORI, ELIS	NAMELOCAL	Αλποχώρι
ELAIOCHORI, ARCADIA	NAMELOCAL	Ελαιοχώρι
ANDROS	NAMELOCAL	Άνδρος
TINOS	NAMELOCAL	Τήνος
GYRI, ZAKYNTHOS	NAMELOCAL	Γύρι
ARGOS ORESTIKO	NAMELOCAL	Άργος Ορεστικό
KARDARITSI	NAMELOCAL	Καρδαρίτσι
ATHAMANIA, TRIKALA	NAMELOCAL	Αθαμανία
CHRYSOVITSI	NAMELOCAL	Χρυσοβίτσι
ANO GERAKARI	NAMELOCAL	Άνω Γερακάρι
CHOULIARADES	NAMELOCAL	Χουλιαράδες
PEROULADES	NAMELOCAL	Περουλάδες
DAFNI, LACONIA	NAMELOCAL	Δαφνί
FONAITIKA	NAMELOCAL	Φοναΐτικα
ANO PEDINA	NAMELOCAL	Άνω Πεδινά
PLATI, MESSENIA	NAMELOCAL	Πλάτη
POTAMOI, DRAMA	NAMELOCAL	Ποταμοί
MAVROCHORI, DRAMA	NAMELOCAL	Μαυροχώρι
KOUFOVOUNO	NAMELOCAL	Κουφόβουνο
EXOCHIKO, FILIATRA	NAMELOCAL	Εξοχικό
KATSAROS	NAMELOCAL	Κατσαρός
AGIOI DEKA	NAMELOCAL	Άγιοι Δέκα
LOUTRO, MESSENIA	NAMELOCAL	Λουτρό
KARATOULA, ELIS	NAMELOCAL	Καράτουλα
CHARIA	NAMELOCAL	Χαριά
GEROLIMENAS	NAMELOCAL	Γερολιμένας
IOLCOS	NAMELOCAL	Iωλκός
PRASINO, ELIS	NAMELOCAL	Πράσινο
VATHY, EUBOEA	NAMELOCAL	Βαθύ
RHODES	NAMELOCAL	Ρόδος
OLYMPIAKI AKTI	NAMELOCAL	Ολυμπιακή Ακτή
KASTANITSA	NAMELOCAL	Καστάνιτσα
PRASTOS	NAMELOCAL	Πραστός
PARALIO ASTROS	NAMELOCAL	Παράλιο Άστρος
VOGATSIKO	NAMELOCAL	Βογατσικό
KLINDIA	NAMELOCAL	Κλινδιά
KAFKONIA	NAMELOCAL	Καυκωνία
MAINALO, ARCADIA	NAMELOCAL	Μαίναλο
PALAIOKASTRO, HERAKLION	NAMELOCAL	Παλαιόκαστρο
KASTRI, THESPROTIA	NAMELOCAL	Καστρί
PSOFIDA	NAMELOCAL	Ψωφίδα
KALOI LIMENES	NAMELOCAL	Καλοί Λιμένες
NEA VRASNA	NAMELOCAL	Νέα Βρασνά
KEFALOVRYSO, TRIKALA	NAMELOCAL	Κεφαλόβρυσο
KATAVOTHRA	NAMELOCAL	LIGURAT
LEONTARI, BOEOTIA	NAMELOCAL	Λεοντάρι
KATSIKAS	NAMELOCAL	Κατσικάς
METAMORFOSI, LACONIA	NAMELOCAL	Μεταμόρφωση
SYKIA, LACONIA	NAMELOCAL	Συκιά
REPANIDI	NAMELOCAL	Κότσινος
ARCHANGELOS, LACONIA	NAMELOCAL	Αρχάγγελος
PARORI, BOEOTIA	NAMELOCAL	Παρόρι
SALMONI, ELIS	NAMELOCAL	Σαλμώνη
MINTHI	NAMELOCAL	Μίνθη
EPANO VATHEIA	NAMELOCAL	Επάνω Βάθεια
GONSENHEIM	NAMELOCAL	GUNSENUM
ZELI	NAMELOCAL	Ζέλι
SAMOS	NAMELOCAL	Σάμος
LOUTROCHORI, PELLA	NAMELOCAL	Λουτροχώρι
KILKIS	NAMELOCAL	Κιλκίς
OROPIOI	NAMELOCAL	Δήμος Ωρωπίων
NORTH TZOUMERKA	NAMELOCAL	Βόρεια Τζουμέρκα
POGONI	NAMELOCAL	Πωγώνι
CENTRAL TZOUMERKA	NAMELOCAL	Κεντρικά Τζουμέρκα
NIKOLAOS SKOUFAS	NAMELOCAL	Νικόλαος Σκουφάς
ZIROS, PREVEZA	NAMELOCAL	Ζηρός
FILOTHEI-PSYCHIKO	NAMELOCAL	Φιλοθέη-Ψυχικό
LYKOVRYSI-PEFKI	NAMELOCAL	Λυκόβρυση-Πεύκη
PAPAGOU-HOLARGOS	NAMELOCAL	Παπάγου-Χολαργός
AGIOI ANARGYROI-KAMATERO	NAMELOCAL	Άγιοι Ανάργυροι-Καματερό
FILADELFEIA-CHALKIDONA	NAMELOCAL	Φιλαδέλφεια-Χαλκηδόνα
DAFNI-YMITTOS	NAMELOCAL	Δάφνη-Υμηττός
ELLINIKO-ARGYROUPOLI	NAMELOCAL	Ελληνικό-Αργυρούπολη
MOSCHATO-TAVROS	NAMELOCAL	Μοσχάτο-Ταύρος
RAFINA-PIKERMI	NAMELOCAL	Ραφήνα-Πικέρμι
SARONIKOS, ATTICA	NAMELOCAL	Σαρωνικός
SPATA-ARTEMIDA	NAMELOCAL	Σπάτα-Αρτέμιδα
VARI-VOULA-VOULIAGMENI	NAMELOCAL	Βάρη-Βούλα-Βουλιαγμένη
KERATSINI-DRAPETSONA	NAMELOCAL	Κερατσίνι-Δραπετσώνα
NIKAIA-AGIOS IOANNIS RENTIS	NAMELOCAL	Νίκαια-Άγιος Ιωάννης Ρέντης
TROIZINIA-METHANA	NAMELOCAL	Τροιζηνία-Μέθανα
MANDRA-EIDYLLIA	NAMELOCAL	Μάνδρα-Ειδύλλια
DISTOMO-ARACHOVA-ANTIKYRA	NAMELOCAL	Δίστομο-Αράχοβα-Αντίκυρα
DIRFYS-MESSAPIA	NAMELOCAL	Δίρφυς-Μεσσάπια
ISTIAIA-AIDIPSOS	NAMELOCAL	Ιστιαία-Αιδηψός
KYMI-ALIVERI	NAMELOCAL	Κύμη-Αλιβέρι
MANTOUDI-LIMNI-AGIA ANNA	NAMELOCAL	Μαντούδι-Λίμνη-Αγία Άννα
LOKROI	NAMELOCAL	Λοκροί
AMFIKLEIA-ELATEIA	NAMELOCAL	Δήμος Αμφίκλειας-Ελάτειας
MOLOS-AGIOS KONSTANTINOS	NAMELOCAL	Μώλος-Άγιος Κωνσταντίνος
NEA PROPONTIDA	NAMELOCAL	Νέα Προποντίδα
ARISTOTELIS	NAMELOCAL	Αριστοτέλης
PAIONIA	NAMELOCAL	Παιονία
PYDNA-KOLINDROS	NAMELOCAL	Πύδνα-Κολινδρός
DIO-OLYMPOS	NAMELOCAL	Δίο-Όλυμπος
DELTA, THESSALONIKI	NAMELOCAL	Δέλτα
AMPELOKIPOI-MENEMENI	NAMELOCAL	Αμπελόκηποι-Μενεμένη
KORDELIO-EVOSMOS	NAMELOCAL	Κορδελιό-Εύοσμος
NEAPOLI-SYKIES	NAMELOCAL	Νεάπολη-Συκιές
PAVLOS MELAS	NAMELOCAL	Παύλος Μελάς
PYLAIA-CHORTIATIS	NAMELOCAL	Πυλαία-Χορτιάτης
VOLVI	NAMELOCAL	Βόλβη
NESTOS	NAMELOCAL	Νέστος
MARONEIA-SAPES	NAMELOCAL	Μαρώνεια-Σάπες
KANTANOS-SELINO	NAMELOCAL	Κάντανος-Σέλινο
ARCHANES-ASTEROUSIA	NAMELOCAL	Αρχάνες-Αστερούσια
FAISTOS	NAMELOCAL	Φαιστός
MINOA PEDIADA	NAMELOCAL	Μινώα Πεδιάδα
MALEVIZI	NAMELOCAL	Μαλεβίζι
AMARI	NAMELOCAL	Αμάρι
AGIOS VASILEIOS, RETHYMNO	NAMELOCAL	Άγιος Βασίλειος
MYLOPOTAMOS, CRETE	NAMELOCAL	Μυλοπόταμος
NAXOS AND LESSER CYCLADES	NAMELOCAL	Νάξος και Μικρές Κυκλάδες
SOUTH KYNOURIA	NAMELOCAL	Νότια Κυνουρία
ERMIONIDA	NAMELOCAL	Ερμιονίδα
ARGOS-MYKINES	NAMELOCAL	Άργος-Μυκήνες
XYLOKASTRO-EVROSTINA	NAMELOCAL	Ξυλόκαστρο-Ευρωστίνα
LOUTRAKI-PERACHORA-AGIOI THEODOROI	NAMELOCAL	Λουτράκι-Περαχώρα-Άγιοι Θεόδωροι
VELO-VOCHA	NAMELOCAL	Βέλο-Βόχα
EVROTAS	NAMELOCAL	Ευρώτας
TRIFYLIA	NAMELOCAL	Τριφυλία
PYLOS-NESTOR	NAMELOCAL	Δήμος Πύλου - Νέστορος
WEST MANI	NAMELOCAL	Δυτική Μάνη
LAKE PLASTIRAS	NAMELOCAL	Λίμνη Πλαστήρα
TEMPI	NAMELOCAL	Τέμπη
ZAGORA-MOURESI	NAMELOCAL	Ζαγορά-Μουρέσι
SOUTH PELION	NAMELOCAL	Νότιο Πήλιο
RIGAS FERAIOS	NAMELOCAL	Ρήγας Φεραίος
ERYMANTHOS	NAMELOCAL	Ερύμανθος
WEST ACHAEA	NAMELOCAL	Δυτική Αχαΐα
AKTIO-VONITSA	NAMELOCAL	Άκτιο-Βόνιτσα
XIROMERO	NAMELOCAL	Ξηρόμερο
ILIDA	NAMELOCAL	Ήλιδα
ANDRAVIDA-KYLLINI	NAMELOCAL	Ανδραβίδα-Κυλλήνη
ANDRITSAINA-KRESTENA	NAMELOCAL	Ανδρίτσαινα-Κρέστενα
PINEIOS	NAMELOCAL	Πηνειός
VOIO	NAMELOCAL	Βόιο
SERVIA-VELVENTOS	NAMELOCAL	Σέρβια-Βελβεντός
LERNA	NAMELOCAL	Λέρνα
VYTHOS	NAMELOCAL	Βυθὀς
AGIOI THEODOROI, KOZANI	NAMELOCAL	Άγιοι Θεόδωροι
ARGYROPOULI	NAMELOCAL	Αργυροπούλι
VELESTINO	NAMELOCAL	Βελεστίνο
ASPROCHOMA, LARISSA	NAMELOCAL	Ασπρόχωμα
PALAIA EPIDAVROS	NAMELOCAL	Παλαιά Επίδαυρος
KYMI, GREECE	NAMELOCAL	Κύμη
KLADAS, GREECE	NAMELOCAL	Κλαδάς
NEOI POROI	NAMELOCAL	Νέοι Πόροι
ARISTODIMIO	NAMELOCAL	Αριστοδήμειον
ARSINOI	NAMELOCAL	Αρσινόη
METAXOCHORI	NAMELOCAL	Μεταξοχώρι
POTAMIA, AGIA	NAMELOCAL	Ποταμιά
SKOTINA	NAMELOCAL	Σκοτίνα
KARITSA, PIERIA	NAMELOCAL	Καρίτσα
PLATANAKIA	NAMELOCAL	Πλατανάκια
NEA EFESOS	NAMELOCAL	Νέα Έφεσος
RETHYMNO	NAMELOCAL	Ρέθυμνο
BRALOS	NAMELOCAL	Μπράλος
KALYVIA ANALIPSEOS	NAMELOCAL	Καλύβια Αναλήψεως
RIGIO	NAMELOCAL	Ρήγιο
BETTRINGEN	NAMELOCAL	BETTRINGEN
AGIOS NIKOLAOS, VOIES	NAMELOCAL	Άγιος Νικόλαος
SIRIKARI	NAMELOCAL	Σηρικάρι
KATO TITHOREA	NAMELOCAL	Κάτω Τιθορέα
PETRALONA, CHALKIDIKI	NAMELOCAL	Πετράλωνα
AKRAIFNIO	NAMELOCAL	Ακραίφνιο
KOUKLIOI	NAMELOCAL	Κουκλιοί
RETHYMNO	NAMELOCAL	Ρέθυμνο
CHROMONASTIRI	NAMELOCAL	Χρωμοναστήρι
ROUSTIKA	NAMELOCAL	Ρούστικα
MAROULAS	NAMELOCAL	Μαρουλάς
ROUSSOSPITI	NAMELOCAL	Ρουσσοσπίτι
AMNATOS	NAMELOCAL	Αμνάτος
ATSIPOPOULO	NAMELOCAL	Ατσιπόπουλο
PIGI, RETHYMNO	NAMELOCAL	Πηγή
GERANI, RETHYMNO	NAMELOCAL	Γεράνι
MYRIOKEFALA	NAMELOCAL	Μυριοκέφαλα
NENITA	NAMELOCAL	Νένητα
MYLI, RETHYMNO	NAMELOCAL	Μύλοι
TELENDOS	NAMELOCAL	Τέλενδος
ARMENOCHORI, GREECE	NAMELOCAL	Αρμενοχώρι
NIKITI	NAMELOCAL	Νικήτη
KARFAS	NAMELOCAL	Καρφάς
PALAIOCHORI, LESBOS	NAMELOCAL	Παλαιοχώρι
MOUSIOTITSA	NAMELOCAL	Μουσιωτίτσα
ARCHAIES KLEONES	NAMELOCAL	Αρχαίες Κλεωνές
IMEROS	NAMELOCAL	Ίμερος
SPARMOS	NAMELOCAL	Σπαρμός
KAMEIROS	NAMELOCAL	Κάμειρος
LEGRENA	NAMELOCAL	Λεγρενά
AKONTIO	NAMELOCAL	Ακόντιο
MOSCHOPOTAMOS	NAMELOCAL	Μοσχοπόταμος
MOSCHOCHORI, PIERIA	NAMELOCAL	Μοσχοχώρι
ARONAS	NAMELOCAL	Αρωνάς
KATALONIA	NAMELOCAL	Καταλώνια
KALLITHEA, PIERIA	NAMELOCAL	Καλλιθέα
AGIOS DIMITRIOS, PIERIA	NAMELOCAL	Άγιος Δημήτριος
RITINI	NAMELOCAL	Ρητίνη
VRIA	NAMELOCAL	Βρία
PERISTASI, PIERIA	NAMELOCAL	Περίσταση
PALAIO KERAMIDI	NAMELOCAL	Παλαιό Κεραμίδι
TRILOFOS, PIERIA	NAMELOCAL	Τρίλοφος
NEOKAISAREIA, PIERIA	NAMELOCAL	Νεοκαισάρεια
KATO AGIOS IOANNIS	NAMELOCAL	Κάτω Άγιος Ιωάννης
LAGORRACHI	NAMELOCAL	Λαγόρραχη
MELIADI	NAMELOCAL	Μελιάδι
MILIA, PIERIA	NAMELOCAL	Μηλιά
FOTEINA	NAMELOCAL	Φωτεινά
LOFOS, PIERIA	NAMELOCAL	Λόφος
KOUKKOS, PIERIA	NAMELOCAL	Κούκκος
PANTELEIMONAS, PIERIA	NAMELOCAL	Παντελεήμονας
ANO AGIOS IOANNIS	NAMELOCAL	Άνω Άγιος Ιωάννης
SVORONOS	NAMELOCAL	Σβορώνος
NEA TRAPEZOUNTA, PIERIA	NAMELOCAL	Νέα Τραπεζούντα
PISTAMATA	NAMELOCAL	Πιστάματα
SEVASTI	NAMELOCAL	Σεβαστή
EXOCHI, PIERIA	NAMELOCAL	Εξοχή
KATACHAS	NAMELOCAL	Καταχάς
LOURES, HERAKLION	NAMELOCAL	Λούρες
PIRAMA, CHIOS	NAMELOCAL	Πιραμά
MAKRYGIALOS, PIERIA	NAMELOCAL	Μακρύγιαλος
LIVADI, PIERIA	NAMELOCAL	Λιβάδι
VARVARA, CHALKIDIKI	NAMELOCAL	Βαρβάρα
ALIMIA	NAMELOCAL	Αλιμιά
NIMOS	NAMELOCAL	Νίμος
STAVROS, LARISSA	NAMELOCAL	Σταυρός
KALCHAS, RHODOPE	NAMELOCAL	Κάλχας
MEGALI PANAGIA, CHALKIDIKI	NAMELOCAL	Μεγάλη Παναγιά
LIANOVERGI	NAMELOCAL	Λιανοβέργι
OINOI, BOEOTIA	NAMELOCAL	Οινόη
KALOCHORI-PANTEICHI	NAMELOCAL	Καλοχώρι-Παντείχι
OMALOS	NAMELOCAL	Ομαλός
SPILI	NAMELOCAL	Σπήλι
AGIA GALINI	NAMELOCAL	Αγία Γαλήνη
IERAKAS	NAMELOCAL	Γέρακας
PALAIO ELEFTHEROCHORI	NAMELOCAL	Παλαιό Ελευθεροχώρι
SFENDAMI	NAMELOCAL	Σφενδάμι
ALONIA, PIERIA	NAMELOCAL	Αλώνια
RYAKIA	NAMELOCAL	Ρυάκια
NEA AGATHOUPOLI	NAMELOCAL	Νέα Αγαθούπολη
PALAIOSTANI	NAMELOCAL	Παλαιόστανη
NEO KERAMIDI	NAMELOCAL	Νέο Κεραμίδι
ANATOLIKO, KOZANI	NAMELOCAL	Ανατολικό
KAPNOCHORI	NAMELOCAL	Καπνοχώρι
PERDIKKAS, KOZANI	NAMELOCAL	Περδίκκας
MESOVOUNO	NAMELOCAL	Μεσόβουνο
PYRGOI	NAMELOCAL	Πύργοι
KATAFYGIO, KOZANI	NAMELOCAL	Καταφύγιο
GALATINI	NAMELOCAL	Γαλατινή
NAMATA, KOZANI	NAMELOCAL	Νάματα
SISANI	NAMELOCAL	Σισάνι
MIKROKASTRO	NAMELOCAL	Μικρόκαστρο
DRYOVOUNO	NAMELOCAL	Δρυόβουνο
PEPONIA, KOZANI	NAMELOCAL	Πεπονιά
MESOLONGOS	NAMELOCAL	Μεσόλογγος
LEFKOTHEA, KOZANI	NAMELOCAL	Λευκοθέα
RODITIS, KOZANI	NAMELOCAL	Ροδίτης
MIKROVALTO	NAMELOCAL	Μικρόβαλτο
POLYFYTO	NAMELOCAL	Πολύφυτο
MOLOCHA, KOZANI	NAMELOCAL	Μολόχα
PERISTERA, KOZANI	NAMELOCAL	Περιστέρα
PLATANIA, KOZANI	NAMELOCAL	Πλατανιά
POLYLAKKO	NAMELOCAL	Πολύλακκο
PYLORIO	NAMELOCAL	Πυλώριο
SIMANTRO	NAMELOCAL	Σήμαντρο
SKALOCHORI	NAMELOCAL	Σκαλοχώρι
VOUCHORINA	NAMELOCAL	Βουχωρίνα
KLEISOREIA	NAMELOCAL	Κλεισώρεια
STAVRODROMI, KOZANI	NAMELOCAL	Σταυροδρόμι
OMALI, KOZANI	NAMELOCAL	Ομαλή
POLYKASTANO	NAMELOCAL	Πολυκάστανο
LOUVRI	NAMELOCAL	Λούβρη
LOUKOMI	NAMELOCAL	Λουκόμι
PLAKIDA	NAMELOCAL	Πλακίδα
MORFI, KOZANI	NAMELOCAL	Μόρφη
AGIASMA, KOZANI	NAMELOCAL	Αγίασμα
VELANIDIA, KOZANI	NAMELOCAL	Βελανιδιά
VRONTI	NAMELOCAL	Βροντή
TRAPEZITSA	NAMELOCAL	Τραπεζίτσα
PALAIOKASTRO, KOZANI	NAMELOCAL	Παλαιόκαστρο
MEGALI GEFYRA	NAMELOCAL	Μεγάλη Γέφυρα
RACHI, PIERIA	NAMELOCAL	Ράχη
POROI	NAMELOCAL	Πόροι
PALIAMPELA, PIERIA	NAMELOCAL	Παλιάμπελα
NEA CHRANI	NAMELOCAL	Νέα Χράνη
FTERI, PIERIA	NAMELOCAL	Φτέρη
ANDROMACHI	NAMELOCAL	Ανδρομάχη
PETRA, BOEOTIA	NAMELOCAL	Πέτρα
LIVERA, KOZANI	NAMELOCAL	Λιβερά
KATO KOMI	NAMELOCAL	Κάτω Κώμη
MILEA, KOZANI	NAMELOCAL	Μηλέα
SPARTO, KOZANI	NAMELOCAL	Σπάρτο
EXOCHI, KOZANI	NAMELOCAL	Εξοχή
TETRALOFO	NAMELOCAL	Τετράλοφο
RYAKI, KOZANI	NAMELOCAL	Ρυάκι
VOSKOCHORI	NAMELOCAL	Βοσκοχώρι
KASTRI, PREVEZA	NAMELOCAL	Καστρί
DOLICHI	NAMELOCAL	Δολίχη
TOXO, PIERIA	NAMELOCAL	Τόξο
KARYES, PIERIA	NAMELOCAL	Καρυές
MIKRI MILIA, PIERIA	NAMELOCAL	Μικρή Μηλιά
PROSILIO, PIERIA	NAMELOCAL	Προσήλιο
PLAKA, PIERIA	NAMELOCAL	Πλάκα
KONTOVOUNI	NAMELOCAL	Κοντοβούνι
KAISAREIA, KOZANI	NAMELOCAL	Καισάρεια
POLYMYLOS	NAMELOCAL	Πολύμυλος
SIDERAS	NAMELOCAL	Σιδεράς
KOILADA, KOZANI	NAMELOCAL	Κοιλάδα
LEFKARA, KOZANI	NAMELOCAL	Λεύκαρα
KLEITOS, KOZANI	NAMELOCAL	Κλείτος
PYRGOS, GARGALIANOI	NAMELOCAL	Πύργος Τριφυλίας
GERAKAROU	NAMELOCAL	Γερακαρού
VASILOUDI	NAMELOCAL	Βασιλούδι
AGIOS VASILEIOS, THESSALONIKI	NAMELOCAL	Άγιος Βασίλειος
OSSA, THESSALONIKI	NAMELOCAL	Όσσα
ADAM, THESSALONIKI	NAMELOCAL	Αδάμ
ZAGLIVERI	NAMELOCAL	Ζαγκλιβέρι
PALIOI POROI	NAMELOCAL	Παλιοί Πόροι
SKOTEINA	NAMELOCAL	Σκοτεινά
ALYKI, PIERIA	NAMELOCAL	Αλυκή
KITROS	NAMELOCAL	Κίτρος
IRAKLEIO, THESSALONIKI	NAMELOCAL	Ηράκλειο
KAVALLARI, THESSALONIKI	NAMELOCAL	Καβαλλάρι
KAVALLARI, IOANNINA	NAMELOCAL	Καβαλλάρι
PERIVOLAKI, THESSALONIKI	NAMELOCAL	Περιβολάκι
CHRYSAVGI, THESSALONIKI	NAMELOCAL	Χρυσαυγή
LAGYNA	NAMELOCAL	Λαγυνά
ANALIPSI, THESSALONIKI	NAMELOCAL	Ανάληψη
KRITHIA, THESSALONIKI	NAMELOCAL	Κριθιά
PETROKERASA	NAMELOCAL	Πετροκέρασα
NEA KALLINDOIA	NAMELOCAL	Νέα Καλλίνδοια
KALYVIA VARIKOU	NAMELOCAL	Καλύβια Βαρικου
MESOKOMO	NAMELOCAL	Μεσόκωμο
KALAMOTO	NAMELOCAL	Καλαμωτό
KRYONERI, THESSALONIKI	NAMELOCAL	Κρυονέρι
PARALIA KORINOU	NAMELOCAL	Παραλία Κορινού
KARTERES	NAMELOCAL	Καρτερές
KOLCHIKO	NAMELOCAL	Κολχικό
ANILIO, IOANNINA	NAMELOCAL	Ανήλιο
OSSA, LARISSA	NAMELOCAL	Όσσα
LOFISKOS, THESSALONIKI	NAMELOCAL	Λοφίσκος
EXALOFOS, THESSALONIKI	NAMELOCAL	Εξάλοφος
AGIA VARVARA, PIERIA	NAMELOCAL	Αγία Βαρβάρα
PENTE VRYSES	NAMELOCAL	Πέντε Βρύσες
POLYDENDRI, THESSALONIKI	NAMELOCAL	Πολυδένδρι
SARAKINA, THESSALONIKI	NAMELOCAL	Σαρακήνα
AGIOS CHARALAMBOS, THESSALONIKI	NAMELOCAL	Άγιος Χαράλαμπος
AVGI, THESSALONIKI	NAMELOCAL	Αυγή
NIKOPOLI, THESSALONIKI	NAMELOCAL	Νικόπολη
AGIANNIS, PIERIA	NAMELOCAL	Αγιάννης
KATO MILIA	NAMELOCAL	Κάτω Μηλιά
XYLOPOLI	NAMELOCAL	Ξυλόπολη
PLAGIARI, THESSALONIKI	NAMELOCAL	Πλαγιάρι
LEFKOCHORI, THESSALONIKI	NAMELOCAL	Λευκοχώρι
KARDIA, THESSALONIKI	NAMELOCAL	Καρδιά
KATO SCHOLARI	NAMELOCAL	Κάτω Σχολάρι
TAGARADES	NAMELOCAL	Ταγαράδες
NEO RYSIO	NAMELOCAL	Νέο Ρύσιο
PERISTERA, THESSALONIKI	NAMELOCAL	Περιστερά
AGIA PARASKEVI, THESSALONIKI	NAMELOCAL	Αγία Παρασκευή
AGIOS ANTONIOS, THESSALONIKI	NAMELOCAL	Άγιος Αντώνιος
MONOPIGADO	NAMELOCAL	Μονοπήγαδο
NEA RAIDESTOS	NAMELOCAL	Νέα Ραιδεστός
FILOTHEI, THESSALONIKI	NAMELOCAL	Φιλοθέη
LAKKIA, THESSALONIKI	NAMELOCAL	Λακκιά
DRAKONTIO	NAMELOCAL	Δρακόντιο
MELISSOURGOS	NAMELOCAL	Μελισσουργός
NIKOMIDINO	NAMELOCAL	Νικομηδινό
STIVOS	NAMELOCAL	Στίβος
EVANGELISMOS, THESSALONIKI	NAMELOCAL	Ευαγγελισμός
STAVROS, THESSALONIKI	NAMELOCAL	Σταυρός
ANO STAVROS	NAMELOCAL	Άνω Σταυρός
SCHOLARI	NAMELOCAL	Σχολάρι
POTHIA	NAMELOCAL	Πόθια
NEA MADYTOS	NAMELOCAL	Νέα Μάδυτος
MAVROUDA	NAMELOCAL	Μαυρούδα
ANO MILIA, PIERIA	NAMELOCAL	Άνω Μηλιά
NYMFOPETRA	NAMELOCAL	Νυμφόπετρα
MODI, THESSALONIKI	NAMELOCAL	Μόδι
PROFITIS	NAMELOCAL	Προφήτης
SKEPASTO, THESSALONIKI	NAMELOCAL	Σκεπαστό
NEA KARVALI	NAMELOCAL	Νέα Καρβάλη
MAKRINO	NAMELOCAL	Μακρίνο
FLAMBOURARI	NAMELOCAL	Φλαμπουράρι
GREVENITI	NAMELOCAL	Γρεβενίτι
TRISTENO	NAMELOCAL	Τρίστενο
KASTANONAS	NAMELOCAL	Καστανώνας
ELATOCHORI, IOANNINA	NAMELOCAL	Ελατοχώρι
DILAKKO	NAMELOCAL	Δίλακκο
DOLIANI	NAMELOCAL	Δόλιανη
LIMENAS LITOCHOROU	NAMELOCAL	Λιμένας Λιτοχώρου
OCHTHIA, AETOLIA-ACARNANIA	NAMELOCAL	Όχθια
GOURIOTISSA	NAMELOCAL	Γουριώτισσα
PALAIOMANINA	NAMELOCAL	Παλαιομάνινα
AGRAMPELA, AETOLIA-ACARNANIA	NAMELOCAL	Αγράμπελα
STRONGYLOVOUNI	NAMELOCAL	Στρογγυλοβούνι
MANINA VLIZIANON	NAMELOCAL	Μάνινα Βλιζιανών
PSARADES	NAMELOCAL	Ψαράδες
ELEFTHERES, LARISSA	NAMELOCAL	Ελευθερές Λάρισας
STEFANINA, THESSALONIKI	NAMELOCAL	Στεφανινά
FILADELFIO	NAMELOCAL	Φιλαδέλφιο
APOLLONIA, MADYTOS	NAMELOCAL	Απολλωνία
VOLVI, THESSALONIKI	NAMELOCAL	Βόλβη
AGIOS DIMITRIOS, DIO-OLYMPOS	NAMELOCAL	Άγιος Δημήτριος
AGIA PARASKEVI, ASPROPOTAMOS	NAMELOCAL	Αγία Παρασκευή
STEFANI, TRIKALA	NAMELOCAL	Στεφάνι
POLYTHEA, TRIKALA	NAMELOCAL	Πολυθέα
NEA APOLLONIA	NAMELOCAL	Νέα Απολλωνία
PERISTERONA, THESSALONIKI	NAMELOCAL	Περιστερώνα
KOUMARIA, IMATHIA	NAMELOCAL	Κουμαριά
PENTALOFOS, THESSALONIKI	NAMELOCAL	Πεντάλοφος
VOURVOUROU	NAMELOCAL	Βουρβουρού
NEA FILADELFEIA, THESSALONIKI	NAMELOCAL	Νέα Φιλαδέλφεια
MELISSOCHORI, THESSALONIKI	NAMELOCAL	Μελισσοχώρι
MESAIO	NAMELOCAL	Μεσαίο
DRYMOS, THESSALONIKI	NAMELOCAL	Δρυμός
KALOCHORI, THESSALONIKI	NAMELOCAL	Καλοχώρι
KYMINA	NAMELOCAL	Κύμινα
NEA MALGARA	NAMELOCAL	Νέα Μάλγαρα
VRACHIA	NAMELOCAL	Βραχιά
ANATOLIKO, THESSALONIKI	NAMELOCAL	Ανατολικό
NEA MAGNISIA	NAMELOCAL	Νέα Μαγνησία
DIAVATA	NAMELOCAL	Διαβατά
EXOCHI, THESSALONIKI	NAMELOCAL	Εξοχή
ASVESTOCHORI, THESSALONIKI	NAMELOCAL	Ασβεστοχώρι
GEFYRA, THESSALONIKI	NAMELOCAL	Γέφυρα
ANCHIALOS, THESSALONIKI	NAMELOCAL	Αγχίαλος
VATHYLAKKOS, THESSALONIKI	NAMELOCAL	Βαθύλακκος
PARTHENI, THESSALONIKI	NAMELOCAL	Παρθένι
VALTOCHORI	NAMELOCAL	Βαλτοχώρι
ELEOUSA, THESSALONIKI	NAMELOCAL	Ελεούσα
PROCHOMA	NAMELOCAL	Πρόχωμα
AGIA TRIADA, THESSALONIKI	NAMELOCAL	Αγία Τριάδα
MIKRO MONASTIRI	NAMELOCAL	Μικρό Μοναστήρι
NEA KERASIA	NAMELOCAL	Νέα Κερασιά
MESIMERI, THESSALONIKI	NAMELOCAL	Μεσημέρι
KATAKALI, GREVENA	NAMELOCAL	Κατάκαλη
PARASKEVI, GREVENA	NAMELOCAL	Παρασκευή
KARPERO	NAMELOCAL	Καρπερό
KYLLINI, ELIS	NAMELOCAL	Κυλλήνη
PANAGIA, GREVENA	NAMELOCAL	Παναγία
TRIKOKKIA	NAMELOCAL	Τρικοκκιά
DIMITRA, GREVENA	NAMELOCAL	Δήμητρα
TRIFYLLI, GREVENA	NAMELOCAL	Τριφύλλι
ANOIXI, GREVENA	NAMELOCAL	Άνοιξη
GILOFOS	NAMELOCAL	Γήλοφος
KRANEA, GREVENA	NAMELOCAL	Κρανέα
KALLITHEA, GREVENA	NAMELOCAL	Καλλιθέα
PRIONIA, GREVENA	NAMELOCAL	Πριόνια
KIPOUREIO	NAMELOCAL	Κηπουρείο
PIGADITSA	NAMELOCAL	Πηγαδίτσα
MIKROLIVADO	NAMELOCAL	Μικρολίβαδο
SITARAS	NAMELOCAL	Σιταράς
POLYNERI, GREVENA	NAMELOCAL	Πολυνέρι
LAVDAS	NAMELOCAL	Λάβδας
PANORAMA, GREVENA	NAMELOCAL	Πανόραμα
MONACHITI	NAMELOCAL	Μοναχίτι
PROSVORRO	NAMELOCAL	Πρόσβορρο
SPILAIO, GREVENA	NAMELOCAL	Σπήλαιο
ALATOPETRA	NAMELOCAL	Αλατόπετρα
KOSMATI	NAMELOCAL	Κοσμάτι
ANAVRYTA, GREVENA	NAMELOCAL	Αναβρυτά
PERIVOLAKI, GREVENA	NAMELOCAL	Περιβολάκι
ZAKAS	NAMELOCAL	Ζάκας
STAVROS, GREVENA	NAMELOCAL	Σταυρός
MAVRONOROS, GREVENA	NAMELOCAL	Μαυρονόρος
MAVRONOROS, IOANNINA	NAMELOCAL	Μαυρονόρος
EXARCHOS, GREVENA	NAMELOCAL	Έξαρχος
VARIS, GREVENA	NAMELOCAL	Βάρης
KENTRO, GREVENA	NAMELOCAL	Κέντρο
AGALAIOI	NAMELOCAL	Αγαλαίοι
NISI, GREVENA	NAMELOCAL	Νησί
KNIDI	NAMELOCAL	Κνίδη
ITEA, GREVENA	NAMELOCAL	Ιτέα
MIKROKLEISOURA, GREVENA	NAMELOCAL	Μικροκλεισούρα
PISTIKO	NAMELOCAL	Πιστικό
POROS, GREVENA	NAMELOCAL	Πόρος
PALAIOCHORI, GREVENA	NAMELOCAL	Παλαιοχώρι
PONTINI	NAMELOCAL	Ποντινή
PYLOROI	NAMELOCAL	Πυλωροί
SARAKINA, GREVENA	NAMELOCAL	Σαρακήνα
DIPORO, GREVENA	NAMELOCAL	Δίπορο
NEOCHORI, GREVENA	NAMELOCAL	Νεοχώρι
AGIOS GEORGIOS, GREVENA	NAMELOCAL	Άγιος Γεώργιος
KIVOTOS	NAMELOCAL	Κιβωτός
TAXIARCHIS, GREVENA	NAMELOCAL	Ταξιάρχης
POLYDENDRO, GREVENA	NAMELOCAL	Πολύδενδρο
KLIMATAKI	NAMELOCAL	Κληματάκι
KOKKINIA, GREVENA	NAMELOCAL	Κοκκινιά
NEA FIGALEIA	NAMELOCAL	Νέα Φιγαλεία
VRASNA	NAMELOCAL	Βρασνά
NEA TRAPEZOUNTA, GREVENA	NAMELOCAL	Νέα Τραπεζούντα
AIDONIA, GREVENA	NAMELOCAL	Αηδόνια
DASAKI	NAMELOCAL	Δασάκι
KALIRACHI, GREVENA	NAMELOCAL	Καληράχη
MEGARO	NAMELOCAL	Μέγαρο
KYPARISSI, GREVENA	NAMELOCAL	Κυπαρίσσι
OROPEDIO, GREVENA	NAMELOCAL	Οροπέδιο
LEIPSI	NAMELOCAL	Λείψι
KYDONIES, GREVENA	NAMELOCAL	Κυδωνιές
EKKLISIA, GREVENA	NAMELOCAL	Εκκλησία
ANO EKKLISIA	NAMELOCAL	Άνω Εκκλησία
VATOLAKKOS, GREVENA	NAMELOCAL	Βατόλακκος
KYRAKALI	NAMELOCAL	Κυρακαλή
RODIA, GREVENA	NAMELOCAL	Ροδιά
SYNDENDRO	NAMELOCAL	Σύνδενδρο
FELLI, GREVENA	NAMELOCAL	Φελλί
ELEFTHEROCHORI, GREVENA	NAMELOCAL	Ελευθεροχώρι
MEGALO SEIRINI	NAMELOCAL	Μεγάλο Σειρήνι
MIKRO SEIRINI	NAMELOCAL	Μικρό Σειρήνι
KRYONERI, CORINTHIA	NAMELOCAL	Κρυονέρι
ELEFTHERO, GREVENA	NAMELOCAL	Ελεύθερο
ELEFTHERO PROSFYGON	NAMELOCAL	Ελεύθερο Προσφύγων
STENI DIRFYOS	NAMELOCAL	Στενή Δίρφυος
MYRSINA, GREVENA	NAMELOCAL	Μυρσίνα
ASPROKAMPOS, GREVENA	NAMELOCAL	Απρόκαμπος
PSACHNA	NAMELOCAL	Ψαχνά
LARYMNA	NAMELOCAL	Λάρυμνα
PYRGADIKIA	NAMELOCAL	Πυργαδίκια
NEAPOLI VOION	NAMELOCAL	Νεάπολη Βοιών
SELLI, RETHYMNO	NAMELOCAL	Σελλί
AIMILIANOS, GREVENA	NAMELOCAL	Αιμιλιανός
DESPOTIS, GREVENA	NAMELOCAL	Δεσπότης
ANTHRAKIA	NAMELOCAL	Ανθρακιά
AGIOI THEODOROI, GREVENA	NAMELOCAL	Άγιοι Θεόδωροι
EPTALOFOS, PHOCIS	NAMELOCAL	Επτάλοφος
KASTRO, GREVENA	NAMELOCAL	Κάστρο
ELATOS, GREVENA	NAMELOCAL	Έλατος
AMYGDALIES, GREVENA	NAMELOCAL	Αμυγδαλιές
POLYDROSOS	NAMELOCAL	Πολύδροσος
ALYKI, BOEOTIA	NAMELOCAL	Αλυκή
KALOCHI	NAMELOCAL	Καλόχι
AGIOS GEORGIOS, DESKATI	NAMELOCAL	Άγιος Γεώργιος
DIASELLAKI	NAMELOCAL	Διασελλάκι
AGAPI, GREVENA	NAMELOCAL	Αγάπη
MESOLAKKOS	NAMELOCAL	Μεσόλακκος
DOXARAS	NAMELOCAL	Δοξαράς
KALAMITSI, GREVENA	NAMELOCAL	Καλαμίτσι
GALINI, THESSALONIKI	NAMELOCAL	Γαλήνη
LOUDIAS, THESSALONIKI	NAMELOCAL	Λουδίας
DORKADA, THESSALONIKI	NAMELOCAL	Δορκάδα
MAVRORRACHI, THESSALONIKI	NAMELOCAL	Μαυρορράχη
STEFANIA, THESSALONIKI	NAMELOCAL	Στεφάνια
MIKRI VOLVI	NAMELOCAL	Μικρή Βόλβη
MEGALI VOLVI	NAMELOCAL	Μεγάλη Βόλβη
VAMVAKIA, THESSALONIKI	NAMELOCAL	Βαμβακιά
LIMNI, THESSALONIKI	NAMELOCAL	Λίμνη
ANOIXIA	NAMELOCAL	Ανοιξιά
XIROPOTAMOS, THESSALONIKI	NAMELOCAL	Ξηροπόταμος
LEFKOUDA	NAMELOCAL	Λευκούδα
MESOPOTAMO, THESSALONIKI	NAMELOCAL	Μεσοπόταμο
LOUTRA VOLVIS	NAMELOCAL	Λουτρά Βόλβης
SPITAKIA, THESSALONIKI	NAMELOCAL	Σπιτάκια
PLATEIA, THESSALONIKI	NAMELOCAL	Πλατεία
KATOCHI	NAMELOCAL	Κατοχή
PETROTO, THESSALONIKI	NAMELOCAL	Πετρωτό
MONOLOFO	NAMELOCAL	Μονόλοφο
KOKKALOU	NAMELOCAL	Κοκκαλού
CHOROUDA	NAMELOCAL	Χωρούδα
ARETI, THESSALONIKI	NAMELOCAL	Αρετή
AKROPOTAMOS, THESSALONIKI	NAMELOCAL	Ακροπόταμος
KASTANAS	NAMELOCAL	Καστανάς
KATO STEFANINA	NAMELOCAL	Κάτω Στεφανινά
MIKROKOMI	NAMELOCAL	Μικροκώμη
VAIOCHORI	NAMELOCAL	Βαϊοχώρι
TSOUKALADES, BOEOTIA	NAMELOCAL	Τσουκαλάδες
AGRAPIDOCHORI	NAMELOCAL	Αγραπιδοχώρι
DRYMOS, LARISSA	NAMELOCAL	Δρυμός
EVANGELISMOS, ELASSONA	NAMELOCAL	Ευαγγελισμός
GALANOVRYSI	NAMELOCAL	Γαλανόβρυση
KEFALOVRYSO, LARISSA	NAMELOCAL	Κεφαλόβρυσο
PALAIOKASTRO, LARISSA	NAMELOCAL	Παλαιόκαστρο
STEFANOVOUNO	NAMELOCAL	Στεφανόβουνο
LEFKI, LARISSA	NAMELOCAL	Λεύκη
AGIOS STEFANOS AVLIOTES	NAMELOCAL	Παραλία του Αγίου Στεφάνου
AVLIOTES	NAMELOCAL	Αυλιώτες
KRANIA, ELASSONA	NAMELOCAL	Κρανιά
AKRI, LARISSA	NAMELOCAL	Άκρη
KLEISOURA, LARISSA	NAMELOCAL	Κλεισούρα
VALANIDA	NAMELOCAL	Βαλανίδα
LOUTRO, ELASSONA	NAMELOCAL	Λουτρό
KRYOVRYSI, LARISSA	NAMELOCAL	Κρυόβρυση
SYKAMINEA, LARISSA	NAMELOCAL	Συκαμινέα
KOKKINOPILOS	NAMELOCAL	Κοκκινοπηλός
KALYVIA, LARISSA	NAMELOCAL	Καλύβια
PYTHIO, LARISSA	NAMELOCAL	Πύθιο
KOKKINOGEIO	NAMELOCAL	Κοκκινόγειο
OLYMPIADA, LARISSA	NAMELOCAL	Ολυμπιάδα
LOFOS, ELASSONA	NAMELOCAL	Λόφος
PETROTO, LARISSA	NAMELOCAL	Πετρωτό
SKOPIA, ELASSONA	NAMELOCAL	Σκοπιά
VLACHOGIANNI	NAMELOCAL	Βλαχογιάννι
PRAITORI, LARISSA	NAMELOCAL	Πραιτώρι
DOMENIKO	NAMELOCAL	Δομένικο
AMOURI, LARISSA	NAMELOCAL	Αμούρι
AMOURI, PTHIOTIS	NAMELOCAL	Αμούρι
MAGOULA, LARISSA	NAMELOCAL	Μαγούλα
MEGALO ELEFTHEROCHORI	NAMELOCAL	Μέγα Ελευθεροχώρι
MESOCHORI, LARISSA	NAMELOCAL	Μεσοχώρι
AZOROS	NAMELOCAL	Άζωρος
GIANNOTA	NAMELOCAL	Γιαννωτά
GERANIA, LARISSA	NAMELOCAL	Γεράνια
LYKOUDI	NAMELOCAL	Λυκούδι
TSAPOURNIA, LARISSA	NAMELOCAL	Τσαπουρνιά
FARMAKI	NAMELOCAL	Φαρμάκη
VARKOS	NAMELOCAL	Βάρκος
PALIASKIA	NAMELOCAL	Παλιάσκια
PALIAMPELA, LARISSA	NAMELOCAL	Παλιάμπελα
PALIAMPELA, THESSALONIKI	NAMELOCAL	Παλιάμπελα
KOUTSOUFLIANI, LARISSA	NAMELOCAL	Κουτσούφλιανη
KALYVES POLYGYROU	NAMELOCAL	Καλύβες
KERASOCHORI	NAMELOCAL	Κερασοχώρι
AGIOS MAMAS, CHALKIDIKI	NAMELOCAL	Άγιος Μάμας
PSAKOUDIA	NAMELOCAL	Ψακούδια
VOURGARELI	NAMELOCAL	Βουργαρέλι
DAMASI, LARISSA	NAMELOCAL	Δαμάσι
DELERIA	NAMELOCAL	Δελέρια
RODIA, LARISSA	NAMELOCAL	Ροδιά
VRYOTOPOS	NAMELOCAL	Βρυότοπος
MIKROLITHOS	NAMELOCAL	Μικρόλιθος
AMPELIA, LARISSA	NAMELOCAL	Αμπέλια
KASTRIA	NAMELOCAL	Καστρία
KLEITOR, ACHAEA	NAMELOCAL	Κλειτορ
DENDRA TYRNAVOU	NAMELOCAL	Δένδρα Τυρνάβου
PLATANOULIA	NAMELOCAL	Πλατανούλια
AGIOS ATHANASIOS, PELLA	NAMELOCAL	Άγιος Αθανάσιος
AGIA SOPHIA, LARISSA	NAMELOCAL	Αγία Σοφία
DAMASOULI	NAMELOCAL	Δαμασούλι
EMMANOUIL PAPPAS	NAMELOCAL	Εμμανουήλ Παππάς
AGIOS IOANNIS, PELION	NAMELOCAL	Άγιος Ιωάννης Πηλίου
EXARCHOS, PHTHIOTIS	NAMELOCAL	Έξαρχος
MUNICIPALITY OF THESSALONIKI	NAMELOCAL	Δήμος Θεσσαλονίκης
KATOUNA	NAMELOCAL	Κατούνα
KRITIRI	NAMELOCAL	Κριτήρι
LYGARIA, LARISSA	NAMELOCAL	Λυγαριά
PERICHORA, LARISSA	NAMELOCAL	Περίχωρα
AETOLOFOS, LARISSA	NAMELOCAL	Αετόλοφος
GERAKARI, LARISSA	NAMELOCAL	Γερακάρι
ELAFOS, LARISSA	NAMELOCAL	Έλαφος
ELAFOS, PIERIA	NAMELOCAL	Έλαφος
MEGALOVRYSO	NAMELOCAL	Μεγαλόβρυσο
NEROMYLOI, LARISSA	NAMELOCAL	Νερόμυλοι
ANAVRA, LARISSA	NAMELOCAL	Ανάβρα
PRINIAS, LARISSA	NAMELOCAL	Πρινιάς
OMOLIO	NAMELOCAL	Ομόλιο
PALAIOPYRGOS, LARISSA	NAMELOCAL	Παλαιόπυργος
ALEXANDRINI	NAMELOCAL	Αλεξανδρινή
KOUMARITSI	NAMELOCAL	KOυμαρίτσι
DYO VOUNA	NAMELOCAL	Δύο Βουνά
OITI	NAMELOCAL	Οίτη
PONTI, GREECE	NAMELOCAL	Πόντι αγίου πέτρου
KARITSA, LARISSA	NAMELOCAL	Καρίτσα
STRINTZIOS	NAMELOCAL	Στρίντζιος
LYGOURIO	NAMELOCAL	Λυγουριό
ISTHMIA, CORINTHIA	NAMELOCAL	Ισθμία
VATHYLAKKOS, DRAMA	NAMELOCAL	Βαθύλακκος
MESTA, GREECE	NAMELOCAL	Μεστά
PYRGI, GREECE	NAMELOCAL	Πυργί
PLIENINGEN	NAMELOCAL	PLIENINGEN
STUTTGART-CENTER	NAMELOCAL	STUTTGART-MITTE
FANARI, KARDITSA	NAMELOCAL	Φανάρι
STUTTGART-NORTH	NAMELOCAL	STUTTGART-NORD
GAVRIA, ARTA	NAMELOCAL	Γαβριά
CHORA, MESSINIA	NAMELOCAL	Χώρα
PANAGIA, THASOS	NAMELOCAL	Παναγία
POTOS, THASOS	NAMELOCAL	Ποτός
PRINOS, THASOS	NAMELOCAL	Πρίνος
MARIES, THASOS	NAMELOCAL	Μαριές
LIMENARIA	NAMELOCAL	Λιμενάρια
KALLIRACHI, THASOS	NAMELOCAL	Καλλιράχη
XIROPIGADO	NAMELOCAL	Ξηροπήγαδο
ELEOUSA, IOANNINA	NAMELOCAL	Ελεούσα
