HOOVER DAM	NAMEOFFICIAL	HOOVER DAM
ITAIPU DAM	NAMEOFFICIAL	CENTRAL HIDROELéCTRICA ITAIPú BINACIONAL
ITAIPU DAM	NAMEOFFICIAL	USINA HIDRELéTRICA ITAIPU BINACIONAL
ASWAN DAM	NAMEOFFICIAL	ASWAN HIGH DAM
MANSFIELD DAM	NAMEOFFICIAL	MANSFIELD DAM
CARDIFF BAY BARRAGE	NAMEOFFICIAL	CARDIFF BAY BARRAGE
LONGHORN DAM	NAMEOFFICIAL	LONGHORN DAM
MAX STARCKE DAM	NAMEOFFICIAL	MAX STARCKE DAM
TOM MILLER DAM	NAMEOFFICIAL	TOM MILLER DAM
WIRTZ DAM	NAMEOFFICIAL	WIRTZ DAM
INKS DAM	NAMEOFFICIAL	INKS DAM
BUCHANAN DAM	NAMEOFFICIAL	BUCHANAN DAM
WANAPUM DAM	NAMEOFFICIAL	WANAPUM DAM
TETON DAM	NAMEOFFICIAL	TETON DAM
SHANNON HYDROELECTRIC SCHEME	NAMEOFFICIAL	ARDNACRUSHA POWER STATION
LA GRANDE-3 GENERATING STATION	NAMEOFFICIAL	LA GRANDE-3
VAJONT DAM	NAMEOFFICIAL	VAJONT DAM
GARDINER DAM	NAMEOFFICIAL	GARDINER DAM
THE DALLES DAM	NAMEOFFICIAL	THE DALLES LOCK AND DAM
VAAL DAM	NAMEOFFICIAL	VAAL DAM
IMPERIAL DAM	NAMEOFFICIAL	IMPERIAL DIVERSION DAM
KOYNA DAM	NAMEOFFICIAL	KOYNA DAM D05104
NORRIS DAM	NAMEOFFICIAL	NORRIS DAM
GURI DAM	NAMEOFFICIAL	CENTRAL HIDROELéCTRICA SIMóN BOLíVAR
DAVIS DAM	NAMEOFFICIAL	DAVIS DAM
KHADAKWASLA DAM	NAMEOFFICIAL	KHADAKWASLA DAM
OAHE DAM	NAMEOFFICIAL	OAHE DAM
PAINTED ROCK DAM	NAMEOFFICIAL	PAINTED ROCK DAM
MACTAQUAC DAM	NAMEOFFICIAL	MACTAQUAC GENERATING STATION
KALLANAI DAM	NAMEOFFICIAL	KALLANAI DAM
WATTS BAR DAM	NAMEOFFICIAL	WATTS BAR DAM
FORT LOUDOUN DAM	NAMEOFFICIAL	FORT LOUDOUN DAM
MELTON HILL DAM	NAMEOFFICIAL	MELTON HILL DAM
NEW BULLARDS BAR DAM	NAMEOFFICIAL	NEW BULLARDS BAR DAM
ATATüRK DAM	NAMEOFFICIAL	ATATüRK DAM
MULSHI DAM	NAMEOFFICIAL	MULSHI DAM
BHAKRA DAM	NAMEOFFICIAL	BHAKRA DAM
DON PEDRO DAM	NAMEOFFICIAL	OLD DON PEDRO DAM
ALQUEVA DAM	NAMEOFFICIAL	BARRAGEM DO ALQUEVA
KATSE DAM	NAMEOFFICIAL	KATSE DAM
MCALPINE LOCKS AND DAM	NAMEOFFICIAL	MCALPINE LOCKS AND DAM
FONTANA DAM	NAMEOFFICIAL	FONTANA DAM
KOLKEWADI DAM	NAMEOFFICIAL	KOLKEWADI DAM D05103
MARINA BARRAGE	NAMEOFFICIAL	MARINA BARRAGE
TARBELA DAM	NAMEOFFICIAL	TARBELA DAM
PANSHET DAM	NAMEOFFICIAL	PANSHET DAM
PANSHET DAM	NAMEOFFICIAL	TANAJISAGAR DAM
HEBGEN DAM	NAMEOFFICIAL	HEBGEN DAM
TABQA DAM	NAMEOFFICIAL	سد الثورة
WACHUSETT DAM	NAMEOFFICIAL	WACHUSETT RESERVOIR DAM
BATMAN DAM	NAMEOFFICIAL	BATMAN BARAJI
DEVEGEçIDI DAM	NAMEOFFICIAL	DEVEGEçIDI BARAJI
DICLE DAM	NAMEOFFICIAL	DICLE BARAJI
KARKAMış DAM	NAMEOFFICIAL	KARKAMış BARAJI
KRALKıZı DAM	NAMEOFFICIAL	KRALKıZı BARAJI
ILıSU DAM	NAMEOFFICIAL	ILıSU BARAJI
GUNTERSVILLE DAM	NAMEOFFICIAL	GUNTERSVILLE DAM
WHEELER DAM	NAMEOFFICIAL	WHEELER DAM
MIDMAR DAM	NAMEOFFICIAL	MIDMAR DAM
HARTBEESPOORT DAM	NAMEOFFICIAL	HARTBEESPOORT DAM
BULL RUN HYDROELECTRIC PROJECT	NAMEOFFICIAL	BULL RUN HYDROELECTRIC PROJECT
LAKE CHELAN DAM	NAMEOFFICIAL	LAKE CHELAN HYDROELECTRIC PROJECT
SALUDA DAM	NAMEOFFICIAL	DREHER SHOALS DAM
AMERICAN FALLS DAM	NAMEOFFICIAL	AMERICAN FALLS DAM
PALISADES DAM	NAMEOFFICIAL	PALISADES DAM
GANDHI SAGAR DAM	NAMEOFFICIAL	BHADRA
GARIEP DAM	NAMEOFFICIAL	GARIEP DAM
BOTNUR POWER PLANT	NAMEOFFICIAL	ELEKTRISITETSVERKIð í BOTNI
LIUJIAXIA DAM	NAMEOFFICIAL	刘家峡大坝
NAGARJUNA SAGAR DAM	NAMEOFFICIAL	NAGARJUNA SAGAR DAM
CONOWINGO DAM	NAMEOFFICIAL	CONOWINGO HYDROELECTRIC STATION
WALAYAR DAM	NAMEOFFICIAL	WALUWANAD
NOVOSIBIRSK RESERVOIR	NAMEOFFICIAL	Новосибирское водохранилище
ESCHBACH DAM	NAMEOFFICIAL	ESCHBACHTALSPERRE
GEHEYAN DAM	NAMEOFFICIAL	清江隔河岩水利枢纽工程
LONGTAN DAM	NAMEOFFICIAL	龙滩大坝
TINAROO DAM	NAMEOFFICIAL	TINAROO FALLS DAM
LAKE MUTIRIKWE	NAMEOFFICIAL	LAKE MUTIRIKWE
PICKWICK LANDING DAM	NAMEOFFICIAL	PICKWICK LANDING DAM
GOMAL ZAM DAM	NAMEOFFICIAL	GOMAL ZAM DAM
BHANDARDARA	NAMEOFFICIAL	WILSON DAM
CONTRA DAM	NAMEOFFICIAL	CONTRA DAM
BUREYA DAM	NAMEOFFICIAL	Бурейская ГЭС
MIRANI DAM	NAMEOFFICIAL	MIRANI DAM
KARDZHALI RESERVOIR	NAMEOFFICIAL	KARDZHALI DAM
KINZUA DAM	NAMEOFFICIAL	KINZUA DAM
BRISAY GENERATING STATION	NAMEOFFICIAL	CENTRALE BRISAY
LAFORGE-1 GENERATING STATION	NAMEOFFICIAL	LAFORGE-1
LA GRANDE-4 GENERATING STATION	NAMEOFFICIAL	LA GRANDE-4
ROBERT-BOURASSA GENERATING STATION	NAMEOFFICIAL	CENTRALE ROBERT-BOURASSA
LA GRANDE-1 GENERATING STATION	NAMEOFFICIAL	CENTRALE LA GRANDE-1
LA GRANDE-2-A GENERATING STATION	NAMEOFFICIAL	LA GRANDE-2-A
LAFORGE-2 GENERATING STATION	NAMEOFFICIAL	CENTRALE LAFORGE-2
HIRAKUD DAM	NAMEOFFICIAL	HIRAKUD DAM
EL CAJóN DAM	NAMEOFFICIAL	DIQUE EL CAJóN
NYUMBA YA MUNGU DAM	NAMEOFFICIAL	PANGANI HYDRO SYSTEMS
SATPARA DAM	NAMEOFFICIAL	SATPARA DAM
RANCE TIDAL POWER STATION	NAMEOFFICIAL	USINE MARéMOTRICE DE LA RANCE
NICKAJACK DAM	NAMEOFFICIAL	NICKAJACK DAM
CHICKAMAUGA DAM	NAMEOFFICIAL	CHICKAMAUGA DAM
KENTUCKY DAM	NAMEOFFICIAL	KENTUCKY DAM
HADITHA DAM	NAMEOFFICIAL	سد حديثة
PANGANI FALLS DAM	NAMEOFFICIAL	PANGANI HYDRO SYSTEMS
HALE DAM	NAMEOFFICIAL	HALE POWER STATION
CRYSTAL SPRINGS DAM	NAMEOFFICIAL	LOWER CRYSTAL SPRINGS DAM
HOLTWOOD DAM	NAMEOFFICIAL	HOLTWOOD HYDROELECTRIC PLANT
SAFE HARBOR DAM	NAMEOFFICIAL	SAFE HARBOR HYDROELECTRIC STATION
QUEBRADA DE ULLúM DAM	NAMEOFFICIAL	QUEBRADA DE ULLúM DAM
ALICURá DAM	NAMEOFFICIAL	AES ALICURá
EL CHOCóN DAM	NAMEOFFICIAL	EMBALSE EZEQUIEL RAMOS MEXíA
TAJEWALA BARRAGE	NAMEOFFICIAL	TAJEWALA BARRAGE
BURDEKIN DAM	NAMEOFFICIAL	BURDEKIN FALLS DAM
WINSOR DAM	NAMEOFFICIAL	WINSOR DAM
CAMPOS NOVOS DAM	NAMEOFFICIAL	BARRAGEM DE CAMPOS NOVOS
YORK HAVEN DAM	NAMEOFFICIAL	YORK HAVEN HYDRO STATION
FOSTER DAM	NAMEOFFICIAL	FOSTER DAM
LATYAN DAM	NAMEOFFICIAL	سد لتیان
MULLAPERIYAR DAM	NAMEOFFICIAL	PERIYAR DAM
SULTAN MAHMUD POWER STATION	NAMEOFFICIAL	SULTAN MAHMUD POWER STATION
LAGGAN DAM	NAMEOFFICIAL	LAGGAN DAM
PEECHI DAM	NAMEOFFICIAL	PEECHI DAM
BHAVANISAGAR DAM	NAMEOFFICIAL	BHAVANISAGAR ANAICUT பவானிசாகர் அணைக்கட்டு
GHAZI-BAROTHA HYDROPOWER PROJECT	NAMEOFFICIAL	غازى بروتھا
MALAMPUZHA DAM	NAMEOFFICIAL	മലമ്പുഴ അണക്കെട്ട്
BRATSK HYDROELECTRIC POWER STATION	NAMEOFFICIAL	BRATSK HYDROELECTRIC POWER STATION
LOCK AND DAM NO. 11	NAMEOFFICIAL	GENERAL ZEBULON PIKE LOCK AND DAM NO. 11
CHAIN OF ROCKS LOCK	NAMEOFFICIAL	LOCKS NO. 27
GOODNOUGH DIKE	NAMEOFFICIAL	GOODNOUGH DIKE
WINDSOR DAM	NAMEOFFICIAL	WINDSOR DAM
LINGANAMAKKI DAM	NAMEOFFICIAL	LINGANAMAKKI RESERVOIR
CHICOPEE FALLS DAM	NAMEOFFICIAL	CHICOPEE FALLS DAM
BARRE FALLS DAM	NAMEOFFICIAL	BARRE FALLS DAM
BHATSA DAM	NAMEOFFICIAL	BHATSA DAM
HASAN UğURLU DAM	NAMEOFFICIAL	HASAN UğURLU DAM
GöKçEKAYA DAM	NAMEOFFICIAL	GöKçEKAYA BARAJI
ALTıNKAYA DAM	NAMEOFFICIAL	ALTıNKAYA DAM
ALMUS DAM	NAMEOFFICIAL	ALMUS DAM & HYDROELECTRICITY STATION
SıR DAM	NAMEOFFICIAL	SıR BARAJI
DOUGLAS DAM	NAMEOFFICIAL	DOUGLAS DAM
WRIGHTS COMPLEX LOWER DAM	NAMEOFFICIAL	WRIGHTS COMPLEX LOWER DAM
SUAT UğURLU DAM	NAMEOFFICIAL	SUAT UğURLU DAM
SILVAN DAM	NAMEOFFICIAL	SILVAN BARAJı
BLOEDE'S DAM	NAMEOFFICIAL	BLOEDE'S DAM
KOURIS DAM	NAMEOFFICIAL	KOURIS DAM
RANA PRATAP SAGAR DAM	NAMEOFFICIAL	RANAPRATAP SAGAR DAM
ASPROKREMMOS DAM	NAMEOFFICIAL	ASPROKREMMOS DAM
EVRETOU DAM	NAMEOFFICIAL	EVRETOU DAM
EVRETOU DAM	NAMEOFFICIAL	Φράγμα Ευρέτου
MORBE DAM	NAMEOFFICIAL	MORBE DAM D04373
ALMATTI DAM	NAMEOFFICIAL	UPPER KRISHNA-I
VULCAN STREET PLANT	NAMEOFFICIAL	VULCAN STREET PLANT
TILLARI	NAMEOFFICIAL	TILLARI  DAM D04936
ENGLEBRIGHT DAM	NAMEOFFICIAL	ENGLEBRIGHT DAM
CALEDONIA DAM	NAMEOFFICIAL	CALEDONIA DAM
VOLGA HYDROELECTRIC STATION	NAMEOFFICIAL	Волжская ГЭС
SARATOV HYDROELECTRIC STATION	NAMEOFFICIAL	Саратовская ГЭС
CHATS FALLS	NAMEOFFICIAL	CHUTE-DES-CHATS GENERATING STATION
TOUTLE RIVER SEDIMENT RETENTION STRUCTURE	NAMEOFFICIAL	SEDIMENT RETENTION STRUCTURE
COCHITI DAM	NAMEOFFICIAL	COCHITI DAM
SYNCRUDE TAILINGS DAM	NAMEOFFICIAL	SYNCRUDE TAILINGS DAM
THE BARRIER	NAMEOFFICIAL	THE BARRIER
OXBOW DAM	NAMEOFFICIAL	OXBOW DAM
BROWNLEE DAM	NAMEOFFICIAL	BROWNLEE DAM
KURPSAI DAM	NAMEOFFICIAL	Курпсайская ГЭС
BELO MONTE DAM	NAMEOFFICIAL	COMPLEXO HIDRELéTRICO BELO MONTE
RED ROCK DAM	NAMEOFFICIAL	RED ROCK DAM
VANDERKLOOF DAM	NAMEOFFICIAL	VANDERKLOOF DAM
MANSFIELD HOLLOW LAKE	NAMEOFFICIAL	MANSFIELD HOLLOW DAM
TERAGAIKE	NAMEOFFICIAL	寺ヶ池
ALTA HYDROELECTRIC POWER STATION	NAMEOFFICIAL	ALTA KRAFTVERK
FANSHAWE DAM	NAMEOFFICIAL	FANSHAWE DAM
PANCHET DAM	NAMEOFFICIAL	PANCHET DAM
RAPPBODE DAM	NAMEOFFICIAL	RAPPBODE-TALSPERRE
CROTON DAM	NAMEOFFICIAL	CROTON HYDROELECTRIC PLANT
X. HENRY GOODNOUGH	NAMEOFFICIAL	GOODNOUGH DIKE
UJJANI DAM	NAMEOFFICIAL	UJANI DAM
UJJANI DAM	NAMEOFFICIAL	BHIMA DAM
CONANT BROOK DAM	NAMEOFFICIAL	CONANT BROOK DAM
EAST BRIMFIELD DAM	NAMEOFFICIAL	EAST BRIMFIELD DAM
WESTVILLE DAM	NAMEOFFICIAL	WESTVILLE DAM
SAMEURA DAM	NAMEOFFICIAL	SAMEURA DAM
RIVIèRE DES PRAIRIES GENERATING STATION	NAMEOFFICIAL	CENTRALE DE LA RIVIèRE DES PRAIRIES
NANDONI DAM	NAMEOFFICIAL	NANDONI DAM
AMBUKLAO DAM	NAMEOFFICIAL	AMBUKLAO DAM
APALACHIA DAM	NAMEOFFICIAL	APALACHIA DAM
WAGHUR DAM	NAMEOFFICIAL	WAGHUR DAM D02985
RAINBOW DAM	NAMEOFFICIAL	RAINBOW DAM
AVIEMORE DAM	NAMEOFFICIAL	AVIEMORE DAM
MAZVIKADEI DAM	NAMEOFFICIAL	MAZVIKADEI DAM
MOHALE DAM	NAMEOFFICIAL	MOHALE DAM
FRANK D. COMERFORD DAM	NAMEOFFICIAL	FRANK D. COMERFORD DAM
JOHN T. MYERS LOCKS AND DAM	NAMEOFFICIAL	JOHN T. MYERS LOCKS AND DAM
CHEBOKSARY DAM	NAMEOFFICIAL	Чебокса́рская ГЭС
ZHIGULI HYDROELECTRIC STATION	NAMEOFFICIAL	Жигулёвская ГЭС
E.J. BEARDMORE DAM	NAMEOFFICIAL	E. J. BEARDMORE DAM
XILUODU DAM	NAMEOFFICIAL	溪洛渡大坝
WATERBURY DAM	NAMEOFFICIAL	WATERBURY DAM
YUSUFELI DAM	NAMEOFFICIAL	YUSUFELI BARAJI
XIAOLANGDI DAM	NAMEOFFICIAL	小浪底
SQUANNACOOK RIVER DAM	NAMEOFFICIAL	SQUANNACOOK RIVER DAM
TUCURUí DAM	NAMEOFFICIAL	USINA HIDRELéTRICA DE TUCURUí
SOUTHEDGE DAM	NAMEOFFICIAL	LAKE MITCHELL DAM
LEWISTON DAM	NAMEOFFICIAL	LEWISTON DAM
IBIS DAM	NAMEOFFICIAL	IBIS DAM
BUFFALO BILL DAM	NAMEOFFICIAL	BUFFALO RIDGE
VAJIRALONGKORN DAM	NAMEOFFICIAL	VAJIRALONGKORN DAM
XIANGJIABA DAM	NAMEOFFICIAL	向家坝
LAXIWA DAM	NAMEOFFICIAL	拉西瓦大坝
PUBUGOU DAM	NAMEOFFICIAL	瀑布沟大坝
GOUPITAN DAM	NAMEOFFICIAL	构皮滩大坝
XIAOWAN DAM	NAMEOFFICIAL	小湾坝
WUDONGDE DAM	NAMEOFFICIAL	乌东德坝
BAIHETAN DAM	NAMEOFFICIAL	白鹤滩大坝
ERTAN DAM	NAMEOFFICIAL	二灘大壩
HOLT LOCK AND DAM	NAMEOFFICIAL	HOLT LOCK AND DAM
JAMES J. LENIHAN DAM	NAMEOFFICIAL	LEXINGTON DAM
ADOLFO RUIZ CORTINES DAM	NAMEOFFICIAL	ADOLFO RUIZ CORTINES DAM
VICTORIA DAM	NAMEOFFICIAL	VICTORIA DAM
JAYAKWADI DAM	NAMEOFFICIAL	JAYAKWADI-I D02995
SORPE DAM	NAMEOFFICIAL	SORPETALSPERRE
PRAKASAM BARRAGE	NAMEOFFICIAL	ప్రకాశం బ్యారేజి
PERUNCHANI DAM	NAMEOFFICIAL	PERUNCHANI DAM
CARILLON GENERATING STATION	NAMEOFFICIAL	CENTRALE DE CARILLON
KOUGA DAM	NAMEOFFICIAL	KOUGA DAM
GILLESPIE DAM	NAMEOFFICIAL	GILLESPIE DAM
SOLAIYAR DAM	NAMEOFFICIAL	SOLAIYAR DAM
LAKE AMISTAD DAM INTERNATIONAL CROSSING	NAMEOFFICIAL	AMISTAD DAM
STEENBRAS DAM	NAMEOFFICIAL	STEENBRAS DAM
CHIXOY HYDROELECTRIC DAM	NAMEOFFICIAL	PLANTA HIDROELéCTRICA CHIXOY
RIRIE RESERVOIR	NAMEOFFICIAL	RIRIE DAM
DOCK STREET DAM	NAMEOFFICIAL	DOCK STREET DAM
PUNT DAL GALL DAM	NAMEOFFICIAL	PUNT DAL GALL
KALIGANDAKI A HYDROELECTRIC POWER STATION	NAMEOFFICIAL	KALIGANDAKI A HYDROELECTRIC POWER STATION
STERKFONTEIN DAM	NAMEOFFICIAL	STERKFONTEIN DAM
MALIBU HYDRO	NAMEOFFICIAL	MALIBU HYDRO DAM
SPIOENKOP DAM	NAMEOFFICIAL	SPIOENKOP DAM
MANWAN DAM	NAMEOFFICIAL	漫灣大壩
ALBERTO LLERAS DAM	NAMEOFFICIAL	EMBALSE DEL GUAVIO
SWIFT DAM	NAMEOFFICIAL	SWIFT NO. 1 DAM
AMARAVATHI DAM	NAMEOFFICIAL	AMARAVATHI DAM
SAKUMA DAM	NAMEOFFICIAL	佐久間ダム
KOSHI BARRAGE	NAMEOFFICIAL	KOSHI NEPAL BARRAGE
HYUGAMI DAM	NAMEOFFICIAL	日向神ダム
ASAHI DAM	NAMEOFFICIAL	朝日ダム
ŌI DAM	NAMEOFFICIAL	大井ダム
HOSOBIDANI DAM	NAMEOFFICIAL	細尾谷ダム
HONNA DAM	NAMEOFFICIAL	本名ダム
SHIROYAMA DAM	NAMEOFFICIAL	城山ダム
SITE C DAM	NAMEOFFICIAL	SITE C PROJECT
WRIGHTSVILLE DAM	NAMEOFFICIAL	WRIGHTSVILLE DAM
RIETVLEI DAM	NAMEOFFICIAL	RIETVLEI DAM
KILBURN DAM	NAMEOFFICIAL	KILBURN DAM
FIERZA HYDROELECTRIC POWER STATION	NAMEOFFICIAL	HIDROCENTRALI I FIERZëS
LADZHANURI HYDRO POWER PLANT	NAMEOFFICIAL	ლაჯანურის ჰიდროელექტროსადგური
DRIEKLOOF DAM	NAMEOFFICIAL	DRIEKLOOF DAM
RIHAND DAM	NAMEOFFICIAL	GOVIND BALLABH PANT SAGAR
WATAUGA DAM	NAMEOFFICIAL	WATAUGA DAM
ROODEPLAAT DAM	NAMEOFFICIAL	ROODEPLAAT DAM
CHINGAZA DAM	NAMEOFFICIAL	CHINGAZA DAM
CHEROKEE DAM	NAMEOFFICIAL	CHEROKEE DAM
PITTOCK DAM	NAMEOFFICIAL	PITTOCK DAM
WILDWOOD DAM	NAMEOFFICIAL	WILDWOOD DAM
RAMPART DAM	NAMEOFFICIAL	RAMPART DAM
BLUE RIDGE DAM	NAMEOFFICIAL	BLUE RIDGE DAM
OCOEE DAM NO. 3	NAMEOFFICIAL	OCOEE DAM NUMBER 3
HIWASSEE DAM	NAMEOFFICIAL	HIWASSEE DAM
NOTTELY DAM	NAMEOFFICIAL	NOTTELY DAM
CHATUGE DAM	NAMEOFFICIAL	CHATUGE DAM
OSBORNE DAM	NAMEOFFICIAL	OSBORNE DAM
SOUTH HOLSTON DAM	NAMEOFFICIAL	SOUTH HOLSTON DAM
BOONE DAM	NAMEOFFICIAL	BOONE DAM
FORT PATRICK HENRY DAM	NAMEOFFICIAL	FORT PATRICK HENRY DAM
LAS VACAS DAM	NAMEOFFICIAL	PLANTA HIDROELéCTRICA RíO LAS VACAS
GLENDOE HYDRO SCHEME	NAMEOFFICIAL	GLENDOE HYDRO SCHEME
CHULABHORN DAM	NAMEOFFICIAL	CHULABHORN DAM
VON BACH DAM	NAMEOFFICIAL	VON BACH DAM
CURWENSVILLE DAM	NAMEOFFICIAL	CURWENSVILLE DAM
SWAKOPPOORT DAM	NAMEOFFICIAL	SWAKOPPOORT DAM
CHAMERA DAM	NAMEOFFICIAL	CHAMERA DAM
KAMBARATA-1 DAM	NAMEOFFICIAL	Камбаратинская ГЭС-1
FRIEDENAU DAM	NAMEOFFICIAL	FRIEDENAU DAM
FORTUNA DAM	NAMEOFFICIAL	EDWIN FABREGA DAM
SPRING CREEK DAM	NAMEOFFICIAL	SPRING CREEK DEBRIS DAM
DUDHAWA DAM	NAMEOFFICIAL	DUDHAWA DAM
TASHIRO DAM	NAMEOFFICIAL	　田代ダム
ŌIGAWA DAM	NAMEOFFICIAL	大井川ダム
HATANAGI-I DAM	NAMEOFFICIAL	畑薙第一ダム
HATANAGI-II DAM	NAMEOFFICIAL	　畑薙第第二ダム
IKAWA DAM	NAMEOFFICIAL	井川ダム
MAGUGA DAM	NAMEOFFICIAL	MAGUGA DAM
CERRóN GRANDE DAM	NAMEOFFICIAL	CENTRAL HIDROELéCTRICA CERRóN GRANDE
EMMARENTIA DAM	NAMEOFFICIAL	EMMARENTIA DAM
SASAMAGAWA DAM	NAMEOFFICIAL	笹間川ダム
SENZU DAM	NAMEOFFICIAL	千頭ダム
NAGASHIMA DAM	NAMEOFFICIAL	長島ダム
FUNAGIRA DAM	NAMEOFFICIAL	船明ダム
SHIOGō DAM	NAMEOFFICIAL	塩郷ダム
MISAKUBO DAM	NAMEOFFICIAL	水窪ダム
AKIBA DAM	NAMEOFFICIAL	秋葉ダム
EL CAJóN DAM	NAMEOFFICIAL	CENTRAL HIDROELéCTRICA FRANCISCO MORAZáN
SANGTUDA 1 HYDROELECTRIC POWER PLANT	NAMEOFFICIAL	SANGTUDINSKAYA GES-1
DUMITRA HYDRO POWER PLANT	NAMEOFFICIAL	DUMITRA HYDRO POWER PLANT
MIYAGASE DAM	NAMEOFFICIAL	宮ヶ瀬ダム
SAGAMI DAM	NAMEOFFICIAL	相模ダム
MIHO DAM	NAMEOFFICIAL	三保ダム
BOGUCHANY DAM	NAMEOFFICIAL	Богучанская ГЭС
IDRISS I DAM	NAMEOFFICIAL	BARRAGE IDRISS I
NILWANDE DAM	NAMEOFFICIAL	UPPER PRAVARA NILWANDE DAM D02986
BHADBHADA DAM	NAMEOFFICIAL	BHADBHADA DAM
AKHORI DAM	NAMEOFFICIAL	AKHORI DAM
O'NEILL DAM	NAMEOFFICIAL	O'NEILL DAM
JIM WOODRUFF DAM	NAMEOFFICIAL	JIM WOODRUFF DAM
ANGAT DAM	NAMEOFFICIAL	ANGAT DAM
ALBASINI DAM	NAMEOFFICIAL	ALBASINI DAM
SUSRI DAM	NAMEOFFICIAL	SUSRI DAM
HEMRIN DAM	NAMEOFFICIAL	HEMRIN DAM
CIZRE DAM	NAMEOFFICIAL	CIZRE BARAJI
SAN JERóNIMO DAM	NAMEOFFICIAL	PRESA SAN JERóNIMO
ASLANTAş DAM	NAMEOFFICIAL	ASLANTAş BARAJı
ADıGüZEL DAM	NAMEOFFICIAL	ADıGüZEL BARAJI
TOCOMA DAM	NAMEOFFICIAL	MANUEL PIAR HYDROELECTRIC POWER PLANT
NEUSTADT DAM	NAMEOFFICIAL	TALSPERRE NEUSTADT
CALIRAYA DAM	NAMEOFFICIAL	KALAYAAN PUMPED-STORAGE PROJECT
BINGA DAM	NAMEOFFICIAL	BINGA HYDROELECTRIC POWER PLANT
AKHASAN DAM	NAMEOFFICIAL	AKHASAN BARAJı
ALIBEY DAM	NAMEOFFICIAL	ALIBEY BARAJı
AKKöPRü DAM	NAMEOFFICIAL	AKKöPRü BARAJI
ATASU DAM	NAMEOFFICIAL	ATASU BARAJI
ALPASLAN-1 DAM	NAMEOFFICIAL	ALPASLAN I BARAJı
ALTıNHISAR DAM	NAMEOFFICIAL	ALTıNHISAR BARAJı
SATHANUR DAM	NAMEOFFICIAL	LOWER SATHANUR DAM PROJECT
KRISHNAGIRI DAM	NAMEOFFICIAL	KRISHNAGIRI RESERVOIR PROJECT DAM
TEKEZé DAM	NAMEOFFICIAL	TEKEZE DAM
NARVA HYDROELECTRIC STATION	NAMEOFFICIAL	Нарвская гидроэлектростанция
FEITSUI DAM	NAMEOFFICIAL	翡翠水庫
MINGTAN DAM	NAMEOFFICIAL	明潭壩
BERG RIVER DAM	NAMEOFFICIAL	BERG RIVER DAM
VARASGAON DAM	NAMEOFFICIAL	VARASGAON DAM
BORçKA DAM	NAMEOFFICIAL	BORçKA BARAJı
ZERNEK DAM	NAMEOFFICIAL	ZERNEK BARAJI
ÇAT DAM	NAMEOFFICIAL	ÇAT BARAJI
GöKSU DAM	NAMEOFFICIAL	GöKSU BARAJI
GöRDES DAM	NAMEOFFICIAL	GöRDES BARAJI
DERINER DAM	NAMEOFFICIAL	DERINER BARAJı
DIM DAM	NAMEOFFICIAL	DIM BARAJI
DILIMLI DAM	NAMEOFFICIAL	DILIMLI BARAJI
Kığı DAM	NAMEOFFICIAL	Kığı BARAJI
KüRTüN DAM	NAMEOFFICIAL	KüRTüN BARAJI
KUZGUN DAM	NAMEOFFICIAL	KUZGUN BARAJI
MURATLı DAM	NAMEOFFICIAL	MURATLı BARAJı
PATNOS DAM	NAMEOFFICIAL	PATNOS DAM
PALANDöKEN DAM	NAMEOFFICIAL	PALANDöKEN BARAJI
ÖZLüCE DAM	NAMEOFFICIAL	ÖZLüCE BARAJI
TORUL DAM	NAMEOFFICIAL	TORUL BARAJI
YAZıCı DAM	NAMEOFFICIAL	YAZıCı BARAJı
UZUNçAYıR DAM	NAMEOFFICIAL	UZUNçAYıR BARAJI
SAZLıDERE DAM	NAMEOFFICIAL	SAZLıDERE BARAJı
BLOEMHOF DAM	NAMEOFFICIAL	BLOEMHOF DAM
BAATH DAM	NAMEOFFICIAL	سد البعث
WOODSTOCK DAM	NAMEOFFICIAL	WOODSTOCK DAM
TISHRIN DAM	NAMEOFFICIAL	سد تشرين
ALLEMANSKRAAL DAM	NAMEOFFICIAL	ALLEMANSKRAAL DAM
ALPHEN DAM	NAMEOFFICIAL	ALPHEN DAM
ALBERT FALLS DAM	NAMEOFFICIAL	ALBERT FALLS DAM
BEERVLEI DAM	NAMEOFFICIAL	BEERVLEI DAM
BIVANE DAM	NAMEOFFICIAL	BIVANE DAM
ARMENIA DAM	NAMEOFFICIAL	ARMENIA DAM
BON ACCORD DAM	NAMEOFFICIAL	BON ACCORD DAM
BLYDERIVIERPOORT DAM	NAMEOFFICIAL	BLYDERIVIERPOORT DAM
BLYDERIVIERPOORT DAM	NAMEOFFICIAL	BLYDE RIVER POORT DAM
BOEGOEBERG DAM	NAMEOFFICIAL	BOEGOEBERG DAM
BOSPOORT DAM	NAMEOFFICIAL	BOSPOORT DAM
BRANDVLEI DAM	NAMEOFFICIAL	BRANDVLEI DAM
BRONKHORSTSPRUIT DAM	NAMEOFFICIAL	BRONKHORSTSPRUIT DAM
BRIDLE DRIFT DAM	NAMEOFFICIAL	BRIDAL DRIFT DAM
BOSKOP DAM	NAMEOFFICIAL	BOSKOP DAM
DRIEKLOOF DAM	NAMEOFFICIAL	DRIEKLOOF DAM
DAP NAUDé DAM	NAMEOFFICIAL	DAP NAUDé DAM
BUFFELJAGS DAM	NAMEOFFICIAL	BUFFELJAGS DAM
KROMME DAM	NAMEOFFICIAL	KROMME DAM
CERES KOEKEDOUW DAM	NAMEOFFICIAL	CERES KOEKEDOUW DAM
DOORNDRAAI DAM	NAMEOFFICIAL	DOORNDRAAI DAM
CLANWILLIAM DAM	NAMEOFFICIAL	CLANWILLIAM DAM
DARLINGTON DAM	NAMEOFFICIAL	DARLINGTON DAM
CRAIGIE BURN DAM	NAMEOFFICIAL	CRAIGIE BURN DAM
DRIEKOPPIES DAM	NAMEOFFICIAL	DRIEKOPPIES DAM
EBENEZER DAM	NAMEOFFICIAL	EBENEZER DAM
EIKENHOF DAM	NAMEOFFICIAL	EIKENHOF DAM
ELANDSKUIL DAM	NAMEOFFICIAL	ELANDSKUIL DAM
ELANDSKLOOF DAM	NAMEOFFICIAL	ELANDSKLOOF DAM
ERFENIS DAM	NAMEOFFICIAL	ERFENIS DAM
FLAG BOSHIELO DAM	NAMEOFFICIAL	FLAG BOSHIELO DAM
EGMONT DAM	NAMEOFFICIAL	EGMONT DAM
HELLSGATE DAM	NAMEOFFICIAL	HELLSGATE DAM
GLEN ALPINE DAM	NAMEOFFICIAL	GLEN ALPINE DAM
GREATER BRANDVLEI DAM	NAMEOFFICIAL	GREATER BRANDVLEI DAM
GROOTDRAAI DAM	NAMEOFFICIAL	GROOTDRAAI DAM
IMPOFU DAM	NAMEOFFICIAL	IMPOFU DAM
HEYSHOPE DAM	NAMEOFFICIAL	HEYSHOPE DAM
GOEDERTROUW DAM	NAMEOFFICIAL	GOEDERTROUW DAM
KEEROM DAM	NAMEOFFICIAL	KEEROM DAM
KALKFONTEIN DAM	NAMEOFFICIAL	KALKFONTEIN DAM
KLIPBERG DAM	NAMEOFFICIAL	KLIPBERG DAM
METZ DAM	NAMEOFFICIAL	METZ DAM
KLIPDRIF DAM	NAMEOFFICIAL	KLIPDRIF DAM
KNELLPOORT DAM	NAMEOFFICIAL	KNELLPOORT DAM
KLERKSKRAAL DAM	NAMEOFFICIAL	KLERKSKRAAL DAM
INANDA DAM	NAMEOFFICIAL	INANDA DAM
KWAGGASKLOOF DAM	NAMEOFFICIAL	KWAGGASKLOOF DAM
LUPHEPHE DAM	NAMEOFFICIAL	LUPHEPHE DAM
LUBISI DAM	NAMEOFFICIAL	LUBISI DAM
KOPPIES DAM	NAMEOFFICIAL	KOPPIES DAM
KWENA DAM	NAMEOFFICIAL	KWENA DAM
LOSKOP DAM	NAMEOFFICIAL	LOSKOP DAM
MOKOLO DAM	NAMEOFFICIAL	MOKOLO DAM
MOLATEDI DAM	NAMEOFFICIAL	MOLATEDI DAM
LAKENVALLEI DAM	NAMEOFFICIAL	LAKENVALLEI DAM
MISVERSTAND DAM	NAMEOFFICIAL	MISVERSTAND DAM
MUTSHEDZI DAM	NAMEOFFICIAL	MUTSHEDZI DAM
KOGELBERG DAM	NAMEOFFICIAL	KOGELBERG DAM
NAGLE DAM	NAMEOFFICIAL	NAGLE DAM
MIDDLE LETABA DAM	NAMEOFFICIAL	MIDDLE LETABA DAM
PHIPHIDI DAM	NAMEOFFICIAL	PHIPHIDI DAM
NOOITGEDACHT DAM	NAMEOFFICIAL	NOOITGEDACHT DAM
NZHELELE DAM	NAMEOFFICIAL	NZHELELE DAM
NWANEDI DAM	NAMEOFFICIAL	NWANEDI DAM
NCORA DAM	NAMEOFFICIAL	NCORA DAM
NTSHINGWAYO DAM	NAMEOFFICIAL	NTSHINGWAYO DAM
QEDUSIZI DAM	NAMEOFFICIAL	QEDUSIZI DAM
XONXA DAM	NAMEOFFICIAL	XONXA DAM
WITBANK DAM	NAMEOFFICIAL	WITBANK DAM
WEMMERSHOEK DAM	NAMEOFFICIAL	WEMMERSHOEK DAM
WELBEDACHT DAM	NAMEOFFICIAL	WELBEDACHT DAM
STETTYNSKLOOF DAM	NAMEOFFICIAL	STETTYNSKLOOF DAM
SPITSKOP DAM	NAMEOFFICIAL	SPITSKOP DAM
RHENOSTERKOP DAM	NAMEOFFICIAL	RHENOSTERKOP DAM
ZAAIHOEK DAM	NAMEOFFICIAL	ZAAIHOEK DAM
WAGENDRIFT DAM	NAMEOFFICIAL	WAGENDRIFT DAM
PONGOLAPOORT DAM	NAMEOFFICIAL	PONGOLAPOORT DAM
PIETERSFONTEIN DAM	NAMEOFFICIAL	PIETERSFONTEIN DAM
POORTJIESKLOOF DAM	NAMEOFFICIAL	POORTJIESKLOOF DAM
TIANSHENGQIAO-I DAM	NAMEOFFICIAL	TIANSHENGQIAO-I HYDROPOWER STATION
GANGES BARRAGE	NAMEOFFICIAL	LAV KHUSH BARRAGE
IRAN–TURKMENISTAN FRIENDSHIP DAM	NAMEOFFICIAL	DOOSTI RESERVOIR DAM
ODER DAM	NAMEOFFICIAL	ODERTALSPERRE
BONGOLO DAM	NAMEOFFICIAL	BONGOLO DAM
BONGOLO DAM	NAMEOFFICIAL	BONKOLO DAM
KOMMANDODRIF DAM	NAMEOFFICIAL	KOMMANDODRIF DAM
PAVNANAGAR	NAMEOFFICIAL	PAVANA DAM
BUFFELSPOORT DAM	NAMEOFFICIAL	BUFFELSPOORT DAM
BLOEMHOEK DAM	NAMEOFFICIAL	BLOEMHOEK DAM
DA GAMA DAM	NAMEOFFICIAL	DA GAMA DAM
BINFIELD PARK DAM	NAMEOFFICIAL	BINFIELD PARK DAM
BOSCHMANSKOP NO 1 DAM	NAMEOFFICIAL	BOSCHMANSKOP NO 1+2 DAM
DAMANI DAM	NAMEOFFICIAL	DAMANI DAM
DISANENG DAM	NAMEOFFICIAL	DISANENG DAM
DORING RIVER DAM	NAMEOFFICIAL	DORING RIVER DAM
DE HOOP DAM	NAMEOFFICIAL	DE HOOP DAM
DOUGLAS WEIR	NAMEOFFICIAL	DOUGLAS WEIR
FIKA-PATSO DAM	NAMEOFFICIAL	FIKA-PATSO DAM
GAMKAPOORT DAM	NAMEOFFICIAL	GAMKAPOORT DAM
FLORISKRAAL DAM	NAMEOFFICIAL	FLORISKRAAL DAM
GRASSRIDGE DAM	NAMEOFFICIAL	GRASSRIDGE DAM
GROENDAL DAM	NAMEOFFICIAL	GROENDAL DAM
HAZELMERE DAM	NAMEOFFICIAL	HAZELMERE DAM
INJAKA DAM	NAMEOFFICIAL	INJAKA DAM
INJAKA DAM	NAMEOFFICIAL	INYAKA DAM
JERICHO DAM	NAMEOFFICIAL	JERICHO DAM
KAMMANASSIE DAM	NAMEOFFICIAL	KAMMANASSIE DAM
KATRIVIER DAM	NAMEOFFICIAL	KATRIVIER DAM
KETTINGSPRUIT DAM	NAMEOFFICIAL	KETTINGSPRUIT DAM
KLIPKOPJES DAM	NAMEOFFICIAL	KLIPKOPJES DAM
KLIPVOOR DAM	NAMEOFFICIAL	KLIPVOOR DAM
KROMFONTEINLOWER	NAMEOFFICIAL	KROMFONTEINLOWER  COFFERDAM
KROMFONTEIN MIDDLE COFFERDAM	NAMEOFFICIAL	KROMFONTEIN MIDDLE COFFERDAM
KRUGERDRIFT DAM	NAMEOFFICIAL	KRUGERDRIFT DAM
KRUISMANSRIVIER DAM	NAMEOFFICIAL	KRUISRIVIER DAM
LAING DAM	NAMEOFFICIAL	LAING DAM
LAKE ARTHUR DAM	NAMEOFFICIAL	LAKE ARTHUR DAM
LAKE MZINGAZI DAM	NAMEOFFICIAL	LAKE MZINGAZI DAM
LEEU-GAMKA DAM	NAMEOFFICIAL	LEEU-GAMKA DAM
LINDLEYSPOORT DAM	NAMEOFFICIAL	LINDLEYSPOORT DAM
MANJIRENJI DAM	NAMEOFFICIAL	MANJIRENJI DAM
BANGALA DAM	NAMEOFFICIAL	BANGALA DAM
MADIKWE DAM	NAMEOFFICIAL	MADIKWE DAM
MAKULEKE DAM	NAMEOFFICIAL	MAKULEKE DAM
MIDDELBURG DAM	NAMEOFFICIAL	MIDDELBURG DAM
MARICO-BOSVELD DAM	NAMEOFFICIAL	MARICO-BOSVELD DAM
MODDERPOORT DAM	NAMEOFFICIAL	MODDERPOORT DAM
MORGENSTOND DAM	NAMEOFFICIAL	MORGENSTOND DAM
MTHATHA DAM	NAMEOFFICIAL	MTHATHA DAM
NAHOON DAM	NAMEOFFICIAL	NAHOON DAM
PORTUGUéS DAM	NAMEOFFICIAL	REPRESA PORTUGUéS
LIMóN DAM	NAMEOFFICIAL	PRESA LIMON
LIMóN DAM	NAMEOFFICIAL	PROYECTO ESPECIAL OLMOS TINAJONES
KELBRA DAM	NAMEOFFICIAL	TALSPERRE KELBRA
NGODWANA DAM	NAMEOFFICIAL	NGODWANA DAM
NGOTWANE DAM	NAMEOFFICIAL	NGOTWANE DAM
NAYKA DAM	NAMEOFFICIAL	BHOGAVO-I WATER RESOURCES PROJECT
NQWEBA DAM	NAMEOFFICIAL	NQWEBA DAM
OLIFANTSNEK DAM	NAMEOFFICIAL	OLIFANTSNEK DAM
CHIMMONY DAM	NAMEOFFICIAL	CHIMMINI DAM
OUDEBAASKRAAL DAM	NAMEOFFICIAL	OUDEBAASKRAAL DAM
ROCKVIEW DAM	NAMEOFFICIAL	ROCKVIEW DAM
ROODEKOPPIES DAM	NAMEOFFICIAL	ROODEKOPPIES DAM
RUSTFONTEIN DAM	NAMEOFFICIAL	RUSTFONTEIN DAM
SANDILE DAM	NAMEOFFICIAL	SANDILE DAM
SETUMO DAM	NAMEOFFICIAL	SETUMO DAM
SLANGDRAAI DAM	NAMEOFFICIAL	SLANGDRAAI DAM
SMARTT DAM	NAMEOFFICIAL	SMARTT DAM
SOL PLAATJE DAM	NAMEOFFICIAL	SOL PLAATJE DAM
STEENBRAS DAM – UPPER	NAMEOFFICIAL	STEENBRAS DAM - UPPER
TAUNG DAM	NAMEOFFICIAL	TAUNG DAM
STOMPDRIFT DAM	NAMEOFFICIAL	STOMPDRIFT DAM
TRICHARDTSFONTEIN DAM	NAMEOFFICIAL	TRICHARDTSFONTEIN DAM
TSOJANA DAM	NAMEOFFICIAL	TSOJANA DAM
VAAL BARRAGE	NAMEOFFICIAL	VAAL BARRAGE
WATERDOWN DAM	NAMEOFFICIAL	WATERDOWN DAM
TWEEDRAAI DAM	NAMEOFFICIAL	TWEEDRAAI DAM
VONDO DAM	NAMEOFFICIAL	VONDO DAM
WESTOE DAM	NAMEOFFICIAL	WESTOE DAM
WITKLIP DAM	NAMEOFFICIAL	WITKLIP DAM
WOLWEDANS DAM	NAMEOFFICIAL	WOLWEDANS DAM
WRIGGLESWADE DAM	NAMEOFFICIAL	WRIGGLESWADE DAM
SALMA DAM	NAMEOFFICIAL	AFGHAN-INDIA FRIENDSHIP DAM
GREEN PETER DAM	NAMEOFFICIAL	GREEN PETER DAM
E.B. CAMPBELL HYDROELECTRIC STATION	NAMEOFFICIAL	E.B. CAMPBELL
TALA HYDROELECTRIC POWER STATION	NAMEOFFICIAL	TALA HYDROELECTRIC POWER STATION
ANDREW F.C. TURPIN DAM	NAMEOFFICIAL	ANDREW F.C. TURPIN DAM
SAINT-MARTIN DAM	NAMEOFFICIAL	BARRAGE SAINT-MARTIN
KOUHRANG 2 HYDROELECTRIC POWER STATION	NAMEOFFICIAL	KOUHRANG POWER PLANT
THENMALA DAM	NAMEOFFICIAL	KALLADA DAM
STâNCA-COSTEșTI DAM	NAMEOFFICIAL	BARAJUL STâNCA-COSTEşTI
SUBANSIRI LOWER DAM	NAMEOFFICIAL	SUBANSIRI LOWER HYDROELECTRIC POWER PROJECT
RANGIT DAM	NAMEOFFICIAL	RANGIT HYDROPOWER PROJECT, STAGE III
TENUGHAT DAM	NAMEOFFICIAL	TENUGHAT DAM
TILAIYA DAM	NAMEOFFICIAL	TILAIYA DAM
HOLTER DAM	NAMEOFFICIAL	HOLTER DAM
HAUSER DAM	NAMEOFFICIAL	HAUSER DAM
UKAI DAM	NAMEOFFICIAL	UKAI WATER RESOURCES PROJECT
LA GRANGE DAM	NAMEOFFICIAL	LA GRANGE DAM
SALMON CREEK DAM	NAMEOFFICIAL	SALMON CREEK DAM
ALDEADáVILA DAM	NAMEOFFICIAL	PRESA DE ALDEADáVILA
HANNIBAL LOCKS AND DAM	NAMEOFFICIAL	HANNIBAL LOCKS AND DAM
UPPER KOTMALE DAM	NAMEOFFICIAL	UPPER KOTMALE HYDROPOWER PROJECT
BEN CHIFLEY DAM	NAMEOFFICIAL	BEN CHIFLEY DAM
GILEPPE DAM	NAMEOFFICIAL	BARRAGE DE LA GILEPPE
OUTARDES-3	NAMEOFFICIAL	OUTARDES-3 GENERATING STATION
OUTARDES-4	NAMEOFFICIAL	OUTARDES-4 DAM NO.1
PORT MAYACA LOCK AND DAM	NAMEOFFICIAL	PORT MAYACA LOCK AND DAM
VILESHCHAY RESERVOIR	NAMEOFFICIAL	VILESHCHAY DAM
ZANGMU DAM	NAMEOFFICIAL	ZANGMU DAM
UST-ILIMSK HYDROELECTRIC POWER STATION	NAMEOFFICIAL	UST-ILIMSK HYDROELECTRIC POWER STATION
IRKUTSK HYDROELECTRIC POWER STATION	NAMEOFFICIAL	IRKUTSK HYDROELECTRIC POWER STATION
XINGó DAM	NAMEOFFICIAL	HIDROELéTRICA DE XINGó
LUIZ GONZAGA DAM	NAMEOFFICIAL	HIDROELéTRICA DE LUIZ GONZAGA
JOSé RICHA HYDROELECTRIC PLANT	NAMEOFFICIAL	GOVERNADOR JOSé RICHA HYDROELECTRIC PLANT
BENTO MUNHOZ HYDROELECTRIC PLANT	NAMEOFFICIAL	GOVERNOR BENTO MUNHOZ DA ROCHA NETTO HYDROELECTRIC PLANT
NEY BRAGA HYDROELECTRIC PLANT	NAMEOFFICIAL	GOVERNOR NEY BRAGA DE BARROS HYDROELECTRIC PLANT
SALTO SANTIAGO HYDROELECTRIC POWER PLANT	NAMEOFFICIAL	SALTO SANTIAGO HYDROELECTRIC POWER PLANT
SALTO OSóRIO HYDROELECTRIC POWER PLANT	NAMEOFFICIAL	SALTO OSóRIO HYDROELECTRIC POWER PLANT
ITá HYDROELECTRIC POWER PLANT	NAMEOFFICIAL	ITá HYDROELECTRIC POWER PLANT
MACHADINHO HYDROELECTRIC POWER PLANT	NAMEOFFICIAL	MACHADINHO HYDROELECTRIC POWER PLANT
BARRA GRANDE HYDROELECTRIC POWER PLANT	NAMEOFFICIAL	BARRA GRANDE HYDROELECTRIC POWER PLANT
ENG SéRGIO MOTTA DAM	NAMEOFFICIAL	SéRGIO MOTTA HYDROELECTRIC POWER PLANT
ITUMBIARA DAM	NAMEOFFICIAL	USINA DE ITUMBIARA
SERRA DA MESA DAM	NAMEOFFICIAL	USINA DE SERRA DA MESA
MARIMBONDO DAM	NAMEOFFICIAL	USINA DE MARIMBONDO
ÁGUA VERMELHA DAM	NAMEOFFICIAL	USINA DE ÁGUA VERMELHA
ENGINEER SOUZA DIAS DAM	NAMEOFFICIAL	ENGINEER SOUZA DIAS HYDROELECTRIC POWER PLANT
LUIZ BARRETO DAM	NAMEOFFICIAL	USINA DE LUIZ CARLOS BARRETO DE CARVALHO
SãO SIMãO DAM	NAMEOFFICIAL	USINA DE SãO SIMãO
EMBORCAçãO DAM	NAMEOFFICIAL	USINA DE EMBORCAçãO
MOLTENO DAM	NAMEOFFICIAL	THE MOLTENO DAM
MANDOHOL DAM	NAMEOFFICIAL	MANDOHOL DAM
GANDō DAM	NAMEOFFICIAL	岩洞ダム
GOSHO DAM	NAMEOFFICIAL	御所ダム
HAYACHINE DAM	NAMEOFFICIAL	早池峰ダム
TOYOSAWA DAM	NAMEOFFICIAL	豊沢ダム
SANNōKAI DAM	NAMEOFFICIAL	山王海ダム
SHIJūSHIDA DAM	NAMEOFFICIAL	四十四田ダム
OKUNO DAM	NAMEOFFICIAL	奥野ダム
TIKHOL DAM	NAMEOFFICIAL	TIKHOL DAM
PALASHI DAM	NAMEOFFICIAL	PALASHI DAM
HANGA DAM	NAMEOFFICIAL	HANGA DAM
RUI CHATRAPATI DAM	NAMEOFFICIAL	RUI CHATRAPATI DAM
DHOKI DAM	NAMEOFFICIAL	DHOKI DAM
LONIMAVLA DAM	NAMEOFFICIAL	LONIMAVLA DAM
TRêS MARIAS DAM	NAMEOFFICIAL	USINA DE BERNARDO MASCARENHAS
MARMELOS ZERO POWER PLANT	NAMEOFFICIAL	USINA DE MARMELOS ZERO
AL WAHDA DAM	NAMEOFFICIAL	BARRAGE AL WAHDA
DHAMAPUR DAM	NAMEOFFICIAL	DHAMAPUR DAM D03651
TOTLADOH DAM	NAMEOFFICIAL	TOTLADOH DAM D05107
WAN DAM, AKOLA	NAMEOFFICIAL	WAN DAM D03007
WAN DAM, AMBEJOGAI	NAMEOFFICIAL	WAN DAM D01222
BHAM DAM	NAMEOFFICIAL	BHAM DAM
DIMBHE DAM	NAMEOFFICIAL	DIMBHE DAM
CHILEWADI DAM	NAMEOFFICIAL	CHILEWADI DAM D03145
BERDEWADI DAM	NAMEOFFICIAL	BERDEWADI DAM
THOKARWADI DAM	NAMEOFFICIAL	THOKARWADI DAM
MAHAMADWADI DAM	NAMEOFFICIAL	MAHAMADWADI DAM
VIHAR DAM	NAMEOFFICIAL	VIHAR DAM D04998
SHIRSUFAL DAM	NAMEOFFICIAL	SHIRSUFAL DAM D04828
TULSHI DAM	NAMEOFFICIAL	TULSHI DAM D04951
ASHTI DAM, MOHOL	NAMEOFFICIAL	ASHTI DAM
EKRUKH DAM	NAMEOFFICIAL	EKRUKH DAM D00981
MHASWAD DAM	NAMEOFFICIAL	MHASWAD DAM D00984
TANSA DAM	NAMEOFFICIAL	TANSA DAM D05126
PATHARI DAM	NAMEOFFICIAL	PATHARI DAM D04550
CHANDPUR DAM	NAMEOFFICIAL	CHANDPUR DAM D00989
SHETFAL DAM	NAMEOFFICIAL	SHETFAL DAM D04809
KHAIRBANDHA DAM	NAMEOFFICIAL	KHAIRBANDHA DAM D00997
CHANKAPUR DAM	NAMEOFFICIAL	CHANKAPUR DAM D00986
WALWAN DAM	NAMEOFFICIAL	WALWAN DAM
DARNA DAM	NAMEOFFICIAL	DARNA DAM D00972
RAMTEK DAM	NAMEOFFICIAL	RAMTEK DAM D01103
BODALKASA DAM	NAMEOFFICIAL	BODALKASA DAM
SHIRVATA DAM	NAMEOFFICIAL	SHIRVATA DAM
ASOLAMENDHA DAM	NAMEOFFICIAL	ASOLAMENDHA DAM
CHORKHAMARA DAM	NAMEOFFICIAL	CHORKHAMARA DAM D01008
GHORAZARI DAM	NAMEOFFICIAL	GHORAZARI DAM
GHANEWADI DAM	NAMEOFFICIAL	GHANEWADI DAM D03845
VISAPUR DAM	NAMEOFFICIAL	VISAPUR DAM D01010
MAS DAM	NAMEOFFICIAL	MAS DAM D01424
RADHANAGARI DAM	NAMEOFFICIAL	RADHANAGARI DAM D01033
BHATGHAR DAM	NAMEOFFICIAL	BHATGHAR DAM
VAITARNA DAM	NAMEOFFICIAL	VAITARNA DAM / MODAKSAGAR DAM
PURMEPEDA DAM	NAMEOFFICIAL	PURMEPEDA DAM D04657
KHASAPUR DAM	NAMEOFFICIAL	KHASAPUR DAM D01181
DHEKU DAM	NAMEOFFICIAL	DHEKU DAM D01120
SINDPHANA DAM	NAMEOFFICIAL	SINDPHANA DAM D01206
KHELOCALA DAM	NAMEOFFICIAL	KHELOCALA DAM
UPPER DUDHANA DAM	NAMEOFFICIAL	UPPER DUDHANA DAM
HARNI DAM	NAMEOFFICIAL	HARNI DAM D01211
EKBURJI DAM	NAMEOFFICIAL	EKBURJI DAM D01207
GANGAPUR DAM	NAMEOFFICIAL	GANGAPUR DAM D01034
CHANDANI DAM	NAMEOFFICIAL	CHANDANI DAM D01203
WUNNA DAM	NAMEOFFICIAL	WUNNA DAM
GHOD DAM	NAMEOFFICIAL	GHOD DAM D01023
GALHATI DAM	NAMEOFFICIAL	GALHATI DAM D01209
BOR DAM	NAMEOFFICIAL	BOR DAM D01225
TISANGI DAM	NAMEOFFICIAL	TISANGI DAM D04942
MANGI DAM, INDIA	NAMEOFFICIAL	MANGI DAM D04311
MEHAKARI DAM	NAMEOFFICIAL	MEHAKARI DAM D01214
BHUDIHAL DAM	NAMEOFFICIAL	BHUDIHAL DAM D03459
PANDHERBODI DAM	NAMEOFFICIAL	PANDHERBODI DAM
MANAR DAM	NAMEOFFICIAL	MANAR DAM D01052
SUKHANA DAM	NAMEOFFICIAL	SUKHANA DAM D01218
KURNUR DAM	NAMEOFFICIAL	KURNUR DAM D04235
NAWEGAONBANDH DAM	NAMEOFFICIAL	NAWEGAONBANDH DAM
NALGANGA DAM	NAMEOFFICIAL	NALGANGA DAM  D01216
YELDARI DAM	NAMEOFFICIAL	YELDARI DAM D03211
KURJE DAM	NAMEOFFICIAL	KURJE  DAM D03193
DOLWAHAL DAM	NAMEOFFICIAL	DOLWAHAL  DAM D03733
GIRNA DAM	NAMEOFFICIAL	GIRNA DAM D01026
GHARNI DAM	NAMEOFFICIAL	GHARNI DAM D01231
SIDDHESHWAR DAM	NAMEOFFICIAL	SIDDHESHWAR DAM D03206
MALANGAON DAM	NAMEOFFICIAL	MALANGAON DAM D01249
KUNDRALA DAM	NAMEOFFICIAL	KUNDRALA DAM D01263
KARWAND DAM	NAMEOFFICIAL	KARWAND DAM D01234
ITIADOH DAM	NAMEOFFICIAL	ITIADOH DAM
TERNA DAM	NAMEOFFICIAL	TERNA DAM D01221
PUJARITOLA DAM	NAMEOFFICIAL	PUJARITOLA DAM
SIRPUR DAM	NAMEOFFICIAL	SIRPUR DAM
GYANGANGA DAM	NAMEOFFICIAL	GYANGANGA DAM D01244
MORNA GUREGHAR DAM	NAMEOFFICIAL	MORNA  DAM D03137
UPPER PUS DAM	NAMEOFFICIAL	UPPER PUS  DAM D01030
MULA DAM	NAMEOFFICIAL	MULA DAM
KALYANGIRIJA DAM	NAMEOFFICIAL	KALYANGIRIJA DAM D01321
SAIKHEDA DAM	NAMEOFFICIAL	SAIKHEDA DAM D01247
YERALWADI DAM	NAMEOFFICIAL	YERALWADI DAM
UPPER VAITARANA DAM	NAMEOFFICIAL	UPPER VAITARANA DAM D03188
MALKHED DAM	NAMEOFFICIAL	MALKHED DAM D03198
PANZARA DAM	NAMEOFFICIAL	PANZARA DAM D01241
BHOJAPUR DAM	NAMEOFFICIAL	BHOJAPUR DAM
MANYAD DAM	NAMEOFFICIAL	MANYAD DAM D01273
DHAMNA DAM	NAMEOFFICIAL	DHAMNA DAM D01322
DINA DAM	NAMEOFFICIAL	DINA DAM D01326
CHULBANDH DAM	NAMEOFFICIAL	CHULBANDH DAM
KANOLI DAM	NAMEOFFICIAL	KANOLI DAM D01259
KARANJWAN DAM	NAMEOFFICIAL	KARANJWAN DAM D02969
NAZARE DAM	NAMEOFFICIAL	NAZARE DAM D01306
KATEPURNA DAM	NAMEOFFICIAL	KATEPURNA DAM D01237
KARPARA DAM	NAMEOFFICIAL	KARPARA DAM D01286
NIRGUNA DAM	NAMEOFFICIAL	NIRGUNA DAM D01287
ALWANDI DAM	NAMEOFFICIAL	ALWANDI DAM
KANHOLIBARA DAM	NAMEOFFICIAL	KANHOLIBARA DAM D01348
PALKHED DAM	NAMEOFFICIAL	PALKHED DAM D02975
TIRU DAM	NAMEOFFICIAL	TIRU DAM D01294
ADHALA DAM	NAMEOFFICIAL	ADHALA DAM
GARBALDI DAM	NAMEOFFICIAL	SUKI DAM D01350
JAKAPUR DAM	NAMEOFFICIAL	JAKAPUR DAM D01319
KAMTHIKHAIRY DAM	NAMEOFFICIAL	PENCH PROJECT  D01100
PARGAON GHATSHIL DAM	NAMEOFFICIAL	PARGAON GHATSHIL DAM D01358
DHOM DAM	NAMEOFFICIAL	DHOM DAM D02958
HINGANI DAM	NAMEOFFICIAL	HINGANI  DAM D01362
YEDGAON DAM	NAMEOFFICIAL	YEDGAON DAM
BORI DAM	NAMEOFFICIAL	BORI DAM D01356
ADAN DAM	NAMEOFFICIAL	ADAN DAM
JANUNA DAM	NAMEOFFICIAL	JANUNA DAM D04004
MATOBA DAM	NAMEOFFICIAL	MATOBA DAM
MAKARDHOKADA DAM	NAMEOFFICIAL	MAKARDHOKADA DAM
KHANDESHAR DAM	NAMEOFFICIAL	KHANDESHAR DAM D04146
AMBADI DAM	NAMEOFFICIAL	AMBADI DAM
BARVI DAM	NAMEOFFICIAL	BARVI DAM
KARADKHED DAM	NAMEOFFICIAL	KARADKHED DAM D01295
WAGHADI DAM	NAMEOFFICIAL	WAGHADI DAM D01427
ANER DAM	NAMEOFFICIAL	ANER DAM
WAGHAD DAM	NAMEOFFICIAL	WAGHAD DAM D02970
KAWADAS DAM	NAMEOFFICIAL	KAWADAS  DAM
KORADI DAM	NAMEOFFICIAL	KORADI DAM D01436
PETHWADAJ DAM	NAMEOFFICIAL	PETHWADAJ DAM D01397
HARANBARI DAM	NAMEOFFICIAL	HARANBARI DAM D02911
RAIGAVAN DAM	NAMEOFFICIAL	RAIGAVAN DAM D02845
KUNDLIKA DAM	NAMEOFFICIAL	KUNDLIKA DAM D02850
KALYAN DAM	NAMEOFFICIAL	KALYAN DAM D01437
WANDRI DAM	NAMEOFFICIAL	WANDRI DAM D02843
SINA DAM	NAMEOFFICIAL	SINA DAM D02841
KANHER DAM	NAMEOFFICIAL	KANHER DAM
DHAM DAM	NAMEOFFICIAL	DHAM DAM D02889
GIRIJA DAM	NAMEOFFICIAL	GIRIJA DAM D02846
TILLARI	NAMEOFFICIAL	TILLARI  DAM D04937
MORNA DAM, SHIRALA	NAMEOFFICIAL	MORNA DAM D03221
MORNA DAM, SHIRALA	NAMEOFFICIAL	SHIRALA DAM D03221
NATUWADI DAM	NAMEOFFICIAL	NATUWADI DAM D02895
KOLAR DAM	NAMEOFFICIAL	KOLAR DAM D02839
AMALOCALALLA DAM	NAMEOFFICIAL	AMALOCALALLA DAM
MANIKDOH DAM	NAMEOFFICIAL	MANIKDOH DAM
KORDI DAM	NAMEOFFICIAL	KORDI DAM D03136
ERAI DAM	NAMEOFFICIAL	IRAI DAM
LOWER PUS DAM	NAMEOFFICIAL	LOWER PUS DAM D02869
BURAI DAM	NAMEOFFICIAL	BURAI DAM D01422
POTHARA DAM	NAMEOFFICIAL	POTHARA DAM
HATNUR DAM	NAMEOFFICIAL	HATNUR DAM D02977
CHARGAON DAM	NAMEOFFICIAL	CHARGAON DAM
ALANDI DAM	NAMEOFFICIAL	ALANDI DAM
BORNA DAM	NAMEOFFICIAL	BORNA DAM D01393
WADAJ DAM	NAMEOFFICIAL	WADAJ DAM
CHANDAI DAM	NAMEOFFICIAL	CHANDAI DAM D01387
DHAMNI DAM	NAMEOFFICIAL	DHAMNI  DAM D02997
KHEKARANALLA DAM	NAMEOFFICIAL	KHEKARANALLA DAM D05112
ADOL DAM	NAMEOFFICIAL	ADOL DAM
KHAIRI DAM	NAMEOFFICIAL	KHAIRI DAM D02858
BOKANI DAM	NAMEOFFICIAL	BOKANI DAM
SHAHANOOR DAM	NAMEOFFICIAL	SHAHANOOR DAM D02907
ISAPUR DAM	NAMEOFFICIAL	ISAPUR DAM D02978
MANJARA DAM	NAMEOFFICIAL	MANJARA DAM D01111
SAKOL DAM	NAMEOFFICIAL	SAKOL DAM D02924
DEVARGAN DAM	NAMEOFFICIAL	DEVARGAN DAM D03631
BENITURA DAM	NAMEOFFICIAL	BENITURA DAM
RANGAWALI DAM	NAMEOFFICIAL	RANGAWALI DAM D01441
YELAVI DAM	NAMEOFFICIAL	YELAVI DAM D05080
TAWARJA DAM	NAMEOFFICIAL	TAWARJA DAM D01370
MASOLI DAM	NAMEOFFICIAL	MASOLI DAM D01365
OZARKHED DAM	NAMEOFFICIAL	OZARKHED DAM D02973
SONAL DAM	NAMEOFFICIAL	SONAL DAM D01374
GOKI DAM	NAMEOFFICIAL	GOKI DAM D01438
UMA DAM	NAMEOFFICIAL	UMA DAM D01379
KELZAR DAM	NAMEOFFICIAL	KELZAR DAM D01353
BORGAON DAM	NAMEOFFICIAL	BORGAON DAM D02847
MASALGA DAM	NAMEOFFICIAL	MASALGA DAM D02930
UPPER WARDHA DAM	NAMEOFFICIAL	UPPER WARDHA DAM D02982
ARUNAWATI DAM	NAMEOFFICIAL	ARUNAWATI DAM
TISGAON DAM	NAMEOFFICIAL	TISGAON DAM D02974
KADWA DAM	NAMEOFFICIAL	KADWA DAM D03010
JAM DAM	NAMEOFFICIAL	JAM DAM D03081
WALDEVI DAM	NAMEOFFICIAL	WALDEVI DAM D03212
BAHULA DAM	NAMEOFFICIAL	BAHULA DAM
AWASHI DAM	NAMEOFFICIAL	AWASHI DAM D03353
PAKADIGUDDAM DAM	NAMEOFFICIAL	PAKADIGUDDAM DAM D02926
SAKAT DAM	NAMEOFFICIAL	SAKAT DAM D02935
VISHWAMITRI DAM	NAMEOFFICIAL	VISHWAMITRI DAM
TEMBHAPURI DAM	NAMEOFFICIAL	TEMBHAPURI DAM D02917
MAJALGAON DAM	NAMEOFFICIAL	JAYAKWADI STAGE-II DAM
LOWER WUNNA DAM	NAMEOFFICIAL	LOWER WUNNA  DAM
PUNEGAON DAM	NAMEOFFICIAL	PUNEGAON DAM D02972
KALISARAR DAM	NAMEOFFICIAL	KALISARAR DAM D01115
HETWANE DAM	NAMEOFFICIAL	HETWANE DAM D03050
ANJANAPALSHI DAM	NAMEOFFICIAL	ANJANAPALSHI DAM
VADIWALE DAM	NAMEOFFICIAL	VADIWALE DAM D03047
BOR DAHEGAON DAM	NAMEOFFICIAL	BOR DAHEGAON DAM D03074
KASHYPI DAM	NAMEOFFICIAL	KASHYPI DAM D03105
PURNANEOPUR DAM	NAMEOFFICIAL	PURNANEOPUR DAM D03045
SONWAD DAM	NAMEOFFICIAL	SONWAD DAM D03051
MUKANE DAM	NAMEOFFICIAL	MUKANE DAM D02988
SAVATRI DAM	NAMEOFFICIAL	SAVITRI DAM D04776
BHAMA ASAKHED DAM	NAMEOFFICIAL	BHAMA ASAKHED DAM D03019
NARANGI DAM	NAMEOFFICIAL	NARANGI DAM D03100
TEMGHAR DAM	NAMEOFFICIAL	TEMGHAR DAM D03029
PIMPALGAON JOGE DAM	NAMEOFFICIAL	PIMPALGAON JOGE DAM
DONGARGAON DAM	NAMEOFFICIAL	DONGARGAON DAM D03049
GUNJWANI DAM	NAMEOFFICIAL	GUNJWANI DAM
NIRADEVGHAR DAM	NAMEOFFICIAL	NIRADEVGHAR DAM D03016
KAR DAM	NAMEOFFICIAL	KAR DAM D03107
MUN DAM	NAMEOFFICIAL	MUN DAM D03055
NAGYASAKYA DAM	NAMEOFFICIAL	NAGYASAKYA DAM D02922
BHIVARGI DAM	NAMEOFFICIAL	BHIVARGI DAM
UTTARMAND DAM	NAMEOFFICIAL	UTTARMAND DAM D03142
JAMKHEDI DAM	NAMEOFFICIAL	JAMKHEDI DAM D03115
CHITRI DAM	NAMEOFFICIAL	CHITRI DAM  D03132
MADAN DAM	NAMEOFFICIAL	MADAN DAM D03099
BABHULGAON DAM	NAMEOFFICIAL	BABHULGAON DAM
ANDRA VALLEY DAM	NAMEOFFICIAL	ANDRA VALLEY DAM
CHARGAD DAM	NAMEOFFICIAL	CHARGAD DAM D03542
LALOCALALLA DAM	NAMEOFFICIAL	LALOCALALLA DAM
POPATKHED DAM	NAMEOFFICIAL	POPATKHED DAM D04646
TARANDALE DAM	NAMEOFFICIAL	TARANDALE DAM
DEOGAD DAM	NAMEOFFICIAL	DEOGAD DAM D03048
ARALAKALMODI DAM	NAMEOFFICIAL	ARALAKALMODI DAM
PENTAKALI DAM	NAMEOFFICIAL	PENTAKALI DAM D03109
SHIVANA TAKLI DAM	NAMEOFFICIAL	SHIVANA TAKLI DAM D03058
KUDNUR DAM	NAMEOFFICIAL	KUDNUR DAM D04217
MORANA DAM	NAMEOFFICIAL	MORANA  DAM
SINA KOLEGAON DAM	NAMEOFFICIAL	SINA KOLEGAON DAM D03028
GODAVARI DAM	NAMEOFFICIAL	GODAVARI DAM
CHENNA DAM	NAMEOFFICIAL	CHENNA DAM
SARANG KHEDA DAM	NAMEOFFICIAL	SARANG KHEDA DAM
KATANGI DAM	NAMEOFFICIAL	KATANGI DAM
MANIKPURI DAM	NAMEOFFICIAL	MANIKPURI DAM
LOWER TAPI DAM	NAMEOFFICIAL	LOWER TAPI  DAM D03032
KARWAPPA DAM	NAMEOFFICIAL	KARWAPPA DAM D03053
BHAVALI DAM	NAMEOFFICIAL	BHAVALI DAM
JAMKHED DAM	NAMEOFFICIAL	JAMKHED DAM D03999
TALAMBA DAM	NAMEOFFICIAL	TALAMBA DAM D03011
NAGAN DAM	NAMEOFFICIAL	NAGAN DAM D03102
WAKOD DAM	NAMEOFFICIAL	WAKOD DAM D03130
UPPER KADWA DAM	NAMEOFFICIAL	UPPER KADWA DAM
LOWER PANZARA DAM	NAMEOFFICIAL	LOWER PANZARA  DAM D03103
GOMAI DAM	NAMEOFFICIAL	GOMAI DAM D03172
WAKI DAM	NAMEOFFICIAL	WAKI DAM D05046
PRAKASHA BARRAGE DAM	NAMEOFFICIAL	PRAKASHA BARRAGE DAM
NAWATHA DAM	NAMEOFFICIAL	NAWATHA DAM
ANJNERI DAM	NAMEOFFICIAL	ANJNERI DAM
CHANDRABHAGA DAM	NAMEOFFICIAL	CHANDRABHAGA DAM
TULTULI DAM	NAMEOFFICIAL	TULTULI DAM
LOWER WARDHA DAM	NAMEOFFICIAL	LOWER WARDHA DAM D03003
PURNA DAM	NAMEOFFICIAL	PURNA DAM D03125
DEHALI DAM	NAMEOFFICIAL	DEHALI DAM
HUMAN DAM	NAMEOFFICIAL	HUMAN DAM
UTAWALI DAM	NAMEOFFICIAL	UTAWALI DAM D03131
DHANER DAM	NAMEOFFICIAL	DHANER DAM D03655
WADISHEWADI DAM	NAMEOFFICIAL	WADISHEWADI DAM D03129
SULWADE BARRAGE DAM	NAMEOFFICIAL	SULWADE BARRAGE DAM
NANDURI DAM	NAMEOFFICIAL	NANDURI DAM
PUNAD DAM	NAMEOFFICIAL	PUNAD DAM D03013
PIT 3 DAM	NAMEOFFICIAL	PIT NUMBER THREE DAM
YOMASARI DAM	NAMEOFFICIAL	世増ダム
VARVARA RESERVOIR	NAMEOFFICIAL	VARVARA DAM
HONZAWA DAM	NAMEOFFICIAL	本沢ダム
MISEDANI DAM	NAMEOFFICIAL	三瀬谷ダム
NANAIRO DAM	NAMEOFFICIAL	七色ダム
MINAMIKAWA DAM	NAMEOFFICIAL	南川ダム
NARUKO DAM	NAMEOFFICIAL	鳴子ダム
OTTU BARRAGE	NAMEOFFICIAL	OTTU BARRAGE
XACBAL DAM	NAMEOFFICIAL	PLANTA HIDROELéCTRICA XACBAL
AGUACAPA DAM	NAMEOFFICIAL	PLANTA HIDROELéCTRICA AGUACAPA
JURúN MARINALá DAM	NAMEOFFICIAL	PLANTA HIDROELéCTRICA JURúN MARINALá
LOS ESCLAVOS DAM	NAMEOFFICIAL	PLANTA HIDROELéCTRICA LOS ESCLAVOS
SANTA MARíA DAM	NAMEOFFICIAL	PLANTA HIDROELéCTRICA SANTA MARíA
IDAMALAYAR DAM	NAMEOFFICIAL	IDAMALAYAR DAM
KöLNBREIN DAM	NAMEOFFICIAL	KöLNBREINSPERRE
ASWAN LOW DAM	NAMEOFFICIAL	ASWAN LOW DAM
CINGINO DAM	NAMEOFFICIAL	DIGA DEL CINGINO
TIANSHENGQIAO-II DAM	NAMEOFFICIAL	TIANSHENGQIAO-II HYDROPOWER STATION
SIRINDHORN DAM	NAMEOFFICIAL	SIRINDHORN DAM
JINGHONG DAM	NAMEOFFICIAL	景洪大坝
SILIN DAM	NAMEOFFICIAL	思林水坝
CHIRKEY DAM	NAMEOFFICIAL	CHIRKEISK GES
MACAGUA DAM	NAMEOFFICIAL	HIDROELéCTRICA ANTONIO JOSé DE SUCRE
NIZHNEKAMSK HYDROELECTRIC STATION	NAMEOFFICIAL	NIZHNEKAMSK HYDROELECTRIC PLANT
VOTKINSK HYDROELECTRIC STATION	NAMEOFFICIAL	VOTKINSKAYA HPS
PAVLOVKA HYDROELECTRIC STATION	NAMEOFFICIAL	Павловская ГЭС
MENGKUANG DAM	NAMEOFFICIAL	EMPANGAN MENGKUANG
KRASNOKLUTCHEVSKAYA DAM	NAMEOFFICIAL	KRASNOKLUTCHEVSKAYA HYDROELECTRIC POWER
STUNG BATTAMBANG 1 DAM	NAMEOFFICIAL	STUNG BATTAMBANG 1 HYDROPOWER DAM
KIRIROM 1 HYDROPOWER DAM	NAMEOFFICIAL	KIRIROM 1 HYDROPOWER DAM
O CHUM 2 HYDROPOWER DAM	NAMEOFFICIAL	O CHUM 2 HYDROPOWER DAM
STUNG SEN DAM	NAMEOFFICIAL	STUNG SEN HYDROPOWER DAM
HUAI KUM DAM	NAMEOFFICIAL	HUAI KUM DAM
LAM TAKHONG DAM	NAMEOFFICIAL	LAM THA KHONG DAM
LAM PHRA PHLOENG DAM	NAMEOFFICIAL	LAM PHRA PHLOENG DAM
UBOL RATANA DAM	NAMEOFFICIAL	UBOL RATANA DAM
CHICOASéN DAM	NAMEOFFICIAL	PRESA MANUEL MORENO TORRES
MALPASO DAM	NAMEOFFICIAL	REPRESA DE MALPASO
INFIERNILLO DAM	NAMEOFFICIAL	PRESA ADOLFO LóPEZ MATEOS
ANGOSTURA DAM	NAMEOFFICIAL	PRESA BELISARIO DOMíNGUEZ
SALAULIM DAM	NAMEOFFICIAL	SALAULIM DAM
JIRAU DAM	NAMEOFFICIAL	USINA HIDRELéTRICA SANTO ANTôNIO JIRAU
SANTO ANTôNIO DAM	NAMEOFFICIAL	USINA HIDRELéTRICA SANTO ANTôNIO
KıZıLCAHAMAM-AşAğıöREN RESERVOIR	NAMEOFFICIAL	KıZıLCAHAMAM-AşAğıKARAöREN GöLETI
BHADRA DAM	NAMEOFFICIAL	BHADRA
ÁLVARO OBREGóN DAM	NAMEOFFICIAL	PRESA OVIáCHIC
SIRIKIT DAM	NAMEOFFICIAL	QUEEN SIRIKIT DAM
GLENO DAM	NAMEOFFICIAL	DIGA DEL GLENO
CASTELO DE BODE DAM	NAMEOFFICIAL	BARRAGEM DE CASTELO DE BODE
BLACK EAGLE DAM	NAMEOFFICIAL	BLACK EAGLE DAM
MORONY DAM	NAMEOFFICIAL	MORONY DAM
TOSTON DAM	NAMEOFFICIAL	TOSTON DAM
LA ESMERALDA DAM	NAMEOFFICIAL	PRESA LA ESMERALDA
EL QUIMBO DAM	NAMEOFFICIAL	EL QUIMBO DAM
IMBOULOU DAM	NAMEOFFICIAL	IMBOULOU DAM
STARVED ROCK LOCK AND DAM	NAMEOFFICIAL	LOCK AND DAM NO. 6
ZIMAPáN DAM	NAMEOFFICIAL	PRESA ZIMAPáN
AGUAMILPA DAM	NAMEOFFICIAL	PRESA AGUAMILPA
JINPING-I DAM	NAMEOFFICIAL	JINPING-I HYDROPOWER STATION
JINPING-II DAM	NAMEOFFICIAL	JINPING-II HYDROPOWER STATION
ALPE GERA DAM	NAMEOFFICIAL	DIGA ALPE GERA
KOOTENAY CANAL	NAMEOFFICIAL	KOOTENAY CANAL GENERATING STATION
MIEL I DAM	NAMEOFFICIAL	PRESA PATáNGORAS
PUNCHINá DAM	NAMEOFFICIAL	PRESA PUNCHINá
PORCE III DAM	NAMEOFFICIAL	PRESA PORCE III
ITUANGO DAM	NAMEOFFICIAL	PESCADERO-ITUANGO \
LA YESCA DAM	NAMEOFFICIAL	PRESA YESCA
PULICHINTHALA PROJECT	NAMEOFFICIAL	K.L RAO SAGAR
OKUKUBI DAM	NAMEOFFICIAL	億首ダム
KANNA DAM	NAMEOFFICIAL	漢那ダム
FUKUJI DAM	NAMEOFFICIAL	福地ダム
HANEJI DAM	NAMEOFFICIAL	羽地ダム
SRIPADA YELLAMPALLI PROJECT	NAMEOFFICIAL	YELLAMPALLI PROJECT
GALERU NAGARI SUJALA SRAVANTHI PROJECT	NAMEOFFICIAL	GALERU NAGARI SUJALA SRAVANTHI PROJECT
HWACHEON DAM	NAMEOFFICIAL	화천댐
RAPEL DAM	NAMEOFFICIAL	PRESA RAPEL
MUNDA DAM	NAMEOFFICIAL	MUNDA DAM
KEDDARA DAM	NAMEOFFICIAL	BARRAGE KEDDARA
KOUDIAT ACERDOUNE DAM	NAMEOFFICIAL	BARRAGE KOUDIAT ACERDOUNE
AIN ZADA DAM	NAMEOFFICIAL	BARRAGE AIN ZADA
SIDI SALEM DAM	NAMEOFFICIAL	BARRAGE SIDI SALEM
SIDI EL BARRAK DAM	NAMEOFFICIAL	BARRAGE SIDI EL BARRAK
MOHAMED V DAM	NAMEOFFICIAL	BARRAGE MOHAMED V
BIN EL OUIDANE DAM	NAMEOFFICIAL	BARRAGE BIN EL OUIDANE
HASSAN I DAM	NAMEOFFICIAL	BARRAGE HASSAN I
AL MASSIRA DAM	NAMEOFFICIAL	BARRAGE AL MASSIRA
ALLAL AL FASSI DAM	NAMEOFFICIAL	BARRAGE ALLAL AL FASSI
DONGPING DAM	NAMEOFFICIAL	洞坪电站
SHIYAZI DAM	NAMEOFFICIAL	石垭子水电站
KAMLESHWAR DAM	NAMEOFFICIAL	HIRAN-I DAM
PULANGI DAM	NAMEOFFICIAL	PULANGI IV HYDROELECTRIC POWER STATION
ORATHUPPALAYAM DAM	NAMEOFFICIAL	NOYYAL ORATHUPPALAYAM
AATHUPALAYAM DAM	NAMEOFFICIAL	NOYYAL AATHUPALAYAM DAM
KOLDAM DAM	NAMEOFFICIAL	KOLDAM HYDROELECTRIC POWER PROJECT
OGNYANOVO RESERVOIR	NAMEOFFICIAL	Огняново
LAKE VâRșOLț	NAMEOFFICIAL	LACUL DE ACUMULARE VâRșOLț
DAGUANGBA DAM	NAMEOFFICIAL	广坝农场
NIULULING DAM	NAMEOFFICIAL	牛路岭水电站
GRAND'MAISON DAM	NAMEOFFICIAL	BARRAGE DE GRAND'MAISON
GRAND RAPIDS DAM	NAMEOFFICIAL	WABASH LOCK AND DAM, GRAND RAPIDS DAM, OR WABASH LOCKS
JATILUHUR DAM	NAMEOFFICIAL	IR. H. DJUANDA DAM
JATIGEDE DAM	NAMEOFFICIAL	BENDUNGAN JATIGEDE
MINGHU DAM	NAMEOFFICIAL	TAKUAN POWER PLANT
KODIVERI DAM	NAMEOFFICIAL	KODIVERI ANAICUT
SAU RESERVOIR	NAMEOFFICIAL	PANTà DE SAU
SUSQUEDA RESERVOIR	NAMEOFFICIAL	PANTà DE SUSQUEDA
PASTERAL RESERVOIR	NAMEOFFICIAL	PANTà DEL PASTERAL
BOADELLA RESERVOIR	NAMEOFFICIAL	PANTà DE BOADELLA
THISAVROS DAM	NAMEOFFICIAL	Φράγμα Θησαυρού
KöPRü DAM	NAMEOFFICIAL	KöPRü BARAJı VE HES
MOSES-SAUNDERS POWER DAM	NAMEOFFICIAL	ROBERT MOSES-ROBERT H. SAUNDERS POWER DAM
KHANDOLI DAM	NAMEOFFICIAL	KHANDOLI DAM
ROSELEND DAM	NAMEOFFICIAL	BARRAGE DE ROSELEND
SOGAMOSO DAM	NAMEOFFICIAL	PRESA SOGAMOSO
VAALKOP DAM	NAMEOFFICIAL	VAALKOP DAM
MASSINGIR DAM	NAMEOFFICIAL	BARRAGEM DE MASSINGIR
FLORENTINO AMEGHINO DAM	NAMEOFFICIAL	DIQUE FLORENTINO AMEGHINO
MARèGES DAM	NAMEOFFICIAL	BARRAGE DE MARèGES
VETERANS MEMORIAL DAM	NAMEOFFICIAL	VETERANS MEMORIAL  DAM
VAZHANI DAM	NAMEOFFICIAL	VAZHANI DAM
HUITES DAM	NAMEOFFICIAL	LUIS DONALDO COLOSIO DAM
BHEEMGARH DAM	NAMEOFFICIAL	UPPER WAINGANGA DAM
HINGOL DAM	NAMEOFFICIAL	HINGOL DAM
WINDER DAM	NAMEOFFICIAL	WINDER DAM
BARA DAM	NAMEOFFICIAL	BARA DAM
BUNJI DAM	NAMEOFFICIAL	BUNJI HYDRO-POWER PROJECT
TELES PIRES DAM	NAMEOFFICIAL	USINA HIDRELéTRICA TELES PIRES
IRAPé DAM	NAMEOFFICIAL	USINA PRESIDENTE JUSCELINO KUBITSCHEK
SANTA FE RESERVOIR	NAMEOFFICIAL	PANTà DE SANTA FE
DONNELLS DAM	NAMEOFFICIAL	DONNELLS 62-005 DAM
KIRAZLıK DAM	NAMEOFFICIAL	KIRAZLıK REGULATOR AND HYDROELECTRIC POWER PLANT
HANDRI-NEEVA	NAMEOFFICIAL	HANDRI NEEVA SUJALA SRAVANTHI PROJECT
UPPER SVIR HYDROELECTRIC STATION	NAMEOFFICIAL	Верхнесвирская ГЭС
ENGELHARD DAM	NAMEOFFICIAL	ENGELHARD DAM
POTCHEFSTROOM DAM	NAMEOFFICIAL	POTCHEFSTROOM DAM
LOWER SVIR HYDROELECTRIC STATION	NAMEOFFICIAL	Нижнесвирская ГЭС
BASAVA SAGARA	NAMEOFFICIAL	ಬಸವ ಸಾಗರ ಜಲಾಶಯ
MAUá HYDROELECTRIC PLANT	NAMEOFFICIAL	MAUá HYDROELECTRIC PLANT
RUST DE WINTER DAM	NAMEOFFICIAL	RUST DE WINTER DAM
TZANEEN DAM	NAMEOFFICIAL	TZANEEN DAM
OXKRAAL DAM	NAMEOFFICIAL	OXKRAAL DAM
NA HANG DAM	NAMEOFFICIAL	ĐậP NA HANG
SMIR DAM	NAMEOFFICIAL	SMIR BARRAGE
NAKHLA DAM	NAMEOFFICIAL	NAKHLA BARRAGE
BOZ DAM	NAMEOFFICIAL	سَّد بُـز
CARRAíZO DAM	NAMEOFFICIAL	CARRAíZO DAM
DJORF TORBA DAM	NAMEOFFICIAL	BARRAGE DJORF-TORBA
XILINXA DAM	NAMEOFFICIAL	XILINXA DAM
ROOIKRANTZ DAM	NAMEOFFICIAL	ROOIKRANTZ DAM
KARAPUZHA DAM	NAMEOFFICIAL	KARAPUZHA DAM
DHAROI DAM	NAMEOFFICIAL	DHAROI WATER RESOURCES PROJECT
KIYMBI DAM	NAMEOFFICIAL	BARRAGE DE LA KYIMBI
ULLDECONA DAM	NAMEOFFICIAL	EMBASSAMENT D'ULLDECONA
JABER DAM	NAMEOFFICIAL	سد جابر
AKSU DAM	NAMEOFFICIAL	AKSU BARAJI VE HES
GüLLüBAğ DAM	NAMEOFFICIAL	GüLLüBAğ BARAJI VE HES
LALELI DAM	NAMEOFFICIAL	LALELI BARAJI VE HES
GARZAN DAM	NAMEOFFICIAL	GARZAN BARAJI
SıRıMTAş DAM	NAMEOFFICIAL	SıRıMTAş BARAJI
SHAMO DAM	NAMEOFFICIAL	سَّد شمو
BUST-E GEZ DAM	NAMEOFFICIAL	سَّد بست گز
JAWID DAM	NAMEOFFICIAL	سد جاوید
ALPASLAN-2 DAM	NAMEOFFICIAL	ALPASLAN-2 BARAJI
YEDIGöZE DAM	NAMEOFFICIAL	YEDIGöZE BARAJı VE HES
KAVşAK BENDI DAM	NAMEOFFICIAL	KAVşAK BENDI BARAJı VE HES
KARCHAM WANGTOO HYDROELECTRIC PLANT	NAMEOFFICIAL	KARCHAM WANGTOO HYDROELECTRIC PLANT
TAIPINGWAN DAM	NAMEOFFICIAL	T'AEP'YŏNGMAN HYDROPOWER STATION
JAGUARA DAM	NAMEOFFICIAL	USINA HIDRELéTRICA DE JAGUARA
VOLTA GRANDE DAM	NAMEOFFICIAL	USINA HIDRELéTRICA DE VOLTA GRANDE
CAPIVARA DAM	NAMEOFFICIAL	USINA HIDRELéTRICA DE CAPIVARA
SHIHGANG DAM	NAMEOFFICIAL	SHIHGANG DAM
POOMALA DAM	NAMEOFFICIAL	POOMALA DAM
PERINGALKUTHU DAM	NAMEOFFICIAL	PERINGALKUTHU DAM
GéNISSIAT DAM	NAMEOFFICIAL	BARRAGE DE GéNISSIAT
LANKA SAGAR DAM	NAMEOFFICIAL	LANKASAGAR DAM D02073
CHANGUINOLA DAM	NAMEOFFICIAL	CHANGUINOLA I DAM
MERIKOSKI POWER PLANT	NAMEOFFICIAL	MERIKOSKEN VOIMALAITOS
MéKINAC DAM	NAMEOFFICIAL	BARRAGE MéKINAC
KHAN KHWAR HYDROPOWER PLANT	NAMEOFFICIAL	KHAN KHWAR HYDROPOWER PLANT
ALLAI KHWAR HYDROPOWER PLANT	NAMEOFFICIAL	ALLAI KHWAR HYDROPOWER PLANT
MUTWANGA HYDROELECTRIC POWER STATION	NAMEOFFICIAL	MUTWANGA HYDROPOWER STATION
MUJIB DAM	NAMEOFFICIAL	سد الموجب
BEDUHE DAM	NAMEOFFICIAL	BEDUHE DAM
PATORA DAM	NAMEOFFICIAL	ପତୋରା ଡାମ୍
KREMENCHUK HYDROELECTRIC POWER PLANT	NAMEOFFICIAL	KREMENCHUG HPP
KAKHOVKA HYDROELECTRIC POWER PLANT	NAMEOFFICIAL	KAKHOVSKA HPS
DNIPRODZERZHYNSK HYDROELECTRIC POWER PLANT	NAMEOFFICIAL	DNEPRODZERZHINSKA HPS
HABA RIVER SHANKOU DAM	NAMEOFFICIAL	哈巴河山口水电站
DUBER KHWAR HYDROELECTRIC PLANT	NAMEOFFICIAL	DUBER KHWAR HYDROPOWER PLANT
PATRIND HYDROPOWER PLANT	NAMEOFFICIAL	PATRIND DAM
GOLEN GOL HYDROPOWER PROJECT	NAMEOFFICIAL	GOLEN GOL HYDROPOWER PLANT
RENALA KHURD HYDROPOWER PLANT	NAMEOFFICIAL	RENALA KHURD HYDROPOWER PLANT
CHICHONKI MALIAN HYDROPOWER PLANT	NAMEOFFICIAL	CHICHONKI MALIAN HYDROPOWER PLANT
NANDIPUR HYDROPOWER PLANT	NAMEOFFICIAL	NANDIPUR HYDROPOWER PLANT
SHADIWAL HYDROPOWER PLANT	NAMEOFFICIAL	SHADIWAL HYDROPOWER PLANT
KURRAM GARHI HYDROPOWER PLANT	NAMEOFFICIAL	KURRAM GARHI HYDROPOWER PLANT
JABBAN HYDROPOWER PLANT	NAMEOFFICIAL	JABBAN HYDROPOWER PLANT
DARGAI HYDROPOWER PLANT	NAMEOFFICIAL	DARGAI HYDROPOWER PLANT
GULPUR HYDROPOWER PROJECT	NAMEOFFICIAL	GULPUR HYDROPOWER PLANT
DEVECIKONAğı DAM	NAMEOFFICIAL	DEVECIKONAğı BARAJI VE HES
CORBARA DAM	NAMEOFFICIAL	DIGA DI CORBARA
TANGIR HYDROPOWER PROJECT	NAMEOFFICIAL	TANGIR HYDROPOWER PLANT
NAI GAJ DAM	NAMEOFFICIAL	NAI GAJ DAM
CHUTE-ALLARD GENERATING STATION	NAMEOFFICIAL	CHUTE-ALLARD GENERATING STATION
MONCIóN DAM	NAMEOFFICIAL	PRESA MONCIóN
JIGüEY DAM	NAMEOFFICIAL	PRESA JIGüEY
BAO-TAVERA DAMS	NAMEOFFICIAL	COMPLEJO TAVERA-BAO
HATILLO DAM	NAMEOFFICIAL	PRESA HATILLO
ZAZA DAM	NAMEOFFICIAL	PRESA ZAZA
MANCOTAL DAM	NAMEOFFICIAL	PRESA MANCOTAL
VIRGEN DAM	NAMEOFFICIAL	PRESA LA VIRGEN
TUMARíN DAM	NAMEOFFICIAL	PRESA TUMARíN
KHANDIP DAM	NAMEOFFICIAL	KHANDIP ANIKAT
MELONES DAM	NAMEOFFICIAL	PRESA MELONES
NUEVO MUNDO DAM	NAMEOFFICIAL	PRESA NEUVO MUNDO
HANABANILLA DAM	NAMEOFFICIAL	PRESA HANABANILLA
LA VIñA DAM	NAMEOFFICIAL	ANTONIO MEDINA ALLENDE DAM
KLABBöLE POWER PLANT	NAMEOFFICIAL	KLABBöLE KRAFTVERK
TIBI DAM	NAMEOFFICIAL	PRESA TIBI
GAZIVODA DAM	NAMEOFFICIAL	UJMAN DAM
CHILIME HYDROPOWER PLANT	NAMEOFFICIAL	CHILIME HYDROELECTRIC PLANT
KAUSHALYA DAM	NAMEOFFICIAL	KAUSHALYA DAM
THUNAKKADAVU DAM	NAMEOFFICIAL	തുണകടവ്‌
PERUVARIPALLAM DAM	NAMEOFFICIAL	പെരുവരിപാലം
KOHALA HYDROPOWER PROJECT	NAMEOFFICIAL	KOHALA HYDROPOWER PROJECT
POYANG LAKE DAM	NAMEOFFICIAL	鄱阳湖水利枢纽工程
LOWER MANAIR DAM	NAMEOFFICIAL	LOWER MANAIR DAM
SANTA LUZIA DAM	NAMEOFFICIAL	BARRAGEM DE SANTA LUZIA
UPPER MANAIR DAM	NAMEOFFICIAL	UPPER MANAIR DAM
KADDAM PROJECT	NAMEOFFICIAL	KADDAM PROJECT
SRI KOMARAM BHEEM PROJECT	NAMEOFFICIAL	)
SRI KOMARAM BHEEM PROJECT	NAMEOFFICIAL	SRI KOMARAM BHEEM PROJECT
MID MANAIR DAM	NAMEOFFICIAL	MID MANAIR DAM
SHANIGARAM RESERVOIR	NAMEOFFICIAL	SHANIGARAM RESERVOIR
TALIPERU PROJECT	NAMEOFFICIAL	TALIPERU PROJECT
WYRA RESERVOIR	NAMEOFFICIAL	WYRA RESERVOIR
LOWER JURALA HYDRO ELECTRIC PROJECT	NAMEOFFICIAL	LOWER JURALA HYDRO ELECTRIC PROJECT
SIVENS DAM	NAMEOFFICIAL	BARRAGE DE SIVENS
UPPER KARNALI HYDROPOWER PROJECT	NAMEOFFICIAL	UPPER KARNALI HYDROPOWER PROJECT
MAI HYDROPOWER STATION	NAMEOFFICIAL	SANIMA MAI HYDROPOWER PROJECT
TRêS IRMãOS DAM	NAMEOFFICIAL	BARRAGEM TRêS IRMãOS
NOVA AVANHANDAVA DAM	NAMEOFFICIAL	BARRAGEM NOVA AVANHANDAVA
LITTLE ROCK DAM	NAMEOFFICIAL	LITTLE ROCK-PALMDALE DAM
HIVRA DAM	NAMEOFFICIAL	HIVRA DAM
KOLYMA HYDROELECTRIC STATION	NAMEOFFICIAL	KOLYMA HYDROELECTRIC STATION
GREAT HAGI JAFFAR DAM	NAMEOFFICIAL	سد حاجي جعفر الكبير
COLíDER DAM	NAMEOFFICIAL	USINA HIDRELéTRICA COLíDER
FéLOU HYDROELECTRIC PLANT	NAMEOFFICIAL	FéLOU HYDROELECTRIC PLANT
TUYAMUYUN HYDRO COMPLEX	NAMEOFFICIAL	TUYAMUYUN HYDROENGINEERING COMPLEX
ALARCóN DAM	NAMEOFFICIAL	PRESA DE ALARCóN
BISSORTE DAM	NAMEOFFICIAL	BARRAGE DE BISSORTE
PICOTE DAM	NAMEOFFICIAL	BARRAGEM DE PICOTE
BEMPOSTA DAM	NAMEOFFICIAL	BARRAGEM DE BEMPOSTA
MIRANDA DAM	NAMEOFFICIAL	BARRAGEM DE MIRANDA
AGUIEIRA DAM	NAMEOFFICIAL	BARRAGEM DA AGUIEIRA
CABRIL DAM	NAMEOFFICIAL	BARRAGEM DO CABRIL
CARRAPATELO DAM	NAMEOFFICIAL	BARRAGEM DO CARRAPATELO
ENTREPEñAS RESERVOIR	NAMEOFFICIAL	EMBALSE DE ENTREPEñAS
ALTO LINDOSO DAM	NAMEOFFICIAL	BARRAGEM DO ALTO LINDOSO
ALTO RABAGãO DAM	NAMEOFFICIAL	BARRAGEM DO ALTO RABAGãO
MASINGA HYDROELECTRIC POWER STATION	NAMEOFFICIAL	MASINGA POWER STATION
FRATEL DAM	NAMEOFFICIAL	BARRAGEM DE FRATEL
KHERKATTA RESERVOIR	NAMEOFFICIAL	PAKHANJORE RESERVOIR
BELVER DAM	NAMEOFFICIAL	BARRAGEM DE BELVER
BOUçã DAM	NAMEOFFICIAL	BARRAGEM DA BOUçã
CANIçADA DAM	NAMEOFFICIAL	BARRAGEM DA CANIçADA
SALAMONDE DAM	NAMEOFFICIAL	BARRAGEM DE SALAMONDE
POCINHO DAM	NAMEOFFICIAL	BARRAGEM DO POCINHO
OMATAKO DAM	NAMEOFFICIAL	OMATAKO DAM
VALEIRA DAM	NAMEOFFICIAL	BARRAGEM DA VALEIRA
GOREANGAB DAM	NAMEOFFICIAL	GOREANGAB DAM
RéGUA DAM	NAMEOFFICIAL	BARRAGEM DA RéGUA
CRESTUMA-LEVER DAM	NAMEOFFICIAL	BARRAGEM DE CRESTUMA-LEVER
EL SALTO DAM	NAMEOFFICIAL	PRESA EL SALTO
TOUVEDO DAM	NAMEOFFICIAL	BARRAGEM DE TOUVEDO
RAIVA DAM	NAMEOFFICIAL	BARRAGEM DA RAIVA
PRACANA DAM	NAMEOFFICIAL	BARRAGEM DE PRACANA
VILAR DAM	NAMEOFFICIAL	BARRAGEM DE VILAR
KLEINE KINZIG DAM	NAMEOFFICIAL	TALSPERRE KLEINE KINZIG
NALLATHANGAL DAM	NAMEOFFICIAL	NALLATHANGAAL DAM
KOMA KULSHAN PROJECT	NAMEOFFICIAL	KOMA KULSHAN PROJECT
CHANDRABHAGA DAM	NAMEOFFICIAL	CHANDRABHAGA DAM D01360
THOTAPALLI BARRAGE	NAMEOFFICIAL	SARDAR GOUTHU LATCHANNA THOTAPALLI BARRAGE
THOTAPALLI BARRAGE	NAMEOFFICIAL	सर्दार् गौतु लच्चन्न  तोटपल्लि बांध
PATGAON	NAMEOFFICIAL	PATGAON DAM D03059
ÉMOSSON DAM	NAMEOFFICIAL	BARRAGE D'ÉMOSSON
VELIGALLU DAM RESERVOIR	NAMEOFFICIAL	VELIGALLU DAM
KALYANI DAM	NAMEOFFICIAL	KALYANI DAM
DANTIWADA DAM	NAMEOFFICIAL	DANTIWADA WATER RESOURCES PROJECT
MAI CASCADE HYDROPOWER PLANT	NAMEOFFICIAL	SANIMA MAI HYDROPOWER PROJECT
SUNKOSHI SMALL HYDROPOWER PLANT	NAMEOFFICIAL	SANIMA HYDROPOWER
BOLARQUE DAM	NAMEOFFICIAL	PRESA DE BOLARQUE
GOSE KHURD DAM	NAMEOFFICIAL	GOSIKHURD DAM D03002
DAMSAL DAM	NAMEOFFICIAL	DAMSAL DAM
INDRAVATI DAM	NAMEOFFICIAL	UPPER INDRAVATI POWER STATION
EMSWORTH LOCKS AND DAM	NAMEOFFICIAL	EMSWORTH LOCKS AND DAM
DASHIELDS LOCKS AND DAM	NAMEOFFICIAL	DASHIELDS LOCKS AND DAM
MONTGOMERY LOCKS AND DAM	NAMEOFFICIAL	MONTGOMERY LOCKS AND DAM
NEW CUMBERLAND LOCKS AND DAM	NAMEOFFICIAL	NEW CUMBERLAND LOCKS AND DAM
PIKE ISLAND LOCKS AND DAM	NAMEOFFICIAL	PIKE ISLAND LOCK AND DAM
WILLOW ISLAND LOCK AND DAM	NAMEOFFICIAL	WILLOW ISLAND LOCK AND DAM
BELLEVILLE LOCK AND DAM	NAMEOFFICIAL	BELLEVILLE LOCK AND DAM
RACINE LOCK AND DAM	NAMEOFFICIAL	RACINE LOCK AND DAM
ROBERT C. BYRD LOCK AND DAM	NAMEOFFICIAL	ROBERT C. BYRD LOCK AND DAM
GREENUP LOCK AND DAM	NAMEOFFICIAL	GREENUP LOCK AND DAM
UPPER KALEKöY DAM	NAMEOFFICIAL	YUKARı KALEKöY BARAJI VE HEPP
BAğışTAş 1 DAM	NAMEOFFICIAL	BAğışTAş 1 BARAJI VE HEPP
BAğışTAş 2 DAM	NAMEOFFICIAL	BAğışTAş 2 BARAJI VE HEPP
EGGLFING-OBERNBERG HYDROPOWER PLANT	NAMEOFFICIAL	KRAFTWERK EGGLFING-OBERNBERG
SUKI KINARI HYDROPOWER PROJECT	NAMEOFFICIAL	SUKI KINARI HYDROOPWER PROJECT
KAROT HYDROPOWER PROJECT	NAMEOFFICIAL	KAROT HYDROPOWER PROJECT
SHAHPURKANDI DAM PROJECT	NAMEOFFICIAL	SHAHPUR KANDI HEP
PATHRALA BARRAGE	NAMEOFFICIAL	PATHRALA BARRAGE
MEQUINENZA DAM	NAMEOFFICIAL	PRESA DE MEQUINENZA
RIBARROJA DAM	NAMEOFFICIAL	PRESA DE RIBARROJA
WILLIAMSPORT DAM	NAMEOFFICIAL	HEPBURN STREET DAM
SAMUEL HYDROELECTRIC DAM	NAMEOFFICIAL	USINA HIDRELéTRICA SAMUEL
VALIDE DAM	NAMEOFFICIAL	VALIDE BENDI
NEW DAM	NAMEOFFICIAL	YENI BENT
TOPUZLU DAM	NAMEOFFICIAL	TOPUZLU BENT
MOFORSEN HYDROELECTRIC POWER STATION	NAMEOFFICIAL	MOFORSENS KRAFTVERK
KRåNGEDE HYDROELECTRIC POWER STATION	NAMEOFFICIAL	KRåNGEDE KRAFTVERK
VARGFORS HYDROELECTRIC POWER STATION	NAMEOFFICIAL	VARGFORS KRAFTSTATION
HöLJES HYDROELECTRIC POWER STATION	NAMEOFFICIAL	HöLJES KRAFTVERK
STORNORRFORS HYDROELECTRIC POWER STATION	NAMEOFFICIAL	STORNORRFORS KRAFTVERK
STORFINNFORSEN HYDROELECTRIC POWER STATION	NAMEOFFICIAL	STORFINNFORSENS KRAFTVERK
SOLBERGFOSS HYDROELECTRIC POWER STATION	NAMEOFFICIAL	SOLBERGFOSS KRAFTVERK
MANSO DAM	NAMEOFFICIAL	REPRESA DE MANSO
LONGTANG DAM	NAMEOFFICIAL	龙塘大坝
KREUZBERGMAUT HYDROELECTRIC POWER STATION	NAMEOFFICIAL	KRAFTWERK KREUZBERGMAUT
LOWER KALEKöY DAM	NAMEOFFICIAL	AşAğı KALEKöY BARAJI VE HEPP
GARSTEN-ST. ULRICH HYDROELECTRIC POWER STATION	NAMEOFFICIAL	KRAFTWERK GARSTEN-ST. ULRICH
STURGIS DAM	NAMEOFFICIAL	STURGIS DAM
