BARRY LYNDON	NARRATOR	MICHAEL HORDERN
HEATHERS	NARRATOR	WINONA RYDER
LA JETéE	NARRATOR	JEAN NéGRONI
MEAN STREETS	NARRATOR	MARTIN SCORSESE
THE TEXAS CHAIN SAW MASSACRE	NARRATOR	JOHN LARROQUETTE
THE INCREDIBLE SHRINKING MAN	NARRATOR	GRANT WILLIAMS
THE PRINCESS BRIDE	NARRATOR	PETER FALK
JFK	NARRATOR	MARTIN SHEEN
THE GREATEST SHOW ON EARTH	NARRATOR	CECIL B. DEMILLE
ANYWHERE BUT HERE	NARRATOR	NATALIE PORTMAN
AMéLIE	NARRATOR	ANDRé DUSSOLLIER
MARS NEEDS WOMEN	NARRATOR	LARRY BUCHANAN
ARMAGEDDON	NARRATOR	CHARLTON HESTON
FORBIDDEN PLANET	NARRATOR	LES TREMAYNE
THE MANCHURIAN CANDIDATE	NARRATOR	PAUL FREES
RIGOLETTO	NARRATOR	IVEY LLOYD
AMERICA AMERICA	NARRATOR	ELIA KAZAN
THE QUIET MAN	NARRATOR	WARD BOND
DETOUR	NARRATOR	TOM NEAL
FANTASIA	NARRATOR	DEEMS TAYLOR
FRANK FILM	NARRATOR	FRANK MOURIS
THE HOSPITAL	NARRATOR	PADDY CHAYEFSKY
HOW THE WEST WAS WON	NARRATOR	SPENCER TRACY
JAMMIN' THE BLUES	NARRATOR	KNOX MANNING
KING: A FILMED RECORD... MONTGOMERY TO MEMPHIS	NARRATOR	HARRY BELAFONTE
KING: A FILMED RECORD... MONTGOMERY TO MEMPHIS	NARRATOR	RUBY DEE
KING: A FILMED RECORD... MONTGOMERY TO MEMPHIS	NARRATOR	BEN GAZZARA
KING: A FILMED RECORD... MONTGOMERY TO MEMPHIS	NARRATOR	CHARLTON HESTON
KING: A FILMED RECORD... MONTGOMERY TO MEMPHIS	NARRATOR	JAMES EARL JONES
KING: A FILMED RECORD... MONTGOMERY TO MEMPHIS	NARRATOR	BURT LANCASTER
KING: A FILMED RECORD... MONTGOMERY TO MEMPHIS	NARRATOR	PAUL NEWMAN
KING: A FILMED RECORD... MONTGOMERY TO MEMPHIS	NARRATOR	ANTHONY QUINN
KING: A FILMED RECORD... MONTGOMERY TO MEMPHIS	NARRATOR	CLARENCE WILLIAMS III
KING: A FILMED RECORD... MONTGOMERY TO MEMPHIS	NARRATOR	JOANNE WOODWARD
THE LIVING DESERT	NARRATOR	WINSTON HIBLER
POWERS OF TEN	NARRATOR	JUDITH BRONOWSKI , PHILIP MORRISON
SHERMAN'S MARCH	NARRATOR	ROSS MCELWEE
THE TELL-TALE HEART	NARRATOR	JAMES MASON
THE TEN COMMANDMENTS	NARRATOR	CECIL B. DEMILLE
HOLD BACK THE DAWN	NARRATOR	CHARLES BOYER
HEAVEN CAN WAIT	NARRATOR	DON AMECHE
FATHER OF THE BRIDE	NARRATOR	SPENCER TRACY
DECISION BEFORE DAWN	NARRATOR	RICHARD BASEHART
STAND BY ME	NARRATOR	RICHARD DREYFUSS
THE TIGGER MOVIE	NARRATOR	JOHN HURT
TOM JONES	NARRATOR	MICHEáL MAC LIAMMóIR
ROMEO AND JULIET	NARRATOR	LAURENCE OLIVIER
HUDSON HAWK	NARRATOR	WILLIAM CONRAD
NETWORK	NARRATOR	LEE RICHARDSON
DEAD MEN DON'T WEAR PLAID	NARRATOR	STEVE MARTIN
THE RIGHT STUFF	NARRATOR	LEVON HELM
BABE	NARRATOR	ROSCOE LEE BROWNE
CRIES AND WHISPERS	NARRATOR	INGMAR BERGMAN
BOWLING FOR COLUMBINE	NARRATOR	MICHAEL MOORE
QUO VADIS	NARRATOR	WALTER PIDGEON
SANDS OF IWO JIMA	NARRATOR	ARTHUR FRANZ
STALAG 17	NARRATOR	GIL STRATTON
THE ENDLESS SUMMER	NARRATOR	BRUCE BROWN
HERCULES	NARRATOR	CHARLTON HESTON
SPARTACUS	NARRATOR	VIC PERRIN
A CANTERBURY TALE	NARRATOR	UK: ESMOND KNIGHT
A CANTERBURY TALE	NARRATOR	US: RAYMOND MASSEY
RUSSIAN ARK	NARRATOR	ALEXANDER SOKUROV
FRIDAY	NARRATOR	ICE CUBE
HENRY V	NARRATOR	DEREK JACOBI
A CERTAIN SACRIFICE	NARRATOR	CHUCK VARESKO
WHALE RIDER	NARRATOR	KEISHA CASTLE-HUGHES
THE ANIMATRIX	NARRATOR	JULIA FLETCHER
SLC PUNK!	NARRATOR	MATTHEW LILLARD
THE BATTLE OF THE RIVER PLATE	NARRATOR	DAVID FARRAR
THE THREE FACES OF EVE	NARRATOR	ALISTAIR COOKE
Y TU MAMá TAMBIéN	NARRATOR	DANIEL GIMéNEZ CACHO
LOCK, STOCK AND TWO SMOKING BARRELS	NARRATOR	ALAN FORD
IRMA LA DOUCE	NARRATOR	LOUIS JOURDAN
SUPER MARIO BROS.	NARRATOR	DAN CASTELLANETA
DAY OF THE FIGHT	NARRATOR	DOUGLAS EDWARDS
THE ROYAL TENENBAUMS	NARRATOR	ALEC BALDWIN
THE NAKED EYE	NARRATOR	RAYMOND MASSEY
CHARLIE'S ANGELS: FULL THROTTLE	NARRATOR	JOHN FORSYTHE
THE GODS MUST BE CRAZY	NARRATOR	PADDY O'BYRNE
MAD MAX 2	NARRATOR	HAROLD BAIGENT
THERE'S SOMETHING ABOUT MARY	NARRATOR	JONATHAN RICHMAN
JESUS	NARRATOR	ALEXANDER SCOURBY
THE KILLING	NARRATOR	ART GILMORE
TAKE THE MONEY AND RUN	NARRATOR	JACKSON BECK
PINK FLAMINGOS	NARRATOR	JOHN WATERS
CHARLIE'S ANGELS	NARRATOR	JOHN FORSYTHE
MACKENNA'S GOLD	NARRATOR	VICTOR JORY
SUSPIRIA	NARRATOR	DARIO ARGENTO
THE DARK CRYSTAL	NARRATOR	JOSEPH O'CONOR
BROTHER BEAR	NARRATOR	HAROLD GOULD
LOST IN LA MANCHA	NARRATOR	JEFF BRIDGES
24 HOUR PARTY PEOPLE	NARRATOR	STEVE COOGAN
THE MASTER OF DISGUISE	NARRATOR	HAROLD GOULD
LAST OF THE DOGMEN	NARRATOR	WILFORD BRIMLEY
LAGAAN	NARRATOR	AMITABH BACHCHAN
THE GREAT ROCK 'N' ROLL SWINDLE	NARRATOR	MALCOLM MCLAREN
DOGVILLE	NARRATOR	JOHN HURT
CINDERELLA	NARRATOR	BETTY LOU GERSON
THE HIRE	NARRATOR	CLIVE OWEN
THOMAS AND THE MAGIC RAILROAD	NARRATOR	ALEC BALDWIN
EDUCATION FOR DEATH	NARRATOR	ART SMITH
HISTORY OF THE WORLD, PART I	NARRATOR	ORSON WELLES
SEABISCUIT	NARRATOR	DAVID MCCULLOUGH
WHITE WILDERNESS	NARRATOR	WINSTON HIBLER
SAMSON AND DELILAH	NARRATOR	CECIL B. DEMILLE
CHEAPER BY THE DOZEN	NARRATOR	BONNIE HUNT
WISHMASTER	NARRATOR	ANGUS SCRIMM
RUN LOLA RUN	NARRATOR	HANS PAETSCH
A CINDERELLA STORY	NARRATOR	HILARY DUFF
IN AMERICA	NARRATOR	SARAH BOLGER
SINBAD OF THE SEVEN SEAS	NARRATOR	DARIA NICOLODI
TOMBSTONE	NARRATOR	ROBERT MITCHUM
EIGHT CRAZY NIGHTS	NARRATOR	ROB SCHNEIDER
WAR OF THE WORLDS	NARRATOR	MORGAN FREEMAN
PAULIE	NARRATOR	JAY MOHR
THE GOSPEL OF JOHN	NARRATOR	CHRISTOPHER PLUMMER
A MATTER OF LIFE AND DEATH	NARRATOR	JOHN LONGDEN
DIRTY WORK	NARRATOR	NORM MACDONALD
BABE: PIG IN THE CITY	NARRATOR	ROSCOE LEE BROWNE
VELVET GOLDMINE	NARRATOR	JANET MCTEER
KAL HO NAA HO	NARRATOR	PREITY ZINTA
SHATTERED GLASS	NARRATOR	HAYDEN CHRISTENSEN
MY OWN PRIVATE IDAHO	NARRATOR	RIVER PHOENIX
THE CANADIAN CONSPIRACY	NARRATOR	CHRISTOPHER BRITTON
LESSONS OF DARKNESS	NARRATOR	WERNER HERZOG
WIZARDS	NARRATOR	SUSAN TYRRELL
KISS OF DEATH	NARRATOR	COLEEN GRAY
WATERWORLD	NARRATOR	HAL DOUGLAS
ALIVE	NARRATOR	JOHN MALKOVICH
TREASURE PLANET	NARRATOR	TONY JAY
DOGTOWN AND Z-BOYS	NARRATOR	SEAN PENN
ONE, TWO, THREE	NARRATOR	JAMES CAGNEY
BULL DURHAM	NARRATOR	SUSAN SARANDON
THE SHAGGY DOG	NARRATOR	PAUL FREES
MATILDA	NARRATOR	DANNY DEVITO
THE JUNGLE BOOK	NARRATOR	SEBASTIAN CABOT
LADY IN THE LAKE	NARRATOR	ROBERT MONTGOMERY
THE DUKES OF HAZZARD	NARRATOR	JUNIOR BROWN
FLUKE	NARRATOR	MATTHEW MODINE
MY GIRL 2	NARRATOR	ANNA CHLUMSKY
PANDORA AND THE FLYING DUTCHMAN	NARRATOR	HAROLD WARRENDER
FLYING PADRE	NARRATOR	BOB HITE
CARRY ON CLEO	NARRATOR	E. V. H. EMMETT
POSSE	NARRATOR	WOODY STRODE
DR. DOLITTLE 2	NARRATOR	NORM MACDONALD
JAMES AND THE GIANT PEACH	NARRATOR	PETE POSTLETHWAITE
BISHONEN	NARRATOR	BRIGITTE LIN
16 IN WEBSTER GROVES	NARRATOR	CHARLES KURALT
THE WILD ONE	NARRATOR	MARLON BRANDO
FASTER, PUSSYCAT! KILL! KILL!	NARRATOR	JOHN FURLONG
BERSERKER	NARRATOR	PAUL JOHANSSON
TRUE COLORS	NARRATOR	JAMES SPADER
THE BLACK CAULDRON	NARRATOR	JOHN HUSTON
FREEDOM DOWNTIME	NARRATOR	ERIC GORDON CORLEY
EDVARD MUNCH	NARRATOR	PETER WATKINS
A THIN LINE BETWEEN LOVE AND HATE	NARRATOR	MARTIN LAWRENCE
ZULU	NARRATOR	RICHARD BURTON
GOD'S ANGRY MAN	NARRATOR	WERNER HERZOG
DUCK AND COVER	NARRATOR	ROBERT MIDDLETON
BORIS AND NATASHA: THE MOVIE	NARRATOR	COREY BURTON
THE CARE BEARS MOVIE	NARRATOR	MICKEY ROONEY
IT CAME FROM BENEATH THE SEA	NARRATOR	WILLIAM WOODSON
PT 109	NARRATOR	ANDREW DUGGAN
STANDING IN THE SHADOWS OF MOTOWN	NARRATOR	ANDRE BRAUGHER
IT! THE TERROR FROM BEYOND SPACE	NARRATOR	MARSHALL THOMPSON
20 MILLION MILES TO EARTH	NARRATOR	WILLIAM WOODSON
THE ROAD TO EL DORADO	NARRATOR	ELTON JOHN
A CHRISTMAS STORY	NARRATOR	JEAN SHEPHERD
OPERATION PETTICOAT	NARRATOR	CARY GRANT
MANDERLAY	NARRATOR	JOHN HURT
NORTH	NARRATOR	BRUCE WILLIS
ALIEN ADVENTURE	NARRATOR	JOHN BOYLE
A WALK IN THE SUN	NARRATOR	BURGESS MEREDITH
TO HELL AND BACK	NARRATOR	GENERAL WALTER BEDELL SMITH
BATTLE OF THE BULGE	NARRATOR	WILLIAM CONRAD
BABETTE'S FEAST	NARRATOR	GHITA NøRBY
WATERSHIP DOWN	NARRATOR	MICHAEL HORDERN
ROBIN HOOD	NARRATOR	ROGER MILLER
PETER PAN	NARRATOR	TOM CONWAY
THE HITCHHIKER'S GUIDE TO THE GALAXY	NARRATOR	STEPHEN FRY
THE MIGHTY KONG	NARRATOR	ROLF SAXON
WINGED MIGRATION	NARRATOR	JACQUES PERRIN
WINGED MIGRATION	NARRATOR	PHILIPPE LABRO
WHITE FANG	NARRATOR	ETHAN HAWKE
FIRST DAUGHTER	NARRATOR	FOREST WHITAKER
BROTHERHOOD OF THE WOLF	NARRATOR	JACQUES PERRIN
CHARLES MANSON SUPERSTAR	NARRATOR	NIKOLAS SCHRECK
CHARLES MANSON SUPERSTAR	NARRATOR	ZEENA SCHRECK
11	NARRATOR	RON SILVER
MY DOG SKIP	NARRATOR	HARRY CONNICK, JR.
POKéMON: DESTINY DEOXYS	NARRATOR	UNSHO ISHIZUKA
ESCAPE FROM SOBIBOR	NARRATOR	HOWARD K. SMITH
RADIO FLYER	NARRATOR	TOM HANKS
SOUL FOOD	NARRATOR	BRANDON HAMMOND
AśOKA	NARRATOR	SURESH OBEROI
THE MARCH OF TIME	NARRATOR	WESTBROOK VAN VOORHIS
HIJACKING CATASTROPHE	NARRATOR	JULIAN BOND
DAREDEVIL	NARRATOR	BEN AFFLECK
DELGO	NARRATOR	SALLY KELLERMAN
ME, MYSELF & IRENE	NARRATOR	REX ALLEN, JR.
BEING HUMAN	NARRATOR	THERESA RUSSELL
UNIVERSE	NARRATOR	DOUGLAS RAIN
MICKEY'S TWICE UPON A CHRISTMAS	NARRATOR	CLIVE REVILL
THE POWERPUFF GIRLS MOVIE	NARRATOR	TOM KENNY
THE ADVENTURES OF ROCKY AND BULLWINKLE	NARRATOR	KEITH SCOTT
UNDERCOVER BROTHER	NARRATOR	J.D. HALL
CKY	NARRATOR	BRANDON DICAMILLO
MURDER, MY SWEET	NARRATOR	DICK POWELL
LOST EMBRACE	NARRATOR	DANIEL HENDLER
JIN-ROH: THE WOLF BRIGADE	NARRATOR	YOSHISADA SAKAGUCHI
A VERY LONG ENGAGEMENT	NARRATOR	FLORENCE THOMASSIN
THE TAKE	NARRATOR	NAOMI KLEIN AND AVI LEWIS
HOMEWARD BOUND: THE INCREDIBLE JOURNEY	NARRATOR	MICHAEL J. FOX
VINCENT	NARRATOR	VINCENT PRICE
VEER-ZAARA	NARRATOR	SHAH RUKH KHAN
LEMONY SNICKET'S A SERIES OF UNFORTUNATE EVENTS	NARRATOR	JUDE LAW
BOUNDIN'	NARRATOR	BUD LUCKEY
SUGAR & SPICE	NARRATOR	MARLA SOKOLOFF
RUSH TO JUDGMENT	NARRATOR	MARK LANE
GETTYSBURG	NARRATOR	W. MORGAN SHEPPARD
THE LAND BEFORE TIME	NARRATOR	PAT HINGLE
YU-GI-OH! THE MOVIE: PYRAMID OF LIGHT	NARRATOR	MASANORI IKEDA
EUROPA	NARRATOR	MAX VON SYDOW
SCARED STRAIGHT!	NARRATOR	PETER FALK
REBECCA	NARRATOR	JOAN FONTAINE
SPANGLISH	NARRATOR	AIMEE GARCIA
EK AUR EK GYARAH	NARRATOR	OM PURI
CHARLIE AND THE CHOCOLATE FACTORY	NARRATOR	GEOFFREY HOLDER
MY SUMMER STORY	NARRATOR	JEAN SHEPHERD
BLUE SKIES	NARRATOR	FRED ASTAIRE
TWILIGHT ZONE: THE MOVIE	NARRATOR	*
TWILIGHT ZONE: THE MOVIE	NARRATOR	BURGESS MEREDITH
TWILIGHT ZONE: THE MOVIE	NARRATOR	* ROD SERLING
GODZILLA: FINAL WARS	NARRATOR	KōICHI YAMADERA
BEN-HUR	NARRATOR	FINLAY CURRIE
HEAD IN THE CLOUDS	NARRATOR	STUART TOWNSEND
KING OF KINGS	NARRATOR	ORSON WELLES
THE AFFAIR OF THE NECKLACE	NARRATOR	BRIAN COX
MY FAMILY	NARRATOR	EDWARD JAMES OLMOS
BéBé'S KIDS	NARRATOR	FAIZON LOVE
BERLIN BABYLON	NARRATOR	ANGELA WINKLER
THE RULES OF ATTRACTION	NARRATOR	JAMES VAN DER BEEK, SHANNYN SOSSAMON, IAN SOMERHALDER, KIP PARDUE
THE SEAFARERS	NARRATOR	DON HOLLENBECK
HARVIE KRUMPET	NARRATOR	GEOFFREY RUSH
BASTARD OUT OF CAROLINA	NARRATOR	LAURA DERN
THE LAST POLKA	NARRATOR	DAVE THOMAS
THE SALTON SEA	NARRATOR	VAL KILMER
THE CLAN OF THE CAVE BEAR	NARRATOR	SALOME JENS
INSIDE DEEP THROAT	NARRATOR	DENNIS HOPPER
PORTRAIT OF JENNIE	NARRATOR	JOSEPH COTTEN
FUN AND FANCY FREE	NARRATOR	*
FUN AND FANCY FREE	NARRATOR	DINAH SHORE
FUN AND FANCY FREE	NARRATOR	EDGAR BERGEN
RICHIE RICH	NARRATOR	JONATHAN HYDE
POKéMON HEROES	NARRATOR	UNSHō ISHIZUKA
POKéMON: THE MOVIE 2000	NARRATOR	UNSHō ISHIZUKA
THE MANY ADVENTURES OF WINNIE THE POOH	NARRATOR	SEBASTIAN CABOT
SOUTHLAND TALES	NARRATOR	JUSTIN TIMBERLAKE
THE SERPENT AND THE RAINBOW	NARRATOR	BILL PULLMAN
THE LEGEND OF BAGGER VANCE	NARRATOR	JACK LEMMON
PINK FLOYD – THE WALL	NARRATOR	PINK FLOYD
POKéMON: JIRACHI WISH MAKER	NARRATOR	UNSHō ISHIZUKA
DOLPHINS	NARRATOR	PIERCE BROSNAN
LIFE AND DEBT	NARRATOR	BELINDA BECKER
POKéMON: LUCARIO AND THE MYSTERY OF MEW	NARRATOR	MIKE POLLOCK
SEPTEMBER TAPES	NARRATOR	GEORGE CALIL
MANGAL PANDEY: THE RISING	NARRATOR	OM PURI
I WAS A COMMUNIST FOR THE FBI	NARRATOR	FRANK LOVEJOY
THE LEADER, HIS DRIVER AND THE DRIVER'S WIFE	NARRATOR	NICK BROOMFIELD
PHANTOM OF THE PARADISE	NARRATOR	ROD SERLING
TURBO: A POWER RANGERS MOVIE	NARRATOR	ROBERT L. MANAHAN
RETURN TO NEVER LAND	NARRATOR	CLIVE REVILL
ALMOST HEROES	NARRATOR	HARRY SHEARER
THUNDERBIRD 6	NARRATOR	KEITH ALEXANDER
SILVER BULLET	NARRATOR	TOVAH FELDSHUH
NEVER DIE ALONE	NARRATOR	DMX
CALL NORTHSIDE 777	NARRATOR	TRUMAN BRADLEY
THE ADVENTURES OF ICHABOD AND MR. TOAD	NARRATOR	BASIL RATHBONE
THE ADVENTURES OF ICHABOD AND MR. TOAD	NARRATOR	BING CROSBY
CALLING ALL ENGINES!	NARRATOR	MICHAEL ANGELIS
CALLING ALL ENGINES!	NARRATOR	MICHAEL BRANDON
THE COLOR OF POMEGRANATES	NARRATOR	ARMEN DZHIGARKHANYAN
NIAGARA	NARRATOR	JOSEPH COTTEN
LADY IN THE WATER	NARRATOR	DAVID OGDEN STIERS
THE BIG SLEEP	NARRATOR	ROBERT MITCHUM
THE BIBLE: IN THE BEGINNING...	NARRATOR	JOHN HUSTON
ELIZABETHTOWN	NARRATOR	ORLANDO BLOOM
ZERO HOUR!	NARRATOR	WILLIAM CONRAD
THE ENCHANTED COTTAGE	NARRATOR	HERBERT MARSHALL
DUPLEX	NARRATOR	DANNY DEVITO
ALIEN HUNTER	NARRATOR	SCIFI CHANNEL
COMPANY	NARRATOR	MAKRAND DESHPANDE
SNOW DAY	NARRATOR	MARK WEBBER
SERIES 7: THE CONTENDERS	NARRATOR	WILL ARNETT
FORKLIFT DRIVER KLAUS – THE FIRST DAY ON THE JOB	NARRATOR	EGON HOEGEN
WAKKO'S WISH	NARRATOR	TOM BODETT
LOVE KE LIYE KUCH BHI KAREGA	NARRATOR	PARESH RAWAL
MICKEY'S ONCE UPON A CHRISTMAS	NARRATOR	KELSEY GRAMMER
SUMMER OF '42	NARRATOR	ROBERT MULLIGAN
THE SOLID GOLD CADILLAC	NARRATOR	GEORGE BURNS
LES MISTONS	NARRATOR	MICHEL FRANçOIS
BADE MIYAN CHOTE MIYAN	NARRATOR	AMITABH BACHCHAN
BADE MIYAN CHOTE MIYAN	NARRATOR	VASHU BHAGNANI
CUBAN REBEL GIRLS	NARRATOR	ERROL FLYNN
MESA OF LOST WOMEN	NARRATOR	LYLE TALBOT
PAHELI	NARRATOR	NASEERUDDIN SHAH
AN EVENING OF EDGAR ALLAN POE	NARRATOR	VINCENT PRICE
RASCAL	NARRATOR	WALTER PIDGEON
WHAT DO YOU SAY TO A NAKED LADY%3F	NARRATOR	ALLEN FUNT
THE MONOLITH MONSTERS	NARRATOR	PAUL FREES
ROCK-A-DOODLE	NARRATOR	PHIL HARRIS
THE LADY FROM SHANGHAI	NARRATOR	ORSON WELLES
KABHI ALVIDA NAA KEHNA	NARRATOR	SHAH RUKH KHAN
LA RONDE	NARRATOR	ANTON WALBROOK
SPACE STATION 3D	NARRATOR	TOM CRUISE
COMIC BOOK: THE MOVIE	NARRATOR	BILLY WEST
DUMA	NARRATOR	ALEXANDER MICHALETOS
LEGENDARY CHAMPIONS	NARRATOR	NORMAN ROSE
DRAGON BALL Z: WRATH OF THE DRAGON	NARRATOR	TONY JAY
TRACES OF DEATH	NARRATOR	DAMON FOX
ENRON: THE SMARTEST GUYS IN THE ROOM	NARRATOR	PETER COYOTE
THE RED BADGE OF COURAGE	NARRATOR	JAMES WHITMORE
THE ETERNAL JEW	NARRATOR	HARRY GIESE
THE LONG SHIPS	NARRATOR	EDWARD JUDD
THE NAKED CITY	NARRATOR	MARK HELLINGER
POKéMON 4EVER	NARRATOR	UNSHō ISHIZUKA
THE SECRET LIFE OF WORDS	NARRATOR	SARAH POLLEY
BIG WEDNESDAY	NARRATOR	ROBERT ENGLUND
THE ALLIGATOR PEOPLE	NARRATOR	BEVERLY GARLAND
DOKI-DOKI	NARRATOR	HARUKI IWAKIRI
THE OLD NEGRO SPACE PROGRAM	NARRATOR	RODNEY SAULSBERRY
CANNERY ROW	NARRATOR	JOHN HUSTON
THE FIRST WIVES CLUB	NARRATOR	DIANE KEATON
THE BEAST OF YUCCA FLATS	NARRATOR	COLEMAN FRANCIS
BELLY	NARRATOR	NAS
STEALING HARVARD	NARRATOR	JASON LEE
HARDWARE WARS	NARRATOR	PAUL FREES
FATAL INSTINCT	NARRATOR	ARMAND ASSANTE
BUNTY AUR BABLI	NARRATOR	AMITABH BACHCHAN
FLYING CASANOVAS	NARRATOR	DAVID ATTENBOROUGH
SERPENT OF THE NILE	NARRATOR	FRED F. SEARS
THE CELLULOID CLOSET	NARRATOR	LILY TOMLIN
THE MIRACLE OF OUR LADY OF FATIMA	NARRATOR	WALTER HAMPDEN
A TRIP THROUGH THE WALT DISNEY STUDIOS	NARRATOR	WALT DISNEY
THE CURSE OF THE WEREWOLF	NARRATOR	CLIFFORD EVANS
DECONSTRUCTING HARRY	NARRATOR	WOODY ALLEN
I WALKED WITH A ZOMBIE	NARRATOR	FRANCES DEE
THE ST. VALENTINE'S DAY MASSACRE	NARRATOR	PAUL FREES
THE HOUSE ON 92ND STREET	NARRATOR	REED HADLEY
LAJJA	NARRATOR	BHARAT SHAH
GODZILLA, KING OF THE MONSTERS!	NARRATOR	RAYMOND BURR
THE BLACK SLEEP	NARRATOR	BASIL RATHBONE
HIGHWAY 301	NARRATOR	EDMON RYAN
SIDE STREET	NARRATOR	PAUL KELLY
DONALD IN MATHMAGIC LAND	NARRATOR	PAUL FREES
ONE SONG A DAY TAKES MISCHIEF AWAY	NARRATOR	TOMISLAV ŽGANEC
JULES AND JIM	NARRATOR	MICHEL SUBOR
LL BE BETTER TOMORROW	NARRATOR	ROBERT DOWNEY, JR.
BIO-DOME	NARRATOR	RODGER BUMPASS
BEYOND THE MAT	NARRATOR	BARRY W. BLAUSTEIN
SOMETHING WICKED THIS WAY COMES	NARRATOR	ARTHUR HILL
EARTH	NARRATOR	SHABANA AZMI
BIG JAKE	NARRATOR	GEORGE FENNEMAN
QUEST OF THE DELTA KNIGHTS	NARRATOR	DAVID WARNER
BEN AND ME	NARRATOR	STERLING HOLLOWAY
HOME OF THE BRAVE	NARRATOR	STOCKARD CHANNING
INSIDE THE WALLS OF FOLSOM PRISON	NARRATOR	WILLIAM WOODSON
THE PARTY ANIMAL	NARRATOR	JERRY JONES
RESIDENT EVIL: EXTINCTION	NARRATOR	MILLA JOVOVICH
SIMON BIRCH	NARRATOR	JIM CARREY
SLEEPING BEAUTY	NARRATOR	MARVIN MILLER
LITTLE CHILDREN	NARRATOR	WILL LYMAN
THE KILLER THAT STALKED NEW YORK	NARRATOR	REED HADLEY
MARCH OF THE PENGUINS	NARRATOR	*
MARCH OF THE PENGUINS	NARRATOR	CHARLES BERLING
MARCH OF THE PENGUINS	NARRATOR	ROMANE BOHRINGER
MARCH OF THE PENGUINS	NARRATOR	JULES SITRUK
MARCH OF THE PENGUINS	NARRATOR	MORGAN FREEMAN
SALAAM NAMASTE	NARRATOR	ABHISHEK BACHCHAN
THE LAND BEFORE TIME II: THE GREAT VALLEY ADVENTURE	NARRATOR	JOHN INGLE
2001: A SPACE TRAVESTY	NARRATOR	LESLIE NIELSEN
OPERATION CONCRETE	NARRATOR	JEAN-LUC GODARD
TALE OF TWO SISTERS	NARRATOR	CHARLIE SHEEN
ONE DAY IN SEPTEMBER	NARRATOR	MICHAEL DOUGLAS
GRIZZLY MAN	NARRATOR	WERNER HERZOG
GEORGE GROSZ' INTERREGNUM	NARRATOR	LOTTE LENYA
JUDGE DREDD	NARRATOR	JAMES EARL JONES
PORT OF NEW YORK	NARRATOR	CHET HUNTLEY
INVENTING THE ABBOTTS	NARRATOR	MICHAEL KEATON
RADIO DAYS	NARRATOR	WOODY ALLEN
YELLOW SUBMARINE	NARRATOR	PAUL ANGELIS
MY BEST FIEND	NARRATOR	WERNER HERZOG
EDGE OF DOOM	NARRATOR	DANA ANDREWS
PALINDROMES	NARRATOR	MAGGIE MOORE
POKéMON: THE FIRST MOVIE	NARRATOR	UNSHō ISHIZUKA
THE WEATHER MAN	NARRATOR	NICOLAS CAGE
FLETCH	NARRATOR	CHEVY CHASE
WILD IN THE STREETS	NARRATOR	PAUL FREES
CHIMES AT MIDNIGHT	NARRATOR	RALPH RICHARDSON
TONGUES UNTIED	NARRATOR	MARLON RIGGS
TONGUES UNTIED	NARRATOR	VARIOUS
THE LAND BEFORE TIME III: THE TIME OF THE GREAT GIVING	NARRATOR	JOHN INGLE
THE FALL OF '55	NARRATOR	CLAUDIA WEATHERMON
THE ANDERSON PLATOON	NARRATOR	PIERRE SCHOENDOERFFER
THE ANDERSON PLATOON	NARRATOR	STUART WHITMAN (ENGLISH VERSION)
THE OTHER GUYS	NARRATOR	ICE-T
CHISUM	NARRATOR	WILLIAM CONRAD
THE MIRROR	NARRATOR	*
THE MIRROR	NARRATOR	INNOKENTY SMOKTUNOVSKY
THE MIRROR	NARRATOR	ARSENY TARKOVSKY
GORDY	NARRATOR	FRANK WELKER
ONE MILLION B.C.	NARRATOR	CONRAD NAGEL
THE LAND BEFORE TIME IV: JOURNEY THROUGH THE MISTS	NARRATOR	JOHN INGLE
FRANKENSTEIN UNBOUND	NARRATOR	JOHN HURT
THE SHIRALEE	NARRATOR	CHARLES TINGWELL
LORD OF WAR	NARRATOR	NICOLAS CAGE
FREDDIE AS F.R.O.7	NARRATOR	ADRIAN DELLA TOUCHE
FREDDIE AS F.R.O.7	NARRATOR	JAMES EARL JONES
THE SMURFS	NARRATOR	TOM KANE
WITHOUT WARNING!	NARRATOR	GENE WOOD
CHARLOTTE'S WEB	NARRATOR	SAM SHEPARD
A CHRISTMAS CAROL	NARRATOR	MICHAEL REDGRAVE
AMERICATHON	NARRATOR	GEORGE CARLIN
THE SECRET OF NIMH 2: TIMMY TO THE RESCUE	NARRATOR	PETER MACNICOL
HAPPILY N'EVER AFTER	NARRATOR	FREDDIE PRINZE, JR.
WINNIE THE POOH AND THE HONEY TREE	NARRATOR	SEBASTIAN CABOT
WINNIE THE POOH AND THE BLUSTERY DAY	NARRATOR	SEBASTIAN CABOT
WINNIE THE POOH AND TIGGER TOO	NARRATOR	SEBASTIAN CABOT
BATTLES WITHOUT HONOR AND HUMANITY	NARRATOR	ASAO KOIKE
STANLEY KUBRICK: A LIFE IN PICTURES	NARRATOR	TOM CRUISE
THE LAND THAT TIME FORGOT	NARRATOR	DOUG MCCLURE
THE TIME MACHINE	NARRATOR	ROD TAYLOR
THE NEVERENDING STORY	NARRATOR	ALAN OPPENHEIMER
THE DESERT FOX: THE STORY OF ROMMEL	NARRATOR	MICHAEL RENNIE
NOTHING	NARRATOR	MAURICE DEAN WINT
BEE MOVIE	NARRATOR	JIM CUMMINGS
TASK FORCE	NARRATOR	GARY COOPER
VIRUDDH... FAMILY COMES FIRST	NARRATOR	JOHN ABRAHAM
VOLCANOES OF THE DEEP SEA	NARRATOR	ED HARRIS
JUST VISITING	NARRATOR	KELSEY GRAMMER
THE LAND BEFORE TIME V: THE MYSTERIOUS ISLAND	NARRATOR	JOHN INGLE
GRENDEL GRENDEL GRENDEL	NARRATOR	PETER USTINOV
ULTRAVIOLET	NARRATOR	MILLA JOVOVICH
KHARTOUM	NARRATOR	LEO GENN
SHAKE HANDS WITH THE DEVIL	NARRATOR	MICHAEL RENNIE
EXPEDITION: BISMARCK	NARRATOR	LANCE HENRIKSEN
NAYAKAN	NARRATOR	INDRAJITH SUKUMARAN
CRONOS	NARRATOR	JORGE MARTíNEZ DE HOYOS
ACROSS THE WIDE MISSOURI	NARRATOR	HOWARD KEEL
ISLE OF FLOWERS	NARRATOR	PAULO JOSé
POOH'S GRAND ADVENTURE: THE SEARCH FOR CHRISTOPHER ROBIN	NARRATOR	DAVID WARNER
WHAT YOU MEAN WE%3F	NARRATOR	SPALDING GRAY
HELL'S ISLAND	NARRATOR	JOHN PAYNE
THE MESSAGE	NARRATOR	RICHARD JOHNSON
TALES OF TERROR	NARRATOR	VINCENT PRICE
THE OPPOSITE SEX	NARRATOR	ANN SHERIDAN
DON'T DRINK THE WATER	NARRATOR	ED HERLIHY
THE BATTLE OF CHINA	NARRATOR	ANTHONY VEILLER
THE NAZIS STRIKE	NARRATOR	WALTER HUSTON
THE BATTLE OF RUSSIA	NARRATOR	WALTER HUSTON
MOTHER NIGHT	NARRATOR	NICK NOLTE
DAS NETZ	NARRATOR	EVA MATTES
DAS NETZ	NARRATOR	THOMAS VOGT
THE TEXAS CHAINSAW MASSACRE	NARRATOR	JOHN LARROQUETTE
THE TEXAS CHAINSAW MASSACRE: THE BEGINNING	NARRATOR	JOHN LARROQUETTE
DEEWANE HUYE PAAGAL	NARRATOR	VIVEK OBEROI
GARFIELD: A TAIL OF TWO KITTIES	NARRATOR	ROSCOE LEE BROWNE
TMNT	NARRATOR	LAURENCE FISHBURNE
EVEREST	NARRATOR	LIAM NEESON
THE LAND BEFORE TIME IX: JOURNEY TO BIG WATER	NARRATOR	JOHN INGLE
THE DELHI WAY	NARRATOR	LEO GENN
LITTLE DIETER NEEDS TO FLY	NARRATOR	WERNER HERZOG
LITTLE DIETER NEEDS TO FLY	NARRATOR	DIETER DENGLER
BELLS FROM THE DEEP	NARRATOR	WERNER HERZOG
LA SOUFRIèRE	NARRATOR	WERNER HERZOG
HOW MUCH WOOD WOULD A WOODCHUCK CHUCK	NARRATOR	WERNER HERZOG
THE LEGEND OF FROSTY THE SNOWMAN	NARRATOR	BURT REYNOLDS
MY BROTHER…NIKHIL	NARRATOR	JUHI CHAWLA
CLIFFORD	NARRATOR	MARTIN SHORT
MY NEIGHBORS THE YAMADAS	NARRATOR	DAVID OGDEN STIERS
PRELUDE TO WAR	NARRATOR	WALTER HUSTON
THEY CALL US MISFITS	NARRATOR	STEFAN JARL
ABEL'S ISLAND	NARRATOR	TIM CURRY
POKéMON RANGER AND THE TEMPLE OF THE SEA	NARRATOR	UNSHOU ISHIZUKA
REEFER MADNESS	NARRATOR	ALAN CUMMING
THE GODS MUST BE CRAZY II	NARRATOR	PADDY O'BYRNE
ONE SURVIVOR REMEMBERS	NARRATOR	PETER THOMAS
SPRINGTIME WITH ROO	NARRATOR	DAVID OGDEN STIERS
MICKEY'S MAGICAL CHRISTMAS: SNOWED IN AT THE HOUSE OF MOUSE	NARRATOR	JOHN CLEESE
PERVERSION FOR PROFIT	NARRATOR	GEORGE PUTNAM
X-15	NARRATOR	JAMES STEWART
LITTLE SHOP OF HORRORS	NARRATOR	STAN JONES
GEORGE OF THE JUNGLE	NARRATOR	KEITH SCOTT
GEORGE OF THE JUNGLE 2	NARRATOR	KEITH SCOTT
ELIZABETHAN EXPRESS	NARRATOR	ALAN WHEATLEY
ELIZABETHAN EXPRESS	NARRATOR	HOWARD MARION-CRAWFORD
THE MASTER GUNFIGHTER	NARRATOR	BURGESS MEREDITH
JODHAA AKBAR	NARRATOR	AMITABH BACHCHAN
STARDUST	NARRATOR	IAN MCKELLEN
KRONK'S NEW GROOVE	NARRATOR	DAVID SPADE
THE MAGNIFICENT AMBERSONS	NARRATOR	ORSON WELLES
THE LAST OF ENGLAND	NARRATOR	NIGEL TERRY
JINNAH	NARRATOR	SHASHI KAPOOR
C.S.A.: THE CONFEDERATE STATES OF AMERICA	NARRATOR	CHARLES FRANK
THE ROAD HOME	NARRATOR	SUN HONGLEI
THE SILENCE OF THE HAMS	NARRATOR	EZIO GREGGIO
THE LONG GRAY LINE	NARRATOR	TYRONE POWER
HIS KIND OF WOMAN	NARRATOR	CHARLES MCGRAW
THE VIRGIN SUICIDES	NARRATOR	GIOVANNI RIBISI
THE LAND BEFORE TIME VI: THE SECRET OF SAURUS ROCK	NARRATOR	KENNETH MARS
TRINITY AND BEYOND	NARRATOR	WILLIAM SHATNER
WINNIE THE POOH AND A DAY FOR EEYORE	NARRATOR	LAURIE MAIN
SEX SLAVES	NARRATOR	RIC ESTHER BIENSTOCK
GNOMES	NARRATOR	LEE RICHARDSON
ISLAND IN THE SKY	NARRATOR	WILLIAM WELLMAN
CARL TH. DREYER—MY METIER	NARRATOR	HARALD PAALGAARD
A CONSTANT FORGE	NARRATOR	LENNY CITRANO
THE RIVER	NARRATOR	JUNE HILLMAN
THE THREE LIVES OF THOMASINA	NARRATOR	ELSPETH MARCH
MAN ON FIRE	NARRATOR	SCOTT GLENN
DON'T LOSE YOUR HEAD	NARRATOR	PATRICK ALLEN
CARRY ON DOCTOR	NARRATOR	PATRICK ALLEN
MAN OF THE HOUSE	NARRATOR	JONATHAN TAYLOR THOMAS
CHARLOTTE'S WEB	NARRATOR	REX ALLEN
UNPRECEDENTED: THE 2000 PRESIDENTIAL ELECTION	NARRATOR	PETER COYOTE
ANITA: SWEDISH NYMPHET	NARRATOR	CHRISTINA LINDBERG
ANITA: SWEDISH NYMPHET	NARRATOR	STELLAN SKARSGåRD
THE BARBARIAN AND THE GEISHA	NARRATOR	EIKO ANDO
THE KID STAYS IN THE PICTURE	NARRATOR	ROBERT EVANS
LOVE, HONOUR AND OBEY	NARRATOR	JONNY LEE MILLER
PHIR HERA PHERI	NARRATOR	NANA PATEKAR
THE UNKNOWN MAN	NARRATOR	BARRY SULLIVAN
SIKKIM	NARRATOR	SATYAJIT RAY
SUKUMAR RAY	NARRATOR	SOUMITRA CHATTERJEE
GOD SLEEPS IN RWANDA	NARRATOR	ROSARIO DAWSON
THE MYSTERIOUS GEOGRAPHIC EXPLORATIONS OF JASPER MORELLO	NARRATOR	JOEL EDGERTON
BEEF	NARRATOR	VING RHAMES
TAXI NO. 9211	NARRATOR	SANJAY DUTT
THE SEVENTH CURSE	NARRATOR	NI KUANG
HENNA	NARRATOR	SHAMMI KAPOOR
THE BIG KNIFE	NARRATOR	RICHARD BOONE
TENSION	NARRATOR	BARRY SULLIVAN
THE LAND BEFORE TIME VIII: THE BIG FREEZE	NARRATOR	JOHN INGLE
THE GREATEST PHARAOHS	NARRATOR	FRANK LANGELLA
A VERY MERRY POOH YEAR	NARRATOR	MICHAEL YORK
FIGHTING NORWAY	NARRATOR	LORNE GREENE
BANSHEES OVER CANADA	NARRATOR	LORNE GREENE
THE RESURRECTION OF BRONCHO BILLY	NARRATOR	RUTH HUSSEY
THE RESURRECTION OF BRONCHO BILLY	NARRATOR	RICKY NELSON
SOPHIE'S CHOICE	NARRATOR	JOSEF SOMMER
POOH'S HEFFALUMP HALLOWEEN MOVIE	NARRATOR	DAVID OGDEN STIERS
TO BE OR NOT TO BE	NARRATOR	SCOTT BEACH
GOLDEN DREAMS	NARRATOR	WHOOPI GOLDBERG
THE MAN WHO SKIED DOWN EVEREST	NARRATOR	DOUGLAS RAIN
VAASTAV: THE REALITY	NARRATOR	REEMA LAGOO
DEVDAS	NARRATOR	SANJAY LEELA BHANSALI
RIDING GIANTS	NARRATOR	STACY PERALTA
THEY CHOSE FREEDOM	NARRATOR	VLADIMIR V. KARA-MURZA
STICK IT	NARRATOR	MISSY PEREGRYM
BEWARE OF THE CAR	NARRATOR	YURIY YAKOVLEV
THE LAND BEFORE TIME XI: INVASION OF THE TINYSAURUSES	NARRATOR	JOHN INGLE
EMMANUEL'S GIFT	NARRATOR	OPRAH WINFREY
OBJECTIVE, BURMA!	NARRATOR	TRUMAN BRADLEY
THE PANAMA DECEPTION	NARRATOR	ELIZABETH MONTGOMERY
THE SLEEPING CITY	NARRATOR	RICHARD CONTE
SOUTHSIDE 1-1000	NARRATOR	GERALD MOHR
JIMMY JOHNSTONE: LORD OF THE WING	NARRATOR	BILLY CONNOLLY
KAAKHA KAAKHA	NARRATOR	SATHYARAJ
MADELINE: LOST IN PARIS	NARRATOR	CHRISTOPHER PLUMMER
ABOUT A BOY	NARRATOR	NICHOLAS HOULT
ROVING MARS	NARRATOR	PAUL NEWMAN
BUZZ LIGHTYEAR OF STAR COMMAND: THE ADVENTURE BEGINS	NARRATOR	TIM ALLEN
10,000 BC	NARRATOR	OMAR SHARIF
THE LAND BEFORE TIME X: THE GREAT LONGNECK MIGRATION	NARRATOR	JOHN INGLE
DEAR BRIGITTE	NARRATOR	ED WYNN
DEVDAS	NARRATOR	BIMAL ROY
THE HERO: LOVE STORY OF A SPY	NARRATOR	SUNNY DEOL
BEEF III	NARRATOR	DJ KAYSLAY
GALLIPOLI	NARRATOR	SAM NEILL
GALLIPOLI	NARRATOR	ZAFER ERGIN
GALLIPOLI	NARRATOR	DEMETRI GORITSAS
GALLIPOLI	NARRATOR	JEREMY IRONS
VOYAGER	NARRATOR	SAM SHEPARD
WORLD WAR III	NARRATOR	DAVID MCCALLUM
FREDERIC REMINGTON: THE TRUTH OF OTHER DAYS	NARRATOR	GREGORY PECK
THOMAS JEFFERSON	NARRATOR	OSSIE DAVIS
SMILEY FACE	NARRATOR	ROSCOE LEE BROWNE
AMERICA'S MUSIC: THE ROOTS OF COUNTRY	NARRATOR	KRIS KRISTOFFERSON
RALLY ROUND THE FLAG, BOYS!	NARRATOR	DAVID HEDISON
ANDRE	NARRATOR	ANNETTE O'TOOLE
MR. MAGORIUM'S WONDER EMPORIUM	NARRATOR	ZACH MILLS
HOLY GHOST PEOPLE	NARRATOR	PETER ADAIR
CHEAPER BY THE DOZEN	NARRATOR	JEANNE CRAIN
THE ADVENTURES OF LOLO THE PENGUIN	NARRATOR	ALEXEI BATALOV
FARCE OF THE PENGUINS	NARRATOR	SAMUEL L. JACKSON
THE SOCIETY OF THE SPECTACLE	NARRATOR	GUY DEBORD
DIVIDE AND CONQUER	NARRATOR	WALTER HUSTON
TO SELL A WAR	NARRATOR	LINDEN MACINTYRE
PAID IN FULL	NARRATOR	WOOD HARRIS
MONSTROSITY	NARRATOR	BRADFORD DILLMAN
TO KILL A MOCKINGBIRD	NARRATOR	KIM STANLEY
TEXAS RANGERS	NARRATOR	JAMES COBURN
WAR COMES TO AMERICA	NARRATOR	WALTER HUSTON
WAR COMES TO AMERICA	NARRATOR	LLOYD NOLAN
THE HORSEMAN ON THE ROOF	NARRATOR	JACQUES WEBER
POKéMON 3: THE MOVIE	NARRATOR	UNSHō ISHIZUKA
ALAKAZAM THE GREAT	NARRATOR	STERLING HOLLOWAY
BARBIE AS THE PRINCESS AND THE PAUPER	NARRATOR	KELLY SHERIDAN
BEEF II	NARRATOR	KEITH DAVID
RABINDRANATH TAGORE	NARRATOR	SATYAJIT RAY
THE INNER EYE	NARRATOR	SATYAJIT RAY
BALA	NARRATOR	SATYAJIT RAY
THE GREEN GLOVE	NARRATOR	JOHN DEHNER
THE CAT IN THE HAT	NARRATOR	VICTOR BRANDT
FORBIDDEN	NARRATOR	JACQUELINE BISSET
HOW GREEN WAS MY VALLEY	NARRATOR	IRVING PICHEL
DUDLEY DO-RIGHT	NARRATOR	COREY BURTON
CAUDILLO	NARRATOR	HECTOR ALTERIO
DR. SEUSS' HOW THE GRINCH STOLE CHRISTMAS	NARRATOR	ANTHONY HOPKINS
TANGO CHARLIE	NARRATOR	BOBBY DEOL
WHO KILLED THE ELECTRIC CAR%3F	NARRATOR	MARTIN SHEEN
CHAMBER OF HORRORS	NARRATOR	WILLIAM CONRAD
QUEEN OF THE AMAZONS	NARRATOR	JOHN MILJAN
THE COMPLEAT BEATLES	NARRATOR	MALCOLM MCDOWELL
SATTE PE SATTA	NARRATOR	KADER KHAN
YOUR STUDIO AND YOU	NARRATOR	TREY PARKER
WE'RE BACK! A DINOSAUR'S STORY	NARRATOR	JOHN GOODMAN
GERONIMO: AN AMERICAN LEGEND	NARRATOR	MATT DAMON
SANTA VS. THE SNOWMAN 3D	NARRATOR	DON LAFONTAINE
ANATOMY OF HELL	NARRATOR	CATHERINE BREILLAT
SHANGHAI GHETTO	NARRATOR	MARTIN LANDAU
THE LOONEY LOONEY LOONEY BUGS BUNNY MOVIE	NARRATOR	RALPH JAMES
CHUCK AMUCK: THE MOVIE	NARRATOR	DICK VOSBURGH
BUGS BUNNY: SUPERSTAR	NARRATOR	ORSON WELLES
MOONRUNNERS	NARRATOR	WAYLON JENNINGS
TUCK EVERLASTING	NARRATOR	ELISABETH SHUE
MALAMAAL WEEKLY	NARRATOR	NASEERUDDIN SHAH
TULSA	NARRATOR	CHILL WILLS
ENCHANTED	NARRATOR	JULIE ANDREWS
GHULAMI	NARRATOR	AMITABH BACHCHAN
HATHYAR	NARRATOR	SACHIN KHEDEKAR
SANGAM	NARRATOR	RAJ KAPOOR
NAKED IN NEW YORK	NARRATOR	ERIC STOLTZ
GADAR: EK PREM KATHA	NARRATOR	OM PURI
HAV PLENTY	NARRATOR	CHRISTOPHER SCOTT CHEROT
HOUSE ARREST	NARRATOR	KYLE HOWARD
THE PHANTOM	NARRATOR	PATRICK MCGOOHAN
THE HOTEL NEW HAMPSHIRE	NARRATOR	ROB LOWE
GUNGA JUMNA	NARRATOR	DILIP KUMAR
SANS SOLEIL	NARRATOR	FLORENCE DELAY
SANS SOLEIL	NARRATOR	RIYOKO IKEDA
SANS SOLEIL	NARRATOR	CHARLOTTE KERR
SANS SOLEIL	NARRATOR	ALEXANDRA STEWART
SAAWARIYA	NARRATOR	RANI MUKERJI
SIR! NO SIR!	NARRATOR	TROY GARITY
THE VIKINGS	NARRATOR	ORSON WELLES
CHORI CHORI	NARRATOR	RANI MUKERJI
CREATURE FROM THE HAUNTED SEA	NARRATOR	ROBERT TOWNE
LIVE FREAKY! DIE FREAKY!	NARRATOR	TIM ARMSTRONG
TEN CANOES	NARRATOR	DAVID GULPILIL
SPIN	NARRATOR	BRIAN SPRINGER
I'M NOT THERE	NARRATOR	KRIS KRISTOFFERSON
GLOBALISATION IS GOOD	NARRATOR	JOHAN NORBERG
EASTERN PROMISES	NARRATOR	TATIANA MASLANY
HITLER: A FILM FROM GERMANY	NARRATOR	HANS-JüRGEN SYBERBERG
UKRAINE IN FLAMES	NARRATOR	ALEXANDER DOVZHENKO
BEFORE AND AFTER	NARRATOR	JULIA WELDON
MADONNA: TRUTH OR DARE	NARRATOR	MADONNA
MAN IN THE SAND	NARRATOR	NORA GUTHRIE
A DATE WITH YOUR FAMILY	NARRATOR	HUGH BEAUMONT
GRASS	NARRATOR	WOODY HARRELSON
THE DEVIL'S BACKBONE	NARRATOR	FEDERICO LUPPI
AMERICA SCREAMS	NARRATOR	VINCENT PRICE
MEMOIRS OF A GEISHA	NARRATOR	SHIZUKO HOSHI
THE LION HAS WINGS	NARRATOR	E.V.H. EMMETT
THE LION HAS WINGS	NARRATOR	LOWELL THOMAS
AN AIRMAN'S LETTER TO HIS MOTHER	NARRATOR	JOHN GIELGUD
AN AIRMAN'S LETTER TO HIS MOTHER	NARRATOR	MICHAEL POWELL
THE PHANTOM	NARRATOR	KNOX MANNING
WAR IS HELL	NARRATOR	AUDIE MURPHY
DIGIMON: THE MOVIE	NARRATOR	LARA JILL MILLER
CITIZEN DOG	NARRATOR	PEN-EK RATANARUANG
VALENTíN	NARRATOR	RODRIGO NOYA
CASPER'S HAUNTED CHRISTMAS	NARRATOR	DAVID KAYE
TINKER BELL	NARRATOR	LOREENA MCKENNITT
ZOOM	NARRATOR	COURTENEY COX
ALIVE: 20 YEARS LATER	NARRATOR	MARTIN SHEEN
KERMIT'S SWAMP YEARS	NARRATOR	KERMIT THE FROG
THE MATING HABITS OF THE EARTHBOUND HUMAN	NARRATOR	DAVID HYDE PIERCE
FRANCO, ESE HOMBRE	NARRATOR	ÁNGEL PICAZO
STAIRS 1 GENEVA	NARRATOR	PETER GREENAWAY
MEN OF CRISIS: THE HARVEY WALLINGER STORY	NARRATOR	REED HADLEY
THE TIMES OF HARVEY MILK	NARRATOR	HARVEY FIERSTEIN
WELCOME	NARRATOR	OM PURI
SAMSON AND DELILAH	NARRATOR	MAX VON SYDOW
ANGELS & DEMONS	NARRATOR	ALFRED MOLINA
THE DEVIL AT YOUR HEELS	NARRATOR	GORDON PINSENT
ONE BRIGHT SHINING MOMENT: THE FORGOTTEN SUMMER OF GEORGE MCGOVERN	NARRATOR	AMY GOODMAN
NOIN SEITSEMäN VELJESTä	NARRATOR	MARTTI SILVENNOINEN
NOIN SEITSEMäN VELJESTä	NARRATOR	ILKKA LIPSANEN
THE ERNEST GREEN STORY	NARRATOR	ERNEST GREEN
DALAI LAMA RENAISSANCE	NARRATOR	HARRISON FORD
THE AGE OF INNOCENCE	NARRATOR	JOANNE WOODWARD
BANGKOK DANGEROUS	NARRATOR	NICOLAS CAGE
BHUVAN SHOME	NARRATOR	AMITABH BACHCHAN
THE WHITE DIAMOND	NARRATOR	WERNER HERZOG
MAELSTRöM	NARRATOR	PIERRE LEBEAU
POKéMON: THE RISE OF DARKRAI	NARRATOR	UNSHOU ISHIZUKA
ASTERIX AND THE BIG FIGHT	NARRATOR	TONY JAY
HORTON HEARS A WHO!	NARRATOR	CHARLES OSGOOD
DOC SAVAGE: THE MAN OF BRONZE	NARRATOR	PAUL FREES
THE SPANISH EARTH	NARRATOR	*
THE SPANISH EARTH	NARRATOR	ORSON WELLES
THE SPANISH EARTH	NARRATOR	*ERNEST HEMINGWAY
THE SPANISH EARTH	NARRATOR	JEAN RENOIR
THE PUPPET MASTERS	NARRATOR	CHRISTOPHER BRITTON
SYNDROMES AND A CENTURY	NARRATOR	LEE CHATAMETIKOOL
OCCUPATION 101	NARRATOR	ALISON WEIR
THE HORSE WITH THE FLYING TAIL	NARRATOR	GEORGE FENNEMAN
THE DESERT RATS	NARRATOR	MICHAEL RENNIE
CITIZEN TOXIE: THE TOXIC AVENGER IV	NARRATOR	STAN LEE
EVERYONE STARES	NARRATOR	STEWART COPELAND
THE PROMOTION	NARRATOR	SEANN WILLIAM SCOTT
THE PROMOTION	NARRATOR	RICHARD HENZEL
INDOCTRINATE U	NARRATOR	EVAN COYNE MALONEY
THE SILENT SCREAM	NARRATOR	BERNARD NATHANSON
ONE GOT FAT	NARRATOR	EDWARD EVERETT HORTON
NIGHT MAIL	NARRATOR	JOHN GRIERSON
THE GREAT ECSTASY OF WOODCARVER STEINER	NARRATOR	WERNER HERZOG
CLASS OF NUKE 'EM HIGH 3: THE GOOD, THE BAD AND THE SUBHUMANOID	NARRATOR	BRICK BRONSKY
JULES VERNE'S ROCKET TO THE MOON	NARRATOR	MAURICE DENHAM
FULL CLIP	NARRATOR	WYCLEF JEAN
THE LAND BEFORE TIME XII: THE GREAT DAY OF THE FLYERS	NARRATOR	JOHN INGLE
EARTHLINGS	NARRATOR	JOAQUIN PHOENIX
THE CREW	NARRATOR	RICHARD DREYFUSS
SATYAM SHIVAM SUNDARAM	NARRATOR	RAJ KAPOOR
ANIMAL FARM	NARRATOR	GORDON HEATH
DEEP SEA 3D	NARRATOR	JOHNNY DEPP
DEEP SEA 3D	NARRATOR	KATE WINSLET
BERLIN ALEXANDERPLATZ	NARRATOR	RAINER WERNER FASSBINDER
NAKSHA	NARRATOR	ANIL KAPOOR
THE EDUCATION OF CHARLIE BANKS	NARRATOR	JESSE EISENBERG
SUBMARINE COMMAND	NARRATOR	WILLIAM HOLDEN
KNIGHTS OF THE ROUND TABLE	NARRATOR	VALENTINE DYALL
CHEERLEADER NINJAS	NARRATOR	KEVIN CAMPBELL
SUPER SPEEDWAY	NARRATOR	PAUL NEWMAN
AZHAGAI IRUKKIRAI BAYAMAI IRUKKIRATHU	NARRATOR	R. PARTHIBAN
IN THE REALMS OF THE UNREAL	NARRATOR	DAKOTA FANNING
THE BIG MOUTH	NARRATOR	FRANK DE VOL
JOE GOULD'S SECRET	NARRATOR	STANLEY TUCCI
MADAME BOVARY	NARRATOR	JAMES MASON
HERDSMEN OF THE SUN	NARRATOR	WERNER HERZOG
THE VANISHING PRAIRIE	NARRATOR	WINSTON HIBLER
11: PRESS FOR TRUTH	NARRATOR	MICHAEL PRITCHARD
I'LL BE SEEING YOU	NARRATOR	JOSEPH COTTEN
THE GUNS OF NAVARONE	NARRATOR	JAMES ROBERTSON JUSTICE
THE BOOK OF THE DEAD	NARRATOR	KYōKO KISHIDA
PERFUME: THE STORY OF A MURDERER	NARRATOR	JOHN HURT
ONE BY ONE	NARRATOR	STACY KEACH
ASTERIX THE GAUL	NARRATOR	JOHN CLIVE
LIVE AND BECOME	NARRATOR	PATRICK DESCAMPS
ELLA ENCHANTED	NARRATOR	ERIC IDLE
DIGBY, THE BIGGEST DOG IN THE WORLD	NARRATOR	TED KEY
KURT COBAIN: ABOUT A SON	NARRATOR	KURT COBAIN
SANTA CLAUS	NARRATOR	KEN SMITH
MARADONA BY KUSTURICA	NARRATOR	EMIR KUSTURICA
NO SMOKING	NARRATOR	PETER HUDSON
THE BLUES	NARRATOR	LAURENCE FISHBURNE
THE WEREWOLF	NARRATOR	FRED F. SEARS
THREE CAME HOME	NARRATOR	CLAUDETTE COLBERT
ATHIDHI	NARRATOR	ABBURI RAVI
MERE YAAR KI SHAADI HAI	NARRATOR	SAURABH SHUKLA
KING RICHARD AND THE CRUSADERS	NARRATOR	LESTER MATTHEWS
THE NEW SWISS FAMILY ROBINSON	NARRATOR	JAMIE RENéE SMITH
TWO FAMILY HOUSE	NARRATOR	FRANK WHALEY
THE BUCKET LIST	NARRATOR	MORGAN FREEMAN
THE NAKED MONSTER	NARRATOR	GEORGE FENNEMAN
INCIDENT AT OGLALA	NARRATOR	ROBERT REDFORD
UNFORGIVABLE BLACKNESS: THE RISE AND FALL OF JACK JOHNSON	NARRATOR	KEITH DAVID
JAPANESE RELOCATION	NARRATOR	MILTON S. EISENHOWER
ASTERIX CONQUERS AMERICA	NARRATOR	HARALD JUHNKE
ASTERIX CONQUERS AMERICA	NARRATOR	JOHN RYE
THE BATTLE OF MIDWAY	NARRATOR	DONALD CRISP
KNOW YOUR ENEMY: JAPAN	NARRATOR	WALTER HUSTON
KNOW YOUR ENEMY: JAPAN	NARRATOR	DANA ANDREWS
DARBY'S RANGERS	NARRATOR	JACK WARDEN
BRING ME THE HEAD OF CHARLIE BROWN	NARRATOR	RICH MOORE
11	NARRATOR	STEVE BUSCEMI
FRED CLAUS	NARRATOR	TREVOR PEACOCK
THE COMEBACKS	NARRATOR	CARL WEATHERS
ANNA AND THE MOODS	NARRATOR	TERRY JONES
THE GREAT WARMING	NARRATOR	ALANIS MORISSETTE
THE GREAT WARMING	NARRATOR	KEANU REEVES
BLACK BEAUTY	NARRATOR	ALAN CUMMING
EVEN COWGIRLS GET THE BLUES	NARRATOR	TOM ROBBINS
THUNDERBOLT!	NARRATOR	LLOYD BRIDGES
THUNDERBOLT!	NARRATOR	ROBERT LOWERY
UNDERFUNDED	NARRATOR	MATHER ZICKEL
WINGS OF HOPE	NARRATOR	WERNER HERZOG
EGOMANIA	NARRATOR	BERNARD HILL
ROGUE TRADER	NARRATOR	EWAN MCGREGOR
EPIC MOVIE	NARRATOR	ROSCOE LEE BROWNE
ROXIE HART	NARRATOR	GEORGE MONTGOMERY
THE TREE IN A TEST TUBE	NARRATOR	PETE SMITH
THE TREE IN A TEST TUBE	NARRATOR	LEE VICKERS
WINGS FOR THIS MAN	NARRATOR	RONALD REAGAN
LEGIONNAIRE	NARRATOR	JEAN-CLAUDE VAN DAMME
LAAGA CHUNARI MEIN DAAG	NARRATOR	RANI MUKERJI
HYMN OF THE NATIONS	NARRATOR	KNOX MANNING
HYMN OF THE NATIONS	NARRATOR	BURGESS MEREDITH
COSMIC VOYAGE	NARRATOR	MORGAN FREEMAN
UNCONQUERED	NARRATOR	CECIL B. DEMILLE
LOOK AT LIFE	NARRATOR	TIM TURNER AND OTHERS
TONY HAWK IN BOOM BOOM SABOTAGE	NARRATOR	MICHAEL DONOVAN
THE LONG WAY HOME	NARRATOR	MORGAN FREEMAN
SHE SHOULDA SAID NO!	NARRATOR	KNOX MANNING
SWEET	NARRATOR	NOEL FIELDING
DOWN AND OUT IN AMERICA	NARRATOR	LEE GRANT
BROKEN RAINBOW	NARRATOR	MARTIN SHEEN
GENOCIDE	NARRATOR	ELIZABETH TAYLOR
GENOCIDE	NARRATOR	ORSON WELLES
WHO ARE THE DEBOLTS%3F AND WHERE DID THEY GET NINETEEN KIDS%3F	NARRATOR	HENRY WINKLER
HERO	NARRATOR	MICHAEL CAINE
THE GREAT AMERICAN COWBOY	NARRATOR	JOEL MCCREA
ABBOTT AND COSTELLO IN THE FOREIGN LEGION	NARRATOR	JEFF CHANDLER
HENRY BROWNE, FARMER	NARRATOR	CANADA LEE
KINGS OF THE SUN	NARRATOR	JAMES COBURN
RING OF STEEL	NARRATOR	SPENCER TRACY
VISHWATMA	NARRATOR	NASEERUDDIN SHAH
JOURNEY INTO SELF	NARRATOR	STANLEY KRAMER
THE ELEANOR ROOSEVELT STORY	NARRATOR	ERIC SEVAREID
THE ELEANOR ROOSEVELT STORY	NARRATOR	ARCHIBALD MACLEISH
THE ELEANOR ROOSEVELT STORY	NARRATOR	FRANCIS COLE
ROBERT FROST: A LOVER'S QUARREL WITH THE WORLD	NARRATOR	ROBERT FROST
BLACK FOX: THE RISE AND FALL OF ADOLF HITLER	NARRATOR	MARLENE DIETRICH
SERENGETI SHALL NOT DIE	NARRATOR	BERNHARD GRZIMEK
ALBERT SCHWEITZER	NARRATOR	FREDRIC MARCH
ALBERT SCHWEITZER	NARRATOR	BURGESS MEREDITH
HELEN KELLER IN HER STORY	NARRATOR	KATHARINE CORNELL
PANDA AND THE MAGIC SERPENT	NARRATOR	MARVIN MILLER
KILLERS FROM SPACE	NARRATOR	MARK SCOTT
O. HENRY'S FULL HOUSE	NARRATOR	JOHN STEINBECK
THE WORLD OF ABBOTT AND COSTELLO	NARRATOR	JACK E. LEONARD
GO THERE, DON'T KNOW WHERE	NARRATOR	GEORGIY VITSIN
GO THERE, DON'T KNOW WHERE	NARRATOR	DMITRIY ZHURAVLYOV
THE LOST LETTER	NARRATOR	VASILIY KACHALOV
DEEP WATER	NARRATOR	JEAN BADIN
DEEP WATER	NARRATOR	TILDA SWINTON
GESUALDO: DEATH FOR FIVE VOICES	NARRATOR	WERNER HERZOG
PINOCCHIO	NARRATOR	DAVID SUCHET
GRACIAS AMIGOS	NARRATOR	LOWELL THOMAS
SHE-DEVIL	NARRATOR	ROSEANNE BARR
IN SEARCH OF THE SECOND AMENDMENT	NARRATOR	DAVID T. HARDY
CHILDREN OF TSUNAMI: NO MORE TEARS	NARRATOR	GREGORY BURNS
THE DREAM IS ALIVE	NARRATOR	WALTER CRONKITE
SILENT NIGHT	NARRATOR	MICHAEL SINELNIKOFF
HELLO	NARRATOR	KATRINA KAIF
ARN – THE KNIGHT TEMPLAR	NARRATOR	SVEN-BERTIL TAUBE
THE STILWELL ROAD	NARRATOR	RONALD REAGAN
THE BATTLE OF BRITAIN	NARRATOR	WALTER HUSTON
TO THE PEOPLE OF THE UNITED STATES	NARRATOR	JEAN HERSHOLT
GUIDE	NARRATOR	DEV ANAND
GUIDE	NARRATOR	WAHEEDA REHMAN
GUIDE	NARRATOR	LEELA CHITNIS
STATESIDE	NARRATOR	JONATHAN TUCKER
REPORT FROM THE ALEUTIANS	NARRATOR	JOHN HUSTON
REPORT FROM THE ALEUTIANS	NARRATOR	WALTER HUSTON
BAWARCHI	NARRATOR	AMITABH BACHCHAN
METRO-LAND	NARRATOR	JOHN BETJEMAN
THE PICTURE OF DORIAN GRAY	NARRATOR	CEDRIC HARDWICKE
MUHAMMAD: THE LAST PROPHET	NARRATOR	BRIAN NISSEN
CHURCHILL'S ISLAND	NARRATOR	LORNE GREENE
SUPERMAN: DOOMSDAY	NARRATOR	JAMES MARSTERS
MEGAVILLE	NARRATOR	J.C. QUINN
NEHLLE PE DEHLLA	NARRATOR	SHAKTI KAPOOR
ROCKET SCIENCE	NARRATOR	DAN CASHMAN
FASTER	NARRATOR	EWAN MCGREGOR
WHAT'S GOING ON UP THERE%3F	NARRATOR	LEONARD NIMOY
GIANT CREEPY CRAWLIES	NARRATOR	NIGEL MARVEN
THE LIVING SEA	NARRATOR	MERYL STREEP
WINNING YOUR WINGS	NARRATOR	JAMES STEWART
IT'S EVERYBODY'S WAR	NARRATOR	HENRY FONDA
CORAL REEF ADVENTURE	NARRATOR	LIAM NEESON
SPECIAL EFFECTS: ANYTHING CAN HAPPEN	NARRATOR	JOHN LITHGOW
DESIGNING WOMAN	NARRATOR	LAUREN BACALL
DESIGNING WOMAN	NARRATOR	GREGORY PECK
THE DANISH POET	NARRATOR	LIV ULLMANN
ALASKA: SPIRIT OF THE WILD	NARRATOR	CHARLTON HESTON
AFRICA: THE SERENGETI	NARRATOR	JAMES EARL JONES
ADVENTURES IN WILD CALIFORNIA	NARRATOR	JIMMY SMITS
MR. ACE	NARRATOR	KNOX MANNING
HURRICANE ON THE BAYOU	NARRATOR	MERYL STREEP
UNTAMED	NARRATOR	SUSAN HAYWARD
RAWHIDE	NARRATOR	GARY MERRILL
BEHIND THE CAMERA: THE UNAUTHORIZED STORY OF THREE'S COMPANY	NARRATOR	JOYCE DEWITT
BATTLES WITHOUT HONOR AND HUMANITY: DEADLY FIGHT IN HIROSHIMA	NARRATOR	TETSU SAKAI
EVERYTHING WILL BE OK	NARRATOR	DON HERTZFELDT
JOY OF LEARNING	NARRATOR	JEAN-LUC GODARD
A KING'S STORY	NARRATOR	ORSON WELLES
NǃAI, THE STORY OF A ǃKUNG WOMAN	NARRATOR	JOHN MARSHALL
TRADING WOMEN	NARRATOR	ANGELINA JOLIE
BASTARDS OF THE PARTY	NARRATOR	CLE SLOAN
PRIVATE PARTS	NARRATOR	HOWARD STERN
THE FIGHTING LADY	NARRATOR	ROBERT TAYLOR
THE FIGHTING LADY	NARRATOR	CHARLES BOYER
DAY THE WORLD ENDED	NARRATOR	CHET HUNTLEY
18-J	NARRATOR	NORMA ALEANDRO
KYAA KOOL HAI HUM	NARRATOR	JOHNNY LEVER
THE RAILWAY CHILDREN	NARRATOR	JENNY AGUTTER
ATTACK! THE BATTLE OF NEW BRITAIN	NARRATOR	LEO GENN
ATTACK! THE BATTLE OF NEW BRITAIN	NARRATOR	BURGESS MEREDITH
ATTACK! THE BATTLE OF NEW BRITAIN	NARRATOR	ANTHONY VEILLER
CHENNAI 600028	NARRATOR	S. P. BALASUBRAHMANYAM
BATTLEFIELD	NARRATOR	TIM PIGGOTT-SMITH
BATTLEFIELD	NARRATOR	TIM PIGGOTT-SMITH\N  MUSIC          = DAVID GALBRAITH
BATTLEFIELD	NARRATOR	GAVIN MACFADYEN
THE CHILDREN OF GOLZOW	NARRATOR	WINFRIED JUNGE
THE MAKING OF MILWAUKEE	NARRATOR	JOHN GURDA
ARAYA	NARRATOR	JOSé IGNACIO CABRUJAS
ARAYA	NARRATOR	LAURENT TERZIEFF
LA BARRA MENDOCINA	NARRATOR	MARIO SOFFICI
ANTI-SEMITISM IN THE 21ST CENTURY: THE RESURGENCE	NARRATOR	JUDY WOODRUFF
FAMILY LAW	NARRATOR	DANIEL HENDLER
THE LONG WALK HOME	NARRATOR	MARY STEENBURGEN
FIRES ON THE PLAIN	NARRATOR	EIJI FUNAKOSHI
THE RISE OF CATHERINE THE GREAT	NARRATOR	ALEXANDER KERENSKY
WINNIE THE POOH DISCOVERS THE SEASONS	NARRATOR	LAURIE MAIN
BEAT THIS: A HIP-HOP HISTORY	NARRATOR	IMHOTEP GARY BYRD
REDLINE	NARRATOR	NADIA BJORLIN
A DIARY FOR TIMOTHY	NARRATOR	MICHAEL REDGRAVE
BOILING POINT	NARRATOR	TOBIN BELL
SPECIAL DELIVERY	NARRATOR	SANDY SANDERSON
SPECIAL DELIVERY	NARRATOR	JEAN MARCHAND
EL MUERTO ES UN VIVO	NARRATOR	HARRY MIMMO
THE BLACK STALLION RETURNS	NARRATOR	HOYT AXTON
BELLADONNA OF SADNESS	NARRATOR	CHINATSU NAKAYAMA
BEAUTY IN TROUBLE	NARRATOR	PETR JARCHOVSKý
BEAUTY IN TROUBLE	NARRATOR	JAN HřEBEJK
SLATTERY'S HURRICANE	NARRATOR	GARY MERRILL
DESTINATION GOBI	NARRATOR	RICHARD WIDMARK
PROPHECIES OF NOSTRADAMUS	NARRATOR	KYōKO KISHIDA
PROPHECIES OF NOSTRADAMUS	NARRATOR	JACK RYLAND
THE SEVEN LITTLE FOYS	NARRATOR	CHARLEY FOY
ULTIME GRIDA DALLA SAVANA	NARRATOR	GIUSEPPE RINALDI
VISAS AND VIRTUE	NARRATOR	SHIZUKO HOSHI
LE TEMPS DES BOUFFONS	NARRATOR	PIERRE FALARDEAU
TERE MERE SAPNE	NARRATOR	AMITABH BACHCHAN
THE REIVERS	NARRATOR	BURGESS MEREDITH
PURPLE STORM	NARRATOR	DANIEL WU
THE ANGELIC CONVERSATION	NARRATOR	JUDI DENCH
BOROM SARRET	NARRATOR	OUSMANE SEMBèNE
RETURN TO THE LAND OF WONDERS	NARRATOR	MAYSOON PACHACHI
THE BROTHERS BLOOM	NARRATOR	RICKY JAY
THE BUSY LITTLE ENGINE	NARRATOR	DESMOND MULLEN
WHEEL OF TIME	NARRATOR	WERNER HERZOG
THE CONQUEST OF EVEREST	NARRATOR	MEREDITH EDWARDS
THE SHARK IS STILL WORKING	NARRATOR	ROY SCHEIDER
EYE OF THE LEOPARD	NARRATOR	JEREMY IRONS
SHARKWATER	NARRATOR	ROB STEWART
SHARKWATER	NARRATOR	PAUL WATSON
THE DEAL	NARRATOR	DONALD SUTHERLAND
THE PRINCIPLE	NARRATOR	KATE MULGREW
THE HUNT FOR EAGLE ONE	NARRATOR	THERESA RANDLE
DEATH DEFYING ACTS	NARRATOR	SAOIRSE RONAN
HERE IS GERMANY	NARRATOR	WALTER HUSTON
HERE IS GERMANY	NARRATOR	ANTHONY VEILLER
TRACES OF A DRAGON	NARRATOR	TI LUNG
THE DEVIL'S DISCIPLE	NARRATOR	PETER LEEDS
SAGINA	NARRATOR	DILIP KUMAR
A PLUMM SUMMER	NARRATOR	JEFF DANIELS
JUNOON	NARRATOR	AMRISH PURI
VICKY CRISTINA BARCELONA	NARRATOR	CHRISTOPHER EVAN WELCH
THE REAL SHLEMIEL	NARRATOR	FYVUSH FINKEL
FOG CITY MAVERICKS	NARRATOR	PETER COYOTE
UFOS: SEEING IS BELIEVING	NARRATOR	PETER JENNINGS
THE BAREFOOT EXECUTIVE	NARRATOR	KURT RUSSELL
TAKING LIBERTIES	NARRATOR	*
TAKING LIBERTIES	NARRATOR	ASHLEY JENSEN
TAKING LIBERTIES	NARRATOR	DAVID MORRISSEY
KERALA VARMA PAZHASSI RAJA	NARRATOR	MOHANLAL
KERALA VARMA PAZHASSI RAJA	NARRATOR	KAMAL HAASAN
KERALA VARMA PAZHASSI RAJA	NARRATOR	SHAHRUKH KHAN
THE VELOCITY OF GARY	NARRATOR	VINCENT D'ONOFRIO
GHARAONDA	NARRATOR	GULZAR
THE SINGING REVOLUTION	NARRATOR	LINDA HUNT
THE POPPY IS ALSO A FLOWER	NARRATOR	GRACE KELLY
THE MAGNETIC MONSTER	NARRATOR	RICHARD CARLSON
ROOM 666	NARRATOR	WIM WENDERS
MOBUTU, KING OF ZAIRE	NARRATOR	THIERRY MICHEL
THE WIZARD OF OZ IN CONCERT: DREAMS COME TRUE	NARRATOR	JOEL GREY
THE WIZARD OF OZ IN CONCERT: DREAMS COME TRUE	NARRATOR	DEBRA WINGER
THE SNOWS OF KILIMANJARO	NARRATOR	GREGORY PECK
INSANIYAT	NARRATOR	MUKESH KHANNA
BETWEEN HITLER AND STALIN	NARRATOR	JACK PALANCE
COUNTDOWN TO DOOMSDAY	NARRATOR	MATT LAUER
THE THREE ROBBERS	NARRATOR	TOMI UNGERER
RINGERS: LORD OF THE FANS	NARRATOR	DOMINIC MONAGHAN
BOMMALATTAM	NARRATOR	BHARATHIRAJA
DAYS OF WAITING: THE LIFE & ART OF ESTELLE ISHIGO	NARRATOR	DOROTHY STROUP
DAYS OF WAITING: THE LIFE & ART OF ESTELLE ISHIGO	NARRATOR	ADDITIONAL NARRATION LYNN O'DONNELL
THE BACK OF BEYOND	NARRATOR	KEVIN BRENNAN
UTSAV	NARRATOR	AMJAD KHAN
DISNEY PRINCESS ENCHANTED TALES: FOLLOW YOUR DREAMS	NARRATOR	SUSANNE BLAKESLEE
THE OSCAR	NARRATOR	TONY BENNETT
FRIDAY AFTER NEXT	NARRATOR	ICE CUBE
THE LAST PARADISES: ON THE TRACK OF RARE ANIMALS	NARRATOR	WOLF ACKVA
RUNNING THE SAHARA	NARRATOR	MATT DAMON
YOU MUST BE JOKING!	NARRATOR	DAVID BLOOD
YOU MUST BE JOKING!	NARRATOR	TONY SANDERSON
ARCTIC TALE	NARRATOR	QUEEN LATIFAH
THE IMPORTANCE OF BEING ICELANDIC	NARRATOR	JON GUSTAFSSON
HOW TO SLEEP	NARRATOR	ROBERT BENCHLEY
HOW TO TRAIN A DOG	NARRATOR	ROBERT BENCHLEY
HOW TO BEHAVE	NARRATOR	ROBERT BENCHLEY
VAMPIRE SECRETS	NARRATOR	COREY BURTON
A HALFWAY HOUSE CHRISTMAS	NARRATOR	BOBCAT GOLDTHWAIT
FAZA NAVARDAN	NARRATOR	SIAMAK ANSARI
BLINDNESS	NARRATOR	DANNY GLOVER
WOMEN IN DEFENSE	NARRATOR	KATHARINE HEPBURN
SANTOSH SUBRAMANIAM	NARRATOR	SATHYARAJ
AN ACT OF CONSCIENCE	NARRATOR	MARTIN SHEEN
THE LEGEND OF LOBO	NARRATOR	REX ALLEN
TWELFTH NIGHT	NARRATOR	BEN KINGSLEY
MANODU	NARRATOR	PRIYADARSHINI RAM
MYSTERIOUS CASTLES OF CLAY	NARRATOR	ORSON WELLES
SHADRACH	NARRATOR	MARTIN SHEEN
MOSCOW ELEGY	NARRATOR	ALEXANDER SOKUROV
BEST FRIEND FORGOTTEN	NARRATOR	DAVID DUCHOVNY
TWO BITS	NARRATOR	ALEC BALDWIN
SWAMI	NARRATOR	AMITABH BACHCHAN
SIR HENRY AT RAWLINSON END	NARRATOR	VIVIAN STANSHALL
RUDO Y CURSI	NARRATOR	GUILLERMO FRANCELLA
LET THERE BE LIGHT	NARRATOR	WALTER HUSTON
FREUD: THE SECRET PASSION	NARRATOR	JOHN HUSTON
LA LIBéRATION DE PARIS	NARRATOR	PIERRE BLANCHAR
DEMENTED DEATH FARM MASSACRE	NARRATOR	JOHN CARRADINE
THE 11TH HOUR	NARRATOR	LEONARDO DICAPRIO
TARGET	NARRATOR	TIM HOLT
HEER RAANJHA	NARRATOR	CHETAN ANAND
TRAINING WOMEN FOR WAR PRODUCTION	NARRATOR	ELEANOR ROOSEVELT
POKéMON: GIRATINA AND THE SKY WARRIOR	NARRATOR	UNSHOU ISHIZUKA
JUKEN SENTAI GEKIRANGER: NEI-NEI! HOU-HOU! HONG KONG DECISIVE BATTLE	NARRATOR	KEI GRANT
THE BABE RUTH STORY	NARRATOR	KNOX MANNING
FINAL OFFER	NARRATOR	HENRY RAMER
LAST YEAR'S SNOW WAS FALLING	NARRATOR	STANISLAV SADALSKIY
NORTH WEST MOUNTED POLICE	NARRATOR	CECIL B. DEMILLE
BOY CULTURE	NARRATOR	DEREK MAGYAR
WHARF OF WINDOWS	NARRATOR	TRONG NINH LUU
THE CONSPIRACY OF SILENCE	NARRATOR	KATHLEEN TURNER
DESTINY IN SPACE	NARRATOR	LEONARD NIMOY
MARION'S TRIUMPH	NARRATOR	DEBRA MESSING
CITY OF GOLD	NARRATOR	PIERRE BERTON
FROM SWASTIKA TO JIM CROW	NARRATOR	LUC SANTE
THE WAR ON BRITAIN'S JEWS%3F	NARRATOR	RICHARD LITTLEJOHN
KISMAT KONNECTION	NARRATOR	SHAH RUKH KHAN
ONE NINE NINE FOUR	NARRATOR	TONY HAWK
COMMANDOS STRIKE AT DAWN	NARRATOR	LESTER COWAN
O.S.S.	NARRATOR	RICHARD MAIBAUM
THE TALE OF DESPEREAUX	NARRATOR	SIGOURNEY WEAVER
FROZEN	NARRATOR	ROSHAN SETH
AMERICAN MULLET	NARRATOR	MATTHEW BOSE
AMERICAN ROOTS MUSIC	NARRATOR	KRIS KRISTOFFERSON
MILLENNIUM MAMBO	NARRATOR	SHU QI
BROOKLYN DODGERS: GHOSTS OF FLATBUSH	NARRATOR	LIEV SCHREIBER
SISTERS IN RESISTANCE	NARRATOR	KATE MULGREW
ERREWAY: 4 CAMINOS	NARRATOR	CARLA PANDOLFI
AWAKE, MY SOUL: THE STORY OF THE SACRED HARP	NARRATOR	JIM LAUDERDALE
THE TRIBE	NARRATOR	PETER COYOTE
THE CLOWN AT MIDNIGHT	NARRATOR	DAVID KIRSCHNER
THE CLOWN AT MIDNIGHT	NARRATOR	COREY SIENEGA
THE FORGOTTEN CHILDREN OF CONGO	NARRATOR	ROBERT POWELL
LIGHT IT UP	NARRATOR	ROBERT RI'CHARD
YOUR FRIEND THE RAT	NARRATOR	TONY RUSSELL
NICHOLAS NICKLEBY	NARRATOR	NATHAN LANE
THE TRIALS OF HENRY KISSINGER	NARRATOR	BRIAN COX
KING DINOSAUR	NARRATOR	MARVIN MILLER
BEYOND THE GATES OF SPLENDOR	NARRATOR	STEVE SAINT
THE WAY TO THE SEA	NARRATOR	GEOFFREY TANDY
THE WAY TO THE SEA	NARRATOR	NORMAN WOOLAND
STOWAWAY IN THE SKY	NARRATOR	JACK LEMMON
INDEPENDENTS	NARRATOR	JAMES C. KAUFMAN
SILSIILAY	NARRATOR	SHAHRUKH KHAN
2 DAYS IN PARIS	NARRATOR	JULIE DELPY
ENCOUNTERS AT THE END OF THE WORLD	NARRATOR	WERNER HERZOG
THE ARCHITECTURE OF DOOM	NARRATOR	ROLF ARSENIUS
THE ARCHITECTURE OF DOOM	NARRATOR	BRUNO GANZ \NSAM GRAY
JALSA	NARRATOR	MAHESH BABU
AMMUVAGIYA NAAN	NARRATOR	PADMAMAGAN
THE GENTLE SEX	NARRATOR	LESLIE HOWARD
CAPTAIN MIKE ACROSS AMERICA	NARRATOR	MICHAEL MOORE
THE LAST TIME I SAW ARCHIE	NARRATOR	JACK WEBB
GUNG HO!	NARRATOR	CHET HUNTLEY
STOP VIOLENCE	NARRATOR	A. K. LOHITHADAS
PUSH	NARRATOR	DAKOTA FANNING
SEX AND THE CITY	NARRATOR	SARAH JESSICA PARKER
DALE	NARRATOR	PAUL NEWMAN
THE LOVER	NARRATOR	JEANNE MOREAU
THE JUNGLE BOOK: MOWGLI'S STORY	NARRATOR	FRED SAVAGE
THE PASSIONATE PILGRIM	NARRATOR	JOHN LE MESURIER
RUBY GENTRY	NARRATOR	BARNEY PHILLIPS
IMAGINE: JOHN LENNON	NARRATOR	JOHN LENNON
ENGEL & JOE	NARRATOR	KAI HERMANN
ENGEL & JOE	NARRATOR	VANESSA JOPP
ENGEL & JOE	NARRATOR	OLIVER SIMON
PANCHATHANTIRAM	NARRATOR	SIMRAN
VENGEANCE	NARRATOR	FRANCISCO RABAL
YOUTH IN REVOLT	NARRATOR	MICHAEL CERA
DOG DAYS OF SUMMER	NARRATOR	COLIN KEY
A FAIR TO REMEMBER	NARRATOR	BARRY CORBIN
CRAZY SAFARI	NARRATOR	STEPHEN CHOW
CRAZY SAFARI	NARRATOR	NG MAN-TAT
DER KONGRESS DER PINGUINE	NARRATOR	FRANZ HOHLER
HOME IN INDIANA	NARRATOR	REED HADLEY
THE JUNIOR DEFENDERS	NARRATOR	JOHN WATERS
THE ANIMAL WORLD	NARRATOR	THEODORE VON ELTZ
TARKA THE OTTER	NARRATOR	PETER USTINOV
BARBIE AS THE ISLAND PRINCESS	NARRATOR	KELLY SHERIDAN
CHOCOLATE	NARRATOR	IRRFAN KHAN
CHOCOLATE	NARRATOR	TANUSHREE DUTTA
I AM BECAUSE WE ARE	NARRATOR	MADONNA
TIME BOMBS	NARRATOR	VLASTA VRáNA
TIME BOMBS	NARRATOR	RéAL BOSSé
EARTH	NARRATOR	PATRICK STEWART
EARTH	NARRATOR	JAMES EARL JONES
EARTH	NARRATOR	CONSTANTINO ROMERO
EARTH	NARRATOR	ULRICH TUKUR
TERROR'S ADVOCATE	NARRATOR	BARBET SCHROEDER
AMERICAN GUERRILLA IN THE PHILIPPINES	NARRATOR	JACK ELAM
THE TEN COMMANDMENTS	NARRATOR	BEN KINGSLEY
THE PERFECT HOLIDAY	NARRATOR	QUEEN LATIFAH
FROM THE EARTH TO THE MOON	NARRATOR	ROBERT CLARKE
PLAGUES & PLEASURES ON THE SALTON SEA	NARRATOR	JOHN WATERS
CORSO: THE LAST BEAT	NARRATOR	ETHAN HAWKE
TWICE-TOLD TALES	NARRATOR	VINCENT PRICE
THE AMERICAN GANGSTER	NARRATOR	DENNIS FARINA
THE RAPE OF EUROPA	NARRATOR	JOAN ALLEN
PAPERLAND: THE BUREAUCRAT OBSERVED	NARRATOR	DONALD BRITTAIN
SEA MONSTERS: A PREHISTORIC ADVENTURE	NARRATOR	LIEV SCHREIBER
LIFE AFTER DEATH ROW	NARRATOR	CROOKED I
DREAM STREET	NARRATOR	D. W. GRIFFITH
WHITE EAGLE	NARRATOR	KNOX MANNING
HOLT OF THE SECRET SERVICE	NARRATOR	KNOX MANNING
PERILS OF THE ROYAL MOUNTED	NARRATOR	KNOX MANNING
CAPTAIN MIDNIGHT	NARRATOR	KNOX MANNING
THE SECRET CODE	NARRATOR	KNOX MANNING
THE VALLEY OF VANISHING MEN	NARRATOR	KNOX MANNING
SON OF THE GUARDSMAN	NARRATOR	KNOX MANNING
JACK ARMSTRONG	NARRATOR	KNOX MANNING
ROAR OF THE IRON HORSE	NARRATOR	KNOX MANNING
PERILS OF THE WILDERNESS	NARRATOR	KNOX MANNING
THE CAPTURE	NARRATOR	LEW AYRES
DRAGONBALL EVOLUTION	NARRATOR	RANDALL DUK KIM
BEFORE STONEWALL	NARRATOR	RITA MAE BROWN
NAKED AMBITION: AN R RATED LOOK AT AN X RATED INDUSTRY	NARRATOR	MICHAEL GRECCO
WHERE ANGELS GO, TROUBLE FOLLOWS	NARRATOR	ROSALIND RUSSELL
THE COMIC	NARRATOR	DICK VAN DYKE
CHRISTOPHER COLUMBUS	NARRATOR	VALENTINE DYALL
FRATERNITY ROW	NARRATOR	CLIFF ROBERTSON
WHITE MANE	NARRATOR	FRANK SILVERA
WHITE MANE	NARRATOR	LES MARSHAK
OPAPATIKA	NARRATOR	PONGPAT WACHIRABANJONG
THE PUPPETMASTER	NARRATOR	LI TIAN-LU
MISCHIEF NIGHT	NARRATOR	KELLI HOLLIS
SACRED PLANET	NARRATOR	ROBERT REDFORD
THE DAY TIME ENDED	NARRATOR	JIM DAVIS
MOTHER WORE TIGHTS	NARRATOR	ANNE BAXTER
FORGOTTEN ELLIS ISLAND	NARRATOR	ELLIOTT GOULD
RECOGNITION OF THE JAPANESE ZERO FIGHTER	NARRATOR	ART GILMORE
THE FLYING DOCTORS OF EAST AFRICA	NARRATOR	WILFRIED KLAUS
RING OF FIRE	NARRATOR	ROBERT FOXWORTH
THE GIRL NEXT DOOR	NARRATOR	WILLIAM ATHERTON
PORTRAIT WERNER HERZOG	NARRATOR	WERNER HERZOG
HANDICAPPED FUTURE	NARRATOR	ROLF ILLIG
HERE AND ELSEWHERE	NARRATOR	JEAN-LUC GODARD
JAG MANDIR	NARRATOR	WERNER HERZOG
THE MIRACLE OF SOUND	NARRATOR	FRANK WHITBECK
DET KæRE LEGETøJ	NARRATOR	HOLGER JUUL HANSEN
SARAH	NARRATOR	MIA FARROW
THE FIGHT FOR THE SKY	NARRATOR	RONALD REAGAN
HISTOIRE	NARRATOR	JEAN-LUC GODARD
NINE DAYS IN ONE YEAR	NARRATOR	ZINOVI GERDT
GONZO: THE LIFE AND WORK OF DR. HUNTER S. THOMPSON	NARRATOR	JOHNNY DEPP
THE BETRAYAL – NERAKHOON	NARRATOR	THAVISOUK PHRASAVATH
PATTI SMITH: DREAM OF LIFE	NARRATOR	PATTI SMITH
BROOKLYN BRIDGE	NARRATOR	DAVID MCCULLOUGH
CHOCOLATE	NARRATOR	HIROSHI ABE
THE STATUE OF LIBERTY	NARRATOR	DAVID MCCULLOUGH
HUEY LONG	NARRATOR	DAVID MCCULLOUGH
EMPIRE OF THE AIR: THE MEN WHO MADE RADIO	NARRATOR	JASON ROBARDS
FULL CIRCLE	NARRATOR	RICK ZIEFF
CADILLAC DESERT	NARRATOR	ALFRE WOODARD
THE HOUR OF THE FURNACES	NARRATOR	MARíA DE LA PAZ
THE HOUR OF THE FURNACES	NARRATOR	FERNANDO SOLANAS
THE HOUR OF THE FURNACES	NARRATOR	EDGARDO SUáREZ
THE TWIN	NARRATOR	PIERRE RICHARD
BLAST OF SILENCE	NARRATOR	LIONEL STANDER
A DANGEROUS PROFESSION	NARRATOR	JIM BACKUS
PERRI	NARRATOR	WINSTON HIBLER
RESIDENT EVIL: AFTERLIFE	NARRATOR	MILLA JOVOVICH
THE PIXAR STORY	NARRATOR	STACY KEACH
THE RISING OF THE MOON	NARRATOR	TYRONE POWER
THE LITTLE MERMAID: ARIEL'S BEGINNING	NARRATOR	SAMUEL E. WRIGHT
13 RUE MADELEINE	NARRATOR	REED HADLEY
GLOBAL WARMING: THE SIGNS AND THE SCIENCE	NARRATOR	ALANIS MORISSETTE
THE SONG OF CEYLON	NARRATOR	LIONEL WENDT
CHRISTMAS IS HERE AGAIN	NARRATOR	JAY LENO
HAMLET 2	NARRATOR	STEVE COOGAN
AFTER STONEWALL	NARRATOR	MELISSA ETHERIDGE
THE INCREDIBLE WORLD OF JAMES BOND	NARRATOR	ALEXANDER SCOURBY
UNDERWORLD: RISE OF THE LYCANS	NARRATOR	KATE BECKINSALE
THE GALLANT HOURS	NARRATOR	ROBERT MONTGOMERY
THE GALLANT HOURS	NARRATOR	ART GILMORE
LES PARENTS TERRIBLES	NARRATOR	JEAN COCTEAU
THE CUTTING EDGE: THE MAGIC OF MOVIE EDITING	NARRATOR	KATHY BATES
IRVINE WELSH'S ECSTASY	NARRATOR	ADAM SINCLAIR
FASHION	NARRATOR	PRIYANKA CHOPRA
ANNABELLE'S WISH	NARRATOR	RANDY TRAVIS
THE ROAD	NARRATOR	VIGGO MORTENSEN
STARS IN MY CROWN	NARRATOR	MARSHALL THOMPSON
WOMBLING FREE	NARRATOR	LIONEL JEFFRIES
VIETNAM, LONG TIME COMING	NARRATOR	JOE MANTEGNA
STAR WARS: THE CLONE WARS	NARRATOR	TOM KANE
MY SISTER'S KEEPER	NARRATOR	ALEC BALDWIN
FLEISCH	NARRATOR	ZDF
HILLS OF HOME	NARRATOR	DONALD CRISP
SOUL MEN	NARRATOR	RANDY JACKSON
MADAME BOVARY	NARRATOR	FRANçOIS PéRIER
THE OLD MAN AND THE SEA	NARRATOR	SPENCER TRACY
MUMBAI SE AAYA MERA DOST	NARRATOR	AMITABH BACHCHAN
DINOSAURS: GIANTS OF PATAGONIA	NARRATOR	DONALD SUTHERLAND
ASSASSINATION OF A HIGH SCHOOL PRESIDENT	NARRATOR	REECE THOMPSON
CHéRI	NARRATOR	STEPHEN FREARS
FAIRYTALE OF KATHMANDU	NARRATOR	NEASA Ní CHIANáIN
BEDTIME STORIES	NARRATOR	JONATHAN PRYCE
MARIO	NARRATOR	DAVE KITSON
BERKELEY IN THE SIXTIES	NARRATOR	SUSAN GRIFFIN
THE INFORMANT!	NARRATOR	MATT DAMON
BALLAD OF THE LITTLE SOLDIER	NARRATOR	WERNER HERZOG
AMERICAN DRUG WAR: THE LAST WHITE HOPE	NARRATOR	KEVIN BOOTH
CHAINDANCE	NARRATOR	MICHAEL IRONSIDE
EVIL CALLS: THE RAVEN	NARRATOR	MARIANNE FAITHFULL
WIND IN THE WILLOWS	NARRATOR	MICHEL WILLAMS
THE A-TEAM	NARRATOR	COREY BURTON
CADILLAC RECORDS	NARRATOR	CEDRIC THE ENTERTAINER
HONTO NI ATTA! NOROI NO VIDEO	NARRATOR	YOSHIHIRO NAKAMURA
DOUBLE DOWN	NARRATOR	KANE PICOY
ISAAC IN AMERICA: A JOURNEY WITH ISAAC BASHEVIS SINGER	NARRATOR	JUDD HIRSCH
THE AFRICAN LION	NARRATOR	WINSTON HIBLER
EDO MAAJKA – SEVDAH O RODAMA	NARRATOR	EDO MAAJKA
EDO MAAJKA – SEVDAH O RODAMA	NARRATOR	SILVANA ARMENULIć
EVEREST PEACE PROJECT	NARRATOR	ORLANDO BLOOM
SITA SINGS THE BLUES	NARRATOR	ASEEM CHHABRA
SITA SINGS THE BLUES	NARRATOR	BHAVANA NAGULAPALLY
SITA SINGS THE BLUES	NARRATOR	MANISH ACHARYA
A NIGHT AT THE MOVIES	NARRATOR	ROBERT BENCHLEY
THE LAST AIRBENDER	NARRATOR	NICOLA PELTZ
COUNTRY MUSIC: THE SPIRIT OF AMERICA	NARRATOR	HAL HOLBROOK
THE SIMPLE-MINDED MURDERER	NARRATOR	STELLAN SKARSGåRD
DINOSAURS ALIVE!	NARRATOR	MICHAEL DOUGLAS
BUNRAKU	NARRATOR	MIKE PATTON
MY FATHER'S GLORY	NARRATOR	JEAN-PIERRE DARRAS
JUNKET WHORE	NARRATOR	LAUREN HUTTON
TEN FOR GRANDPA	NARRATOR	DAVID ALPAY
NITRATE KISSES	NARRATOR	BARBARA HAMMER
KRAKATOA	NARRATOR	GRAHAM MCNAMEE
CITY OF WAX	NARRATOR	GAYNE WHITMAN
PETER AND THE WOLF	NARRATOR	STERLING HOLLOWAY
SWIMMERS	NARRATOR	TARA DEVON GALLAGHER
THE CHESS PLAYERS	NARRATOR	AMITABH BACHCHAN
SEAL ISLAND	NARRATOR	WINSTON HIBLER
IN BEAVER VALLEY	NARRATOR	WINSTON HIBLER
NATURE'S HALF ACRE	NARRATOR	WINSTON HIBLER
WATER BIRDS	NARRATOR	WINSTON HIBLER
BEAR COUNTRY	NARRATOR	WINSTON HIBLER
FLOWER IN THE GUN BARREL	NARRATOR	MARTIN SHEEN
LICENSED TO KILL	NARRATOR	ARTHUR DONG
THE BLACK CANDLE	NARRATOR	MAYA ANGELOU
BENJY	NARRATOR	HENRY FONDA
THE ALASKAN ESKIMO	NARRATOR	WINSTON HIBLER
THURSDAY'S CHILDREN	NARRATOR	RICHARD BURTON
MEN AGAINST THE ARCTIC	NARRATOR	WINSTON HIBLER
NINE FROM LITTLE ROCK	NARRATOR	JEFFERSON THOMAS
A YEAR TOWARD TOMORROW	NARRATOR	PAUL NEWMAN
TEKKEN	NARRATOR	JON FOO
TEKKEN	NARRATOR	KELLY OVERTON
KARL HESS: TOWARD LIBERTY	NARRATOR	KEVIN BURNS
CONFESSIONS OF AN OPIUM EATER	NARRATOR	VINCENT PRICE
MENU	NARRATOR	PETE SMITH
THE SEA	NARRATOR	GAYNE WHITMAN
CAMERA THRILLS	NARRATOR	GRAHAM MCNAMEE
AUDIOSCOPIKS	NARRATOR	PETE SMITH
WANTED – A MASTER	NARRATOR	PETE SMITH
THE LONDON ROCK AND ROLL SHOW	NARRATOR	MICK JAGGER
COMIC BOOK VILLAINS	NARRATOR	DJ QUALLS
MY WINNIPEG	NARRATOR	GUY MADDIN
THE CONGRESS	NARRATOR	DAVID MCCULLOUGH
THE NOTEBOOK	NARRATOR	JAMES GARNER
FATHERHOOD USA	NARRATOR	BILL BRADLEY
3 IDIOTS	NARRATOR	R. MADHAVAN
THE LEGEND OF GOD'S GUN	NARRATOR	JOSEPH CAMPANELLA
THE RED MENACE	NARRATOR	LLOYD G. DAVIES
500 DAYS OF SUMMER	NARRATOR	RICHARD MCGONAGLE
DISNEY'S AMERICAN LEGENDS	NARRATOR	JAMES EARL JONES
GHOSTRIDE THE WHIP	NARRATOR	SWAY CALLOWAY
THE GREAT NORTHFIELD MINNESOTA RAID	NARRATOR	PAUL FREES
WILD BILL	NARRATOR	JOHN HURT
MEERKAT MANOR: THE STORY BEGINS	NARRATOR	WHOOPI GOLDBERG
BUSTIN' DOWN THE DOOR	NARRATOR	EDWARD NORTON
UP THE YANGTZE	NARRATOR	YUNG CHANG
BOOK OF LOVE	NARRATOR	TREACH
BOOK OF LOVE	NARRATOR	ERIC K. GEORGE
BOOK OF LOVE	NARRATOR	RICHARD T. JONES
CHRIS & DON	NARRATOR	MICHAEL YORK
TAKEOFF	NARRATOR	SERGEI BONDARCHUK
UNCOMMON FRIENDS OF THE 20TH CENTURY	NARRATOR	WALTER CRONKITE
QUANTUM HOOPS	NARRATOR	DAVID DUCHOVNY
WAR MADE EASY: HOW PRESIDENTS & PUNDITS KEEP SPINNING US TO DEATH	NARRATOR	SEAN PENN
FIVE ACES	NARRATOR	AIMéE LEIGH
MADAMPI	NARRATOR	SURESH GOPI
ANDOLAN	NARRATOR	DALIP TAHIL
DRAGON BALL: YO! SON GOKU AND HIS FRIENDS RETURN!!	NARRATOR	JōJI YANAMI
PINOCCHIO	NARRATOR	RENATO RASCEL
THE STORY OF A CRIME	NARRATOR	ZINOVY GERDT
THE LEGEND OF BILLY THE KID	NARRATOR	DAVID MARSHALL GRANT
VERONIKA DECIDES TO DIE	NARRATOR	SARAH MICHELLE GELLAR
PLAN 9 FROM OUTER SPACE	NARRATOR	THE AMAZING CRISWELL
EADWEARD MUYBRIDGE, ZOOPRAXOGRAPHER	NARRATOR	DEAN STOCKWELL
AMAZING JOURNEY: THE STORY OF THE WHO	NARRATOR	PAUL CROWDER
THE BATTLE OF GETTYSBURG	NARRATOR	LESLIE NIELSEN
SYDNEY – A STORY OF A CITY	NARRATOR	STEPHEN SEWELL
SYDNEY – A STORY OF A CITY	NARRATOR	JOHN IZZARD
THE FOUNTAIN OF YOUTH	NARRATOR	ORSON WELLES
BLUE HILL AVENUE	NARRATOR	ALLEN PAYNE
BALADUR	NARRATOR	LAKSHMI BHOOPAL
RIDE	NARRATOR	MELISSA DE SOUSA
PRINCE VALIANT	NARRATOR	MICHAEL RENNIE
AMERICA THE BEAUTIFUL	NARRATOR	DARRYL ROBERTS
DORAEMON: NOBITA'S THREE VISIONARY SWORDSMEN	NARRATOR	YOUSUKE AKIMOTO
DORAEMON: NOBITA AND THE GALAXY SUPER-EXPRESS	NARRATOR	HIROKO EMORI
THE KEYS OF THE KINGDOM	NARRATOR	SIR CEDRIC HARDWICKE
HOW TO BE A SERIAL KILLER	NARRATOR	SHADOE STEVENS
THE STORY OF STUFF	NARRATOR	ANNIE LEONARD
ESCAPE FROM AFFLUENZA	NARRATOR	WANDA URBANSKA
WITH OR WITHOUT YOU	NARRATOR	MUSHOND LEE
HôTEL DES INVALIDES	NARRATOR	MICHEL SIMON
GAJIBIJI	NARRATOR	SATHYANAND
JEWS AND BUDDHISM	NARRATOR	SHARON STONE
THE FOX AND THE CHILD	NARRATOR	ISABELLE CARRé
THE FOX AND THE CHILD	NARRATOR	KATE WINSLET
GARFIELD'S FUN FEST	NARRATOR	TIM CONWAY
NENINTHE	NARRATOR	PURI JAGANNADH
THE ADVENTURES OF PICASSO	NARRATOR	TOVIO PAWLO
THE ADVENTURES OF PICASSO	NARRATOR	BERNARD CRIBBINS
THE ADVENTURES OF PICASSO	NARRATOR	OVE SPROGøE
THE ADVENTURES OF PICASSO	NARRATOR	PER AABEL
THE ADVENTURES OF PICASSO	NARRATOR	RAYMOND BUSSIèRES
THE NEARLY COMPLETE AND UTTER HISTORY OF EVERYTHING	NARRATOR	ANGUS DEAYTON
JOHN F. KENNEDY: YEARS OF LIGHTNING, DAY OF DRUMS	NARRATOR	GREGORY PECK
JOHN F. KENNEDY: YEARS OF LIGHTNING, DAY OF DRUMS	NARRATOR	MAXIMILIAN SCHELL
MAN IN THE 5TH DIMENSION	NARRATOR	BILLY GRAHAM
RIME OF THE ANCIENT MARINER	NARRATOR	SIR
RIME OF THE ANCIENT MARINER	NARRATOR	MICHAEL REDGRAVE
2081	NARRATOR	PATRICIA CLARKSON
DINOSAUR!	NARRATOR	CHRISTOPHER REEVE
BALLETS RUSSES	NARRATOR	MARIAN SELDES
A YIDDISH WORLD REMEMBERED	NARRATOR	ELLIOTT GOULD
FOREVER ACTIVISTS	NARRATOR	RONNIE GILBERT
DERBY DAY	NARRATOR	RAYMOND GLENDENNING
LISTEN TO BRITAIN	NARRATOR	LEONARD BROCKINGTON
ARN – THE KINGDOM AT ROAD'S END	NARRATOR	SVEN-BERTIL TAUBE
NEW YORK	NARRATOR	NEIL NITIN MUKESH
THAT'S ADEQUATE	NARRATOR	TONY RANDALL
YATTERMAN	NARRATOR	KōICHI YAMADERA
ONE DAY IN THE LIFE OF ANDREI ARSENEVICH	NARRATOR	ALEXANDRA STEWART
ONE DAY IN THE LIFE OF ANDREI ARSENEVICH	NARRATOR	EVA MATTES
ONE DAY IN THE LIFE OF ANDREI ARSENEVICH	NARRATOR	MARINA VLADY
DOUGAL AND THE BLUE CAT	NARRATOR	ERIC THOMPSON
THE DRAYTON CASE	NARRATOR	EDGAR LUSTGARTEN
A SCANDAL IN PARIS	NARRATOR	GEORGE SANDERS
SLACKER UPRISING	NARRATOR	MICHAEL MOORE
THE AGE OF STUPID	NARRATOR	PETE POSTLETHWAITE
CHRISTMAS IN LOVE	NARRATOR	CHRISTIAN DE SICA AND MASSIMO BOLDI
14 WOMEN	NARRATOR	ANNETTE BENING
PRAN JAYE PAR SHAAN NA JAYE	NARRATOR	VIJAY RAAZ
PRAN JAYE PAR SHAAN NA JAYE	NARRATOR	SUSHMITA SEN
REDUX RIDING HOOD	NARRATOR	GARRISON KEILLOR
AMERICAN TONGUES	NARRATOR	POLLY HOLLIDAY
THE LAST CONFEDERATE: THE STORY OF ROBERT ADAMS	NARRATOR	WESTON ADAMS
KICKING IT	NARRATOR	COLIN FARRELL
TARGET TOKYO	NARRATOR	RONALD REAGAN
FEAR	NARRATOR	NICOLE GARCIA
MUSTAFA	NARRATOR	YETKIN DIKICILER
MUSTAFA	NARRATOR	CAN DüNDAR
MUSTAFA	NARRATOR	BEYHAN SARAN
MUSTAFA	NARRATOR	ARIF SOYSALAN
THE EYE OF THE STORM	NARRATOR	BILL BEUTEL
BASEKETBALL	NARRATOR	STEPHEN MCHATTIE
THE GRASS HARP	NARRATOR	BOYD GAINES
ACCIDENTS HAPPEN	NARRATOR	TYLER COPPIN
BLUE PLANET	NARRATOR	TONI MYERS
YOGI BEAR	NARRATOR	JOSH ROBERT THOMPSON
ORIZURU OSEN	NARRATOR	SUISEI MATSUI
ORIZURU OSEN	NARRATOR	MIDORI SAWATO
GYAKURYU	NARRATOR	MIDORI SAWATO
KOINA NO GINPEI, YUKI NO WATARIDORI	NARRATOR	SHUNSUI MATSUDA
KOINA NO GINPEI, YUKI NO WATARIDORI	NARRATOR	MIDORI SAWATO
THE MAGIC VOYAGE	NARRATOR	HANS PAETSCH
THE MAGIC VOYAGE	NARRATOR	DAVID KEHOE
THE MAGIC VOYAGE	NARRATOR	MICKEY ROONEY
KURAMA TENGU: KYōFU JIDAI	NARRATOR	MIDORI SAWATO
NISHIKIE EDOSUGATA HATAMOTO TO MACHIYAKKO	NARRATOR	SHUNSUI MATSUDA
NISHIKIE EDOSUGATA HATAMOTO TO MACHIYAKKO	NARRATOR	MIDORI SAWATO
DOKURO	NARRATOR	MIDORI SAWATO
WAR DEPARTMENT REPORT	NARRATOR	WALTER HUSTON
DESIGN FOR DEATH	NARRATOR	KENT SMITH
DESIGN FOR DEATH	NARRATOR	HANS CONRIED
THE SECRET LAND	NARRATOR	ROBERT MONTGOMERY
THE SECRET LAND	NARRATOR	ROBERT TAYLOR
THE SECRET LAND	NARRATOR	VAN HEFLIN
THE TITAN: STORY OF MICHELANGELO	NARRATOR	FREDRIC MARCH
THE SEA AROUND US	NARRATOR	DON FORBES
THE SEA AROUND US	NARRATOR	THEODORE VON ELTZ
THE HOAXTERS	NARRATOR	MARILYN ERSKINE
A QUEEN IS CROWNED	NARRATOR	LAURENCE OLIVIER
THE STRATFORD ADVENTURE	NARRATOR	JOHN DRAINIE
WHERE MOUNTAINS FLOAT	NARRATOR	LARS HENNING-JENSEN
THE HIDDEN WORLD	NARRATOR	GREGORY PECK
THE RACE FOR SPACE	NARRATOR	MIKE WALLACE
THE HUMAN DUTCH	NARRATOR	SIMON CARMIGGELT
THE HUMAN DUTCH	NARRATOR	PETER USTINOV
THE FINEST HOURS	NARRATOR	ORSON WELLES
FOUR DAYS IN NOVEMBER	NARRATOR	RICHARD BASEHART
THE BATTLE OF THE BULGE... THE BRAVE RIFLES	NARRATOR	ARTHUR KENNEDY
THE FORTH ROAD BRIDGE	NARRATOR	ALEC CLUNES
LET MY PEOPLE GO: THE STORY OF ISRAEL	NARRATOR	RICHARD BASEHART
TO DIE IN MADRID	NARRATOR	JOHN GIELGUD
THE REALLY BIG FAMILY	NARRATOR	HENRY FONDA
KURAMA TENGU	NARRATOR	SHUNSUI MATSUDA
KURAMA TENGU	NARRATOR	MIDORI SAWATO
OATSURAE JIROKICHI KOSHI	NARRATOR	SHUNSUI MATSUDA
OATSURAE JIROKICHI KOSHI	NARRATOR	MIDORI SAWATO
SAND AND SORROW	NARRATOR	GEORGE CLOONEY
THE OLYMPICS IN MEXICO	NARRATOR	ENRIQUE LIZALDE
THE OLYMPICS IN MEXICO	NARRATOR	ROBERTO MORALES
KODAKARA SODO	NARRATOR	SHUNSUI MATSUDA
KODAKARA SODO	NARRATOR	MIDORI SAWATO
AKEYUKU SORA	NARRATOR	MIDORI SAWATO
THE CASTLE	NARRATOR	STEPHEN CURRY
NIGHT AND FOG	NARRATOR	MICHEL BOUQUET
BLACK	NARRATOR	RANI MUKERJI
JACK JOHNSON	NARRATOR	KEVIN KENNEDY
JACK JOHNSON	NARRATOR	BROCK PETERS
SAY GOODBYE	NARRATOR	ROD MCKUEN
APE AND SUPER-APE	NARRATOR	ANTON KOOLHAAS
APE AND SUPER-APE	NARRATOR	ALEXANDER SCOURBY
MALCOLM X	NARRATOR	JAMES EARL JONES
MALCOLM X	NARRATOR	OSSIE DAVIS
ALWAYS A NEW BEGINNING	NARRATOR	JAMES LAWLESS
JOURNEY TO THE OUTER LIMITS	NARRATOR	LESLIE NIELSEN
THE CHALLENGE... A TRIBUTE TO MODERN ART	NARRATOR	ORSON WELLES
FIGHTING FOR OUR LIVES	NARRATOR	LUIS VALDEZ
THE INCREDIBLE MACHINE	NARRATOR	E. G. MARSHALL
THE OTHER HALF OF THE SKY: A CHINA MEMOIR	NARRATOR	SHIRLEY MACLAINE
OFF THE EDGE	NARRATOR	RON HAJEK
PEOPLE OF THE WIND	NARRATOR	JAMES MASON
VOLCANO: AN INQUIRY INTO THE LIFE AND DEATH OF MALCOLM LOWRY	NARRATOR	DONALD BRITTAIN
THE CHILDREN OF THEATRE STREET	NARRATOR	GRACE KELLY
HOMAGE TO CHAGALL: THE COLOURS OF LOVE	NARRATOR	JEAN GASCON
HOMAGE TO CHAGALL: THE COLOURS OF LOVE	NARRATOR	JAMES MASON
HOMAGE TO CHAGALL: THE COLOURS OF LOVE	NARRATOR	JOSEPH WISEMAN
RAONI	NARRATOR	MARLON BRANDO
RAONI	NARRATOR	PAULO CéSAR PERéIO
RAONI	NARRATOR	JACQUES PERRIN
GOING THE DISTANCE	NARRATOR	MICHAEL KANE
THE KILLING GROUND	NARRATOR	BRIT HUME
THE DAY AFTER TRINITY	NARRATOR	PAUL FREES
THE YELLOW STAR: THE PERSECUTION OF THE JEWS IN EUROPE 1933-45	NARRATOR	ALEXANDER SCOURBY
EL SALVADOR: ANOTHER VIETNAM	NARRATOR	MIKE FARRELL
AFTER THE AXE	NARRATOR	ROGER MATTIUSSI
THE PROFESSION OF ARMS	NARRATOR	GWYNNE DYER
IN THE NAME OF THE PEOPLE	NARRATOR	MARTIN SHEEN
THE MOTHERS OF PLAZA DE MAYO	NARRATOR	CARMEN ZAPATA
CHILE: WHEN WILL IT END%3F	NARRATOR	DAVID BRADBURY
WITNESS TO APARTHEID	NARRATOR	SHARON I. SOPHER
SUPER CHIEF: THE LIFE AND LEGACY OF EARL WARREN	NARRATOR	GREGORY PECK
ADAM CLAYTON POWELL	NARRATOR	JULIAN BOND
OUR SCHOOL	NARRATOR	KIM MYEONG-JOON
BUILDING BOMBS	NARRATOR	JANE ALEXANDER
WALDO SALT: A SCREENWRITER'S JOURNEY	NARRATOR	PETER COYOTE
THE RESTLESS CONSCIENCE: RESISTANCE TO HITLER WITHIN GERMANY 1933-1945	NARRATOR	JOHN DILDINE
FIRES OF KUWAIT	NARRATOR	RIP TORN
LIBERATORS: FIGHTING ON TWO FRONTS IN WORLD WAR II	NARRATOR	DENZEL WASHINGTON
MUSIC FOR THE MOVIES: BERNARD HERRMANN	NARRATOR	PHILIP BOSCO
A GREAT DAY IN HARLEM	NARRATOR	QUINCY JONES
D-DAY REMEMBERED	NARRATOR	DAVID MCCULLOUGH
PROTEUS	NARRATOR	MARIAN SELDES
THE LINE KING: THE AL HIRSCHFELD STORY	NARRATOR	MARILYN ERSKINE
TELL THE TRUTH AND RUN: GEORGE SELDES AND THE AMERICAN PRESS	NARRATOR	SUSAN SARANDON
AYN RAND: A SENSE OF LIFE	NARRATOR	SHARON GLESS
IT WAS A WONDERFUL LIFE	NARRATOR	JODIE FOSTER
LENNY BRUCE: SWEAR TO TELL THE TRUTH	NARRATOR	ROBERT DE NIRO
LAND, GOLD AND WOMEN	NARRATOR	TERENCE MCKENNA
CHRISTMAS UNDER FIRE	NARRATOR	QUENTIN REYNOLDS
WARCLOUDS IN THE PACIFIC	NARRATOR	LORNE GREENE
SWEDES IN AMERICA	NARRATOR	INGRID BERGMAN
PLAN FOR DESTRUCTION	NARRATOR	LEWIS STONE
1848	NARRATOR	BERNARD BLIER
TRAFFIC WITH THE DEVIL	NARRATOR	CHARLES REINEKE
ATOMIC POWER	NARRATOR	WESTBROOK VAN VOORHIS
CHūKON GIRETSU: JITSUROKU CHūSHINGURA	NARRATOR	SHUNSUI MATSUDA
CHūKON GIRETSU: JITSUROKU CHūSHINGURA	NARRATOR	MIDORI SAWATO
RAIDEN	NARRATOR	MIDORI SAWATO
THE SEEING EYE	NARRATOR	MARVIN MILLER
THE LIVING CITY	NARRATOR	JAMES BRILL
MARY AND MAX	NARRATOR	BARRY HUMPHRIES
THE LIVING STONE	NARRATOR	GEORGE WHALLEY
JOURNEY INTO SPRING	NARRATOR	STEPHEN MURRAY
A CITY CALLED COPENHAGEN	NARRATOR	OSVALD HELMUTH
DE DANA DAN	NARRATOR	AKSHAY KUMAR
THE ROAD TO THE WALL	NARRATOR	JAMES CAGNEY
THE FIVE CITIES OF JUNE	NARRATOR	CHARLTON HESTON
YEATS COUNTRY	NARRATOR	TOM ST. JOHN BARRY
YEATS COUNTRY	NARRATOR	NIALL TOIBIN
ADOLESCENCE	NARRATOR	SONIA PETROVNA
MONUMENT TO THE DREAM	NARRATOR	PAUL RICHARDS
SEE YOU AT THE PILLAR	NARRATOR	ANTHONY QUAYLE
WHILE I RUN THIS RACE	NARRATOR	CHARLTON HESTON
A SPACE TO GROW	NARRATOR	HENRY FONDA
AN IMPRESSION OF JOHN STEINBECK: WRITER	NARRATOR	HENRY FONDA
JENNY IS A GOOD THING	NARRATOR	BURT LANCASTER
LAFAYETTE ESCADRILLE	NARRATOR	WILLIAM A. WELLMAN
THE GIFTS	NARRATOR	LORNE GREENE
BLACKWOOD	NARRATOR	GORDON PINSENT
UNIVERSE	NARRATOR	WILLIAM SHATNER
THE SHETLAND EXPERIENCE	NARRATOR	ERIC PORTER
THE ERUPTION OF MOUNT ST. HELENS!	NARRATOR	ROBERT FOXWORTH
AMERICAS IN TRANSITION	NARRATOR	EDWARD ASNER
PERRIER'S BOUNTY	NARRATOR	GABRIEL BYRNE
SEWING WOMAN	NARRATOR	LISA LU
THE KLAN: A LEGACY OF HATE IN AMERICA	NARRATOR	JAMES WHITMORE
A LITTLE VICIOUS	NARRATOR	KEVIN BACON
WHEN ABORTION WAS ILLEGAL: UNTOLD STORIES	NARRATOR	DOROTHY FADIMAN
THE SHADOW OF HATE	NARRATOR	JULIAN BOND
SCHOOL OF THE AMERICAS ASSASSINS	NARRATOR	SUSAN SARANDON
AMAZON	NARRATOR	LINDA HUNT
SUNRISE OVER TIANANMEN SQUARE	NARRATOR	SHUI-BO WANG
WHY CAN'T WE BE A FAMILY AGAIN%3F	NARRATOR	OSSIE DAVIS
RECYCLED LIFE	NARRATOR	EDWARD JAMES OLMOS
SPREAD	NARRATOR	ASHTON KUTCHER
TICKLED	NARRATOR	DAVID FARRIER
LIST OF ONE PIECE FILMS	NARRATOR	MAHITO ŌBA
PLUMP FICTION	NARRATOR	DON LAFONTAINE
POKéMON: ARCEUS AND THE JEWEL OF LIFE	NARRATOR	UNSHō ISHIZUKA
JUMBO	NARRATOR	AKSHAY KUMAR
DUET	NARRATOR	KIARASH ANVARI
SHORTS: THE ADVENTURES OF THE WISHING ROCK	NARRATOR	JIMMY BENNETT
WHEN YOU'RE STRANGE	NARRATOR	JOHNNY DEPP
FIST OF THE NORTH STAR	NARRATOR	TARO ISHIDA
THE MAN WHO SLEEPS	NARRATOR	LUDMILA MIKAëL
JYOT JALE	NARRATOR	NIRUPA ROY
JYOT JALE	NARRATOR	TARUN BOSE
JYOT JALE	NARRATOR	ABHI BHATTACHARYA
CRYSTAL VOYAGER	NARRATOR	GEORGE GREENOUGH
FANTASTIC ANIMATION FESTIVAL	NARRATOR	PAUL FREES
FANTASTIC ANIMATION FESTIVAL	NARRATOR	SPIKE MILLIGAN
MY NAME IS KHAN	NARRATOR	SHAH RUKH KHAN
INDONESIA CALLING	NARRATOR	PETER FINCH
PARIS 1900	NARRATOR	CLAUDE DAUPHIN
PARIS 1900	NARRATOR	MONTY WOOLLEY
A PLACE BETWEEN – THE STORY OF AN ADOPTION	NARRATOR	CURTIS KALTENBAUGH
JANGO	NARRATOR	JOSé WILKER
THIS HAPPY BREED	NARRATOR	LAURENCE OLIVIER
THE PEBBLE AND THE PENGUIN	NARRATOR	SHANI WALLIS
THE THRILL KILLERS	NARRATOR	COLEMAN FRANCIS
THERE GOES MY BABY	NARRATOR	ANNE ARCHER
THE CRIMSON CURTAIN	NARRATOR	YVES FURET
THE INHABITED ISLAND	NARRATOR	GENNADI VENGEROV
TN 07 AL 4777	NARRATOR	JEEVA
GREEN MAGIC	NARRATOR	CARLOS MONTALBáN
GREEN MAGIC	NARRATOR	BRET MORRISON
MAN OF AFRICA	NARRATOR	GORDON HEATH
I AM A HOTEL	NARRATOR	LEONARD COHEN
THE HUNTERS	NARRATOR	JOHN MARSHALL
SIEGE	NARRATOR	JULIEN BRYAN
GRAND CANYON ADVENTURE: RIVER AT RISK	NARRATOR	ROBERT REDFORD
A FLOOD IN BAATH COUNTRY	NARRATOR	OMAR AMIRALAY
THERE ARE SO MANY THINGS STILL TO SAY	NARRATOR	SAADALLAH WANNOUS
ON A DAY OF ORDINARY VIOLENCE, MY FRIEND MICHEL SEURAT...	NARRATOR	OMAR AMIRALAY
A PLATE OF SARDINES	NARRATOR	OMAR AMIRALAY
THE MAN WITH THE GOLDEN SOLES	NARRATOR	OMAR AMIRALAY
HANA YORI DANGO FINAL	NARRATOR	MAO INOUE
SNOW WHITE AND THE SEVEN DWARFS	NARRATOR	PAUL TRIPP
SEVEN YEARS IN TIBET	NARRATOR	HEINRICH HARRER
GABY: A TRUE STORY	NARRATOR	NORMA ALEANDRO
A WOMAN CALLED MOSES	NARRATOR	ORSON WELLES
BLACK WIND, WHITE LAND	NARRATOR	ALI HEWSON
LA ROSA DI BAGDAD	NARRATOR	STEFANO SIBALDI
LA ROSA DI BAGDAD	NARRATOR	HOWARD MARION-CRAWFORD
PORTUGUESE RHAPSODY	NARRATOR	PEDRO MOUTINHO
ONCE UPON A TIME IN MUMBAAI	NARRATOR	RANDEEP HOODA
LA MAISON EN PETITS CUBES	NARRATOR	MASAMI NAGASAWA
KRABAT – THE SORCERER'S APPRENTICE	NARRATOR	LUDěK MUNZAR
POUR LA SUITE DU MONDE	NARRATOR	STANLEY JACKSON
THE 3 ROOMS OF MELANCHOLIA	NARRATOR	PIRKKO SAISIO
COMPUTER DREAMS	NARRATOR	AMANDA PAYS
THE OBJECTIVE	NARRATOR	JONAS BALL
TEN THOUSAND YEARS OLDER	NARRATOR	WERNER HERZOG
ASAL	NARRATOR	AJITH KUMAR
A VERY SHORT LIFE	NARRATOR	CHEUNG SIU-FAI
NEW TOKYO DECADENCE – THE SLAVE	NARRATOR	RINAKO HIRASAWA
VOYAGE OF TIME	NARRATOR	* BRAD PITT\N*
VOYAGE OF TIME	NARRATOR	CATE BLANCHETT
INTERVIEW	NARRATOR	RANJIT MULLICK
OSCAR AND LUCINDA	NARRATOR	GEOFFREY RUSH
EFFI BRIEST	NARRATOR	RAINER WERNER FASSBINDER
VEENDUM LISA	NARRATOR	BABY
INSIDE OUT	NARRATOR	PETER DUFFELL
BEAUTIFUL DARLING	NARRATOR	CHLOë SEVIGNY
THE IRON CURTAIN	NARRATOR	REED HADLEY
THE MEERKATS	NARRATOR	PAUL NEWMAN
ENEMY IMAGE	NARRATOR	JOE WALSH
CALCUTTA	NARRATOR	LOUIS MALLE
NOT FOR OURSELVES ALONE	NARRATOR	SALLY KELLERMAN
AN AMERICAN OPERA	NARRATOR	TOM MCPHEE
THE MARRIED COUPLE OF THE YEAR TWO	NARRATOR	JEAN-PIERRE MARIELLE
10,000 KIDS AND A COP	NARRATOR	JAMES STEWART
10,000 KIDS AND A COP	NARRATOR	BRENDA JOYCE
WAVERIDERS	NARRATOR	CILLIAN MURPHY
ONE HAMLET LESS	NARRATOR	CARMELO BENE
THE WHITE RIBBON	NARRATOR	ERNST JACOBI
FUTURE SHOCK	NARRATOR	ORSON WELLES
NEVER LET ME GO	NARRATOR	CAREY MULLIGAN
BIRDS DO IT, BEES DO IT	NARRATOR	LEE BERGERE
THE INCREDIBLE JOURNEY	NARRATOR	REX ALLEN
400 YEARS OF THE TELESCOPE	NARRATOR	NEIL DEGRASSE TYSON
SCHAKELS	NARRATOR	HERMAN HEIJERMANS , MAURITS BINGER
THE HATE THAT HATE PRODUCED	NARRATOR	MIKE WALLACE
HOME	NARRATOR	GLENN CLOSE
HOME	NARRATOR	JACQUES GAMBLIN
HOME	NARRATOR	SALMA HAYEK
HOME	NARRATOR	MAHMOOD SAID
HOME	NARRATOR	ZHOU XUN
HOME	NARRATOR	STEPHEN CHAN CHI WAN
THE INVENTION OF LYING	NARRATOR	RICKY GERVAIS
WILD GRASS	NARRATOR	ÉDOUARD BAER
OF DOLLS AND MURDER	NARRATOR	JOHN WATERS
A WAR STORY	NARRATOR	DIARY
A WAR STORY	NARRATOR	DONALD SUTHERLAND
A WAR STORY	NARRATOR	STORY
A WAR STORY	NARRATOR	ANNE WHEELER
CRYING FREEMAN	NARRATOR	JULIE CONDRA
RECLAIMING THE BLADE	NARRATOR	JOHN RHYS-DAVIES
CHASE A CROOKED SHADOW	NARRATOR	DOUGLAS FAIRBANKS JR.
STOCKHOLMSNATT	NARRATOR	QUINCY JONES III
HERO OF THE RAILS	NARRATOR	MICHAEL ANGELIS
HERO OF THE RAILS	NARRATOR	MICHAEL BRANDON
BLUE GOLD: WORLD WATER WARS	NARRATOR	MALCOLM MCDOWELL
DUG'S SPECIAL MISSION	NARRATOR	BOB PETERSON
RHODES OF AFRICA	NARRATOR	LEO GENN
MOONWALK ONE	NARRATOR	LAURENCE LUCKINBILL
DIRECTED BY JOHN FORD	NARRATOR	ORSON WELLES
A LETTER TO FREDDY BUACHE	NARRATOR	JEAN-LUC GODARD
MICHAEL JORDAN TO THE MAX	NARRATOR	LAURENCE FISHBURNE
ALL IN THE BUNKER	NARRATOR	S. SCOTT BULLOCK
THIRD DIMENSIONAL MURDER	NARRATOR	PETE SMITH
REVENGE OF THE ELECTRIC CAR	NARRATOR	TIM ROBBINS
BABA RAMDEV	NARRATOR	NAWAL MATHUR
THE WALL THAT HEALS	NARRATOR	LOUIS GOSSETT JR.
MANJADIKURU	NARRATOR	PRITHVIRAJ SUKUMARAN
ESTHER KAHN	NARRATOR	RAMIN GRAY
TANK ON THE MOON	NARRATOR	CHIP ROUGHTON
DEAD SOULS	NARRATOR	ALEKSANDR TROFIMOV
RUNNING FREE	NARRATOR	LUKAS HAAS
THE MAN WHO PLANTED TREES	NARRATOR	PHILIPPE NOIRET
THE MAN WHO PLANTED TREES	NARRATOR	CHRISTOPHER PLUMMER
IPPODROMI ALL'ALBA	NARRATOR	ARNOLDO FOA
MR. BRAHMACHARI	NARRATOR	J. PALLASSERY
AND THE PURSUIT OF HAPPINESS	NARRATOR	LOUIS MALLE
VIVA IL CINEMA!	NARRATOR	ALBERTO SORDI
MUKUNTHETTA SUMITRA VILIKKUNNU	NARRATOR	PRIYADARSHAN
CHARLES DICKENS'S ENGLAND	NARRATOR	DEREK JACOBI
AGE 7 IN AMERICA	NARRATOR	MERYL STREEP
AHIMSA	NARRATOR	T. DAMODARAN
CAT CHASER	NARRATOR	RENI SANTONI
UNWANTED SOLDIERS	NARRATOR	JARI OSBORNE
GOOD HAIR	NARRATOR	CHRIS ROCK
BACK TO BACK	NARRATOR	W.K. BORDER
BACK TO BACK	NARRATOR	THOMAS CALABRESE
BACK TO BACK	NARRATOR	TAKASHIGE ICHISE
BACK TO BACK	NARRATOR	AKI KOMINE
BACK TO BACK	NARRATOR	MICHAEL LEAHY
BACK TO BACK	NARRATOR	JOEL SOISSON
TEEN DEVIAN	NARRATOR	AMEEN SAYANI
LOVE ISLAND	NARRATOR	ANDRé BARUCH
AFRICA SPEAKS!	NARRATOR	LOWELL THOMAS
X GAMES 3D: THE MOVIE	NARRATOR	EMILE HIRSCH
AS WE FORGIVE	NARRATOR	MIA FARROW
ACES AND EIGHTS	NARRATOR	KARL HACKETT AS WILD BILL HICKOK
KURT & COURTNEY	NARRATOR	NICK BROOMFIELD
SOUTH OF THE BORDER	NARRATOR	OLIVER STONE
HERCULES AND THE CONQUEST OF ATLANTIS	NARRATOR	LEON SELZNICK
THE FORGOTTEN VILLAGE	NARRATOR	BURGESS MEREDITH
DRYLANDERS	NARRATOR	WILLIAM WEINTRAUB
THE WALL	NARRATOR	ALEXANDER SCOURBY
THE REJECTED	NARRATOR	JAMES DAY
I DREAMT I WOKE UP	NARRATOR	JOHN BOORMAN
NO TIME FOR SERGEANTS	NARRATOR	ANDY GRIFFITH
YOUR HIGHNESS	NARRATOR	CHARLES SHAUGHNESSY
PROPHET WITHOUT HONOR	NARRATOR	CAREY WILSON
ZOR LAGAA KE...HAIYA!	NARRATOR	AMITABH BACHCHAN
JOURNEY TO MECCA	NARRATOR	BEN KINGSLEY
TWELVE	NARRATOR	KIEFER SUTHERLAND
THE ANIMALS FILM	NARRATOR	JULIE CHRISTIE
AFTERMATH: THE REMNANTS OF WAR	NARRATOR	JOHN JARVIS
JANIE	NARRATOR	ALEX GOTTLIEB
THE OUTPOST	NARRATOR	MARI TöRőCSIK
THE CAT PIANO	NARRATOR	NICK CAVE
RAKTA CHARITRA	NARRATOR	CHETAN SASITHAL
RAKTA CHARITRA	NARRATOR	RAM GOPAL VARMA
RAKTA CHARITRA	NARRATOR	GAUTHAM MENON
PRINCE OF TEARS	NARRATOR	YONFAN
THE BURNING SEASON	NARRATOR	HUGH JACKMAN
CYANIDE	NARRATOR	PRAKASH RAJ
WORST CASE SCENARIO	NARRATOR	BRIAN YUZNA
CHANCE PE DANCE	NARRATOR	VIJAY RAAZ
THE CRIMSON WING: MYSTERY OF THE FLAMINGOS	NARRATOR	MARIELLA FROSTRUP
THE CRIMSON WING: MYSTERY OF THE FLAMINGOS	NARRATOR	ISABELLE BREITMAN
RETURN WITH HONOR	NARRATOR	TOM HANKS
HARTO THE BORGES	NARRATOR	EDUARDO MONTES-BRADLEY
THE VIKING	NARRATOR	WILFRED GRENFELL
THE LEGEND OF PANCHO BARNES AND THE HAPPY BOTTOM RIDING CLUB	NARRATOR	TOM SKERRITT
VOICES IN THE TUNNELS	NARRATOR	JENNIFER TOTH
SONICSGATE	NARRATOR	JOHN KEISTER
DIARY OF A WIMPY KID	NARRATOR	ZACHARY GORDON
VALENTE QUINTERO	NARRATOR	ELEAZAR GARCíA
ENDGAME	NARRATOR	ALEX JONES
CLASSIFIED X	NARRATOR	MELVIN VAN PEEBLES
BUTTE, AMERICA	NARRATOR	GABRIEL BYRNE
I REMEMBER BETTER WHEN I PAINT	NARRATOR	OLIVIA DE HAVILLAND
SPEAK IT! FROM THE HEART OF BLACK NOVA SCOTIA	NARRATOR	SHINGAI NYAJEKA
CREE HUNTERS OF MISTASSINI	NARRATOR	BOYCE RICHARDSON
THE IDIOT CYCLE	NARRATOR	EMMANUELLE SCHICK GARCIA
SPACE BATTLESHIP YAMATO	NARRATOR	ISAO SASAKI
YOU WILL MEET A TALL DARK STRANGER	NARRATOR	ZAK ORTH
1 A MINUTE	NARRATOR	KELLY MCGILLIS
BLACK RODEO	NARRATOR	WOODY STRODE
THE NEW GLADIATORS	NARRATOR	CHUCK SULLIVAN
LONDON BETTY	NARRATOR	CLINT HOWARD
FIELDS OF SACRIFICE	NARRATOR	DOUGLAS RAIN
THE WAR OF THE WORLDS	NARRATOR	SIR CEDRIC HARDWICKE
FBI CODE 98	NARRATOR	WILLIAM WOODSON
SONG OF SONGS	NARRATOR	RAMIN GRAY
THE FAMILY THAT DWELT APART	NARRATOR	E.B. WHITE
DEATH OF A LEGEND	NARRATOR	STANLEY JACKSON
CRY OF THE WILD	NARRATOR	BILL MASON
HELL SHIP MUTINY	NARRATOR	JON HALL
CANON CITY	NARRATOR	REED HADLEY
THE LEGEND OF MARILYN MONROE	NARRATOR	JOHN HUSTON
ECLIPSE OF REASON	NARRATOR	BERNARD NATHANSON
ECLIPSE OF REASON	NARRATOR	CHARLTON HESTON
A LECTURE ON CAMOUFLAGE	NARRATOR	MEL BLANC
A VALENTINE FOR YOU	NARRATOR	DAVID WARNER
4 CLOWNS	NARRATOR	JAY JACKSON
POKéMON: ZOROARK: MASTER OF ILLUSIONS	NARRATOR	UNSHō ISHIZUKA
OCEANWORLD 3D	NARRATOR	MARION COTILLARD
DRILLBIT	NARRATOR	JIM VAN BEBBER
FORCES OF NATURE	NARRATOR	KEVIN BACON
MAA TUJHHE SALAAM	NARRATOR	OM PURI
RED TAIL REBORN	NARRATOR	MICHAEL DORN
THE BODY	NARRATOR	FRANK FINLAY
THE BODY	NARRATOR	VANESSA REDGRAVE
A WIFE'S LIFE	NARRATOR	PETE SMITH
POOR NO MORE	NARRATOR	MARY WALSH
RANGULA RATNAM	NARRATOR	D.V. NARASA RAJU
RANGULA RATNAM	NARRATOR	PALAGUMMI PADMARAJU
WINNIE THE POOH	NARRATOR	JOHN CLEESE
PONY SOLDIER	NARRATOR	MICHAEL RENNIE
PONY SOLDIER	NARRATOR	TYRONE POWER
WAKING SLEEPING BEAUTY	NARRATOR	DON HAHN
GOLDEN GLOVES	NARRATOR	CLAUDE JUTRA
A MAN CALLED SARGE	NARRATOR	DON LAFONTAINE
MY SON SHALL BE ARMENIAN	NARRATOR	HAGOP GOUDSOUZIAN
STEEP	NARRATOR	PETER KRAUSE
MR. BROADWAY	NARRATOR	ED SULLIVAN
INSIDE FIGHTING CHINA	NARRATOR	LORNE GREENE
INTERNATIONAL MILITARY TRIBUNAL FOR THE FAR EAST	NARRATOR	KEI SATō
EXIT THROUGH THE GIFT SHOP	NARRATOR	RHYS IFANS
LA VIE HEUREUSE DE LéOPOLD Z	NARRATOR	ALBERT MILLAIRE
MISTY ISLAND RESCUE	NARRATOR	MICHAEL ANGELIS
MISTY ISLAND RESCUE	NARRATOR	MICHAEL BRANDON
PIG HUNT	NARRATOR	FANGORIA
NO ONE KILLED JESSICA	NARRATOR	RANI MUKERJI
CHAPLINESQUE, MY LIFE AND HARD TIMES	NARRATOR	GLORIA SWANSON
TOONPUR KA SUPER HERO	NARRATOR	SANJAY DUTT
HUBBLE	NARRATOR	LEONARDO DICAPRIO
TEES MAAR KHAN	NARRATOR	SANJAY DUTT
CRIES FROM THE DEEP	NARRATOR	GEORGES WILSON
DANGEROUS LIVING: COMING OUT IN THE DEVELOPING WORLD	NARRATOR	JANEANE GAROFALO
THE STORY OF RUTH	NARRATOR	EDUARD FRANZ
TREASURE OF THE GOLDEN CONDOR	NARRATOR	CORNEL WILDE
MEESA MADHAVAN	NARRATOR	RANJITH
MIZHI RANDILUM	NARRATOR	RANJITH
ANWAR	NARRATOR	MAMMOOTTY
TRUE GRIT	NARRATOR	ELIZABETH MARVEL
MCDULL, KUNG FU KINDERGARTEN	NARRATOR	WAN KWONG
7 KHOON MAAF	NARRATOR	VIVAAN SHAH
LE PARTI DES CHOSES	NARRATOR	JEAN LESCOT
LE PARTI DES CHOSES	NARRATOR	DAVID TONELLI
ANGELS IN DISGUISE	NARRATOR	LEO GORCEY
MEGASANDESAM	NARRATOR	RAJASENAN
CONAN THE BARBARIAN	NARRATOR	MORGAN FREEMAN
ROYAL JOURNEY	NARRATOR	ELWOOD GLOVER
DOOM RUNNERS	NARRATOR	DEAN O'GORMAN
WHAT ON EARTH!	NARRATOR	DONALD BRITTAIN
PANDIPPADA	NARRATOR	RAFI MECARTIN
THE FORBIDDEN STREET	NARRATOR	MAUREEN O'HARA
HATCHET II	NARRATOR	TONY TODD
HAMILCHAMA AL HASHALOM	NARRATOR	JULES DASSIN
HAMILCHAMA AL HASHALOM	NARRATOR	CLAUDE DAUPHIN
FLASHING SPIKES	NARRATOR	FRED ASTAIRE
MINE YOUR OWN BUSINESS	NARRATOR	PHELIM MCALEER
YAMLA PAGLA DEEWANA	NARRATOR	AJAY DEVGAN
VICTORY THROUGH AIR POWER	NARRATOR	ART BAKER
CHEAT YOU FAIR: THE STORY OF MAXWELL STREET	NARRATOR	JOE MANTEGNA
BANGALI BABU	NARRATOR	ANJAN CHOWDHURY
ON WITH THE DANCE	NARRATOR	ADOLPH ZUKOR
PEEP WORLD	NARRATOR	LEWIS BLACK
THE DISENCHANTED FOREST	NARRATOR	BROOKE SHIELDS
GASLAND	NARRATOR	JOSH FOX
MELEPARAMBIL AANVEEDU	NARRATOR	NARENDRA PRASAD
THE VISUAL BIBLE: MATTHEW	NARRATOR	RICHARD KILEY
THE FIGURINE	NARRATOR	LAGBAJA
MOOMINS AND THE COMET CHASE	NARRATOR	MAX VON SYDOW
COUNTDOWN TO ZERO	NARRATOR	GARY OLDMAN
UNCHAINED MEMORIES	NARRATOR	WHOOPI GOLDBERG
THE LAST PLAY AT SHEA	NARRATOR	ALEC BALDWIN
FLUNKED	NARRATOR	JOE MANTEGNA
THE DESERT HAWK	NARRATOR	JEFF CHANDLER
BRING 'EM BACK ALIVE	NARRATOR	FRANK BUCK
FANG AND CLAW	NARRATOR	FRANK BUCK
8: THE MORMON PROPOSITION	NARRATOR	DUSTIN LANCE BLACK
PERIWIG MAKER	NARRATOR	KENNETH BRANAGH
FREEDOM'S FURY	NARRATOR	MARK SPITZ
EIGHTEEN	NARRATOR	IAN MCKELLEN
NEVER SLEEP AGAIN: THE ELM STREET LEGACY	NARRATOR	HEATHER LANGENKAMP
CARBON NATION	NARRATOR	BILL KURTIS
THE THIRD JIHAD: RADICAL ISLAM'S VISION FOR AMERICA	NARRATOR	ZUHDI JASSER
DIRT! THE MOVIE	NARRATOR	JAMIE LEE CURTIS
ON APPROVAL	NARRATOR	E. V. H. EMMETT
CONFESSIONS OF A CHEAT	NARRATOR	SACHA GUITRY
HIDEAWAYS	NARRATOR	RACHEL HURD-WOOD
INSIDE JOB	NARRATOR	MATT DAMON
THE GAIA MEMORIES OF FATE	NARRATOR	FUMIHIKO TACHIKI
BRUCE LEE: THE CURSE OF THE DRAGON	NARRATOR	GEORGE TAKEI
SHACKLETON'S ANTARCTIC ADVENTURE	NARRATOR	KEVIN SPACEY
THE DIRK DIGGLER STORY	NARRATOR	ERNIE ANDERSON
NUCLEAR TIPPING POINT	NARRATOR	MICHAEL DOUGLAS
AFRICAN CATS	NARRATOR	SAMUEL L. JACKSON
PREM KAA GAME	NARRATOR	SALMAN KHAN
I WANT WHAT I WANT	NARRATOR	SARAH DAVIS
CHORDS OF FAME	NARRATOR	CAST:           = ODETTA, MARTHA WINGATE, BILL BURNETT, ABBIE HOFFMAN, MIKE PORCO, OSCAR BRAND, TOM PAXTON
READY	NARRATOR	SALMAN KHAN
BARFI!	NARRATOR	ILEANA D'CRUZ
LAND OF NO RETURN	NARRATOR	FRANK RAY PERILLI
THE LONDON SCENE	NARRATOR	AUBREY BUXTON
FLIGHT OF THE SNOW GEESE	NARRATOR	ANDREW SACHS
I AM COMIC	NARRATOR	RITCH SHYDNER
UNCONSTITUTIONAL: THE WAR ON OUR CIVIL LIBERTIES	NARRATOR	JAMES HANES
CITY OF SCARS	NARRATOR	KEVIN PORTER
BANGARU PANJARAM	NARRATOR	N. T. RAMA RAO
ISLAMABAD: ROCK CITY	NARRATOR	SUSAN SARANDON
NADUNISI NAAYGAL	NARRATOR	VEERA BAHU
HARRY: A COMMUNICATION BREAKDOWN	NARRATOR	DANNY AIELLO
4CHOSEN: THE DOCUMENTARY	NARRATOR	MONTEL WILLIAMS
EMIL I LöNNEBERGA	NARRATOR	ASTRID LINDGREN
NYA HYSS AV EMIL I LöNNEBERGA	NARRATOR	ASTRID LINDGREN
EMIL AND THE PIGLET	NARRATOR	ASTRID LINDGREN
URUMI	NARRATOR	K. P. A. C. LALITHA
STREET DOGS OF SOUTH CENTRAL	NARRATOR	QUEEN LATIFAH
WHEN WERE YOU BORN	NARRATOR	MANLY P. HALL
SECRET OF THE WINGS	NARRATOR	ANJELICA HUSTON
CAVE OF FORGOTTEN DREAMS	NARRATOR	WERNER HERZOG
THE LAME DEVIL	NARRATOR	SACHA GUITRY
BIG EASY TO BIG EMPTY: THE UNTOLD STORY OF THE DROWNING OF NEW ORLEANS	NARRATOR	GREG PALAST
THE ORANGES	NARRATOR	ALIA SHAWKAT
THE SEARCH FOR ROBERT JOHNSON	NARRATOR	JOHN P. HAMMOND
TRAFFIC	NARRATOR	SREENIVASAN
THE TILLMAN STORY	NARRATOR	JOSH BROLIN
DAYDREAM NATION	NARRATOR	KAT DENNINGS
RAJANNA	NARRATOR	AKKINENI NAGESWARA RAO
TURTLE: THE INCREDIBLE JOURNEY	NARRATOR	MIRANDA RICHARDSON
POKHORONY STALINA	NARRATOR	VSEVOLOD LARIONOV
THE INBETWEENERS MOVIE	NARRATOR	SIMON BIRD
CHARLIE, THE LONESOME COUGAR	NARRATOR	REX ALLEN
THE WILDEST DREAM	NARRATOR	LIAM NEESON
SUBMISSION	NARRATOR	STELLAN SKARSGåRD
KAMEN RIDER × KAMEN RIDER OOO & W FEATURING SKULL: MOVIE WAR CORE	NARRATOR	FUMIHIKO TACHIKI
KAMEN RIDER × KAMEN RIDER OOO & W FEATURING SKULL: MOVIE WAR CORE	NARRATOR	JōJI NAKATA
A SEPARATE PEACE	NARRATOR	PARKER STEVENSON
TEENAGE PAPARAZZO	NARRATOR	THOMAS DE ZENGOTITA
MY RUN	NARRATOR	BILLY BOB THORNTON
BODYGUARD	NARRATOR	HAZEL KEECH
A DEFEATED PEOPLE	NARRATOR	WILLIAM HARTNELL
SON OF ALI BABA	NARRATOR	JEFF CHANDLER
LONELY WATER	NARRATOR	DONALD PLEASENCE
THE BATTLE OF STALINGRAD	NARRATOR	YURI LEVITAN
MOVIE 43	NARRATOR	*
MOVIE 43	NARRATOR	ERIC STUART
MOVIE 43	NARRATOR	*PHIL CROWLEY
SAATCHYA AAT GHARAT	NARRATOR	REEMA LAGOO
HITLER'S REIGN OF TERROR	NARRATOR	EDWIN C. HILL
THE FIRST BASKET	NARRATOR	PETER RIEGERT
KHICHDI: THE MOVIE	NARRATOR	KESAR MAJETHIA
KHICHDI: THE MOVIE	NARRATOR	MARKAND SONI
EX$PENDABLE	NARRATOR	GARY STURGIS
LIPSETT DIARIES	NARRATOR	XAVIER DOLAN
IRANIUM	NARRATOR	SHOHREH AGHDASHLOO
ELDORADO	NARRATOR	PETER O'TOOLE
DAGNY	NARRATOR	LISE FJELDSTAD
DAGNY	NARRATOR	DANIEL OLBRYCHSKI
DAGNY	NARRATOR	PER OSCARSSON
DAGNY	NARRATOR	NILS OLE OFTEBRO
COMING OUT UNDER FIRE	NARRATOR	SALOME JENS
DRUMS OF TAHITI	NARRATOR	MICHAEL ANSARA
TRADITION IS A TEMPLE	NARRATOR	CHUCK PERKINS
SINS OF JEZEBEL	NARRATOR	JOHN HOYT
BATTLE OF MOSCOW	NARRATOR	VYACHESLAV TIKHONOV
BRUCE LEE, MY BROTHER	NARRATOR	ROBERT LEE
BORN TO BE WILD	NARRATOR	MORGAN FREEMAN
THE BLONDE CAPTIVE	NARRATOR	LOWELL THOMAS
SWORD FISHING	NARRATOR	RONALD REAGAN
LUCHINO VISCONTI	NARRATOR	CARLO LIZZANI
POKéMON THE MOVIE: BLACK—VICTINI AND RESHIRAM AND WHITE—VICTINI AND ZEKROM	NARRATOR	UNSHō ISHIZUKA
JEWS AND BASEBALL: AN AMERICAN LOVE STORY	NARRATOR	DUSTIN HOFFMAN
THE EYES OF TAMMY FAYE	NARRATOR	RUPAUL
TRAPPED BENEATH THE SEA	NARRATOR	HOWARD K. SMITH
TOURNAMENT – PLAY & REPLAY	NARRATOR	LAL
NEUROSIA: 50 YEARS OF PERVERSITY	NARRATOR	ROSA VON PRAUNHEIM
THE WAR OF THE ROSES	NARRATOR	DANNY DEVITO
OOO, DEN-O, ALL RIDERS: LET'S GO KAMEN RIDERS	NARRATOR	FUMIHIKO TACHIKI
DIARY OF A WIMPY KID: RODRICK RULES	NARRATOR	ZACHARY GORDON
RETURN OF THE SENTIMENTAL SWORDSMAN	NARRATOR	CHENG MIU
CHINA TOWN	NARRATOR	JAGATHY SREEKUMAR
HAHAHA	NARRATOR	KIM SANG-KYUNG
THE LAST LIONS	NARRATOR	JEREMY IRONS
STUDENT OF THE YEAR	NARRATOR	STUDENT OF THE YEAR
ORU MARUBHOOMIKKADHA	NARRATOR	SREENIVASAN
HARRY CLARKE – DARKNESS IN LIGHT	NARRATOR	JOHN J DOHERTY
LET'S POLLUTE	NARRATOR	JIM THORNTON
SANGOLLI RAYANNA	NARRATOR	SUDEEP
SANTIAGO FILES	NARRATOR	MALCOLM MCDOWELL
WOLVES	NARRATOR	ROBBIE ROBERTSON
GOKAIGER GOSEIGER SUPER SENTAI 199 HERO GREAT BATTLE	NARRATOR	TOMOKAZU SEKI
THE SHOCK OF THE NEW	NARRATOR	ROBERT HUGHES
VIRGIN TERRITORY	NARRATOR	CRAIG PARKINSON
MONDO CANE	NARRATOR	STEFANO SIBALDI
LA TERRA TREMA	NARRATOR	LUCHINO VISCONTI
THE THIEF AND THE COBBLER	NARRATOR	FELIX AYLMER
ONCE UPON A TIME...WHEN WE WERE COLORED	NARRATOR	PHILL LEWIS
TEEN THAY BHAI	NARRATOR	PAWAN MALHOTRA
FOR THE LOVE OF MOVIES: THE STORY OF AMERICAN FILM CRITICISM	NARRATOR	PATRICIA CLARKSON
THE GREAT GATSBY	NARRATOR	TOBEY MAGUIRE
THAT'S WHAT I AM	NARRATOR	GREG KINNEAR
HAPPY PEOPLE: A YEAR IN THE TAIGA	NARRATOR	WERNER HERZOG
SHADOW OF A WOMAN	NARRATOR	ANDREA KING
THE AMAZING GRACE	NARRATOR	JOKE SILVA
A TIME FOR CHAMPIONS	NARRATOR	PATRICK MURPHY
SOMBRA VERDE	NARRATOR	RICARDO MONTALBAN, ARIADNA WELTER, VíCTOR PARRA
WALK A CROOKED MILE	NARRATOR	REED HADLEY
VICKERS WELLINGTON LN514	NARRATOR	FLYING OFFICER J. PEACH, ROYAL CANADIAN AIR FORCE
JOURNEY TO THE EDGE OF THE UNIVERSE	NARRATOR	ALEC BALDWIN
JOURNEY TO THE EDGE OF THE UNIVERSE	NARRATOR	SEAN PERTWEE
THE WAR YOU DON'T SEE	NARRATOR	JOHN PILGER
ORU PENNINTE KATHA	NARRATOR	SATHYANESHAN NADAR
SWARNAM	NARRATOR	MOHANLAL
THE LAST BLITZKRIEG	NARRATOR	DICK YORK
NIGHTJOHN	NARRATOR	ALLISON JONES
TT3D: CLOSER TO THE EDGE	NARRATOR	JARED LETO
TED	NARRATOR	PATRICK STEWART
THE LONG DAYS OF SUMMER	NARRATOR	CHARLES AIDMAN
GLORY ALLEY	NARRATOR	JOHN MCINTIRE
CHINA: THE ROOTS OF MADNESS	NARRATOR	JOSEPH CAMPANELLA
THE FOURTH ESTATE	NARRATOR	GEOFFREY BELL,
THE FOURTH ESTATE	NARRATOR	NICHOLAS HANNEN
THE FOURTH ESTATE	NARRATOR	DENNIS ARUNDELL
DER UNTERTAN	NARRATOR	WOLFGANG STAUDTE
HELLAS OHNE GöTTER	NARRATOR	OTTO MELLIES
LOVE'S CONFUSION	NARRATOR	SLáTAN DUDOW
A REGULAR FRANKIE FAN	NARRATOR	PAUL WILLIAMS
TIM AND ERIC'S BILLION DOLLAR MOVIE	NARRATOR	MICHAEL GROSS
I AM	NARRATOR	TOM SHADYAC
OIL ON ICE	NARRATOR	PETER COYOTE
TREASURE ISLAND	NARRATOR	VITALY SOLOMIN
THE DIRTY PICTURE	NARRATOR	EMRAAN HASHMI
MAXIMUM SPEED	NARRATOR	EWAN MCGREGOR
OUR RUSSIAN FRONT	NARRATOR	WALTER HUSTON
ACTOR'S AND SIN	NARRATOR	DAN O'HERLIHY
ACTOR'S AND SIN	NARRATOR	BEN HECHT
EK THA TIGER	NARRATOR	RANVIR SHOREY
VIETNAM! VIETNAM!	NARRATOR	CHARLTON HESTON
THE AGE OF INNOCENCE	NARRATOR	JOHN BOLES
WORDS FOR BATTLE	NARRATOR	LAURENCE OLIVIER
THREE BRAVE MEN	NARRATOR	KEN SCOTT
THE PRINCE AND THE SURFER	NARRATOR	JON VOIGHT
CHANTONS SOUS L'OCCUPATION	NARRATOR	PASCAL MAZZOTTI
DAY OF THE DIESELS	NARRATOR	MICHAEL BRANDON
DAY OF THE DIESELS	NARRATOR	MICHAEL ANGELIS
VISUAL ACOUSTICS: THE MODERNISM OF JULIUS SHULMAN	NARRATOR	DUSTIN HOFFMAN
RETURN TO EL SALVADOR	NARRATOR	MARTIN SHEEN
KAMEN RIDER OOO WONDERFUL: THE SHOGUN AND THE 21 CORE MEDALS	NARRATOR	JōJI NAKATA
SILENT MINORITY	NARRATOR	NIGEL EVANS
DANTE'S INFERNO: ABANDON ALL HOPE	NARRATOR	JEFF CONAWAY
MILICE, FILM NOIR	NARRATOR	MICHEL BOUQUET
DHARTI KAHE PUKARKE	NARRATOR	DHARMENDRA
ASSA	NARRATOR	NATAN EIDELMAN
DOCTOR LOVE	NARRATOR	ASIF ALI
DIARY OF A WIMPY KID: DOG DAYS	NARRATOR	ZACHARY GORDON
WHERE THE RED FERN GROWS	NARRATOR	WILSON RAWLS
MARCH OF THE DINOSAURS	NARRATOR	STEPHEN FRY
ADVENTURES OF SINBAD THE SAILOR	NARRATOR	JAN TříSKA
DET VAR EN GANG	NARRATOR	HENKI KOLSTAD
KAIZOKU SENTAI GOKAIGER THE MOVIE: THE FLYING GHOST SHIP	NARRATOR	TOMOKAZU SEKI
A LIVELY CHRISTMAS EVE	NARRATOR	GERRY WOLFF
THE BANNER OF KRIVOI ROG	NARRATOR	HELMUT SCHELLHARDT, MARGA LEGAL
KRRISH 3	NARRATOR	AMITABH BACHCHAN
FOOTPRINTS ON THE MOON	NARRATOR	WERNHER VON BRAUN
MAGIC TRIP	NARRATOR	STANLEY TUCCI
MOI, UN NOIR	NARRATOR	*
MOI, UN NOIR	NARRATOR	JEAN ROUCH
MOI, UN NOIR	NARRATOR	OUMAROU GANDA
THE 49TH MAN	NARRATOR	GERALD MOHR
THE SILVER BRUMBY	NARRATOR	CAROLINE GOODALL
HICK	NARRATOR	CHLOë GRACE MORETZ
WAR OF THE WORLDS – THE TRUE STORY	NARRATOR	JIM CISSELL
BEAUMARCHAIS	NARRATOR	PIERRE ARDITI
OCEANS	NARRATOR	JACQUES PERRIN
OCEANS	NARRATOR	PIERCE BROSNAN
DANGEROUS ISHHQ	NARRATOR	KARISMA KAPOOR
INTO THE ABYSS	NARRATOR	WERNER HERZOG
BENJAMIN SNIDDLEGRASS AND THE CAULDRON OF PENGUINS	NARRATOR	STEPHEN FRY
BUSH CHRISTMAS	NARRATOR	JOHN MCCALLUM
C-MAN	NARRATOR	DEAN JAGGER
THE GLENROWAN AFFAIR	NARRATOR	CHARLES TINGWELL
THREE IN ONE	NARRATOR	JOHN MCCALLUM
RRRRRRR!!!	NARRATOR	OLIVIER BAROUX
RAAZ 3D	NARRATOR	EMRAAN HASHMI
THE WILD, WILD WORLD OF JAYNE MANSFIELD	NARRATOR	CAROLYN DE FONSECA
MARILYN	NARRATOR	ROCK HUDSON
ZULM KI HUKUMAT	NARRATOR	AMITABH BACHCHAN
THE COOL SCHOOL	NARRATOR	JEFF BRIDGES
THAT'S CRICKET	NARRATOR	LIONEL LUNN
SUN SEEKERS	NARRATOR	ERWIN GESCHONNECK
STEALING HOME	NARRATOR	YARELI ARIZMENDI
BEING ELMO: A PUPPETEER'S JOURNEY	NARRATOR	WHOOPI GOLDBERG
KINGDOM OF DAVID: THE SAGA OF THE ISRAELITES	NARRATOR	F. MURRAY ABRAHAM
KINGDOM OF DAVID: THE SAGA OF THE ISRAELITES	NARRATOR	RENE AUBERJONOIS
KINGDOM OF DAVID: THE SAGA OF THE ISRAELITES	NARRATOR	KEITH DAVID
KINGDOM OF DAVID: THE SAGA OF THE ISRAELITES	NARRATOR	JEREMY IRONS
KINGDOM OF DAVID: THE SAGA OF THE ISRAELITES	NARRATOR	DEREK JACOBI
WOODROW WILSON AND THE BIRTH OF THE AMERICAN CENTURY	NARRATOR	LINDA HUNT
RUDHRAMADEVI	NARRATOR	CHIRANJEEVI
1981	NARRATOR	RICARDO TROGI
REGENERATION	NARRATOR	RYAN GOSLING
HUMANITY'S END	NARRATOR	NEIL JOHNSON
THAR SHE BLOWS!	NARRATOR	LIONEL LUNN
O V. VARA PRASAD	NARRATOR	KRISHNA BHAGAVAAN ( )
SHABNAM	NARRATOR	MAJROHSULTAN PURI
SHABNAM	NARRATOR	PREM DHAWAN
SHABNAM	NARRATOR	JAVED ANWAR
ROBOTECH: LOVE LIVE ALIVE	NARRATOR	J. JAY SMITH
MONSTER BRAWL	NARRATOR	LANCE HENRIKSEN
ON THE SUNNY SIDE	NARRATOR	MANFRED KRUG
KHILADI 786	NARRATOR	PARESH RAWAL
THE LEGEND OF BIGFOOT	NARRATOR	IVAN MARX
THE HORSE OF PRIDE	NARRATOR	GEORGES WILSON
THE EYE OF VICHY	NARRATOR	MICHEL BOUQUET
THE EYE OF VICHY	NARRATOR	BRIAN COX
THE ART OF LOVE	NARRATOR	PHILIPPE TORRETON
WE FOUND LOVE	NARRATOR	AGYNESS DEYN
STOP GENOCIDE	NARRATOR	ALAMGIR KABIR
THE TALE OF TILLIE'S DRAGON	NARRATOR	FRANK WELKER
KOCHADAIIYAAN	NARRATOR	A. R. RAHMAN
KOCHADAIIYAAN	NARRATOR	AMITABH BACHCHAN
EAMES: THE ARCHITECT AND THE PAINTER	NARRATOR	JAMES FRANCO
HAMMER & TICKLE	NARRATOR	BEN LEWIS
SHOOTOUT AT WADALA	NARRATOR	JOHN ABRAHAM
FASTEST	NARRATOR	EWAN MCGREGOR
TOKUSOU SENTAI DEKARANGER THE MOVIE: FULL BLAST ACTION	NARRATOR	TOSHIO FURUKAWA
NEW YORK STREET GAMES	NARRATOR	HECTOR ELIZONDO
KATARI VEERA SURASUNDARANGI	NARRATOR	SUDEEP
ONE LIFE	NARRATOR	DANIEL CRAIG
THE FREE MARKET CURE	NARRATOR	STUART BROWNING
THE FAMILY OF CHIMPS	NARRATOR	BERT HAANSTRA
ROMANCE OF CELLULOID	NARRATOR	FRANK WHITBECK
ANOTHER ROMANCE OF CELLULOID	NARRATOR	FRANK WHITBECK
OUTBACK PATROL	NARRATOR	CHIPS RAFFERTY
CHIMPANZEE	NARRATOR	TIM ALLEN
LAN KWAI FONG	NARRATOR	JASON CHAN
BEING FLYNN	NARRATOR	ROBERT DE NIRO
YEH JAWAANI HAI DEEWANI	NARRATOR	DEEPIKA PADUKONE
VANNA VANNA POOKKAL	NARRATOR	BALU MAHENDRA
NONE LESS THAN HEROES: THE HONOR FLIGHT STORY	NARRATOR	GARY SINISE
POKéMON THE MOVIE: KYUREM VS. THE SWORD OF JUSTICE	NARRATOR	UNSHō ISHIZUKA
POKéMON THE MOVIE: KYUREM VS. THE SWORD OF JUSTICE	NARRATOR	RODGER PARSONS
TOKI O KAKERU SHōJO	NARRATOR	TOMOYO HARADA
CHENNAI EXPRESS	NARRATOR	SHAHRUKH KHAN
BROKE*	NARRATOR	WILL GRAY
MISS ROBIN CRUSOE	NARRATOR	AMANDA BLAKE
GREEDY LYING BASTARDS	NARRATOR	CRAIG ROSEBRAUGH
KAMEN RIDER × SUPER SENTAI: SUPER HERO TAISEN	NARRATOR	TOMOKAZU SEKI
THE PRICE OF VICTORY	NARRATOR	HENRY A. WALLACE
MARINES IN THE MAKING	NARRATOR	PETE SMITH
FIXING AMERICA	NARRATOR	STEVE LAFFEY
INGREDIENTS	NARRATOR	BEBE NEUWIRTH
PLANZET	NARRATOR	YUSAKU YARA
PRIMITIVE PEOPLES	NARRATOR	PETER FINCH
SONS OF THE ANZACS	NARRATOR	PETER FINCH
SONS OF THE ANZACS	NARRATOR	CHESTER WILMOT
SONS OF THE ANZACS	NARRATOR	DAMIEN PARER
JUNGLE PATROL	NARRATOR	PETER FINCH
LA RABBIA	NARRATOR	GIORGIO BASSANI
LA RABBIA	NARRATOR	RENATO GUTTUSO
LA RABBIA	NARRATOR	CARLO ROMANO
LA RABBIA	NARRATOR	GIGI ARTUSO
THE EYES OF THAILAND	NARRATOR	ASHLEY JUDD
THE PLUNDERERS	NARRATOR	JEFF CHANDLER
USTAD HOTEL	NARRATOR	MAMUKKOYA
THE ROAD WE'VE TRAVELED	NARRATOR	TOM HANKS
BUCK ROGERS IN THE 25TH CENTURY	NARRATOR	WILLIAM CONRAD
BLUE MONEY	NARRATOR	BOB CHINN
LUMUMBA, LA MORT D'UN PROPHèTE	NARRATOR	RAOUL PECK
THE SAINT OF FORT WASHINGTON	NARRATOR	DANNY GLOVER
STORYTIME	NARRATOR	TERRY GILLIAM
RECLAIMING THEIR VOICE: THE NATIVE AMERICAN VOTE IN NEW MEXICO & BEYOND	NARRATOR	PETER COYOTE
STEALING AMERICA: VOTE BY VOTE	NARRATOR	PETER COYOTE
MOMENT BY MOMENT: THE HEALING JOURNEY OF MOLLY HALE	NARRATOR	DOROTHY FADIMAN
SPIRIT	NARRATOR	SIDDIQUE
SPIRIT	NARRATOR	RANJITH
AN AMERICAN ROMANCE	NARRATOR	STEPHEN MCNALLY
OUT OF THE SHADOWS	NARRATOR	DONALD SUTHERLAND
WHY DO THESE KIDS LOVE SCHOOL%3F	NARRATOR	DOROTHY FADIMAN
MéTAMORPHOSE D'UNE GARE	NARRATOR	THIERRY MICHEL
AIDS IN ETHIOPIA	NARRATOR	DOROTHY FADIMAN
RUSH	NARRATOR	DANIEL BRüHL
BRITAIN AT BAY	NARRATOR	J. B. PRIESTLEY
DONKEY XOTE	NARRATOR	JORDI GONZáLEZ
TRUCK DRIVER	NARRATOR	UPASNA SINGH
TRUCK DRIVER	NARRATOR	SURINDER SHINDA
TRUCK DRIVER	NARRATOR	PREETI SAPRU
TRUCK DRIVER	NARRATOR	HARPAL TIWANA
TRUCK DRIVER	NARRATOR	SURINDER SHARMA
BEASTS OF THE SOUTHERN WILD	NARRATOR	QUVENZHANé WALLIS
THE BOY WHO OWNED A MELEPHANT	NARRATOR	TALLULAH BANKHEAD
THE SMURFS 2	NARRATOR	TOM KANE
WOMAN BY WOMAN: NEW HOPE FOR THE VILLAGES OF INDIA	NARRATOR	DOROTHY FADIMAN
NAMUKKU PARKKAN	NARRATOR	MOHANLAL
BREAKTHROUGH	NARRATOR	FRANK LOVEJOY
THE WILD BLUE YONDER	NARRATOR	WENDELL COREY
TUKARAM	NARRATOR	SACHIN KHEDEKAR
FLYING MONSTERS 3D	NARRATOR	DAVID ATTENBOROUGH
THE PENGUIN KING	NARRATOR	DAVID ATTENBOROUGH
THE PENGUIN KING	NARRATOR	TIM ALLEN
THE QUICK GUN	NARRATOR	AUDIE MURPHY
AL CAPONE	NARRATOR	JAMES GREGORY
SUMMER'S END	NARRATOR	VICTOR GARBER
THE HIT LIST	NARRATOR	MOHANLAL
MALEFICENT	NARRATOR	JANET MCTEER
TOKUMEI SENTAI GO-BUSTERS THE MOVIE: PROTECT THE TOKYO ENETOWER!	NARRATOR	SHOO MUNAKATA
ARE ALL MEN PEDOPHILES%3F	NARRATOR	JAN-WILLEM BREURE
4192: THE CROWNING OF THE HIT KING	NARRATOR	J.K. SIMMONS
A CRY IN THE NIGHT	NARRATOR	ALAN LADD
HEIST: WHO STOLE THE AMERICAN DREAM%3F	NARRATOR	THOM HARTMANN
SPACE SHERIFF GAVAN: THE MOVIE	NARRATOR	KIYOSHI KOBAYASHI
DORAEMON: NOBITA'S SECRET GADGET MUSEUM	NARRATOR	SHIORI SUZUKI
THE RISE AND FALL OF ENGLISH MONTREAL	NARRATOR	VLASTA VRáNA
THE QUEEN IN AUSTRALIA	NARRATOR	PETER FINCH
THE QUEEN IN AUSTRALIA	NARRATOR	WILFRED THOMAS
RAGINI IPS	NARRATOR	UPENDRA
ATTAKATHI	NARRATOR	PA. RANJITH
FLIGHT OF THE BUTTERFLIES	NARRATOR	MEGAN FOLLOWS
FRANK'S COCK	NARRATOR	CALLUM KEITH RENNIE
CAPTAIN NAGARJUN	NARRATOR	V. B. RAJENDRA PRASAD
HOWARD ZINN: YOU CAN'T BE NEUTRAL ON A MOVING TRAIN	NARRATOR	MATT DAMON
CHARLIE COUNTRYMAN	NARRATOR	JOHN HURT
NA NAI'A LEGEND OF THE DOLPHINS	NARRATOR	MEGAN FOX
NA NAI'A LEGEND OF THE DOLPHINS	NARRATOR	KATE WINSLET
NA NAI'A LEGEND OF THE DOLPHINS	NARRATOR	GERARD BUTLER
NA NAI'A LEGEND OF THE DOLPHINS	NARRATOR	ELLEN PAGE
NA NAI'A LEGEND OF THE DOLPHINS	NARRATOR	JAMES FRANCO
NA NAI'A LEGEND OF THE DOLPHINS	NARRATOR	ISABELLA ROSSELLINI
NA NAI'A LEGEND OF THE DOLPHINS	NARRATOR	CHEECH MARIN
NA NAI'A LEGEND OF THE DOLPHINS	NARRATOR	DARYL HANNAH
NA NAI'A LEGEND OF THE DOLPHINS	NARRATOR	DIEGO LUNA
NA NAI'A LEGEND OF THE DOLPHINS	NARRATOR	JULIAN LENNON
NA NAI'A LEGEND OF THE DOLPHINS	NARRATOR	WHOOPI GOLDBERG
PUTHAGAM	NARRATOR	RJ BALAJI
THE PARTY'S OVER	NARRATOR	PHILIP SEYMOUR HOFFMAN
EAGLE SQUADRON	NARRATOR	QUENTIN REYNOLDS
BOMGAY	NARRATOR	RAJIT KAPUR
THE PRICE OF KINGS	NARRATOR	HELENA BONHAM CARTER
THE HOBBIT	NARRATOR	ZINOVY GERDT
COLDPLAY LIVE 2012	NARRATOR	GUY BERRYMAN
COLDPLAY LIVE 2012	NARRATOR	JONNY BUCKLAND
COLDPLAY LIVE 2012	NARRATOR	WILL CHAMPION
COLDPLAY LIVE 2012	NARRATOR	CHRIS MARTIN
AUSTRALIA AFTER DARK	NARRATOR	HAYES GORDON
THE ABC OF LOVE AND SEX: AUSTRALIA STYLE	NARRATOR	SANDY GORE
UMAR	NARRATOR	ANUPAM KHER
LE SOLITAIRE	NARRATOR	JEAN-PAUL BELMONDO
RACE GURRAM	NARRATOR	SUNIL
THE DIARIES OF VASLAV NIJINSKY	NARRATOR	DEREK JACOBI
THE DUST BOWL	NARRATOR	PETER COYOTE
MEA MAXIMA CULPA: SILENCE IN THE HOUSE OF GOD	NARRATOR	ALEX GIBNEY
HOUSOS VS. AUTHORITY	NARRATOR	RUSSELL GILBERT
HEALERS OF THE DEAD SEA	NARRATOR	JOHN MARCO ALLEGRO
TED 2	NARRATOR	PATRICK STEWART
GHAZI SHAHEED	NARRATOR	ZIA MOHYEDDIN
BADE DILWALA	NARRATOR	SACHIN KHEDEKAR
THE UPSETTER	NARRATOR	BENICIO DEL TORO
MEDITERRANEAN HOLIDAY	NARRATOR	HANS CLARIN
BREAKING THE TABOO	NARRATOR	MORGAN FREEMAN
BREAKING THE TABOO	NARRATOR	GAEL GARCíA BERNAL
CRUISE OF THE ZACA	NARRATOR	ERROL FLYNN
24 X 24: WIDE OPEN WITH JEFF GORDON	NARRATOR	PATRICK DEMPSEY
POKéMON THE MOVIE: GENESECT AND THE LEGEND AWAKENED	NARRATOR	UNSHō ISHIZUKA
KING OF THE RAILWAY	NARRATOR	MARK MORAGHAN
NITRO CIRCUS: THE MOVIE	NARRATOR	TRAVIS PASTRANA
ANNAYUM RASOOLUM	NARRATOR	SUNNY WAYNE
NOBODY'S DAUGHTER HAEWON	NARRATOR	JUNG EUN-CHAE
FEMMES AUX YEUX OUVERTS	NARRATOR	ANNE-LAURE FOLLY
SARAH MALDOROR OU LA NOSTALGIE DE L'UTOPIE	NARRATOR	ANNE-LAURE FOLLY
FLORENCE: DAYS OF DESTRUCTION	NARRATOR	RICHARD BURTON
PALMERA	NARRATOR	ÉRICA GARCíA
PAUL BUNYAN	NARRATOR	PARLEY BAER
ETHOS	NARRATOR	WOODY HARRELSON
SANS LAISSER DE TRACES	NARRATOR	BENOîT MAGIMEL
D FOR DOPIDI	NARRATOR	NANI
NEFARIOUS: MERCHANT OF SOULS	NARRATOR	BENJAMIN NOLOT
TEACHING TO SEE	NARRATOR	INGE DRUCKREY
HANSEL AND GRETEL	NARRATOR	PAUL TRIPP
PK	NARRATOR	ANUSHKA SHARMA
KUROSAWA'S WAY	NARRATOR	CATHERINE CADOU
DIRTY WARS	NARRATOR	JEREMY SCAHILL
KAMEN RIDER × SUPER SENTAI × SPACE SHERIFF: SUPER HERO TAISEN Z	NARRATOR	TOMOKAZU SEKI
THE OUTER SPACE CONNECTION	NARRATOR	ROD SERLING
MY FATHER EVGENI	NARRATOR	ANDREI ZAGDANSKY, ALEXANDER GELMAN
AFRICAN INDEPENDENCE	NARRATOR	TUKUFU ZUBERI
BEARS AND MAN	NARRATOR	CHIEF DAN GEORGE, PATRICIA BEST
SEX IN A COLD CLIMATE	NARRATOR	DERVLA KIRWAN
LES OUBLIéES	NARRATOR	ANNE-LAURE FOLLY
GUNDAY	NARRATOR	IRRFAN KHAN
LINSANITY	NARRATOR	DANIEL DAE KIM
GIRLFRIEND IN A COMA	NARRATOR	BILL EMMOTT
DEATH OF APARTHEID	NARRATOR	ALLISTER SPARKS
MINIONS	NARRATOR	GEOFFREY RUSH
REVOLUTION	NARRATOR	ROB STEWART
KNIGHT OF CUPS	NARRATOR	BEN KINGSLEY
THE END OF TIME	NARRATOR	PETER METTLER
HAPPY NEW YEAR	NARRATOR	SHAHRUKH KHAN
BOSS	NARRATOR	AMITABH BACHCHAN
THE OTHER SIDE OF BONNIE AND CLYDE	NARRATOR	BURL IVES
STATE PENITENTIARY	NARRATOR	LEO CLEARY
DANGEROUS EDGE: A LIFE OF GRAHAM GREENE	NARRATOR	DEREK JACOBI
PULLIPULIKALUM AATTINKUTTIYUM	NARRATOR	SREENIVASAN
TALES FROM THE ORGAN TRADE	NARRATOR	DAVID CRONENBERG
JAGADGURU ADI SHANKARA	NARRATOR	CHIRANJEEVI
THE DIARY OF A SLUMLORD	NARRATOR	MATT REAVES
KILLING TIME	NARRATOR	TOM CONTI
BEARS	NARRATOR	JOHN C. REILLY
VOYAGE TO THE EDGE OF THE WORLD	NARRATOR	JACQUES-YVES COUSTEAU AND PHILIPPE COUSTEAU
GENGHIS KHAN	NARRATOR	TONY CRUZ
GENGHIS KHAN	NARRATOR	JAMES AGEE
WHEN THE GIRLS TAKE OVER	NARRATOR	JOHN CONTE
AN APOLOGY TO ELEPHANTS	NARRATOR	LILY TOMLIN
THE BOOK THIEF	NARRATOR	ROGER ALLAM
SIRIUS	NARRATOR	THOMAS JANE
BIG TOWN CZAR	NARRATOR	ED SULLIVAN
JUSTIN AND THE KNIGHTS OF VALOUR	NARRATOR	FREDDIE HIGHMORE
JUSTIN AND THE KNIGHTS OF VALOUR	NARRATOR	JAMES COSMO
UFO	NARRATOR	LES TREMAYNE
1987	NARRATOR	RICARDO TROGI
THE MISSING PICTURE	NARRATOR	RANDAL DOUC
THE MISSING PICTURE	NARRATOR	JEAN-BAPTISTE PHOU
UNDER THE DOME	NARRATOR	CHAI JING
LE JOLI MAI	NARRATOR	YVES MONTAND
LE JOLI MAI	NARRATOR	SIMONE SIGNORET
THAKAZHI	NARRATOR	M. T. VASUDEVAN NAIR
THE GHOST ARMY	NARRATOR	PETER COYOTE
THE SECRET HISTORY OF HACKING	NARRATOR	QARIE MARSHALL
DEAR JACK	NARRATOR	TOMMY LEE
ARYAN	NARRATOR	SUDEEP
SIMPLY KAILAWESOME	NARRATOR	SRINAGAR KITTY
CLINTON	NARRATOR	CAMPBELL SCOTT
DREAMING OF LORDS	NARRATOR	ERNIE DINGO
FINDING FANNY	NARRATOR	DEEPIKA PADUKONE
REFUGEE	NARRATOR	RISHABH PRASAD
PORICHOI	NARRATOR	PROSENJIT CHATTERJEE
LOS GRINGOS	NARRATOR	JOHN LEADER
LETTERS TO ALI	NARRATOR	MATT DAMON
ETHNIC NOTIONS	NARRATOR	ESTHER ROLLE
HIDDEN UNIVERSE 3D	NARRATOR	MIRANDA RICHARDSON
ZYUDEN SENTAI KYORYUGER: GABURINCHO OF MUSIC	NARRATOR	SHIGERU CHIBA
CINDERELLA	NARRATOR	HELENA BONHAM CARTER
TERMS AND CONDITIONS MAY APPLY	NARRATOR	CULLEN HOBACK
THE ARMSTRONG LIE	NARRATOR	ALEX GIBNEY
NOT MY LIFE	NARRATOR	GLENN CLOSE
LE BONHEUR DE PIERRE	NARRATOR	PIERRE RICHARD
THE INBETWEENERS 2	NARRATOR	SIMON BIRD
SHRAVANI SUBRAMANYA	NARRATOR	SUDEEP
INTO THE WOODS	NARRATOR	JAMES CORDEN
CITIZEN KANE TRAILER	NARRATOR	ORSON WELLES
A MILLION WAYS TO DIE IN THE WEST	NARRATOR	REX LINN
MONEY FOR NOTHING: INSIDE THE FEDERAL RESERVE	NARRATOR	LIEV SCHREIBER
JERUSALEM	NARRATOR	BENEDICT CUMBERBATCH
RETURN TO NUKE 'EM HIGH VOLUME 1	NARRATOR	STAN LEE
O TERI	NARRATOR	SALMAN KHAN
AN OBSOLETE ALTAR	NARRATOR	RABINDRANATH TAGORE
BLAZE BUSTERS	NARRATOR	DWIGHT WEIST
RED OBSESSION	NARRATOR	RUSSELL CROWE
PEPSI MAX & JEFF GORDON PRESENT: TEST DRIVE	NARRATOR	JEFF GORDON
SON OF GOD	NARRATOR	SEBASTIAN KNAPP
LONDON IN THE RAW	NARRATOR	DAVID GELL
REDLIGHT	NARRATOR	LUCY LIU
THE SHOOTER	NARRATOR	ANDREW STEVENS
SECRETPROJECTREVOLUTION	NARRATOR	MADONNA
GENERATION IRON	NARRATOR	MICKEY ROURKE
THE PATHFINDER	NARRATOR	MICHAEL FOX
THE KILLING OF AMERICA	NARRATOR	CHUCK RILEY
MAFIA	NARRATOR	RANJIT MALLICK
FIRE IN THE BLOOD	NARRATOR	WILLIAM HURT
THE XPOSé	NARRATOR	IRRFAN KHAN
BEYOND BEAUTY: TAIWAN FROM ABOVE	NARRATOR	WU NIEN-JEN
LAST CLEAR CHANCE	NARRATOR	WILLIAM BOYETT
CEYLON	NARRATOR	ARVIND SWAMY
SEEING IS BELIEVING: HANDICAMS, HUMAN RIGHTS AND THE NEWS	NARRATOR	KATERINA CIZEK
THE HIGHWAYMAN	NARRATOR	BRIAN AHERNE
THE END OF PINKY	NARRATOR	HEATHER O'NEILL
THE END OF PINKY	NARRATOR	MARC-ANDRé GRONDIN
I THINK THEY CALL HIM JOHN	NARRATOR	VICTOR SPINETTI
I THINK THEY CALL HIM JOHN	NARRATOR	BESSIE LOVE
THE VISION OF PAOLO SOLERI: PROPHET IN THE DESERT	NARRATOR	JP WHITE
POKéMON THE MOVIE: DIANCIE AND THE COCOON OF DESTRUCTION	NARRATOR	UNSHō ISHIZUKA
ON THE SHOULDERS OF GIANTS	NARRATOR	KAREEM ABDUL JABAAR
ON THE SHOULDERS OF GIANTS	NARRATOR	JAMIE FOXX
MEN, WOMEN & CHILDREN	NARRATOR	EMMA THOMPSON
UNDER THE PAVEMENT LIES THE STRAND	NARRATOR	HELMA SANDERS-BRAHMS
WISCONSIN DEATH TRIP	NARRATOR	IAN HOLM
I KNOW THAT VOICE	NARRATOR	JOHN DIMAGGIO
MAIN TERA HERO	NARRATOR	SALMAN KHAN
SKUM ROCKS!	NARRATOR	ALICE COOPER
COOPER & HEMINGWAY: THE TRUE GEN	NARRATOR	SAM WATERSTON
COOPER & HEMINGWAY: THE TRUE GEN	NARRATOR	LEN CARIOU
BANGALORE DAYS	NARRATOR	NIVIN PAULY
TALE OF THE BRAVE	NARRATOR	MARK MORAGHAN
THE THIN BLUE LINE	NARRATOR	VAN HEFLIN
THE BOLD MEN	NARRATOR	VAN HEFLIN
MAYHEM ON A SUNDAY AFTERNOON	NARRATOR	VAN HEFLIN
CLUB HAVANA	NARRATOR	TOM NEAL
DIVORCE CORP	NARRATOR	DREW PINSKY
THE LADY IN NUMBER 6	NARRATOR	MALCOLM CLARKE
THE DARK STAIRWAY	NARRATOR	EDGAR LUSTGARTEN
VANIUSHA THE NEWCOMER	NARRATOR	VSEVOLOD LARIONOV
VANIUSHA AND THE SPACE PIRATE	NARRATOR	VSEVOLOD LARIONOV
VANIUSHA AND THE GIANT	NARRATOR	VSEVOLOD LARIONOV
MEN OF BURDEN: PEDALING TOWARDS A HORIZON	NARRATOR	DOMENIC ROMANO
DIL DHADAKNE DO	NARRATOR	AAMIR KHAN
5000 DAYS PROJECT	NARRATOR	RICK STEVENSON
FLAME OF CALCUTTA	NARRATOR	FRED F. SEARS
TO THE ARCTIC 3D	NARRATOR	MERYL STREEP
JOURNEY TO THE SOUTH PACIFIC	NARRATOR	CATE BLANCHETT
THE LIFE AND TIMES OF XAVIERA HOLLANDER	NARRATOR	XAVIERA HOLLANDER
OPERATION MALAYA	NARRATOR	CHIPS RAFFERTY
OPERATION MALAYA	NARRATOR	JOHN HUMPHREY
OPERATION MALAYA	NARRATOR	JOHN SLATER
OPERATION MALAYA	NARRATOR	WYNFORD VAUGHAN-THOMAS
PARTICLE FEVER	NARRATOR	DAVID KAPLAN
MANUAL OF LOVE 2	NARRATOR	CLAUDIO BISIO
HOW HITLER LOST THE WAR	NARRATOR	NORMAN ROSE
REY	NARRATOR	RAM POTHINENI
HOLLYWOOD'S MAGICAL ISLAND: CATALINA	NARRATOR	PETER COYOTE
HANGOVER	NARRATOR	PROSENJIT CHATTERJEE
TIME STOOD STILL	NARRATOR	MARVIN MILLER
BAJIRAO MASTANI	NARRATOR	IRRFAN KHAN
THE NUTCRACKER	NARRATOR	KEVIN KLINE
NASHVILLE RISES	NARRATOR	BILLY BOB THORNTON
MALLA	NARRATOR	VISHNUVARDHAN
THE SECOND GAME	NARRATOR	CORNELIU PORUMBOIU
THE SECOND GAME	NARRATOR	ADRIAN PORUMBOIU
O SATYAMURTHY	NARRATOR	ALLU ARJUN
FED UP	NARRATOR	KATIE COURIC
AMERICAN TEACHER	NARRATOR	MATT DAMON
LAN KWAI FONG 3	NARRATOR	CHRISTINE NG
IYOBINTE PUSTHAKAM	NARRATOR	T. G. RAVI
MONKEY KINGDOM	NARRATOR	TINA FEY
CONCERNING VIOLENCE	NARRATOR	SWEDISH RELEASE:
CONCERNING VIOLENCE	NARRATOR	KATI OUTINEN
CONCERNING VIOLENCE	NARRATOR	ENGLISH RELEASE:
CONCERNING VIOLENCE	NARRATOR	LAURYN HILL
GAJAKESARI	NARRATOR	PRAKASH RAJ
THE RETURN OF DON CAMILLO	NARRATOR	EMILIO CIGOLI
TWENTY YEARS LATER	NARRATOR	FERREIRA GULLAR
TWENTY YEARS LATER	NARRATOR	TITE DE LEMOS
PICKET 43	NARRATOR	MOHANLAL
SHAGOON	NARRATOR	WAHEEDA REHMAN
SHAGOON	NARRATOR	KAMALJIT
UNDERWATER DREAMS	NARRATOR	MICHAEL PEñA
LISTEN UP PHILIP	NARRATOR	ERIC BOGOSIAN
1	NARRATOR	MICHAEL FASSBENDER
AADAMA JAICHOMADA	NARRATOR	SHIVA
THE SHORT GAME	NARRATOR	EDD HALL
HAIL, CAESAR!	NARRATOR	MICHAEL GAMBON
OPéRA IMAGINAIRE	NARRATOR	JAMES SMILLIE
ONE NIGHT IN TURIN	NARRATOR	GARY OLDMAN
THE BOSS BABY	NARRATOR	TOBEY MAGUIRE
AXEL: THE BIGGEST LITTLE HERO	NARRATOR	ED ASNER
SAVAGE PAMPAS	NARRATOR	ENRIQUE MUIñO
THE AMAZING PRAYBEYT BENJAMIN	NARRATOR	ALJON MOYOUNG JENNER
BUY THE TICKET, TAKE THE RIDE: HUNTER S. THOMPSON ON FILM	NARRATOR	NICK NOLTE
THE HATEFUL EIGHT	NARRATOR	QUENTIN TARANTINO
VIDEO GAMES: THE MOVIE	NARRATOR	SEAN ASTIN
ENNU NINTE MOIDEEN	NARRATOR	SUDHEER KARAMANA
PASOLINI	NARRATOR	LUCA LIONELLO
GIMME THE POWER	NARRATOR	OLALLO RUBIO
50 CHILDREN: THE RESCUE MISSION OF MR. AND MRS. KRAUS	NARRATOR	ALAN ALDA
SCHOOL FOR DANGER	NARRATOR	HARRY RéE
SCHOOL FOR DANGER	NARRATOR	JACQUELINE NEARNE
THE NIGHT BEFORE	NARRATOR	TRACY MORGAN
ARASURI MAA AMBE	NARRATOR	AMITABH BACHCHAN
BAHADDUR	NARRATOR	PUNEETH RAJKUMAR
NOW — THE PEACE	NARRATOR	LORNE GREENE
KICK 2	NARRATOR	SUNIL
THE JUNGLE BOOK	NARRATOR	BEN KINGSLEY
MIND MELD	NARRATOR	BILLY WEST
RICKY	NARRATOR	SUDEEP
MULBERRY CHILD	NARRATOR	JACQUELINE BISSET
BABY	NARRATOR	DANNY DENZONGPA
MAHABALIPURAM	NARRATOR	SATHYARAJ
INDIA SPEAKS	NARRATOR	RICHARD HALLIBURTON
ISLAND OF LEMURS: MADAGASCAR	NARRATOR	MORGAN FREEMAN
ADVENTURE GIRL	NARRATOR	JOAN LOWELL
AAMAYUM MUYALUM	NARRATOR	MOHANLAL
ACTION HERO BIJU	NARRATOR	LAL JOSE
THE WILD NATION	NARRATOR	* EVELYNE DRESS\N* GéRARD FALCONETTI\N* MYRIAM MéZIERES
THE GOLDEN TWENTIES	NARRATOR	FREDERICK LEWIS ALLEN
THE GOLDEN TWENTIES	NARRATOR	ROBERT Q. LEWIS
THE GOLDEN TWENTIES	NARRATOR	ALLEN PRESCOTT
THE GOLDEN TWENTIES	NARRATOR	RED BARBER
THE GOLDEN TWENTIES	NARRATOR	ELMER DAVIS
PUMP	NARRATOR	JASON BATEMAN
UNDER THE RED SEA	NARRATOR	LES TREMAYNE
BELOW THE SAHARA	NARRATOR	ARMAND DENIS
ONE LITTLE PILL	NARRATOR	CLAUDIA CHRISTIAN
AFRICA ADVENTURE	NARRATOR	ROBERT C. RUARK
VELLIMOONGA	NARRATOR	LAL JOSE
THE DEFENDER	NARRATOR	CEDRIC SMITH
WINGS ON HER SHOULDER	NARRATOR	LORNE GREENE
THE GRACE LEE PROJECT	NARRATOR	GRACE LEE
KALI THE LITTLE VAMPIRE	NARRATOR	CHRISTOPHER PLUMMER
KALI THE LITTLE VAMPIRE	NARRATOR	FERNANDO LOPES
SECRETS OF LIFE	NARRATOR	WINSTON HIBLER
JUNGLE CAT	NARRATOR	WINSTON HIBLER
KING OF THE GRIZZLIES	NARRATOR	WINSTON HIBLER
RUN, COUGAR, RUN	NARRATOR	IAN TYSON
HAGGADA KONE	NARRATOR	SUDEEP
TITANICA	NARRATOR	LEONARD NIMOY
TITANICA	NARRATOR	CEDRIC SMITH
WHY HORROR%3F	NARRATOR	ELIJAH WOOD
WEST END JUNGLE	NARRATOR	DAVID GELL
NUDES OF THE WORLD	NARRATOR	VALERIE SINGLETON
NUDIST MEMORIES	NARRATOR	JILL GASCOINE
AADU	NARRATOR	MAMUKKOYA
CHAAR SAHIBZAADE	NARRATOR	OM PURI
PULI	NARRATOR	NIZHALGAL RAVI
IT'S A BARE, BARE WORLD!	NARRATOR	MONICA SCOTT
THE NAKED WORLD OF HARRISON MARKS	NARRATOR	VALENTINE DYALL
TINKER BELL AND THE LEGEND OF THE NEVERBEAST	NARRATOR	GREY DELISLE
THE REVELATION OF THE PYRAMIDS	NARRATOR	BRIAN COX
BLUE GOLD: AMERICAN JEANS	NARRATOR	EDWARD BURNS
CANTA Y NO LLORES...	NARRATOR	IRMA VILA
THE WHALE	NARRATOR	RYAN REYNOLDS
LEïLA	NARRATOR	MICHEL BOUQUET
AAO WISH KAREIN	NARRATOR	SHAH RUKH KHAN
SHADOWS OF LIBERTY	NARRATOR	KERRY SHALE
TENCHI: THE SAMURAI ASTRONOMER	NARRATOR	HIROYUKI SANADA
GERMAN CONCENTRATION CAMPS FACTUAL SURVEY	NARRATOR	JASPER BRITTON
POKéMON THE MOVIE: HOOPA AND THE CLASH OF AGES	NARRATOR	UNSHō ISHIZUKA
NIGHT WILL FALL	NARRATOR	HELENA BONHAM CARTER
A DANCER'S LIFE	NARRATOR	WILLIAM RICHERT
LOVE THE COOPERS	NARRATOR	STEVE MARTIN
THOMAS & FRIENDS: THE ADVENTURE BEGINS	NARRATOR	MARK MORAGHAN
ME AND MY MOULTON	NARRATOR	ANDREA BRæIN HOVIG
THE HUNTSMAN: WINTER'S WAR	NARRATOR	LIAM NEESON
THE PRIME MINISTERS: THE PIONEERS	NARRATOR	YEHUDA AVNER
CHIRAKODINJA KINAVUKAL	NARRATOR	LAL JOSE
CHIRAKODINJA KINAVUKAL	NARRATOR	SREENIVASAN
THE 400 MILLION	NARRATOR	FREDERIC MARCH
THE DAM KEEPER	NARRATOR	LARS MIKKELSEN
SODOR'S LEGEND OF THE LOST TREASURE	NARRATOR	MARK MORAGHAN
PATTERNS OF EVIDENCE	NARRATOR	KEVIN SORBO
THE ELEPHANT IN THE ROOM	NARRATOR	VIRGINIA MCKENNA
SUPER HERO TAISEN GP: KAMEN RIDER 3	NARRATOR	TOMOKAZU SEKI
CHESTY: A TRIBUTE TO A LEGEND	NARRATOR	JOHN WAYNE
SCHOOLED: THE PRICE OF COLLEGE SPORTS	NARRATOR	SAM ROCKWELL
THE FEARLESS FOUR	NARRATOR	*
THE FEARLESS FOUR	NARRATOR	KLAUSJüRGEN WUSSOW
THE FEARLESS FOUR	NARRATOR	CHRISTOPHER GAZE
DODDMANE HUDGA	NARRATOR	SHIVA RAJKUMAR
GHOSTS OF PORT ARTHUR	NARRATOR	BERT BAILEY
FIGHTING BLOOD	NARRATOR	LLOYD BERRELL
FRACKMAN	NARRATOR	DAYNE PRATZKY
BANGALORE NAATKAL	NARRATOR	BOBBY SIMHA
THE GREAT DOME ROBBERY	NARRATOR	ALAN FORD
MY ITALIAN SECRET: THE FORGOTTEN HEROES	NARRATOR	ISABELLA ROSSELLINI
MY ITALIAN SECRET: THE FORGOTTEN HEROES	NARRATOR	ROBERT LOGGIA
LOVE THY NATURE	NARRATOR	LIAM NEESON
KUNJIRAMAYANAM	NARRATOR	BIJU MENON
MATERIAL OF THE FUTURE	NARRATOR	ALEC BALDWIN
BEFORE VANISHING	NARRATOR	JOUDE GORANI
A BALLERINA'S TALE	NARRATOR	MISTY COPELAND
EVERYDAY SUNSHINE: THE STORY OF FISHBONE	NARRATOR	LAURENCE FISHBURNE
NOWHERE TO RUN	NARRATOR	ALLEN GARFIELD
TOURING TALKIES	NARRATOR	VINAY APTE
MISS AMERICA	NARRATOR	CHERRY JONES
ORU SECOND CLASS YATHRA	NARRATOR	PRITHVIRAJ SUKUMARAN
BRING OUT A BRITON	NARRATOR	CHIPS RAFFERTY
RESTRUNG	NARRATOR	RANDY FULLMER
VILAINE	NARRATOR	JEAN-CLAUDE DREYFUS
WOMEN OF THE WORLD	NARRATOR	STEFANO SIBALDI
WOMEN OF THE WORLD	NARRATOR	PETER USTINOV
GAME	NARRATOR	R. PARTHIBAN
MOTHER'S DAY	NARRATOR	PENNY MARSHALL
THE BEST OF WALT DISNEY'S TRUE-LIFE ADVENTURES	NARRATOR	WINSTON HIBLER
THE OLYMPIC ELK	NARRATOR	WINSTON HIBLER
KANAL	NARRATOR	PRITHVIRAJ SUKUMARAN
JUST, MELVIN: JUST EVIL	NARRATOR	JAMES RONALD WHITNEY
UNSEEN ENEMY	NARRATOR	HUGH BEAUMONT
PROWLERS OF THE EVERGLADES	NARRATOR	WINSTON HIBLER
CAFé SOCIETY	NARRATOR	WOODY ALLEN
WHERE TO INVADE NEXT	NARRATOR	MICHAEL MOORE
A LEGO BRICKUMENTARY	NARRATOR	JASON BATEMAN
STYLE	NARRATOR	LAL
NOTHING BUT THE BLUES	NARRATOR	ERIC CLAPTON
LIFE OF JOSUTTY	NARRATOR	DILEEP
THE MAN WHO DROWNED HIS SORROWS	NARRATOR	ZULASHRAF ABD RAHMAN
JANIS: LITTLE GIRL BLUE	NARRATOR	CAT POWER
TO KILL A CHILD	NARRATOR	STELLAN SKARSGåRD
HOW TO CHANGE THE WORLD	NARRATOR	BARRY PEPPER
THIS CHANGES EVERYTHING	NARRATOR	NAOMI KLEIN
NOTORIOUS	NARRATOR	JAMAL WOOLARD
VIOLATED PARADISE	NARRATOR	PAULETTE GIRARD
VIOLATED PARADISE	NARRATOR	TOM ROWE
THOMAS & FRIENDS: THE GREAT RACE	NARRATOR	MARK MORAGHAN
JIL JUNG JUK	NARRATOR	SIDDHARTH
ALTAIR	NARRATOR	ARNOLDO FOà
OUTLAWED IN PAKISTAN	NARRATOR	HABIBA NOSHEEN
SHOUT GLADI GLADI	NARRATOR	MERYL STREEP
THE STORY OF THE TORTOISE & THE HARE	NARRATOR	GARY OWENS
FAREWELL HERR SCHWARZ	NARRATOR	YAEL REUVENY
NOTHING BY CHANCE	NARRATOR	HUGH DOWNS
SINK OR SWIM	NARRATOR	JESSICA MEYERSON
ULTRAMAN X: HERE IT COMES! OUR ULTRAMAN	NARRATOR	YASUNORI MATSUMOTO
PARALLELS, EVENTS, PEOPLE	NARRATOR	NATELLA BOLTYANSKAYA
AADUPULIYATTAM	NARRATOR	SIDDIQUE
STARK ELECTRIC JESUS	NARRATOR	MALAY ROY CHOUDHURY
FLIGHT 6	NARRATOR	LORNE GREENE
GLOBAL AIR ROUTES	NARRATOR	LORNE GREENE
TRANSPACIFIC FLIGHT	NARRATOR	FRED DAVIS
NAVARASA THILAGAM	NARRATOR	VIMAL
CHALLENGER: AN INDUSTRIAL ROMANCE	NARRATOR	STEPHEN LOW
WINGS OF YOUTH	NARRATOR	LORNE GREENE
DEATH BY MOONLIGHT: BOMBER COMMAND	NARRATOR	TERENCE MCKENNA
FERRY PILOT	NARRATOR	LORNE GREENE
A BEAUTIFUL PLANET	NARRATOR	JENNIFER LAWRENCE
WINGS OF A CONTINENT	NARRATOR	LORNE GREENE
ATLANTIC PATROL	NARRATOR	LORNE GREENE
OUR NORTHERN NEIGHBOUR	NARRATOR	LORNE GREENE
DYING TO DO LETTERMAN	NARRATOR	STEVE MAZAN
TARGET - BERLIN	NARRATOR	LORNE GREENE
EVERYWHERE IN THE WORLD	NARRATOR	LORNE GREENE
PINCERS ON JAPAN	NARRATOR	LORNE GREENE
LOOK TO THE NORTH	NARRATOR	LORNE GREENE
BORN IN CHINA	NARRATOR	ZHOU XUN
BORN IN CHINA	NARRATOR	JO FROST
THE HOME FRONT	NARRATOR	LORNE GREENE
WOMEN ARE WARRIORS	NARRATOR	LORNE GREENE
GUARDS OF THE NORTH	NARRATOR	LORNE GREENE
THE BATTLE OF BRAINS	NARRATOR	LORNE GREENE
U.N.R.R.A. PRESENTS IN THE WAKE OF THE ARMIES ...	NARRATOR	LORNE GREENE
HELLO NAMASTHE	NARRATOR	SURAJ VENJARAMOODU
KAMEN RIDER 1	NARRATOR	TOMOKAZU SEKI
INSIDE FIGHTING CANADA	NARRATOR	LORNE GREENE
99.9 FM	NARRATOR	SHAWAR ALI
THE FRONT OF STEEL	NARRATOR	LORNE GREENE
INSIDE FIGHTING RUSSIA	NARRATOR	LORNE GREENE
WANDERERS	NARRATOR	CARL SAGAN
THE WAR IS OVER	NARRATOR	LORNE GREENE
DALAI LAMA AWAKENING	NARRATOR	HARRISON FORD
WHEN ELEPHANTS WERE YOUNG	NARRATOR	WILLIAM SHATNER
THE BATTLE FOR OIL	NARRATOR	LORNE GREENE
LETTER FROM ALDERSHOT	NARRATOR	LORNE GREENE
CADET HOLIDAY	NARRATOR	JOHN DRAINIE
BREAK-THROUGH	NARRATOR	LORNE GREENE
HEROES OF THE ATLANTIC	NARRATOR	LORNE GREENE
WINTERHAWK	NARRATOR	DAWN WELLS
WOUNDED IN ACTION	NARRATOR	LORNE GREENE
LETTER FROM CAMP BORDEN	NARRATOR	LORNE GREENE
SOLDIERS ALL	NARRATOR	LORNE GREENE
THE GATES OF ITALY	NARRATOR	LORNE GREENE
TRANS-CANADA EXPRESS	NARRATOR	LORNE GREENE
BACK TO JOBS	NARRATOR	LORNE GREENE
THE VOICE OF ACTION	NARRATOR	LORNE GREENE
SQUADRON 992	NARRATOR	LIONEL GAMLIN
THE CHILDREN FROM OVERSEAS	NARRATOR	LORNE GREENE
THE WAR FOR MEN'S MINDS	NARRATOR	LORNE GREENE
LETTER FROM OVERSEAS	NARRATOR	LORNE GREENE
FOOD - WEAPON OF CONQUEST	NARRATOR	LORNE GREENE
TRACEROUTE	NARRATOR	JOHANNES GRENZFURTHNER
PINCER ON AXIS EUROPE	NARRATOR	LORNE GREENE
QUEBEC – PATH OF CONQUEST	NARRATOR	LORNE GREENE
BOMBING THE NAZIS	NARRATOR	LIONEL GAMLIN
WHEN ASIA SPEAKS	NARRATOR	LORNE GREENE
HEADLINE HUNTERS	NARRATOR	*
HEADLINE HUNTERS	NARRATOR	LORNE GREENE
HEADLINE HUNTERS	NARRATOR	* TOMMY TWEED
ROAD TO THE REICH	NARRATOR	LORNE GREENE
GATEWAY TO ASIA	NARRATOR	LORNE GREENE
JAMES DEAN: THE FIRST AMERICAN TEENAGER	NARRATOR	STACY KEACH
ZERO HOUR	NARRATOR	LORNE GREENE
ALL THE WAY TO THE OCEAN	NARRATOR	MARCIA CROSS
AIR CADETS	NARRATOR	LORNE GREENE
POKéMON THE MOVIE: VOLCANION AND THE MECHANICAL MARVEL	NARRATOR	UNSHō ISHIZUKA
THE GUNFIGHTER	NARRATOR	NICK OFFERMAN
STRONGHOLD	NARRATOR	OLALLO RUBIO GANDARA
SAATANAN RADIKAALIT	NARRATOR	LEO JOKELA
CLIMATE HUSTLE	NARRATOR	MARC MORANO
THE SHAKERS	NARRATOR	TOM DAVENPORT
WOLVES AT OUR DOOR	NARRATOR	RICHARD KILEY
DEATH IN THE DESERT	NARRATOR	MICHAEL MADSEN
SPIDER-MAN	NARRATOR	DONALD F. GLUT
AIR STRIKE	NARRATOR	RICHARD DENNING
HAROLD OF ORANGE	NARRATOR	CHARLIE HILL
SECRETS OF THE GODS	NARRATOR	WILLIAM
1964	NARRATOR	OLIVER PLATT
HOW TO BE ALONE	NARRATOR	RAMI BARUCH
TOO LATE	NARRATOR	DANIèLE HUILLET
TOO LATE	NARRATOR	BAHGAT ELNADI
TOO LATE	NARRATOR	GéRARD SAMAAN
JOURNEY TO SPACE	NARRATOR	PATRICK STEWART
HIGHWAY OF TEARS	NARRATOR	NATHAN FILLION
PAULINE HANSON: PLEASE EXPLAIN!	NARRATOR	TARA MORICE
WE ARE THE LAMBETH BOYS	NARRATOR	?REF =TTFC FC CL T1
BATMAN: RETURN OF THE CAPED CRUSADERS	NARRATOR	JEFF BERGMAN
BYOMKESH O CHIRIYAKHANA	NARRATOR	SASWATA CHATTOPADHYAY
THE NEVERENDING STORY	NARRATOR	ALAN OPPENHEIMER
WEEDS ON FIRE	NARRATOR	JAN LAMB
IN SEARCH OF HISTORIC JESUS	NARRATOR	BRAD CRANDALL
L'CHAYIM, COMRADE STALIN!	NARRATOR	RON PERLMAN
DENNIS RODMAN'S BIG BANG IN PYONGYANG	NARRATOR	MATT COOPER
THE HURT BUSINESS	NARRATOR	KEVIN COSTNER
VANGAVEETI	NARRATOR	RAM GOPAL VARMA
