STATE COUNCIL OF THE PEOPLE'S REPUBLIC OF CHINA	NATIVENAMER	ZHōNGHUá RéNMíN GòNGHéGUó GUóWùYUàN
MINISTRY OF INTERNAL AFFAIRS	NATIVENAMER	MINISTERSTVO VNUTRENNIH DEL ROSSIJSKOJ FEDERACII
CHARLES DE GAULLE AIRPORT	NATIVENAMER	(ROISSY AIRPORT)
INDIRA GANDHI INTERNATIONAL AIRPORT	NATIVENAMER	( IṅDIRā GāṅDHī AṅTARRāṣṭRīYA HAVāī Aḍḍā )
MACAU INTERNATIONAL AIRPORT	NATIVENAMER	OUMùHN GWOKJAI GēICHèUHNG
BAGHDAD INTERNATIONAL AIRPORT	NATIVENAMER	MATAR BAġDāD AD-DOWALY
INCHEON INTERNATIONAL AIRPORT	NATIVENAMER	INCHEON GUKJE GONGHANG
KANSAI INTERNATIONAL AIRPORT	NATIVENAMER	KANSAI KOKUSAI KūKō
CENTRAL MILITARY COMMISSION	NATIVENAMER	ZHōNGGUó GòNGCHǎNDǎNG ZHōNGYāNG JūNSHì WěIYUáNHUì
CENTRAL MILITARY COMMISSION	NATIVENAMER	ZHōNGHUá RéNMíN GòNGHéGUó ZHōNGYāNG JūNSHì WěIYUáNHUì
NATIONAL PUBLIC SAFETY COMMISSION	NATIVENAMER	KOKKA KōAN IINKAI
MAIN INTELLIGENCE DIRECTORATE	NATIVENAMER	Главное Разведывательное Управление
TAOYUAN INTERNATIONAL AIRPORT	NATIVENAMER	TáIWāN TáOYUáN GúOJì JīCHǎNG
TAOYUAN INTERNATIONAL AIRPORT	NATIVENAMER	TáOYUáN JīCHǎNG
NAGOYA AIRFIELD	NATIVENAMER	NAGOYA HIKōJō
QUéBEC CITY JEAN LESAGE INTERNATIONAL AIRPORT	NATIVENAMER	JEAN LESAGE INTERNATIONAL AIRPORT
GIMPO INTERNATIONAL AIRPORT	NATIVENAMER	GIMPO GUKJE GONGHANG
GIMPO INTERNATIONAL AIRPORT	NATIVENAMER	KIMP'O KUKCHE KONGHANG
CHHATRAPATI SHIVAJI INTERNATIONAL AIRPORT	NATIVENAMER	( CHHATRAPATī SHIVāJī ĀṅTARARāṣṭRīYA VIMāNATAḷA )
DOMODEDOVO INTERNATIONAL AIRPORT	NATIVENAMER	(Московский аэропорт Домодедово)
GIMHAE INTERNATIONAL AIRPORT	NATIVENAMER	KIMHAE KUKCHE KONGHANG
BEIJING CAPITAL INTERNATIONAL AIRPORT	NATIVENAMER	BěIJīNG SHǒUDū GUóJì JīCHǎNG
BOISE AIRPORT	NATIVENAMER	GOWEN FIELD
NATIONAL LANGUAGES COMMITTEE	NATIVENAMER	GUóYǔ TUīXíNG WěIYUáNHUì
RAF MACHRIHANISH	NATIVENAMER	(PORT-ADHAIR CEANN LOCH)
TAIPEI SONGSHAN AIRPORT	NATIVENAMER	TáIBěI GUóJì HáNGKōNGZHàN
TAIPEI SONGSHAN AIRPORT	NATIVENAMER	TáIBěI SōNGSHāN JīCHǎNG
FUKUOKA AIRPORT	NATIVENAMER	FUKUOKA KūKō
CAMPBELTOWN AIRPORT	NATIVENAMER	MOD MACHRIHANISH
KOBE AIRPORT	NATIVENAMER	KōBE KūKō
POINTE-à-PITRE INTERNATIONAL AIRPORT	NATIVENAMER	(AéROPORT GUADELOUPE PôLE CARAïBES)
ASAHIKAWA AIRPORT	NATIVENAMER	ASAHIKAWA KūKō
YAO AIRPORT	NATIVENAMER	YAO KūKō
LUXEMBOURG FINDEL AIRPORT	NATIVENAMER	(FLUGHAFEN LUXEMBURG)
HAKODATE AIRPORT	NATIVENAMER	HAKODATE KūKō
GUANGZHOU BAIYUN INTERNATIONAL AIRPORT	NATIVENAMER	GUǎNGZHōU BáIYúN GUóJì JīCHǎNG
OKADAMA AIRPORT	NATIVENAMER	SAPPORO OKADAMA KūKō
NATIONAL UNIFICATION COUNCIL	NATIVENAMER	GUóJIā TǒNGYī WěIYUáNHUì
BAHRAIN INTERNATIONAL AIRPORT	NATIVENAMER	MAṭāR AL-BAḥRAYN AL-DWALī
KING KHALID INTERNATIONAL AIRPORT	NATIVENAMER	MATāR AL-MALIK KHāLID AL-DUWALIYY
MINISTRY OF HOME AFFAIRS	NATIVENAMER	JICHI-SHō
TOYAMA AIRPORT	NATIVENAMER	TOYAMA KūKō
CFB SHEARWATER	NATIVENAMER	CFB SHEARWATER
CHōFU AIRPORT	NATIVENAMER	CHōFU HIKōJō
CAIRO INTERNATIONAL AIRPORT	NATIVENAMER	MAṭāR AL-QāHIRAH AL-DUWALIYY
MOORABBIN AIRPORT	NATIVENAMER	(MELBOURNE/MOORABBIN AIRPORT)
KAOHSIUNG INTERNATIONAL AIRPORT	NATIVENAMER	''GāOXIóNG GUóJì HáNGKōNGZHàN
KAOHSIUNG INTERNATIONAL AIRPORT	NATIVENAMER	GāOXIóNG XIǎOGǎNG JīCHǎNG''
PHNOM PENH INTERNATIONAL AIRPORT	NATIVENAMER	(AéROPORT INTERNATIONAL DE PHNOM PENH)
HOUARI BOUMEDIENE AIRPORT	NATIVENAMER	AéROPORT D'ALGER HOUARI BOUMEDIENE
QUEEN ALIA INTERNATIONAL AIRPORT	NATIVENAMER	MATAR AL-MALIKAH ALIA AD-DOWALI
NAHA AIRPORT	NATIVENAMER	NAHA KūKō
GUANGZHOU BAIYUN INTERNATIONAL AIRPORT	NATIVENAMER	GUǎNGZHōU BáIYúN GUóJì JīCHǎNG
IMPERIAL HOUSEHOLD AGENCY	NATIVENAMER	KUNAI-CHō
DEWAN BAHASA DAN PUSTAKA	NATIVENAMER	ديوان بهاس دان ڤوستاک
MINISTRY OF FOREIGN AFFAIRS	NATIVENAMER	GAIMU-SHō
MINISTRY OF FINANCE	NATIVENAMER	ZAIMUSHō
MINISTRY OF THE ENVIRONMENT	NATIVENAMER	KANKYōSHō
MINISTRY OF EDUCATION, CULTURE, SPORTS, SCIENCE AND TECHNOLOGY	NATIVENAMER	MONBU-KAGAKU-SHō
PAYA LEBAR AIR BASE	NATIVENAMER	பாய ளேபர் வான்படைத் தளம்
NEW ZEALAND OFFICE FOR THE COMMUNITY & VOLUNTARY SECTOR	NATIVENAMER	TARI Mō TE RāNGAI ā-HAPORI, ā-TūAO
NEW ZEALAND QUALIFICATIONS AUTHORITY	NATIVENAMER	MANA TOHU MāTAURANGA O AOTEAROA
MAINLAND AFFAIRS COUNCIL	NATIVENAMER	DàLù WěIYUáNHUì
YANGYANG INTERNATIONAL AIRPORT	NATIVENAMER	YANGYANG GUKJE GONGHANG
YANGYANG INTERNATIONAL AIRPORT	NATIVENAMER	YANGYANG KUKCHE KONGHANG
BURGAS AIRPORT	NATIVENAMER	(Летище Бургас)
TENGAH AIR BASE	NATIVENAMER	தெங்கா வான்படைத் தளம்
MONBETSU AIRPORT	NATIVENAMER	OHōTSUKU MONBETSU KūKō
BRUNEI INTERNATIONAL AIRPORT	NATIVENAMER	(LAPANGAN TERBANG ANTARABANGSA BRUNEI)
PRESIDENTIAL SECURITY SERVICE	NATIVENAMER	DAETONGRYUNG KYUNGHOSIL
HIROSHIMA AIRPORT	NATIVENAMER	HIROSHIMA KūKō
NAGASAKI AIRPORT	NATIVENAMER	NAGASAKI KūKō
NAVAL AIR FACILITY ATSUGI	NATIVENAMER	ATSUGI KAIGUN-HIKōJō
NAICHO	NATIVENAMER	NAIKAKU JōHō CHōSASHITSU
KAGOSHIMA AIRPORT	NATIVENAMER	KAGOSHIMA KūKō
LAJES FIELD	NATIVENAMER	(''AEROPORTO DAS LAJES)
MINISTRY OF STATE SECURITY	NATIVENAMER	ZHōNGHUá RéNMíN GòNGHéGUó GUóJIā ĀNQUáNBù
NANJING LUKOU INTERNATIONAL AIRPORT	NATIVENAMER	NáNJīNG LùKǒU GUóJì JīCHǎNG
CABINET OFFICE	NATIVENAMER	NAIKAKU-FU
MINISTRY OF INTERNAL AFFAIRS AND COMMUNICATIONS	NATIVENAMER	SōMU-SHō
MINISTRY OF HEALTH, LABOUR, AND WELFARE	NATIVENAMER	KōSEI-RōDō-SHō
MINISTRY OF AGRICULTURE, FORESTRY AND FISHERIES	NATIVENAMER	NōRIN-SUISAN-SHō
MINISTRY OF LAND, INFRASTRUCTURE, TRANSPORT AND TOURISM	NATIVENAMER	KOKUDOKōTSūSHō
CENTRAL ELECTION COMMISSION	NATIVENAMER	TSENTRVYBORCHKOM
KOKURA AIRPORT	NATIVENAMER	KOKURA KūKō
MINISTRY OF DEFENSE	NATIVENAMER	BōEI-SHō
KITAKYUSHU AIRPORT	NATIVENAMER	KITAKYūSHū-KūKō
MINISTRY OF AGRICULTURE AND FORESTRY	NATIVENAMER	TE MANATU AHUWHENUA, NGāHEREHERE
EARECKSON AIR STATION	NATIVENAMER	60
BELGRADE NIKOLA TESLA AIRPORT	NATIVENAMER	(AERODROM NIKOLA TESLA BEOGRAD)
LANDCARE RESEARCH	NATIVENAMER	MANAAKI WHENUA
DAEGU INTERNATIONAL AIRPORT	NATIVENAMER	TAEGU KUKCHE KONGHANG
SUPREME PEOPLE'S PROCURATORATE	NATIVENAMER	ZHōNGHUá RéNMíN GòNGHéGUó ZUìGāO RéNMíN JIǎNCHáYUàN
CHUBU CENTRAIR INTERNATIONAL AIRPORT	NATIVENAMER	CHūBU KOKUSAI KūKō
TIANJIN BINHAI INTERNATIONAL AIRPORT	NATIVENAMER	TIāNJīN BīNHăI GUóJì JīCHǎNG
MINISTRY OF FINANCE	NATIVENAMER	CáIZHèNGBù
MINISTRY OF EMERGENCY SITUATIONS	NATIVENAMER	MINISTERSTVO PO DELAM GRAZHDANSKOY OBORONY, CHREZVYCHAINYM SITUATSIYAM I LIKVIDATSII POSLEDSTVIY STIHIYNYH BEDSTVIY
MATSU BEIGAN AIRPORT	NATIVENAMER	BěIGāN HáNGKōNGZHàN
MATSU BEIGAN AIRPORT	NATIVENAMER	MǎZǔ BěIGāN JīCHǎNG
MATSU NANGAN AIRPORT	NATIVENAMER	NáNGāN HáNGKōNGZHàN
MATSU NANGAN AIRPORT	NATIVENAMER	MǎZǔ NáNGāN JīCHǎNG
KINMEN AIRPORT	NATIVENAMER	JīNMéN HáNGKōNGZHàN
KINMEN AIRPORT	NATIVENAMER	JīNMéN SHàNGYì JīCHǎNG
TAIWAN AFFAIRS OFFICE	NATIVENAMER	GUóWùYUàN TáIWāN SHìWù BàNGōNGSHì
KING ABDULAZIZ INTERNATIONAL AIRPORT	NATIVENAMER	MATAAR AL-MALIK ABDULAZīZ AD-DOWALIY
DALIAN ZHOUSHUIZI INTERNATIONAL AIRPORT	NATIVENAMER	DàLIáN ZHōUSHUǐZI GUóJì JīCHǎNG
GATINEAU-OTTAWA EXECUTIVE AIRPORT	NATIVENAMER	AéROPORT EXéCUTIF GATINEAU-OTTAWA
SHENZHEN BAO'AN INTERNATIONAL AIRPORT	NATIVENAMER	SHēNZHèN BǎO'āN GUóJì JīCHǎNG
GOVERNMENT INFORMATION OFFICE	NATIVENAMER	XīNWéN Jú
GWANGJU AIRPORT	NATIVENAMER	KWANGJU KONGHANG
CHEONGJU INTERNATIONAL AIRPORT	NATIVENAMER	CH'ŏNGJU KUKCHE KONGHANG
JEJU INTERNATIONAL AIRPORT	NATIVENAMER	CHEJU KUKCHE KONGHANG
SHENYANG TAOXIAN INTERNATIONAL AIRPORT	NATIVENAMER	SHěNYáNG TáOXIāN GUóJì JīCHǎNG
HSINCHU AIR BASE	NATIVENAMER	XīNZHú KōNGJūN JīDì
HSINCHU AIR BASE	NATIVENAMER	XīNZHú JīCHǎNG
FINANCIAL SERVICES AGENCY	NATIVENAMER	KIN'Yū-CHō
CHANGSHA HUANGHUA INTERNATIONAL AIRPORT	NATIVENAMER	CHáNGSHā HUáNGHUā GUóJì JīCHǎNG
ERIK NIELSEN WHITEHORSE INTERNATIONAL AIRPORT	NATIVENAMER	(WHITEHORSE/ERIK NIELSEN INTERNATIONAL AIRPORT)
SELETAR AIRPORT	NATIVENAMER	செலட்டர் வான்முகம்
SEMBAWANG AIR BASE	NATIVENAMER	செம்பவாங் வான்படைத் தளம்
CHANGI AIR BASE	NATIVENAMER	சாங்கி வான்படைத் தளம் கிழக்கு
RNZAF BASE AUCKLAND	NATIVENAMER	UNIFICATION OF THE TWINS
ZHENGZHOU XINZHENG INTERNATIONAL AIRPORT	NATIVENAMER	ZHèNGZHōU XīNZHèNG GUóJì JīCHǎNG
OKAYAMA AIRPORT	NATIVENAMER	OKAYAMA KūKō
INDONESIAN STATE INTELLIGENCE AGENCY	NATIVENAMER	BADAN INTELIJEN NEGARA
SENDAI AIRPORT	NATIVENAMER	SENDAI KūKō
OXFORD AIRPORT	NATIVENAMER	(LONDON OXFORD AIRPORT)
CUSTOMS AND EXCISE DEPARTMENT	NATIVENAMER	HEUNG1GONG2 HOI2GWAAN1
WEST KOOTENAY REGIONAL AIRPORT	NATIVENAMER	(CASTLEGAR/WEST KOOTENAY REGIONAL AIRPORT)
URBAN RENEWAL AUTHORITY	NATIVENAMER	SI5 KEOI1 CUNG4 GIN3 GUK6
LEGAL DEPARTMENT	NATIVENAMER	LEUT6JING3 CHYU5
SINGAPORE CIVIL DEFENCE FORCE	NATIVENAMER	新加坡民防部队
KOEVOET	NATIVENAMER	POLICE COUNTER-INSURGENCY UNIT
CHENGDU SHUANGLIU INTERNATIONAL AIRPORT	NATIVENAMER	CHéNGDū SHUāNGLIú GUóJì JīCHǎNG
TAKAMATSU AIRPORT	NATIVENAMER	TAKAMATSU KūKō
CHINA MARITIME SAFETY ADMINISTRATION	NATIVENAMER	ZHōNGHUá RéNMíN GòNGHéGUó HǎISHìJú
SIEM REAP INTERNATIONAL AIRPORT	NATIVENAMER	AéROPORT INTERNATIONAL DE SIEM REAP
NATIONAL SECURITY BUREAU	NATIVENAMER	GUóJIā ĀNQUáNJú
AYERS ROCK AIRPORT	NATIVENAMER	AYERS ROCK/CONNELLAN AIRPORT
NEW ISHIGAKI AIRPORT	NATIVENAMER	SHIN-ISHIGAKI KūKō
ISHIGAKI AIRPORT	NATIVENAMER	ISHIGAKI KūKō
MADRID–TORREJóN AIRPORT	NATIVENAMER	BASE AéREA DE TORREJóN
FUKUE AIRPORT	NATIVENAMER	FUKUE KūKō
PRISTINA INTERNATIONAL AIRPORT	NATIVENAMER	(Међународни Аеродром Приштина)
TOWNSVILLE AIRPORT	NATIVENAMER	TOWNSVILLE INTERNATIONAL AIRPORT
CHONGJIN AIRPORT	NATIVENAMER	EORANG GONGHANG
ÜRüMQI DIWOPU INTERNATIONAL AIRPORT	NATIVENAMER	WūLǔMùQí DìWōPù GUóJì JīCHǎNG
TENERIFE–SOUTH AIRPORT	NATIVENAMER	(TENERIFE SUR/REINA SOFíA AIRPORT - GCTS)
BOARD OF AUDIT	NATIVENAMER	KAIKEIKENSAIN
CABINET LEGISLATION BUREAU	NATIVENAMER	NAIKAKU-HōSEIKYOKU
NATIONAL INSTITUTE OF WATER AND ATMOSPHERIC RESEARCH	NATIVENAMER	TAIHORO NUKURANGI
VLADIVOSTOK INTERNATIONAL AIRPORT	NATIVENAMER	MEZHDUNARODNYY AEROPORT \
KALLANG AIRPORT	NATIVENAMER	காலாங் வான்முகம்
XIAMEN GAOQI INTERNATIONAL AIRPORT	NATIVENAMER	XIàMéN GāOQí GUóJì JīCHǎNG
MONT TREMBLANT INTERNATIONAL AIRPORT	NATIVENAMER	(LA MACAZA/MONT TREMBLANT INTL INC AIRPORT)
HOME MINISTRY	NATIVENAMER	NAIMU-SHō
MINISTRY OF CULTURE	NATIVENAMER	WéNHùABù
ALICANTE–ELCHE AIRPORT	NATIVENAMER	(AEROPORT D'ALACANT-ELX)
WENZHOU LONGWAN INTERNATIONAL AIRPORT	NATIVENAMER	WēNZHōU LóNGWāN GUóJì JīCHǎNG
NINGBO LISHE INTERNATIONAL AIRPORT	NATIVENAMER	NíNGBō LìSHè GUóJì JīCHǎNG
ROSKILDE AIRPORT	NATIVENAMER	COPENHAGEN AIRPORT, ROSKILDE
ACCIDENT COMPENSATION CORPORATION	NATIVENAMER	TE KAPOREIHANA ĀWHINA HUNGA WHARA
CHITOSE AIR BASE	NATIVENAMER	CHITOSE KICHI
VIGO–PEINADOR AIRPORT	NATIVENAMER	(AEROPORTO DE VIGO)
NIIGATA AIRPORT	NATIVENAMER	NIIGATA KūKō
FUKUSHIMA AIRPORT	NATIVENAMER	FUKUSHIMA KūKō
AKITA AIRPORT	NATIVENAMER	AKITA KūKō
KUSHIRO AIRPORT	NATIVENAMER	KUSHIRO KūKō
WAKKANAI AIRPORT	NATIVENAMER	WAKKANAI KūKō
JAPAN PATENT OFFICE	NATIVENAMER	TOKKYOCHō
INDUSTRIAL RESEARCH LIMITED	NATIVENAMER	TE TAUIHU PūTAIAO
ANSHAN TENG'AO AIRPORT	NATIVENAMER	ĀNSHāN TéNG'áO JīCHǎNG
REYKJAVíK AIRPORT	NATIVENAMER	REYKJAVíKURFLUGVöLLUR
DUBROVNIK AIRPORT	NATIVENAMER	ZRAčNA LUKA DUBROVNIK/ČILIPI
CFB EDMONTON	NATIVENAMER	STEELE BARRACKS
JAIPUR INTERNATIONAL AIRPORT	NATIVENAMER	( JAIPUR AṅTARRāṣHṭRīYA HAVāī Aḍḍā )
HIROSHIMA–NISHI AIRPORT	NATIVENAMER	HIROSHIMA NISHI HIKōJō
XI'AN XIANYANG INTERNATIONAL AIRPORT	NATIVENAMER	Xī'āN XIáNYáNG GUóJì JīCHǎNG
DE KOOY AIRFIELD	NATIVENAMER	MARITIEM VLIEGKAMP DE KOOY
ASTANA INTERNATIONAL AIRPORT	NATIVENAMER	Международный аэропорт Астана
NIš CONSTANTINE THE GREAT AIRPORT	NATIVENAMER	(AERODROM KONSTANTIN VELIKI)
HAIKOU MEILAN INTERNATIONAL AIRPORT	NATIVENAMER	HǎIKǒU MěILáN GUóJì JīCHǎNG
MINSK-1 AIRPORT	NATIVENAMER	Аэропорт Минск-1
NANKI–SHIRAHAMA AIRPORT	NATIVENAMER	NANKI SHIRAHAMA KūKō
ALCIDES FERNáNDEZ AIRPORT	NATIVENAMER	AEROPUERTO DE ACANDí
BRAč AIRPORT	NATIVENAMER	(ZRAčNO PRISTANIšTE BRAč)
ZADAR AIRPORT	NATIVENAMER	(ZRAčNA LUKA ZADAR/ZEMUNIK)
MINISTRY OF NATIONAL DEFENSE	NATIVENAMER	GUóFáNGBù
TOKUSHIMA AIRPORT	NATIVENAMER	TOKUSHIMA AWA-ODORI KūKō
ALMATY INTERNATIONAL AIRPORT	NATIVENAMER	(Международный Аэропорт Алматы)
MINISTRY OF TRADE, INDUSTRY AND ENERGY	NATIVENAMER	SANEOP TONGSANG JAWONBU
MINISTRY OF STRATEGY AND FINANCE	NATIVENAMER	GIHOEK JAEJEONG-BU
VRšAC INTERNATIONAL AIRPORT	NATIVENAMER	AERODROM VRšAC
PONIKVE AIRPORT	NATIVENAMER	AERODROM UžICE-PONIKVE
UNALASKA AIRPORT	NATIVENAMER	TOM MADSEN AIRPORT
KOVIN AIRPORT	NATIVENAMER	AERODROM KOVIN
BATAJNICA AIR BASE	NATIVENAMER	(AERODROM BATAJNICA)
MORAVA AIRPORT	NATIVENAMER	(AERODROM MORAVA)
MAHARANA PRATAP AIRPORT	NATIVENAMER	( MAHāRāṇā PRATāP HAVāī Aḍḍā )
TINGWALL AIRPORT	NATIVENAMER	(LERWICK/TINGWALL AIRPORT)
MINISTRY OF CULTURE, SPORTS AND TOURISM	NATIVENAMER	MUNHWA CHEYUK GWANGWANG-BU
OSMANI INTERNATIONAL AIRPORT	NATIVENAMER	OSMANI ANTôRJATIK BIMANBôNDôR
YONAGUNI AIRPORT	NATIVENAMER	YONAGUNI KūKō
MINISTRY OF COMMUNICATIONS	NATIVENAMER	MINISTèRE DE LA COMMUNICATION
CAGLIARI ELMAS AIRPORT	NATIVENAMER	AEROPORTO DI CAGLIARI
SJENICA AIRPORT	NATIVENAMER	AERODROM SJENICA
NOVI SAD AIRPORT	NATIVENAMER	(AERODROM ČENEJ)
TRSTENIK AIRPORT	NATIVENAMER	AERODROM TRSTENIK
MIRA AIRPORT	NATIVENAMER	(AERODROM MIRA)
CHONGQING JIANGBEI INTERNATIONAL AIRPORT	NATIVENAMER	CHóNGQìNG JIāNGBěI GUóJì JīCHǎNG
ABERPORTH AIRPORT	NATIVENAMER	(WEST WALES/ABERPORTH AIRPORT)
ERBIL INTERNATIONAL AIRPORT	NATIVENAMER	فڕۆکه‌خانه‌ی نێوده‌وڵه‌تی هه‌ولێر
HAVERFORDWEST AIRPORT	NATIVENAMER	WITHYBUSH AIRPORT
CIVIL AVIATION AUTHORITY OF NEW ZEALAND	NATIVENAMER	TE MANA RERERANGI TūMATANUI O AOTEAROA
ANGADS AIRPORT	NATIVENAMER	OUJDA ANGADS AIRPORT
ŽABLJAK AIRPORT	NATIVENAMER	AERODROM ŽABLJAK
PRINCE SULTAN AIR BASE	NATIVENAMER	AL KHARJ AIR BASE
SREMSKA MITROVICA AIRPORT	NATIVENAMER	(AERODROM SREMSKA MITROVICA)
SUBOTICA AIRPORT	NATIVENAMER	(Аеродром Суботица)
ULCINJ AIRPORT	NATIVENAMER	AERODROM ULCINJ
SMEDEREVSKA PALANKA AIRPORT	NATIVENAMER	(AERODROM SMEDEREVSKA PALANKA)
PARAćIN AIRPORT	NATIVENAMER	AERODROM DAVIDOVAC
SIMFEROPOL INTERNATIONAL AIRPORT	NATIVENAMER	(AQMESCIT HALQARA AVA LIMANı)
IZUMO AIRPORT	NATIVENAMER	IZUMO KūKō
PUNE AIRPORT	NATIVENAMER	( PUṇē VIMāNATAḷA )
MINISTRY OF NATIONAL DEFENSE	NATIVENAMER	GUKBANG-BU
HUALIEN AIRPORT	NATIVENAMER	HUāLIáN HáNGKōNGZHàN
HUALIEN AIRPORT	NATIVENAMER	HUāLIáN JīCHǎNG
FAIR TRADE COMMISSION	NATIVENAMER	KōSEI TORIHIKI IINKAI
CIVIL AIRPORT HARNI	NATIVENAMER	વડોદરા એરપોર્ટ
MINISTRY OF HEALTH AND WELFARE	NATIVENAMER	BOGEON BOKJI BU
COUNCIL OF INDIGENOUS PEOPLES	NATIVENAMER	YUáNZHù MíNZú WěIYUáNHUì
MYKOLAIV AIRPORT	NATIVENAMER	MIZHNаRODNYI аеROPORT MYKOLAIV
BHUJ RUDRA MATA AIR FORCE BASE	NATIVENAMER	BHUJ RUDRA MATA AIRPORT
RIVNE INTERNATIONAL AIRPORT	NATIVENAMER	Международный аеропорт «Ровно»
SON BONET AERODROME	NATIVENAMER	AERóDROMO DE SON BONET
LISIčJI JARAK AIRPORT	NATIVENAMER	AERODROM LISIčJI JARAK
PETERBOROUGH BUSINESS AIRPORT	NATIVENAMER	PETERBOROUGH/CONINGTON AIRPORT
XICHANG QINGSHAN AIRPORT	NATIVENAMER	XīCHāNG QīNGSHāN JīCHǎNG
SINGAPORE PRISON SERVICE	NATIVENAMER	PERKHIDMATAN PENJARA SINGAPURA
GOODWOOD AIRPORT	NATIVENAMER	GOODWOOD AERODROME
EARLS COLNE AIRFIELD	NATIVENAMER	90
LASHENDEN	NATIVENAMER	USAAF STATION AAF-410\N90PX\N60PX
HUCKNALL AERODROME	NATIVENAMER	90
CHALGROVE AIRFIELD	NATIVENAMER	USAAF STATION AAF-465
NETHERTHORPE AIRFIELD	NATIVENAMER	100
ELECTION COMMISSION OF THAILAND	NATIVENAMER	กกต.
OBAN AIRPORT	NATIVENAMER	NORTH CONNEL AIRPORT
DUXFORD AERODROME	NATIVENAMER	USAAF STATION 357\N90PX\N60PX
TRANSPORT ACCIDENT INVESTIGATION COMMISSION	NATIVENAMER	TE KOMIHANA TIROTIRO AITUA WAKA
PODGORICA AIRBASE	NATIVENAMER	AERODROM GOLUBOVCI
CFB WINNIPEG	NATIVENAMER	(BILLY BISHOP BUILDING)
AURANGABAD AIRPORT	NATIVENAMER	( AURAṅGāBāD VIMāNATAḷA )
SECURITY AND INTELLIGENCE DIVISION	NATIVENAMER	பாதுகாப்பு மற்றும் புலனாய்வு பிரிவு
DIMAPUR AIRPORT	NATIVENAMER	दीमापुर एयर फोर्स बेस
STATE ADMINISTRATION OF FOREIGN EXCHANGE	NATIVENAMER	GUóJIā WàIHUì GUǎNLǐ Jú
SILCHAR AIRPORT	NATIVENAMER	কুম্ভীরগ্রাম বায়ুসেনা বেস
WUHAN TIANHE INTERNATIONAL AIRPORT	NATIVENAMER	WǔHàN TIāNHé GUóJì JīCHǎNG
ALEPPO INTERNATIONAL AIRPORT	NATIVENAMER	(MATAR HALAB AL-DAWLY)
MINISTRY OF SCIENCE AND TECHNOLOGY	NATIVENAMER	KēJìBù
QAMDO BAMDA AIRPORT	NATIVENAMER	CHāNGDū BāNGDá JīCHǎNG
MINISTRY OF SECURITY AND PUBLIC ADMINISTRATION	NATIVENAMER	ANJEON HAENGJEONG-BU
TAINAN AIRPORT	NATIVENAMER	TáINáN HáNGKōNGZHàN
TAINAN AIRPORT	NATIVENAMER	TáINáN JīCHǎNG
AMMAN CIVIL AIRPORT	NATIVENAMER	MATAR AMMAN AL MADANI
OVERSEAS COMMUNITY AFFAIRS COUNCIL	NATIVENAMER	QIáO Wù WěIYUáNHUì
TALAGI AIRPORT	NATIVENAMER	Аэропорт Талаги
NATIONAL PERSONNEL AUTHORITY	NATIVENAMER	JINJI-IN
YICHANG SANXIA AIRPORT	NATIVENAMER	YíCHāNG SāNXIá JīCHǎNG
TAICHUNG AIRPORT	NATIVENAMER	TáIZHōNG HáNGKōNGZHàN
TAICHUNG AIRPORT	NATIVENAMER	TáIZHōNG QīNGQUáNGǎNG JīCHǎNG
KAZAN INTERNATIONAL AIRPORT	NATIVENAMER	Международный аэропорт Казань
KANDLA AIRPORT	NATIVENAMER	વરસામેડી એરપોર્ટ
YOSHKAR-OLA AIRPORT	NATIVENAMER	Аэропорт Йошкар-Ола
CHARBATIA AIR BASE	NATIVENAMER	एआरसी फील्ड
BORISOGLEBSKOYE AIRFIELD	NATIVENAMER	Аэродром Казань-Борисоглебское
KURSK VOSTOCHNY AIRPORT	NATIVENAMER	90
ANGLESEY AIRPORT	NATIVENAMER	RAF VALLEY
KAVALA INTERNATIONAL AIRPORT	NATIVENAMER	(Κρατικός Αερολιμένας Καβάλας, \
SAHNEWAL AIRPORT	NATIVENAMER	लुधियाना हवाई अड्डे
KARNAL AIRPORT	NATIVENAMER	करनाल हवाई अड्डा
MINISTRY OF ECONOMY, TRADE AND INDUSTRY	NATIVENAMER	KEIZAI-SANGYō-SHō
JAFFNA AIRPORT	NATIVENAMER	SLAF PALALY
MINISTRY FOR FOOD, AGRICULTURE, FORESTRY AND FISHERIES	NATIVENAMER	NONGNIM SUSAN SIKPUM-BU
KHOVD AIRPORT	NATIVENAMER	250
STATISTICS INDONESIA	NATIVENAMER	BADAN PUSAT STATISTIK
KOREA DEPOSIT INSURANCE CORPORATION	NATIVENAMER	YEGEUM BOHUM GONGSA
NOTO AIRPORT	NATIVENAMER	NOTO KūKō
NADOR INTERNATIONAL AIRPORT	NATIVENAMER	(EL AROUI AIRPORT)
RABAT–SALé AIRPORT	NATIVENAMER	AéROPORT INTERNATIONAL DE RABAT-SALé
PAROS NATIONAL AIRPORT	NATIVENAMER	\
SKYROS ISLAND NATIONAL AIRPORT	NATIVENAMER	KRATIKóS AEROLIMéNAS SKýROU
FOLIGNO AIRPORT	NATIVENAMER	\
DASHT-E NAZ AIRPORT	NATIVENAMER	FRūDEGāH-E SARI DASHT-E NāZ
HONDA AIRPORT	NATIVENAMER	HONDA EAPōTO
DAWADMI DOMESTIC AIRPORT	NATIVENAMER	مطار الدوادمي
JIZAN REGIONAL AIRPORT	NATIVENAMER	مطار الملك عبد الله الإقليمي
ALTAY AIRPORT	NATIVENAMER	ĀLèTàI JīCHǎNG
AKSU AIRPORT	NATIVENAMER	ĀKèSù JīCHǎNG
ANSHUN HUANGGUOSHU AIRPORT	NATIVENAMER	ĀNSHùN HUáNGGUǒSHù JīCHǎNG
ANKANG WULIPU AIRPORT	NATIVENAMER	ĀNKāNG WǔLǐPù JīCHǎNG
BAOSHAN YUNDUAN AIRPORT	NATIVENAMER	BǎOSHāN YúNDUāN JīCHǎNG
BAOTOU AIRPORT	NATIVENAMER	BāOTóU JīCHǎNG
BEIHAI FUCHENG AIRPORT	NATIVENAMER	BěIHǎI FúCHéNG JīCHǎNG
HAKKA AFFAIRS COUNCIL	NATIVENAMER	KèJIā WěIYUáNHUì, HAK-Kâ VE-YèN-FI
BEIJING NANYUAN AIRPORT	NATIVENAMER	BěIJīNG NáNYUàN JīCHǎNG
CHANGCHUN LONGJIA INTERNATIONAL AIRPORT	NATIVENAMER	CHáNGCHūN LóNGJIā GUóJì JīCHáNG
CHANGDE TAOHUAYUAN AIRPORT	NATIVENAMER	CHáNGDé TáOHUāYUáN JīCHǎNG
CHANGZHI WANGCUN AIRPORT	NATIVENAMER	CHANGZHI WANGCUN JīCHǎNG
CHIFENG YULONG AIRPORT	NATIVENAMER	CèFēNG YùLóNG JīCHǎNG
DALI AIRPORT	NATIVENAMER	DàLǐ JīCHǎNG
DANDONG LANGTOU AIRPORT	NATIVENAMER	DāNDōNG LàNGTOU JīCHǎNG
DATONG YUNGANG AIRPORT	NATIVENAMER	DàTóNG YúNGāNG JīCHǎNG
ZHANGJIAJIE HEHUA AIRPORT	NATIVENAMER	ZHāNGJIāJIè HéHUā JīCHǎNG
DIQING SHANGRI-LA AIRPORT	NATIVENAMER	DíQìNG XIāNGGéLǐLā JīCHǎNG
DUNHUANG AIRPORT	NATIVENAMER	DūNHUáNG JīCHǎNG
DONGYING SHENGLI AIRPORT	NATIVENAMER	DōNGYíNG SHèNGLì JīCHǎNG
ENSHI XUJIAPING AIRPORT	NATIVENAMER	ENSHī XǔJIāPíNG JīCHǎNG
FUZHOU CHANGLE INTERNATIONAL AIRPORT	NATIVENAMER	FúZHōU CHáNGLè GUóJì JīCHǎNG
GOLMUD AIRPORT	NATIVENAMER	Gé'ěRMù JīCHǎNG
GUANGYUAN PANLONG AIRPORT	NATIVENAMER	GUǎNGYUáN PáNLóNG JīCHǎNG
GUIYANG LONGDONGBAO INTERNATIONAL AIRPORT	NATIVENAMER	GUìYáNG LóNGDòNGBǎO GUóJì JīCHǎNG
HULUNBUIR HAILAR AIRPORT	NATIVENAMER	''HūLúNBèI'ěR HǎILā'ěR JīCHǎNG
HULUNBUIR HAILAR AIRPORT	NATIVENAMER	Хөлөнбуйр Хайлар Онгоцын Буудал''
HANZHONG XIGUAN AIRPORT	NATIVENAMER	HàNZHōNG XIGUāN JīCHǎNG
HEFEI LUOGANG INTERNATIONAL AIRPORT	NATIVENAMER	HéFéI LUòGǎNG GUóJì JīCHǎNG
HARBIN TAIPING INTERNATIONAL AIRPORT	NATIVENAMER	Hā'ěRBīN TàIPíNG GUóJì JīCHǎNG
HOHHOT BAITA INTERNATIONAL AIRPORT	NATIVENAMER	HūHéHàOTè BáITǎ GUóJì JīCHǎNG
MINISTRY OF SCIENCE AND TECHNOLOGY	NATIVENAMER	KGWAHAKGISULBU
HOTAN AIRPORT	NATIVENAMER	HéTIáN JīCHǎNGXOTəN AYRODROMI
TAIZHOU LUQIAO AIRPORT	NATIVENAMER	TāIZHōU LùQIáO JīCHǎNG
JIAMUSI DONGJIAO AIRPORT	NATIVENAMER	JIāMùSī DōNGJIāO JīCHǎNG
JIAYUGUAN AIRPORT	NATIVENAMER	JIāYùGUāN JīCHǎNG
JINAN YAOQIANG INTERNATIONAL AIRPORT	NATIVENAMER	JǐNáN YáOQIáNG GUóJì JīCHǎNG
JINGDEZHEN LUOJIA AIRPORT	NATIVENAMER	JǐNGDéZHèN LUōJIā JīCHǎNG
QUANZHOU JINJIANG INTERNATIONAL AIRPORT	NATIVENAMER	QUáNZHōU JìNJIāNG GUóJì JīCHǎNG
KARAMAY AIRPORT	NATIVENAMER	KèLāMǎYī JīCHǎNG
QUZHOU AIRPORT	NATIVENAMER	QúZHōU JīCHǎNG
JIUJIANG LUSHAN AIRPORT	NATIVENAMER	JIǔJIāNG LúSHāN JīCHǎNG
JINZHOU XIAOLINGZI AIRPORT	NATIVENAMER	JǐNZHōU XIǎOLǐNGZI JīCHǎNG
KASHGAR AIRPORT	NATIVENAMER	KāSHí JīCHǎNG
KASHGAR AIRPORT	NATIVENAMER	قەشقەر ئايىرپورت
KORLA AIRPORT	NATIVENAMER	Kù'ěRLè JīCHǎNG
KUQA QIUCI AIRPORT	NATIVENAMER	KùCHē QIūCí JīCHǎNG
LANZHOU ZHONGCHUAN INTERNATIONAL AIRPORT	NATIVENAMER	LáNZHōU ZHōNGCHUāN GUóJì JīCHǎNG
LHASA GONGGAR AIRPORT	NATIVENAMER	LāSà GòNGGá JīCHǎNG
LHASA GONGGAR AIRPORT	NATIVENAMER	LHA SA GONG DKAR GNAM GRU THANG
LIANYUNGANG BAITABU AIRPORT	NATIVENAMER	LIáNYúNGǎNG BáITǎBù JīCHǎNG
LIJIANG SANYI AIRPORT	NATIVENAMER	LìJIāNG SāNYì JīCHǎNG
NYINGCHI MAINLING AIRPORT	NATIVENAMER	LíNZHī MǐLíN JīCHǎNG
LINCANG AIRPORT	NATIVENAMER	LíNCāNG JīCHǎNG
LINYI SHUBULING AIRPORT	NATIVENAMER	LíNYí SHùBùLíNG JīCHǎNG
LIUZHOU BAILIAN AIRPORT	NATIVENAMER	LIǔZHōU BáILIáN JīCHǎNG
LIPING AIRPORT	NATIVENAMER	LíPíNG JīCHǎNG
LONGYAN GUANZHISHAN AIRPORT	NATIVENAMER	LóNGYáN GUāNZHìSHāN JīCHǎNG
LUOYANG BEIJIAO AIRPORT	NATIVENAMER	LUòYáNG BěIJIāO JīCHǎNG
DEHONG MANGSHI AIRPORT	NATIVENAMER	DéHóNG MáNGSHì JīCHǎNG
MEIXIAN AIRPORT	NATIVENAMER	MéIXIàN JīCHǎNG
LUZHOU LANTIAN AIRPORT	NATIVENAMER	LúZHōU LáNTIáN JīCHǎNG
MANZHOULI XIJIAO AIRPORT	NATIVENAMER	MǎNZHōULǐ XIJIāO JīCHǎNG
MIANYANG NANJIAO AIRPORT	NATIVENAMER	MIáNYáNG NáNJIāO JīCHǎNG
MUDANJIANG HAILANG AIRPORT	NATIVENAMER	MǔDāNJIāNG HǎILàNG JīCHǎNG
NANCHONG GAOPING AIRPORT	NATIVENAMER	NANCHONG GAOPING JīCHǎNG
NANCHANG CHANGBEI INTERNATIONAL AIRPORT	NATIVENAMER	NáNCHāNG CHāNGBěI GUóJì JīCHǎNG
NANNING WUXU INTERNATIONAL AIRPORT	NATIVENAMER	NáNNíNG WúXū GUóJì JīCHǎNG
PANZHIHUA BAO'ANYING AIRPORT	NATIVENAMER	PāNZHīHUā BǎO'āNYíNG JīCHǎNG
NANYANG JIANGYING AIRPORT	NATIVENAMER	NáNYáNG JIāNGYíNG JīCHǎNG
NANTONG XINGDONG AIRPORT	NATIVENAMER	NáNTōNG XìNGDōNG JīCHǎNG
QIEMO AIRPORT	NATIVENAMER	QIěMò JīCHǎNG
QINGYANG AIRPORT	NATIVENAMER	QìNGYáNG JīCHǎNG
QIQIHAR SANJIAZI AIRPORT	NATIVENAMER	QíQíHā'ěR SāNJIāZǐ JīCHǎNG
SANYA PHOENIX INTERNATIONAL AIRPORT	NATIVENAMER	SāNYà FèNGHUáNG GUóJì JīCHáNG
SHANTOU WAISHA AIRPORT	NATIVENAMER	SHàNTóU WàISHā JīCHǎNG
TACHENG AIRPORT	NATIVENAMER	TǎCHéNG JīCHǎNG
JIUZHAI HUANGLONG AIRPORT	NATIVENAMER	JIǔZHàI HUáNGLóNG JīCHǎNG
TAIYUAN WUSU INTERNATIONAL AIRPORT	NATIVENAMER	TàIYUáN WǔXù GUóJì JīCHǎNG
TONGLIAO AIRPORT	NATIVENAMER	TONGLIAO JīCHǎNG
HUANGSHAN TUNXI INTERNATIONAL AIRPORT	NATIVENAMER	HUáNGSHāN TúNXī GUóJì JīCHǎNG
TONGREN FENGHUANG AIRPORT	NATIVENAMER	TóNGJìN FèNGHUáNG JīCHǎNG
MYANMAR LANGUAGE COMMISSION	NATIVENAMER	MYANMAZA APHWE
WANZHOU WUQIAO AIRPORT	NATIVENAMER	WàNZHōU WǔQIáO JīCHǎNG
WENSHAN PUZHEHEI AIRPORT	NATIVENAMER	WéNSHāN PǔZHěHēI JīCHǎNG
WEIHAI DASHUIBO AIRPORT	NATIVENAMER	WēIHǎI DàSHUǐBó JīCHǎNG
WUHAI AIRPORT	NATIVENAMER	WūHǎI JīCHǎNG
WUYISHAN AIRPORT	NATIVENAMER	WǔYíSHāN JīCHǎNG
XIANGYANG LIUJI AIRPORT	NATIVENAMER	XIāNGYáNG LIúJí JīCHǎNG
XILINHOT AIRPORT	NATIVENAMER	XīLíNHàOTè JīCHǎNG
XINGYI WANFENGLIN AIRPORT	NATIVENAMER	XìNGYì WàNFēNGLíN JīCHǎNG
YAN'AN ERSHILIPU AIRPORT	NATIVENAMER	YáN'āN ÈRSHíLǐPù JīCHǎNG
YANJI CHAOYANGCHUAN AIRPORT	NATIVENAMER	YáNJí CHáOYáNGCHUāN JīCHǎNG
XINING CAOJIABAO AIRPORT	NATIVENAMER	XīNíNG CáOJIāBǎO JīCHǎNG
YIBIN CAIBA AIRPORT	NATIVENAMER	YIBīN CàIBà JīCHǎNG
XUZHOU GUANYIN AIRPORT	NATIVENAMER	XúZHōU GUāNYīN GUóJì JīCHǎNG
YINING AIRPORT	NATIVENAMER	YíNíNG JīCHǎNG
ZHAOTONG AIRPORT	NATIVENAMER	ZHāOTōNG JīCHǎNG
YIWU AIRPORT	NATIVENAMER	YìWū JīCHǎNG
ZHANJIANG AIRPORT	NATIVENAMER	ZHàNJIāNG JīCHǎNG
HUAIHUA ZHIJIANG AIRPORT	NATIVENAMER	HUáIHUà ZHǐJIāNG JīCHǎNG
YUNCHENG GUANGONG AIRPORT	NATIVENAMER	YùNCHéNG GUāNGōNG JīCHǎNG
ZHOUSHAN PUTUOSHAN AIRPORT	NATIVENAMER	ZHōUSHāN PǔTUóSHāN JīCHǎNG
ZHUHAI JINWAN AIRPORT	NATIVENAMER	ZHūHǎI JīNWāN JīCHǎNG
JODHPUR AIRPORT	NATIVENAMER	( JODHPUR HAVāī Aḍḍā )
AMAMI AIRPORT	NATIVENAMER	AMAMI KūKō
AOMORI AIRPORT	NATIVENAMER	AOMORI KūKō
IWAMI AIRPORT	NATIVENAMER	IWAMI KūKō
HANAMAKI AIRPORT	NATIVENAMER	HANAMAKI KūKō
HACHIJOJIMA AIRPORT	NATIVENAMER	HACHIJōJIMA KūKō
KUMEJIMA AIRPORT	NATIVENAMER	KUMEJIMA KūKō
MEMANBETSU AIRPORT	NATIVENAMER	MEMANBETSU KūKō
MIYAKEJIMA AIRPORT	NATIVENAMER	MIYAKEJIMA KūKō
MIYAKO AIRPORT	NATIVENAMER	MIYAKO KūKō
SAGA AIRPORT	NATIVENAMER	SAGA-KūKō
SHONAI AIRPORT	NATIVENAMER	SHONAI KūKō
OSHIMA AIRPORT	NATIVENAMER	ŌSHIMA KūKō
ODATE–NOSHIRO AIRPORT	NATIVENAMER	ODATE-NOSHIRO KūKō
YAMAGUCHI UBE AIRPORT	NATIVENAMER	YAMAGUCHI UBE KūKō
TOKUNOSHIMA AIRPORT	NATIVENAMER	TOKUNOSHIMA KūKō
MIHO–YONAGO AIRPORT	NATIVENAMER	YONAGO AIRPORT
GUNSAN AIRPORT	NATIVENAMER	KUNSAN KONGHANG
POHANG AIRPORT	NATIVENAMER	P'OHANG KONGHANG
WONJU AIRPORT	NATIVENAMER	WŏNJU KONGHANG
ULSAN AIRPORT	NATIVENAMER	ULSAN KONGHANG
SACHEON AIRPORT	NATIVENAMER	SACH'ŏN KONGHANG
HENGCHUN AIRPORT	NATIVENAMER	HéNGCHūN HáNGKōNGZHàN
HENGCHUN AIRPORT	NATIVENAMER	HéNGCHūN JīCHǎNG
CHIAYI AIRPORT	NATIVENAMER	JIāYì HáNGKōNGZHàN
CHIAYI AIRPORT	NATIVENAMER	SHUǐSHàNG JīCHǎNG
MAGONG AIRPORT	NATIVENAMER	MǎGōNG HáNGKōNGZHàN
MAGONG AIRPORT	NATIVENAMER	MǎGōNG JīCHǎNG
PINGTUNG AIRPORT	NATIVENAMER	PíNGDōNG HáNGKōNGZHàN
PINGTUNG AIRPORT	NATIVENAMER	PíNGDōNG JīCHǎNG
PINGTUNG AIRPORT	NATIVENAMER	KōNGJūN PíNGDōNG JīDì
TAITUNG AIRPORT	NATIVENAMER	TáIDōNG HáNGKōNGZHàN
TAITUNG AIRPORT	NATIVENAMER	TáIDōNG JīCHǎNG
WANG-AN AIRPORT	NATIVENAMER	WàNG'āN HáNGKōNGZHàN
WANG-AN AIRPORT	NATIVENAMER	WàNG'āN JīCHǎNG
LYUDAO AIRPORT	NATIVENAMER	LǜDǎO HáNGKōNGZHàN
LYUDAO AIRPORT	NATIVENAMER	LǜDǎO JīCHǎNG
LANYU AIRPORT	NATIVENAMER	LáNYǔ HáNGKōNGZHàN
LANYU AIRPORT	NATIVENAMER	LáNYǔ JīCHǎNG
QIMEI AIRPORT	NATIVENAMER	QīMěI HáNGKōNGZHàN
QIMEI AIRPORT	NATIVENAMER	PēNGHú QīMěI JīCHǎNG
MOOREA AIRPORT	NATIVENAMER	MOOREA TEMAE AIRPORT
FEDERAL FINANCIAL SUPERVISORY AUTHORITY	NATIVENAMER	BUNDESANSTALT FüR FINANZDIENSTLEISTUNGSAUFSICHT
IBARAKI AIRPORT	NATIVENAMER	HYAKURI HIKōJōHYAKURI KICHI
SHIZUOKA AIRPORT	NATIVENAMER	SHIZUOKA KūKō
CAPITAL MARKETS AUTHORITY OF SAUDI ARABIA	NATIVENAMER	هيئة السوق المالية
YINCHUAN HEDONG INTERNATIONAL AIRPORT	NATIVENAMER	YíNCHUāN HéDōNG GUóJì JīCHǎNG
MUAN INTERNATIONAL AIRPORT	NATIVENAMER	MUAN GUKJE GONGHANG
MUAN INTERNATIONAL AIRPORT	NATIVENAMER	MUAN KUKCHE KONGHANG
XISHUANGBANNA GASA AIRPORT	NATIVENAMER	XISHUāNGBǎNNà GāSǎ JīCHǎNG
PLOVDIV AIRPORT	NATIVENAMER	Летище Пловдив
MINISTRY OF FOREIGN AFFAIRS	NATIVENAMER	WàIJIāOBù
C-DOT	NATIVENAMER	C-DOT
MINISTRY OF FOREIGN AFFAIRS	NATIVENAMER	OEGYOBU
MINISTRY OF JUSTICE	NATIVENAMER	FǎWùBù
DATONG HUAIREN AIRPORT	NATIVENAMER	DàTóNG HUáIRéN JīCHǎNG
ČAčAK AIRPORT	NATIVENAMER	(AERODROM ČAčAK)
FINANCIAL SUPERVISORY COMMISSION	NATIVENAMER	JīNRóNG JIāNDū GUăNLĭ WěIYUáNHUì
KRUšEVAC AIRPORT	NATIVENAMER	AERODROM KOšIRSKO POLJE
KOSTOLAC AIRPORT	NATIVENAMER	(AERODROM KOSTOLAC)
NERLERIT INAAT AIRPORT	NATIVENAMER	NERLERIT INAAT LUFTHAVN
GORNA ORYAHOVITSA AIRPORT	NATIVENAMER	LETISHTE GORNA ORYAHOVITSA
ASWAN INTERNATIONAL AIRPORT	NATIVENAMER	DARAW AIRPORT
KIKINDA AIRPORT	NATIVENAMER	Аеродром ДраXслеров Салаш
BREGE AIRPORT	NATIVENAMER	(AERODROM BREGE)
SMEDEREVO AIRPORT	NATIVENAMER	(AERODROM SMEDEREVO)
BOJNIK AIRPORT	NATIVENAMER	(AERODROM BOJNIK)
BATLAVA-DONJA PENDUHA AIRFIELD	NATIVENAMER	Аеродром Батлава-Доња Пендуха
PROGAR AIRPORT	NATIVENAMER	(AERODROM PROGAR)
POžAREVAC AIRPORT	NATIVENAMER	(AERODROM POžAREVAC)
BANJIčKI VIS MILITARY BASE	NATIVENAMER	(AEROBAZA BANJIčKI VIS)
NAVOJOA AIRPORT	NATIVENAMER	NAVOJOA NATIONAL AIRPORT
KEMPEN AIRPORT	NATIVENAMER	VLIEGVELD KEMPEN
IKI AIRPORT	NATIVENAMER	IKI KūKō
MONGOLIAN AND TIBETAN AFFAIRS COMMISSION	NATIVENAMER	MěNG-ZàNG WěIYUáNHUì
NEW ZEALAND FOOD SAFETY AUTHORITY	NATIVENAMER	TE POU ORANGA KAI O AOTEAROA
MINISTRY OF POSTS AND TELECOMMUNICATIONS	NATIVENAMER	YūSEI-SHō
ORDOS EJIN HORO AIRPORT	NATIVENAMER	È'ěRDUōSī YīJīN HUòLUò JīCHǎNG
JINGGANGSHAN AIRPORT	NATIVENAMER	JǐNGGāNGSHāN JīCHǎNG
IRUMA AIR BASE	NATIVENAMER	IRUMA-KICHI
VTT TECHNICAL RESEARCH CENTRE OF FINLAND	NATIVENAMER	TEKNOLOGISKA FORSKNINGSCENTRALEN VTT AB
PUBLIC SECURITY INTELLIGENCE AGENCY	NATIVENAMER	KōANCHōSA-CHō
YORON AIRPORT	NATIVENAMER	YORON KūKō
LOD AIR FORCE BASE	NATIVENAMER	RAF LYDDA90PX
KERAMA AIRPORT	NATIVENAMER	KERAMA KūKō
AGUNI AIRPORT	NATIVENAMER	AGUNI KūKō
MINAMI-DAITO AIRPORT	NATIVENAMER	MINAMIDAITō KūKō
TARAMA AIRPORT	NATIVENAMER	TARAMA KūKō
HATERUMA AIRPORT	NATIVENAMER	HATERUMA KūKō
KITADAITO AIRPORT	NATIVENAMER	KITADAITō KūKō
SHIMOJISHIMA AIRPORT	NATIVENAMER	SHIMOJISHIMA KūKō
SECURITY POLICE	NATIVENAMER	KEIBIBU KEIGOKA
LOšINJ AIRPORT	NATIVENAMER	ZRAčNO PRISTANIšTE LOšINJ/LOšINJ I
NETHERLANDS AUTHORITY FOR THE FINANCIAL MARKETS	NATIVENAMER	AUTORITEIT FINANCIëLE MARKTEN
TAJIMA AIRPORT	NATIVENAMER	TAJIMA HIKōJō
KIKAI AIRPORT	NATIVENAMER	KIKAI KūKō
NEW TANEGASHIMA AIRPORT	NATIVENAMER	SHIN TANEGASHIMA KūKō
OKI AIRPORT	NATIVENAMER	OKI KūKō
OKINOERABU AIRPORT	NATIVENAMER	OKINOERABU KūKō
YAKUSHIMA AIRPORT	NATIVENAMER	YAKUSHIMA KūKō
DEPARTMENT OF FINANCE	NATIVENAMER	DHANAKARYA VAKKUPPU
TOKYO METROPOLITAN POLICE DEPARTMENT PUBLIC SECURITY BUREAU	NATIVENAMER	KEISHICHō-KōANBU
MINISTRY OF THE INTERIOR	NATIVENAMER	HAENGJEONG-JACHI BU
CHANGI AIR BASE	NATIVENAMER	சாங்கி வான்படைத் தளம்
CONTROLLER AND AUDITOR-GENERAL OF NEW ZEALAND	NATIVENAMER	TUMUAKI O TE MANA AROTAKE
NEW ZEALAND GEOGRAPHIC BOARD	NATIVENAMER	NGā POU TAUNAHA O AOTEAROA
PARLIAMENTARY COUNSEL OFFICE	NATIVENAMER	TE TARI TOHUTOHU PāREMATA
OKUSHIRI AIRPORT	NATIVENAMER	OKUSHIRI KūKō
SPORTS ADMINISTRATION	NATIVENAMER	TǐYǜ SHǔ
JIEYANG CHAOSHAN INTERNATIONAL AIRPORT	NATIVENAMER	JIēYáNG CHáOSHàN JīCHǎNG
MINISTRY OF TRANSPORTATION AND COMMUNICATIONS	NATIVENAMER	JIāOTōNGBù
TIN CITY LRRS AIRPORT	NATIVENAMER	50
MINISTRY OF RESEARCH, SCIENCE AND TECHNOLOGY	NATIVENAMER	TE MANATū PūTAIAO
DEFENSE INTELLIGENCE HEADQUARTERS	NATIVENAMER	JōHōHONBU
LAND TRANSPORT NEW ZEALAND	NATIVENAMER	IKIIKI WHENUA AOTEAROA
TAN TAN AIRPORT	NATIVENAMER	PLAGE BLANCHE AIRPORT
MINISTRY OF ECONOMIC AFFAIRS	NATIVENAMER	JīNGJìBù
BALKHASH AIRPORT	NATIVENAMER	Аэропорт Балхаш
SINGAPORE CHANGI AIRPORT	NATIVENAMER	சிங்கப்பூர் சாங்கி
SINGAPORE CHANGI AIRPORT	NATIVENAMER	சர்வதேச விமானநிலையம்
TACHIKAWA AIRFIELD	NATIVENAMER	TACHIKAWA HIKōJō
FINANCIAL SERVICES COMMISSION	NATIVENAMER	GEUMNYUNG WIWONHOE
FINANCIAL SUPERVISORY SERVICE	NATIVENAMER	GEUMNYUNG GAMDOGWON
NEW ZEALAND LAW COMMISSION	NATIVENAMER	TE AKA MATUA O TE TURE
PLANT & FOOD RESEARCH	NATIVENAMER	RANGAHAU AHUMāRA KAI
MINISTRY OF FOREIGN AFFAIRS	NATIVENAMER	THE SARANROM
RAF LYMPNE	NATIVENAMER	90
MINISTRY OF FINANCE	NATIVENAMER	KRASUANG KAN KHLANG
RUSE AIRPORT	NATIVENAMER	LETISHTE RUSE
MINISTRY OF THE INTERIOR	NATIVENAMER	NèIZHèNGBù
NATIONAL FIRE AGENCY	NATIVENAMER	XīAOFáNGSHǔ
CENTRAL ELECTION COMMISSION	NATIVENAMER	ZHōNGYāNG XUǎNJǔ WěIYUáNHUì
MINISTRY OF HEALTH AND WELFARE	NATIVENAMER	WèISHēNG FúLì Bù
ENVIRONMENTAL PROTECTION ADMINISTRATION	NATIVENAMER	HUáNJìNGBǎOHù SHǔ
FAIR TRADE COMMISSION	NATIVENAMER	GōNGPíNGJIāOYì WěIYUáNHUì
CENTRAL FIELD	NATIVENAMER	IōTō HIKōJō
AVIATION SAFETY COUNCIL	NATIVENAMER	FēIHáNG ĀNQUáN WěIYUáNHUì
COUNCIL FOR ECONOMIC PLANNING AND DEVELOPMENT	NATIVENAMER	JīNGJì JIàNSHè WěIYUáNHUì
STATE ELECTRICITY REGULATORY COMMISSION	NATIVENAMER	GUóJIā DIàNLì JIāNGUǎN WěIYUáNHUì
STATE OCEANIC ADMINISTRATION	NATIVENAMER	GUóJIā HǎIYáNG Jú
STATE ADMINISTRATION OF CULTURAL HERITAGE	NATIVENAMER	GUóJIā WéNWù Jú
DEVELOPMENT RESEARCH CENTER OF THE STATE COUNCIL	NATIVENAMER	GUóWùYUàN FāZHǎN YáNJIū ZHōNGXīN
TOURISM BUREAU	NATIVENAMER	GUāNGUāNG Jú
PUBLIC CONSTRUCTION COMMISSION	NATIVENAMER	GōNGGòNG GōNGCHéNG WěIYUáNHUì
ATOMIC ENERGY COUNCIL	NATIVENAMER	YUáNZǐNéNG WěIYUáNHUì
POLITICAL SECURITY DIRECTORATE	NATIVENAMER	IDARAT AL-AMN AL-SIYASI
MILITARY INTELLIGENCE DIRECTORATE	NATIVENAMER	SHU'BAT AL-MUKHABARAT AL-'ASKARIYYA
NATIONAL SECURITY AGENCY	NATIVENAMER	AGENCIJA ZA NACIONALNU BEZBJEDNOST
XINJIN AIRPORT	NATIVENAMER	XINJIN JICHANG
GUANGHAN AIRPORT	NATIVENAMER	GUANGHAN JICHANG
HEALTH AND DISABILITY COMMISSIONER	NATIVENAMER	TE TOIHAU HAUORA, HAUāTANGA
HAMAMATSU AIR BASE	NATIVENAMER	HAMAMATSU-KICHI
SHIZUHAMA AIR BASE	NATIVENAMER	SHIZUHAMA-KICHI
TENIENTE R. MARSH AIRPORT	NATIVENAMER	AEROPUERTO VILLA LAS ESTRELLAS
MINAMI TORISHIMA AIRPORT	NATIVENAMER	MARCUS ISLAND AIRPORT
XI'AN XIGUAN AIRPORT	NATIVENAMER	Xī'āN XīGUāN JīCHǎNG
ASSOCIATE DIRECTOR OF NATIONAL INTELLIGENCE AND CHIEF INFORMATION OFFICER	NATIVENAMER	IC CIO
KASUMINOME AIR FIELD	NATIVENAMER	KASUMINOME HIKōJō
SHIMOFUSA AIR BASE	NATIVENAMER	SHIMOFUSA KōKū KICHI
NYUTABARU AIR BASE	NATIVENAMER	NYūTABARU KITCH
OZUKI AIR FIELD	NATIVENAMER	OZUKI HIKōJō
MATSUSHIMA AIR FIELD	NATIVENAMER	MATSUSHIMA HIKōJō
KōNAN AIRPORT	NATIVENAMER	KōNAN HIKōJō
KASUMIGAURA AIR FIELD	NATIVENAMER	KASUMIGAURA HIKōJō
KISARAZU AIR FIELD	NATIVENAMER	KISARAZU HIKōJō
GIFU AIR FIELD	NATIVENAMER	GIFU HIKōJō
METABARU AIR FIELD	NATIVENAMER	METABARU HIKōJō
KANOYA AIR FIELD	NATIVENAMER	KANOYA HIKōJō
HōFU AIR FIELD	NATIVENAMER	HōFU HIKōJō
JMSDF HACHINOHE AIR BASE	NATIVENAMER	HACHINOHE KOKU-KICHI
KōZUSHIMA AIRPORT	NATIVENAMER	KōZUSHIMA KūKō
NIIJIMA AIRPORT	NATIVENAMER	NIIJIMA KūKō
ASHIYA AIR FIELD	NATIVENAMER	ASHIYA HIKōJō
JMSDF TATEYAMA AIR BASE	NATIVENAMER	TATEYAMA KOKU-KICHI
UTSUNOMIYA AIR FIELD	NATIVENAMER	UTSUNOMIYA HIKōJō
TSUIKI AIR FIELD	NATIVENAMER	TSUIKI HIKōJō
NARITA INTERNATIONAL AIRPORT	NATIVENAMER	(NARITA KOKUSAI KūKō)
ITAMI AIRPORT	NATIVENAMER	ITAMI KūKō
ITAMI AIRPORT	NATIVENAMER	ŌSAKA KOKUSAI KūKō
CHINA ATOMIC ENERGY AUTHORITY	NATIVENAMER	GUóJIā YUáNZǐNéNG JīGòU
GRIESHEIM AIRPORT	NATIVENAMER	DARMSTADT ARMY AIRFIELD
CHARITIES SERVICES	NATIVENAMER	NGā RāTONGA KAUPAPA ATAWHAI
COUNCIL OF AGRICULTURE	NATIVENAMER	NóNGYè WěIYUáNHUì
RESEARCH, DEVELOPMENT AND EVALUATION COMMISSION	NATIVENAMER	YáNJIū FāZHǎN KǎOHé WěIYUáNHUì
DIRECTORATE GENERAL OF BUDGET, ACCOUNTING AND STATISTICS	NATIVENAMER	XíNGZHèNGYUàN ZHǔJì ZNGCHù
DIRECTORATE-GENERAL OF PERSONNEL ADMINISTRATION	NATIVENAMER	RéNSHì XíNGZHèNG ZǒNGCHù
ANQING TIANZHUSHAN AIRPORT	NATIVENAMER	ĀNQìNG TIāNZHùSHāN JīCHǎNG
MINISTRY OF EMPLOYMENT AND LABOR	NATIVENAMER	GOYONG NODONGBU
COMMISSIONE NAZIONALE PER LE SOCIETà E LA BORSA	NATIVENAMER	COMMISSIONE NAZIONALE PER LE SOCIETà E LA BORSA
MIDLAND ARMY AIRFIELD	NATIVENAMER	40
SAN ANGELO ARMY AIR FIELD	NATIVENAMER	40
CHILDRESS ARMY AIRFIELD	NATIVENAMER	40
COMISIóN NACIONAL DEL MERCADO DE VALORES	NATIVENAMER	COMISIóN NACIONAL DEL MERCADO DE VALORES
SECURITIES COMMISSION	NATIVENAMER	COMISSãO DE VALORES MOBILIáRIOS
BUREAU OF SPECIAL INVESTIGATION	NATIVENAMER	AHTU SONZAN HSITSEYE HTANA
IIT KANPUR AIRPORT	NATIVENAMER	کلیانپور ہوئی ادا
BANKING, FINANCE AND INSURANCE COMMISSION	NATIVENAMER	COMMISSION BANCAIRE, FINANCIèRE ET DES ASSURANCES
YUSHU BATANG AIRPORT	NATIVENAMER	YùSHù BATáNG JīCHǎNG
SAVINGS DEPOSIT INSURANCE FUND OF TURKEY	NATIVENAMER	TASARRUF MEVDUATı SIGORTA FONU
FINANCIAL SUPERVISORY AUTHORITY	NATIVENAMER	FINANSTILSYNET
NAL AIRPORT	NATIVENAMER	नाल हवाई अड्डे
NGARI GUNSA AIRPORT	NATIVENAMER	ĀLǐ KūNSHā JīCHǎNG
BENGBU AIRPORT	NATIVENAMER	BèNGBù JīCHǎNG
FUYANG XIGUAN AIRPORT	NATIVENAMER	FùYáNG XīGUāN JīCHǎNG
WONSAN KALMA INTERNATIONAL AIRPORT	NATIVENAMER	WONSAN GALMA GUKJE GONGHANG
CAPITAL MARKETS BOARD OF TURKEY	NATIVENAMER	SERMAYE PIYASASı KURULU
FOSHAN SHADI AIRPORT	NATIVENAMER	FóSHāN SHāDī JīCHǎNG
CHICHIJIMA AIRFIELD	NATIVENAMER	CHICHIJIMA HIKōJō
DEPARTMENT OF FORESTS AND WILDLIFE	NATIVENAMER	VANA VANYAJEEVI VAKUPPU
PAYAM INTERNATIONAL AIRPORT	NATIVENAMER	FRODKAHE PAYAM
MINISTRY OF HEALTH	NATIVENAMER	''
WUZHOU CHANGZHOUDAO AIRPORT	NATIVENAMER	WúZHōU CHǎNGZHōUDǎO JīCHǎNG
JIXI XINGKAIHU AIRPORT	NATIVENAMER	JīXI XìNGKǎIHú JīCHǎNG
KOREA COMMUNICATIONS COMMISSION	NATIVENAMER	DAEHANMINGUK BANGSONGTONGSIN WIWONHOE
TENGCHONG TUOFENG AIRPORT	NATIVENAMER	TéNGCHōNG TUóFēNG JīCHǎNG
CONNEMARA AIRPORT	NATIVENAMER	AERFORT NA MINNE
NEW CHITOSE AIRPORT	NATIVENAMER	(SHIN-CHITOSE KūKō)
PUNTLAND INTELLIGENCE AGENCY	NATIVENAMER	وكالة الاستخبارات بونتلاند
MINISTRY OF PUBLIC SAFETY AND SECURITY	NATIVENAMER	GUNGMIN-ANJEONCHEO
NATIONAL ELECTION COMMISSION	NATIVENAMER	JUNGANG SEONGEO GWALLIWIWONHOE
MINISTRY OF THE INTERIOR AND DECENTRALIZATION	NATIVENAMER	MINISTèRE DE L'INTéRIEUR ET DE LA DéCENTRALISATION
CYPRUS SECURITIES AND EXCHANGE COMMISSION	NATIVENAMER	Επιτροπή Κεφαλαιαγοράς
CASCO COVE COAST GUARD STATION	NATIVENAMER	60
BULLEN POINT SHORT RANGE RADAR SITE	NATIVENAMER	60
OLIKTOK LONG RANGE RADAR SITE	NATIVENAMER	60
POINT BARROW LONG RANGE RADAR SITE	NATIVENAMER	60
LOCAL GOVERNMENT OFFICIALS DEVELOPMENT INSTITUTE	NATIVENAMER	JIBANG HAENGJEONG YEONSUWON
MINISTRY OF EDUCATION, SCIENCE AND TECHNOLOGY	NATIVENAMER	GYOYUKGWAHAKGISULBU
MINISTRY OF EDUCATION	NATIVENAMER	GYOYUKBU
MINISTRY OF GENDER EQUALITY AND FAMILY	NATIVENAMER	YEOSEONGGAJOKBU
MINISTRY OF LAND, INFRASTRUCTURE AND TRANSPORT	NATIVENAMER	GUKTOGYOTONGGBU
MINISTRY OF EQUIPMENT AND TRANSPORT	NATIVENAMER	ⵜⴰⵎⴰⵡⴰⵙⵜ ⵏ ⵓⵎⴰⵡⴰ ⴷ ⵡⴰⵙⵙⴰⵢ ⴷ ⵜⵍⵓⵊⵉⵙⵜⵉⵜ
MINISTRY OF EQUIPMENT AND TRANSPORT	NATIVENAMER	MINISTRE DE L'EQUIPEMENT ET DU TRANSPORT
DEPARTMENT OF INDUSTRIES	NATIVENAMER	VYVASAYA VAKKUPPU
HELLENIC CAPITAL MARKET COMMISSION	NATIVENAMER	Η Επιτροπή Κεφαλαιαγοράς
KUNMING CHANGSHUI INTERNATIONAL AIRPORT	NATIVENAMER	KūNMíNG CHáNGSHUǐ GUóJì JīCHǎNG
STATE SPECIAL COMMUNICATIONS SERVICE OF UKRAINE	NATIVENAMER	STATE SPECIAL COMMUNICATIONS SERVICE OF UKRAINE
YULIN YUYANG AIRPORT	NATIVENAMER	YúLíN YúYáNG JīCHǎNG
JHANSI AIRPORT	NATIVENAMER	ARMY AVIATION CORPS
MEERUT AIRPORT	NATIVENAMER	B.R. AMBEDKAR AIRPORT
BAREILLY AIRPORT	NATIVENAMER	TRISHUL AIR BASE
LUCKNOW AIR FORCE STATION	NATIVENAMER	लखनऊ एयरफोर्स स्टेशन
KUSHINAGAR AIRPORT	NATIVENAMER	KASIA AIRPORT
MORADABAD AIRPORT	NATIVENAMER	मुरादाबाद हवाई अड्डे
QIANJIANG WULINGSHAN AIRPORT	NATIVENAMER	QIáNJIāNG WǔLíNGSHāN JīCHǎNG
DAQING SARTU AIRPORT	NATIVENAMER	DàQìNG Sà'ěRTú JīCHǎNG
CHANGHAI AIRPORT	NATIVENAMER	ZHǎNGHǎI DàZHǎNGSHāNDǎO JīCHǎNG
CHANGBAISHAN AIRPORT	NATIVENAMER	CHáNGBáISHāN JīCHǎNG
HAMI AIRPORT	NATIVENAMER	HāMì JīCHǎNG
ZHONGWEI SHAPOTOU AIRPORT	NATIVENAMER	ZHōNGWèI SHāPōTóU JīCHǎNG
HANDAN AIRPORT	NATIVENAMER	HáNDāN JīCHǎNG
TANGSHAN SANNüHE AIRPORT	NATIVENAMER	TáNGSHāN SāNNǚHé JīCHǎNG
GUYUAN LIUPANSHAN AIRPORT	NATIVENAMER	GùYUáN LIùPáNSHāN JīCHǎNG
BOLE ALASHANKOU AIRPORT	NATIVENAMER	BóLè ĀLāSHāNKǒU JīCHǎNG
KANAS AIRPORT	NATIVENAMER	KāNàSī JīCHǎNG
XINYUAN NALATI AIRPORT	NATIVENAMER	NàLāTí JīCHǎNG
TURPAN JIAOHE AIRPORT	NATIVENAMER	TǔLǔFāN JIāOHé JīCHǎNG
ERENHOT SAIWUSU INTERNATIONAL AIRPORT	NATIVENAMER	ÈRLIáNHàOTè SàIWūSū GUóJì JīCHǎNG
LIBO AIRPORT	NATIVENAMER	LìBō JīCHǎNG
CHAOYANG AIRPORT	NATIVENAMER	CHāOYáNG JīCHǎNG
KANGDING AIRPORT	NATIVENAMER	KāNGDìNG JīCHǎNG
TIANSHUI MAIJISHAN AIRPORT	NATIVENAMER	TIāNSHUǐ MàIJīSHāN JīCHǎNG
SHIGATSE PEACE AIRPORT	NATIVENAMER	RìKāZé HéPíNG JīCHǎNG
MOHE GULIAN AIRPORT	NATIVENAMER	MòHé GǔLIáN JīCHǎNG
YONGZHOU LINGLING AIRPORT	NATIVENAMER	YǒNGZHōU LíNGLíNG JīCHǎNG
XINGTAI DALIAN AIRPORT	NATIVENAMER	XíNGTáI DāLIáN JīCHǎNG
JINCHANG JINCHUAN AIRPORT	NATIVENAMER	JīNCHāNG JīNCHUāN JīCHǎNG
CHENGDE PUNING AIRPORT	NATIVENAMER	CHéNGDé JīCHǎNG
BAYANNUR TIANJITAI AIRPORT	NATIVENAMER	BAYàNNàO'ěR TIāNJíTàI JīCHǎNG
CHIZHOU JIUHUASHAN AIRPORT	NATIVENAMER	CHíZHōU JIǔHUàSHāN JīCHǎNG
ZHANGYE GANZHOU AIRPORT	NATIVENAMER	ZHāNGYè GāNZHōU JīCHǎNG
TONGHUA SANYUANPU AIRPORT	NATIVENAMER	TōNGHUà SāNYUáNPǔ JīCHǎNG
JIAXING AIRPORT	NATIVENAMER	JIāXìNG JīCHǎNG
SHAOGUAN GUITOU AIRPORT	NATIVENAMER	SHáOGUāN GUìTóU JīCHǎNG
SHENNONGJIA HONGPING AIRPORT	NATIVENAMER	SHéNNóNGJIà HóNGPíNG JīCHǎNG
DELINGHA AIRPORT	NATIVENAMER	DéLìNGHā JīCHǎNG
WUSHAN SHENNüFENG AIRPORT	NATIVENAMER	WūSHāN SHéNNǚFēNG JīCHǎNG
HENGYANG BAJIALING AIRPORT	NATIVENAMER	HéNGYáNG BāJIǎLǐNG JīCHǎNG
JIAGEDAQI AIRPORT	NATIVENAMER	JIāGéDáQí JīCHǎNG
HECHI JINCHENGJIANG AIRPORT	NATIVENAMER	HéCHí JīNCHéNGJIāNG JīCHǎNG
YICHUN MINGYUESHAN AIRPORT	NATIVENAMER	YíCHūN MíNGYUèSHāN JīCHǎNG
LINFEN QIAOLI AIRPORT	NATIVENAMER	LíNFéN QIáOLI JīCHǎNG
XINYANG MINGGANG AIRPORT	NATIVENAMER	XìNYáNG MíNGGǎNG JīCHǎNG
ARXAN YI'ERSHI AIRPORT	NATIVENAMER	Ā'ěRSHāN Yī'ěRSHī JīCHǎNG
GANNAN XIAHE AIRPORT	NATIVENAMER	GāNNáN XIàHé JīCHǎNG
KAILI HUANGPING AIRPORT	NATIVENAMER	KǎILǐ HUáNGPíNG JīCHǎNG
HONGYUAN AIRPORT	NATIVENAMER	HóNGYUáN JīCHǎNG
OFFICE OF THE CLERK OF THE HOUSE OF REPRESENTATIVES	NATIVENAMER	TE TARI O TE MANAHAUTū O TE WHARE MāNGAI
STATE COMMITTEE IN TELEVISION AND RADIO-BROADCASTING	NATIVENAMER	Держкомтелерадіо
RAEBARELI AIRPORT	NATIVENAMER	FURSATGANJ AIRFIELD
LAKHIMPUR KHERI AIRPORT	NATIVENAMER	PALIYA AIRPRT
CABINET SECRETARIAT	NATIVENAMER	NAIKAKU-KANBō
HUATUGOU AIRPORT	NATIVENAMER	HUāTǔGōU JīCHǎNG
HANZHONG CHENGGU AIRPORT	NATIVENAMER	HàNZHōNG CHéNGGù JīCHǎNG
DONGSHA ISLAND AIRPORT	NATIVENAMER	DōNGSHā KōNGJūN JīDì
DONGSHA ISLAND AIRPORT	NATIVENAMER	DōNGSHā JīCHǎNG
GOLFO DE MORROSQUILLO AIRPORT	NATIVENAMER	AEROPUERTO DE TOLú
DUHOK INTERNATIONAL AIRPORT	NATIVENAMER	(فڕۆکه‌خانه‌ی نێوده‌وڵه‌تی )
NATIONAL NUCLEAR SAFETY ADMINISTRATION	NATIVENAMER	GUóJIā Hé āNQUáN Jú
STATE ARCHIVES ADMINISTRATION	NATIVENAMER	GUóJIā DàNG'àN Jú / ZHōNGYāNG DàNG'àN GUǎN
FINNISH FINANCIAL SUPERVISORY AUTHORITY	NATIVENAMER	FINANSSIVALVONTA
FINNISH FINANCIAL SUPERVISORY AUTHORITY	NATIVENAMER	FINANSINSPEKTIONEN
RENHUAI MAOTAI AIRPORT	NATIVENAMER	RéNHUáI MáOTáI JīCHǎNG
CYPRUS FIRE SERVICE	NATIVENAMER	PIROSVESTIKI IPIRESIA KIPROU
CYPRUS FIRE SERVICE	NATIVENAMER	EIDIKI MONADA ANTIMETOPISIS KATASTROFON
RECONSTRUCTION AGENCY	NATIVENAMER	FUKKō-CHō
RAF CLIFTON	NATIVENAMER	90
SHANGQIU AIRPORT	NATIVENAMER	SHāNGQIū JīCHǎNG
FUYUAN DONGJI AIRPORT	NATIVENAMER	FǔYUǎN DōNGJí JīCHǎNG
SHIHEZI HUAYUAN AIRPORT	NATIVENAMER	SHíHéZI HUãYUáN JīCHǎNG
YONGXING ISLAND AIRPORT	NATIVENAMER	YǒNGXīNG DǎO JīCHǎNG
YIBIN WULIANGYE AIRPORT	NATIVENAMER	YIBīN WǔLIáNGYè JīCHǎNG
LONGNAN CHENGZHOU AIRPORT	NATIVENAMER	LǒNGNáN CHéNGZHōU JīCHǎNG
GANZHOU HUANGJIN AIRPORT	NATIVENAMER	(GàNZHōU HUáNGJīN JīCHǎNG)
CONSUMER AFFAIRS AGENCY	NATIVENAMER	SHOUHISHA-CHō
HISAR AIRPORT	NATIVENAMER	HISAR FLYING CLUB
JAGODINA AIRPORT	NATIVENAMER	AERODROM JAGODINA
NANJING DAJIAOCHANG AIRPORT	NATIVENAMER	NáNJīNG DàJIàOCHǎNG JīCHǎNG
NANJING LUHE AIRPORT	NATIVENAMER	NáNJīNG LùHé JīCHǎNG
GOLOG MAQIN AIRPORT	NATIVENAMER	GUǒLUò MǎQìN JīCHǎNG
RAF BERROW	NATIVENAMER	90
HONGHE MENGZI AIRPORT	NATIVENAMER	HóNGHé MéNGZì JīCHǎNG
BAICHENG CHANG'AN AIRPORT	NATIVENAMER	BáICHéNG CHáNG'āN JīCHǎNG
FINANCIAL SERVICES AUTHORITY	NATIVENAMER	OTORITAS JASA KEUANGAN
MINISTRY OF JUSTICE	NATIVENAMER	BEOBMUBU
ASSOCIATION OF EAST ASIAN RELATIONS	NATIVENAMER	Yà DōNG GUāNXì XIéHUì
GIMHAE AIR BASE	NATIVENAMER	KIMHAE KONGGUN KIGE
SUWON AIR BASE	NATIVENAMER	SUWON KONGGUN KIGE
JINHAE AIRPORT	NATIVENAMER	JINHAE KONGHANG
ZHALANTUN CHENGJISIHAN AIRPORT	NATIVENAMER	ZHāLáNTúN JīCHǎNG
SHAOYANG WUGANG AIRPORT	NATIVENAMER	SHàOYáNG WǔGāNG JīCHǎNG
SUPREME PROSECUTOR OFFICE	NATIVENAMER	ZUìGāO FǎYUàN JIǎNCHá SHǔ
ULANQAB AIRPORT	NATIVENAMER	WūLáNCHáBù JīCHǎNG
JIANSANJIANG AIRPORT	NATIVENAMER	JIàNSāNJIāNG JīCHǎNG
RIZHAO SHANZIHE AIRPORT	NATIVENAMER	RìZHàO SHāNZìHé JīCHǎNG
VATICAN CITY HELIPORT	NATIVENAMER	ELIPORTO DI CITTà DEL VATICANO
ADMINISTRATION FOR SECURITY AND COUNTERINTELLIGENCE	NATIVENAMER	(UPRAVA ZA BEZBEDNOST I KONTRARAZUZNAVANJE )
ARCHITECTURE AND BUILDING RESEARCH INSTITUTE	NATIVENAMER	JIàNZHú YáNJIūSUǒ
NATIONAL SECURITY COMMISSION OF THE COMMUNIST PARTY OF CHINA	NATIVENAMER	ZHōNGYāNG GUóJIā'āNQUáN WěIYUáNHUì
WUDALIANCHI AIRPORT	NATIVENAMER	WǔDàLIáNCHí JīCHǎNG
WULONG XIANNüSHAN AIRPORT	NATIVENAMER	WǔLóNG XIāNNǚSHāN JīCHǎNG
LUZHOU YUNLONG AIRPORT	NATIVENAMER	LúZHōU YúNLóNG JīCHǎNG
NATIONAL DEVELOPMENT COUNCIL	NATIVENAMER	GUóJIā FāZHǎN WěIYUáNHUì
JAHROM AIRPORT	NATIVENAMER	FARūDEGāH-E JAHROM
SHACHE AIRPORT	NATIVENAMER	SHāCHē JīCHǎNG
TUMXUK AIRPORT	NATIVENAMER	TúMùSHūKè JīCHǎNG
SHASHI AIRPORT	NATIVENAMER	SHāSHì JīCHǎNG
NATIONAL SECURITY COUNCIL	NATIVENAMER	KOKKA-ANZEN-HOSHō-KAIGI
NATIONAL SECURITY COUNCIL	NATIVENAMER	GUóJIā ᾹNQUáN HUìYì
TAIWAN AREA NATIONAL FREEWAY BUREAU	NATIVENAMER	TáIWāN Qū GUóDàO GāOSù GōNGLù Jú
RUOQIANG LOULAN AIRPORT	NATIVENAMER	RUòQIāNG LóULáN JīCHǎNG
ARMAMENTS BUREAU	NATIVENAMER	JūNBèIJú
MINISTRY OF HOME AFFAIRS	NATIVENAMER	SARāṣṭRA MONTRONALOYA
JINZHOU BAY AIRPORT	NATIVENAMER	JǐNZHōUWāN JīCHǎNG
DEFENSE ACQUISITION PROGRAM ADMINISTRATION	NATIVENAMER	BANG-WI SAEOP-CHEONG
THE KOREA TRANSPORT INSTITUTE	NATIVENAMER	HANGUK GYOTONG YEONGUWON
NKVD	NATIVENAMER	NARóDNYI KOMISSARIáT VNúTRENNIKH DéL
NATIONAL UNIFICATION ADVISORY COUNCIL	NATIVENAMER	MIN-JU-PYEONG-HWA-TONG-IL-JA-MUN-HOE-UI
CENTERS FOR DISEASE CONTROL	NATIVENAMER	WèISHēNG FúLì Bù JíBìNG GUǎNZHì SHǔ
BAPPEDA KOTA LHOKSEUMAWE	NATIVENAMER	BAPPEDA KOTA LHOKSEUMAWE
INTELLIGENCE AGENCY OF REPUBLIC OF MACEDONIA	NATIVENAMER	(AGENCIJA ZA RAZUZNAVANJE )
MILITARY SERVICE FOR SECURITY AND INTELLIGENCE	NATIVENAMER	(SEKTOR - SLUžBA ZA VOENA BEZBEDNOST I RAZUZNAVANJE )
BAZHONG ENYANG AIRPORT	NATIVENAMER	BāZHōNG ĒNYáNG JīCHǎNG
WUZHOU XIJIANG AIRPORT	NATIVENAMER	WUZHOU XIJIANG JīCHǎNG
QILIAN AIRPORT	NATIVENAMER	QíLIáN JīCHǎNG
SUPERINTENDENCIA FINANCIERA DE COLOMBIA	NATIVENAMER	SUPERINTENDENCIA FINANCIERA DE COLOMBIA
ANKANG FUQIANG AIRPORT	NATIVENAMER	ĀNKāNG FùQIáNG JīCHǎNG
SONGYUAN CHAGANHU AIRPORT	NATIVENAMER	SōNGYUáN CHáGāNHú JīCHǎNG
NATIONAL EMERGENCY MANAGEMENT AGENCY	NATIVENAMER	ANJEON HAENGJEONG-BU
MINISTRY OF COMMUNICATIONS	NATIVENAMER	TEISHIN-SHō
MINISTRY OF GOVERNMENT LEGISLATION	NATIVENAMER	BEOB-JE-CHEO
MINISTRY OF AGRICULTURE, FOOD AND RURAL AFFAIRS	NATIVENAMER	NONGNIM CHUCKSAN SIKPUM-BU
PINJORE AIRPORT	NATIVENAMER	KALKA FLYING CLUB
BHIWANI AIRPORT	NATIVENAMER	BHIWANI FLYING CLUB
MINISTRY OF DEFENCE	NATIVENAMER	KAKWEYE WUNGYI HTANA
SUIFENHE AIRPORT	NATIVENAMER	SUíFēNHé JīCHǎNG
OITAKENOU AIRPORT	NATIVENAMER	OITAKENOU HIKōJYō
STATE AGENCY FOR NATIONAL SECURITY	NATIVENAMER	DARZHAVNA AGENTSIYA \
XIANGXI AIRPORT	NATIVENAMER	XIANGXI JīCHǎNG
CHENZHOU BEIHU AIRPORT	NATIVENAMER	CHēNZHōU BěIHú JīCHǎNG
ARCHIVES OF REPUBLIKA SRPSKA	NATIVENAMER	ARHIV REPUBLIKE SRPSKE
THE TRADE DELEGATION OF THE RUSSIAN FEDERATION IN THE UNITED KINGDOM	NATIVENAMER	Торговое представительство Российской Федерации в Великобритании
MEDICAL AFFAIRS BUREAU	NATIVENAMER	JūNYīJú
GARZE GESAR AIRPORT	NATIVENAMER	GāNZī GéSà'ěR JīCHǎNG
DALIAN JINZHOUWAN INTERNATIONAL AIRPORT	NATIVENAMER	DàLIáN JīNZHōUWāN GUóJì JīCHǎNG
ABADEH AIRPORT	NATIVENAMER	FARūDEGāH-E ĀBāDE
ARMED FORCES DIVISION	NATIVENAMER	BāNLāDēśA SAśASTRA BāHINī BIBHāGA
TALDYKORGAN AIRPORT	NATIVENAMER	Аэропорт Талдыкорган
ZAYSAN AIRPORT	NATIVENAMER	Аэропорт Зайсан
CABINET DIVISION	NATIVENAMER	BāNLāDēśA MANTRIPARIṣADA BIBHāGA
NEW PAROS AIRPORT	NATIVENAMER	\
NATIONAL OFFICE OF BUDDHISM	NATIVENAMER	SăM-NáK NGAAN PRá PúT-Tá-SàAT-Sà-NăA HàENG CHâAT
