TOURADA	NEXTLINK	E DEPOIS DO ADEUS
GLEðIBANKINN	NEXTLINK	HæGT OG HLJóTT
DRAUMUR UM NíNU	NEXTLINK	NEI EðA Já
FLIEGER	NEXTLINK	FREI ZU LEBEN
LET ME TRY	NEXTLINK	TORNERò
MARIANNE	NEXTLINK	DUE GROSSE LACRIME BIANCHE
7TH WONDER	NEXTLINK	TO DREAM AGAIN
L'AMOUR EST BLEU	NEXTLINK	NOUS VIVRONS D'AMOUR
QUAND JE TE RêVE	NEXTLINK	UN BAISER VOLé
TEENAGE LIFE	NEXTLINK	FLYING THE FLAG
EIN BIßCHEN FRIEDEN	NEXTLINK	RüCKSICHT
FåNGAD AV EN STORMVIND	NEXTLINK	I MORGON äR EN ANNAN DAG
IN YOUR EYES	NEXTLINK	ROCK 'N' ROLL KIDS
NOCTURNE	NEXTLINK	I EVIGHET
THE VOICE	NEXTLINK	MYSTERIOUS WOMAN
DIVA	NEXTLINK	YOM HULEDET
FLY ON THE WINGS OF LOVE	NEXTLINK	NEVER EVER LET YOU GO
REFRAIN	NEXTLINK	L'ENFANT QUE J'éTAIS
NET ALS TOEN	NEXTLINK	HEEL DE WERELD
'N BEETJE	NEXTLINK	WAT EEN GELUK
UN PREMIER AMOUR	NEXTLINK	ELLE éTAIT SI JOLIE
NOUS LES AMOUREUX	NEXTLINK	PETIT BONHOMME
DANSEVISE	NEXTLINK	SANGEN OM DIG
MERCI, CHéRIE	NEXTLINK	WARUM ES HUNDERTTAUSEND STERNE GIBT
LA, LA, LA	NEXTLINK	VIVO CANTANDO
VIVO CANTANDO	NEXTLINK	GWENDOLYNE
UN JOUR, UN ENFANT	NEXTLINK	MARIE-BLANCHE
UN BANC, UN ARBRE, UNE RUE	NEXTLINK	COMME ON S'AIME
APRèS TOI	NEXTLINK	TU TE RECONNAîTRAS
L'OISEAU ET L'ENFANT	NEXTLINK	IL Y AURA TOUJOURS DES VIOLONS
HALLELUJAH	NEXTLINK	HALAYLA
WITHOUT YOUR LOVE	NEXTLINK	ANYTIME YOU NEED
LORRAINE	NEXTLINK	LET ME CRY
THE IMAGE OF YOU	NEXTLINK	TOMORROW I GO
TOMORROW I GO	NEXTLINK	ZJARR E FTOHTë
ZJARR E FTOHTë	NEXTLINK	HEAR MY PLEA
JUGAREM A ESTIMAR-NOS	NEXTLINK	LA MIRADA INTERIOR
LA MIRADA INTERIOR	NEXTLINK	SENSE TU
SENSE TU	NEXTLINK	SALVEM EL MóN
DER K UND K KALYPSO AUS WIEN	NEXTLINK	DU HAST MICH SO FASZINIERT
DIE GANZE WELT BRAUCHT LIEBE	NEXTLINK	DER K UND K KALYPSO AUS WIEN
WOHIN, KLEINES PONY%3F	NEXTLINK	DIE GANZE WELT BRAUCHT LIEBE
NUR IN DER WIENER LUFT	NEXTLINK	VIELLEICHT GESCHIEHT EIN WUNDER
WARUM ES HUNDERTTAUSEND STERNE GIBT	NEXTLINK	TAUSEND FENSTER
MUSIK	NEXTLINK	FALTER IM WIND
MY LITTLE WORLD	NEXTLINK	BOOM BOOM BOOMERANG
HEUTE IN JERUSALEM	NEXTLINK	DU BIST MUSIK
HURRICANE	NEXTLINK	EINFACH WEG
EINFACH WEG	NEXTLINK	KINDER DIESER WELT
DU BIST MUSIK	NEXTLINK	WENN DU DA BIST
KINDER DIESER WELT	NEXTLINK	DIE ZEIT IST EINSAM
DIE ZEIT IST EINSAM	NEXTLINK	NUR NOCH GEFüHL
NUR NOCH GEFüHL	NEXTLINK	LISA MONA LISA
LISA MONA LISA	NEXTLINK	NUR EIN LIED
NUR EIN LIED	NEXTLINK	KEINE MAUERN MEHR
KEINE MAUERN MEHR	NEXTLINK	VENEDIG IM REGEN
VENEDIG IM REGEN	NEXTLINK	ZUSAMMEN GEH'N
MARIA MAGDALENA	NEXTLINK	FüR DEN FRIEDEN DER WELT
DIE WELT DREHT SICH VERKEHRT	NEXTLINK	WEIL'S DR GUAT GOT
FüR DEN FRIEDEN DER WELT	NEXTLINK	DIE WELT DREHT SICH VERKEHRT
REFLECTION	NEXTLINK	ALL TO YOU
ALL TO YOU	NEXTLINK	SAY A WORD
SAY A WORD	NEXTLINK	WEIL DER MENSCH ZäHLT
DU BIST	NEXTLINK	Y ASí
Y ASí	NEXTLINK	GET A LIFE - GET ALIVE
MESSIEURS LES NOYéS DE LA SEINE	NEXTLINK	LE PLUS BEAU JOUR DE MA VIE
LE PLUS BEAU JOUR DE MA VIE	NEXTLINK	STRAATDEUNTJE
STRAATDEUNTJE	NEXTLINK	MA PETITE CHATTE
MA PETITE CHATTE	NEXTLINK	HOU TOCH VAN MIJ
HOU TOCH VAN MIJ	NEXTLINK	MON AMOUR POUR TOI
SEPTEMBER, GOUDEN ROOS	NEXTLINK	TON NOM
TON NOM	NEXTLINK	WAAROM?
WAAROM%3F	NEXTLINK	PRèS DE MA RIVIèRE
PRèS DE MA RIVIèRE	NEXTLINK	ALS HET WEER LENTE IS
UN PEU DE POIVRE, UN PEU DE SEL	NEXTLINK	IK HEB ZORGEN
IK HEB ZORGEN	NEXTLINK	QUAND TU REVIENDRAS
QUAND TU REVIENDRAS	NEXTLINK	JENNIFER JENNINGS
JENNIFER JENNINGS	NEXTLINK	VIENS L'OUBLIER
BABY, BABY	NEXTLINK	FLEUR DE LIBERTé
FLEUR DE LIBERTé	NEXTLINK	GELUKKIG ZIJN
GELUKKIG ZIJN	NEXTLINK	JUDY ET CIE
A MILLION IN ONE, TWO, THREE	NEXTLINK	L'AMOUR çA FAIT CHANTER LA VIE
HEY NANA	NEXTLINK	EURO-VISION
L'AMOUR çA FAIT CHANTER LA VIE	NEXTLINK	HEY NANA
LAISSEZ BRILLER LE SOLEIL	NEXTLINK	DOOR DE WIND
DOOR DE WIND	NEXTLINK	MACéDOMIENNE
LAAT ME NU GAAN	NEXTLINK	J'AIME LA VIE
SOLDIERS OF LOVE	NEXTLINK	LAISSEZ BRILLER LE SOLEIL
AVANTI LA VIE	NEXTLINK	LAAT ME NU GAAN
RENDEZ-VOUS	NEXTLINK	AVANTI LA VIE
SAMSON	NEXTLINK	SI TU AIMES MA MUSIQUE
MACéDOMIENNE	NEXTLINK	GEEF HET OP
NOUS, ON VEUT DES VIOLONS	NEXTLINK	IEMAND ALS JIJ
IEMAND ALS JIJ	NEXTLINK	LA VOIX EST LIBRE
LA VOIX EST LIBRE	NEXTLINK	LIEFDE IS EEN KAARTSPEL
DIS OUI	NEXTLINK	LIKE THE WIND
LIEFDE IS EEN KAARTSPEL	NEXTLINK	DIS OUI
SISTER	NEXTLINK	SANOMI
LE GRAND SOIR	NEXTLINK	JE T'ADORE
SVA BOL SVIJETA	NEXTLINK	OSTANI KRAJ MENE
OSTANI KRAJ MENE	NEXTLINK	DVADESET PRVI VIJEK
DVADESET PRVI VIJEK	NEXTLINK	ZA NAšU LJUBAV
GOODBYE	NEXTLINK	PUTNICI
HANO	NEXTLINK	NA JASTUKU ZA DVOJE
NA JASTUKU ZA DVOJE	NEXTLINK	NE BRINI
NE BRINI	NEXTLINK	IN THE DISCO
DON'T EVER CRY	NEXTLINK	NEK' TI BUDE LJUBAV SVA
NEK' TI BUDE LJUBAV SVA	NEXTLINK	NOSTALGIJA
NOSTALGIJA	NEXTLINK	SVETA LJUBAV
SVETA LJUBAV	NEXTLINK	PROBUDI ME
PROBUDI ME	NEXTLINK	NEKA MI NE SVANE
NEKA MI NE SVANE	NEXTLINK	MARIJA MAGDALENA
MARIJA MAGDALENA	NEXTLINK	KAD ZASPU ANđELI
KAD ZASPU ANđELI	NEXTLINK	STRINGS OF MY HEART
STRINGS OF MY HEART	NEXTLINK	EVERYTHING I WANT
EVERYTHING I WANT	NEXTLINK	VIšE NISAM TVOJA
YOU ARE THE ONLY ONE	NEXTLINK	VUKOVI UMIRU SAMI
VUKOVI UMIRU SAMI	NEXTLINK	MOJA šTIKLA
MOJA šTIKLA	NEXTLINK	VJERUJEM U LJUBAV
MONIKA	NEXTLINK	MONO I AGAPI
I AGAPI AKOMA ZI	NEXTLINK	ANNA MARIA LENA
ANNA MARIA LENA	NEXTLINK	TO KATALAVA ARGA
TO KATALAVA ARGA	NEXTLINK	TORA ZO
TORA ZO	NEXTLINK	ASPRO MAVRO
ASPRO MAVRO	NEXTLINK	APOPSE AS VRETHUME
APOPSE AS VRETHUME	NEXTLINK	MILAS POLI
STI FOTIA	NEXTLINK	MONO YIA MAS
ÍME áNTHROPOS KI EGó	NEXTLINK	STI FOTIA
MANA MOU	NEXTLINK	YENESIS
GENESIS	NEXTLINK	THA 'NE EROTAS
THA'NAI EROTAS	NEXTLINK	NOMIZA
FEELING ALIVE	NEXTLINK	STRONGER EVERY MINUTE
STRONGER EVERY MINUTE	NEXTLINK	ELA ELA
UH, JEG VILLE øNSKE JEG VAR DIG	NEXTLINK	DET VAR EN YNDIG TID
SKIBET SKAL SEJLE I NAT	NEXTLINK	JEG REV ET BLAD UD AF MIN DAGBOG
ANGELIQUE	NEXTLINK	VUGGEVISE
VUGGEVISE	NEXTLINK	DANSEVISE
SANGEN OM DIG	NEXTLINK	FOR DIN SKYLD
BOOM BOOM	NEXTLINK	DISCO TANGO
DISCO TANGO	NEXTLINK	TæNKER ALTID På DIG
TæNKER ALTID På DIG	NEXTLINK	KRøLLER ELLER EJ
VIDEO, VIDEO	NEXTLINK	KLODEN DREJER
KLODEN DREJER	NEXTLINK	DET' LIGE DET
DET' LIGE DET	NEXTLINK	SKU' DU SPøRG' FRA NO'EN?
EN LILLE MELODI	NEXTLINK	KA' DU SE HVA' JEG SA'?
DU ER FULD AF LøGN	NEXTLINK	EN LILLE MELODI
SKU' DU SPøRG' FRA NO'EN%3F	NEXTLINK	DU ER FULD AF LøGN
KA' DU SE HVA' JEG SA'%3F	NEXTLINK	VI MALER BYEN RøD
LIGE DER HVOR HJERTET SLåR	NEXTLINK	ALT DET SOM INGEN SER
ALT DET SOM INGEN SER	NEXTLINK	UNDER STJERNERNE På HIMLEN
UNDER STJERNERNE På HIMLEN	NEXTLINK	FRA MOLS TIL SKAGEN
FRA MOLS TIL SKAGEN	NEXTLINK	STEMMEN I MIT LIV
THIS TIME I MEAN IT	NEXTLINK	FLY ON THE WINGS OF LOVE
STEMMEN I MIT LIV	NEXTLINK	THIS TIME I MEAN IT
SHAME ON YOU	NEXTLINK	TALKING TO YOU
TALKING TO YOU	NEXTLINK	TWIST OF LOVE
NAGU MERELAINE	NEXTLINK	KAELAKEE HääL
RUNAWAY	NEXTLINK	EIGHTIES COMING BACK
KEELATUD MAA	NEXTLINK	MERE LAPSED
KAELAKEE HääL	NEXTLINK	KEELATUD MAA
EIGHTIES COMING BACK	NEXTLINK	TII
LET'S GET LOUD	NEXTLINK	THROUGH MY WINDOW
VALOA IKKUNASSA	NEXTLINK	TIPI-TII
TIPI-TII	NEXTLINK	MUISTOJENI LAULU
MUISTOJENI LAULU	NEXTLINK	LAISKOTELLEN
LAISKOTELLEN	NEXTLINK	AURINKO LASKEE LäNTEEN
PLAYBOY	NEXTLINK	VARJOON - SUOJAAN
VARJOON – SUOJAAN	NEXTLINK	KUN KELLO KäY
TOM TOM TOM	NEXTLINK	KEEP ME WARM
KUIN SILLOIN ENNEN	NEXTLINK	TIE UUTEEN PäIVääN
KUN KELLO KäY	NEXTLINK	KUIN SILLOIN ENNEN
TIE UUTEEN PäIVääN	NEXTLINK	MUISTATHAN
MUISTATHAN	NEXTLINK	TOM TOM TOM
KEEP ME WARM	NEXTLINK	OLD MAN FIDDLE
OLD MAN FIDDLE	NEXTLINK	PUMP-PUMP
LAPPONIA	NEXTLINK	ANNA RAKKAUDELLE TILAISUUS
ANNA RAKKAUDELLE TILAISUUS	NEXTLINK	KATSON SINEEN TAIVAAN
KATSON SINEEN TAIVAAN	NEXTLINK	HUILUMIES
HUILUMIES	NEXTLINK	REGGAE OK
REGGAE OK	NEXTLINK	NUKU POMMIIN
NUKU POMMIIN	NEXTLINK	FANTASIAA
FANTASIAA	NEXTLINK	HENGAILLAAN
HENGAILLAAN	NEXTLINK	ELäKööN ELäMä
ELäKööN ELäMä	NEXTLINK	NEVER THE END
NEVER THE END	NEXTLINK	SATA SALAMAA
YAMMA, YAMMA	NEXTLINK	TULE LUO
FRI%3F	NEXTLINK	HULLU Yö
LA DOLCE VITA	NEXTLINK	FRI?
ADDICTED TO YOU	NEXTLINK	TAKES 2 TO TANGO
BYE BYE BABY	NEXTLINK	NIIN KAUNIS ON TAIVAS
NIIN KAUNIS ON TAIVAS	NEXTLINK	AAVA
WHY%3F	NEXTLINK	HARD ROCK HALLELUJAH
LE TEMPS PERDU	NEXTLINK	IL EST Là
IL EST Là	NEXTLINK	LA BELLE AMOUR
OUI, OUI, OUI, OUI	NEXTLINK	TOM PILLIBI
PRINTEMPS, AVRIL CARILLONNE	NEXTLINK	UN PREMIER AMOUR
LE CHANT DE MALLORY	NEXTLINK	N'AVOUE JAMAIS
ELLE éTAIT SI JOLIE	NEXTLINK	LE CHANT DE MALLORY
N'AVOUE JAMAIS	NEXTLINK	CHEZ NOUS
MARIE-BLANCHE	NEXTLINK	UN JARDIN SUR LA TERRE
CHEZ NOUS	NEXTLINK	IL DOIT FAIRE BEAU Là-BAS
UN JARDIN SUR LA TERRE	NEXTLINK	COMé-COMéDIE
UN, DEUX, TROIS	NEXTLINK	L'OISEAU ET L'ENFANT
COMé-COMéDIE	NEXTLINK	SANS TOI
SANS TOI	NEXTLINK	ET BONJOUR à TOI L'ARTISTE
IL Y AURA TOUJOURS DES VIOLONS	NEXTLINK	JE SUIS L'ENFANT SOLEIL
Hé, Hé M'SIEURS DAMES	NEXTLINK	HUMANAHUM
VIVRE	NEXTLINK	AUTANT D'AMOUREUX QUE D'éTOILES
AUTANT D'AMOUREUX QUE D'éTOILES	NEXTLINK	FEMME DANS SES RêVES AUSSI
FEMME DANS SES RêVES AUSSI	NEXTLINK	EUROPéENNES
EUROPéENNES	NEXTLINK	LES MOTS D'AMOUR N'ONT PAS DE DIMANCHE
LES MOTS D'AMOUR N'ONT PAS DE DIMANCHE	NEXTLINK	CHANTEUR DE CHARME
CHANTEUR DE CHARME	NEXTLINK	J'AI VOLé LA VIE
MONTé LA RIVIè	NEXTLINK	MAMA CORSICA
MAMA CORSICA	NEXTLINK	JE SUIS UN VRAI GARçON
JE SUIS UN VRAI GARçON	NEXTLINK	IL ME DONNE RENDEZ-VOUS
IL ME DONNE RENDEZ-VOUS	NEXTLINK	DIWANIT BUGALE
SENTIMENTS SONGES	NEXTLINK	Où ALLER
DIWANIT BUGALE	NEXTLINK	SENTIMENTS SONGES
JE VEUX DONNER MA VOIX	NEXTLINK	ON AURA LE CIEL
ON AURA LE CIEL	NEXTLINK	JE N'AI QUE MON âME
Où ALLER	NEXTLINK	JE VEUX DONNER MA VOIX
IL FAUT DU TEMPS	NEXTLINK	MONTS ET MERVEILLES
MONTS ET MERVEILLES	NEXTLINK	À CHAQUE PAS
CHACUN PENSE à SOI	NEXTLINK	IL éTAIT TEMPS
IL éTAIT TEMPS	NEXTLINK	L'AMOUR à LA FRANçAISE
IM WARTESAAL ZUM GROßEN GLüCK	NEXTLINK	SO GEHT DAS JEDE NACHT
TELEFON, TELEFON	NEXTLINK	FüR ZWEI GROSCHEN MUSIK
HEUTE ABEND WOLLEN WIR TANZEN GEH'N	NEXTLINK	BONNE NUIT MA CHéRIE
FüR ZWEI GROSCHEN MUSIK	NEXTLINK	HEUTE ABEND WOLLEN WIR TANZEN GEH'N
BONNE NUIT MA CHéRIE	NEXTLINK	EINMAL SEHEN WIR UNS WIEDER
EINMAL SEHEN WIR UNS WIEDER	NEXTLINK	ZWEI KLEINE ITALIENER
MARCEL	NEXTLINK	MAN GEWöHNT SICH SO SCHNELL AN DAS SCHöNE
PARADIES, WO BIST DU%3F	NEXTLINK	DIE ZEIGER DER UHR
ANOUSCHKA	NEXTLINK	EIN HOCH DER LIEBE
DIE ZEIGER DER UHR	NEXTLINK	ANOUSCHKA
EIN HOCH DER LIEBE	NEXTLINK	PRIMABALLERINA
WUNDER GIBT ES IMMER WIEDER	NEXTLINK	DIESE WELT
DIESE WELT	NEXTLINK	NUR DIE LIEBE LäßT UNS LEBEN
DIE SOMMERMELODIE	NEXTLINK	EIN LIED KANN EINE BRüCKE SEIN
JUNGER TAG	NEXTLINK	DIE SOMMERMELODIE
NUR DIE LIEBE LäßT UNS LEBEN	NEXTLINK	JUNGER TAG
EIN LIED KANN EINE BRüCKE SEIN	NEXTLINK	SING SANG SONG
THEATER	NEXTLINK	JOHNNY BLUE
JOHNNY BLUE	NEXTLINK	EIN BIßCHEN FRIEDEN
RüCKSICHT	NEXTLINK	AUFRECHT GEH'N
AUFRECHT GEH'N	NEXTLINK	FüR ALLE
FüR ALLE	NEXTLINK	ÜBER DIE BRüCKE GEH'N
LASS DIE SONNE IN DEIN HERZ	NEXTLINK	LIED FüR EINEN FREUND
FREI ZU LEBEN	NEXTLINK	DIESER TRAUM DARF NIEMALS STERBEN
LIED FüR EINEN FREUND	NEXTLINK	FLIEGER
FOR DIN SKYLD	NEXTLINK	STOP - MENS LEGEN ER GO'
TRäUME SIND FüR ALLE DA	NEXTLINK	VIEL ZU WEIT
DIESER TRAUM DARF NIEMALS STERBEN	NEXTLINK	TRäUME SIND FüR ALLE DA
VIEL ZU WEIT	NEXTLINK	WIR GEBEN 'NE PARTY
ZEIT	NEXTLINK	GUILDO HAT EUCH LIEB!
GUILDO HAT EUCH LIEB!	NEXTLINK	REISE NACH JERUSALEM – KUDüS'E SEYAHAT
LET'S GET HAPPY	NEXTLINK	CAN'T WAIT UNTIL TONIGHT
WER LIEBE LEBT	NEXTLINK	I CAN'T LIVE WITHOUT MUSIC
I CAN'T LIVE WITHOUT MUSIC	NEXTLINK	LET'S GET HAPPY
REISE NACH JERUSALEM – KUDüS'E SEYAHAT	NEXTLINK	WADDE HADDE DUDDE DA?
RUN & HIDE	NEXTLINK	NO NO NEVER
PANAGIA MOU, PANAGIA MOU	NEXTLINK	MATHIMA SOLFEGE
CHARLIE CHAPLIN	NEXTLINK	SOKRATI
FEGGARI KALOKERINO	NEXTLINK	MOU LES
DEIXA-ME SONHAR	NEXTLINK	FOI MAGIA
WADDE HADDE DUDDE DA%3F	NEXTLINK	WER LIEBE LEBT
MOU LES	NEXTLINK	MIAZOUME
CLOWN	NEXTLINK	TO DIKO SOU ASTERI
TO DIKO SOU ASTERI	NEXTLINK	HORIS SKOPO
HORIS SKOPO	NEXTLINK	I ANIXI
I ANIXI	NEXTLINK	OLOU TOU KOSMOU I ELPIDA
NO NO NEVER	NEXTLINK	FRAUEN REGIER'N DIE WELT
AUTOSTOP	NEXTLINK	FEGGARI KALOKERINO
TO TREHANDIRI	NEXTLINK	PIA PROSEFHI
PIA PROSEFHI	NEXTLINK	EMIS FORAME TO HIMONA ANIXIATIKA
EMIS FORAME TO HIMONA ANIXIATIKA	NEXTLINK	HOREPSE
HOREPSE	NEXTLINK	MIA KRIFI EVESTHISIA
MIA KRIFI EVESTHISIA	NEXTLINK	DIE FOR YOU
MIéRT KELL, HOGY ELMENJ%3F	NEXTLINK	A HOLNAP MáR NEM LESZ SZOMORú
FOROGJ, VILáG!	NEXTLINK	UNSUBSTANTIAL BLUES
ÞAð SEM ENGINN SéR	NEXTLINK	EITT LAG ENN
EITT LAG ENN	NEXTLINK	DRAUMUR UM NíNU
NæTUR	NEXTLINK	NúNA
NúNA	NEXTLINK	SJúBíDú
SJúBíDú	NEXTLINK	MINN HINSTI DANS
HALLO HALLO	NEXTLINK	LIGE DER HVOR HJERTET SLåR
MINN HINSTI DANS	NEXTLINK	ALL OUT OF LUCK
ALL OUT OF LUCK	NEXTLINK	TELL ME!
COME BACK TO STAY	NEXTLINK	IF I COULD CHOOSE
WALKING THE STREETS IN THE RAIN	NEXTLINK	COME BACK TO STAY
HEAVEN	NEXTLINK	IF I HAD YOUR LOVE
ELOISE	NEXTLINK	STJäRNORNA
CONGRATULATIONS	NEXTLINK	VALENTINE LOST
CHANCE OF A LIFETIME	NEXTLINK	THE WAGES OF LOVE
THE WAGES OF LOVE	NEXTLINK	ALL KINDS OF EVERYTHING
EVERY SONG IS A CRY FOR LOVE	NEXTLINK	THEY CAN'T STOP THE SPRING
ONE DAY LOVE	NEXTLINK	CEOL AN GHRá
DO I DREAM	NEXTLINK	CROSS YOUR HEART
WHEN	NEXTLINK	IT'S NICE TO BE IN LOVE AGAIN
HOROSCOPES	NEXTLINK	HERE TODAY GONE TOMORROW
SHIR HABATLANIM	NEXTLINK	BEN ADAM
TERMINAL 3	NEXTLINK	WAIT UNTIL THE WEEKEND COMES
SOMEWHERE IN EUROPE	NEXTLINK	COULD IT BE THAT I'M IN LOVE
MYSTERIOUS WOMAN	NEXTLINK	IS ALWAYS OVER NOW?
WHEN YOU NEED ME	NEXTLINK	MILLENNIUM OF LOVE
RUNNER IN THE NIGHT	NEXTLINK	ONLY THE LIGHT
WITHOUT YOUR LOVE	NEXTLINK	WE'VE GOT THE WORLD
WE'VE GOT THE WORLD	NEXTLINK	IF MY WORLD STOPPED TURNING
LOVE%3F	NEXTLINK	EVERY SONG IS A CRY FOR LOVE
EY SHAM	NEXTLINK	NATATI LA KHAYAY
NATATI LA KHAYAY	NEXTLINK	AT VA'ANI
AT VE'ANI	NEXTLINK	EMOR SHALOM
BOOGALOO	NEXTLINK	STAD I LJUS
AHAVA HI SHIR LISHNAYIM	NEXTLINK	A-BA-NI-BI
EMOR SHALOM	NEXTLINK	AHAVA HI SHIR LISHNAYIM
SAMEACH	NEXTLINK	EN DAVAR
OLé, OLé	NEXTLINK	YAVO YOM
YAVO YOM	NEXTLINK	SHIR HABATLANIM
BEN ADAM	NEXTLINK	DEREKH HAMELEKH
DEREKH HAMELEKH	NEXTLINK	SHARA BARKHOVOT
KAN	NEXTLINK	ZE RAK SPORT
ZE RAK SPORT	NEXTLINK	SHIRU
EN DAVAR	NEXTLINK	NADLIK BEYAKHAD NER
NADLIK BEYAKHAD NER	NEXTLINK	WORDS FOR LOVE
WORDS FOR LOVE	NEXTLINK	LEHA'AMIN
LEHA'AMIN	NEXTLINK	HASHEKET SHENISH'AR
APRITE LE FINESTRE	NEXTLINK	AMAMI SE VUOI
AMAMI SE VUOI	NEXTLINK	CORDE DELLA MIA CHITARRA
ROMANTICA	NEXTLINK	AL DI Là
UNO PER TUTTE	NEXTLINK	NON HO L'ETà
ADDIO, ADDIO	NEXTLINK	UNO PER TUTTE
DIO, COME TI AMO	NEXTLINK	NON ANDARE PIù LONTANO
DUE GROSSE LACRIME BIANCHE	NEXTLINK	OCCHI DI RAGAZZA
OCCHI DI RAGAZZA	NEXTLINK	L'AMORE è UN ATTIMO
L'AMORE è UN ATTIMO	NEXTLINK	I GIORNI DELL'ARCOBALENO
I GIORNI DELL'ARCOBALENO	NEXTLINK	CHI SARà CON TE
LIBERA	NEXTLINK	QUESTO AMORE
QUESTO AMORE	NEXTLINK	RAGGIO DI LUNA
ERA	NEXTLINK	WE'LL LIVE IT ALL AGAIN
RAGGIO DI LUNA	NEXTLINK	NON SO CHE DAREI
PER LUCIA	NEXTLINK	I TRENI DI TOZEUR
MAGIC OH MAGIC	NEXTLINK	GENTE DI MARE
I TRENI DI TOZEUR	NEXTLINK	MAGIC OH MAGIC
GENTE DI MARE	NEXTLINK	VIVO
AVREI VOLUTO	NEXTLINK	INSIEME: 1992
VIVO	NEXTLINK	AVREI VOLUTO
COMME è DDOCE 'O MARE	NEXTLINK	RAPSODIA
RAPSODIA	NEXTLINK	SOLE D'EUROPA
SOLE D'EUROPA	NEXTLINK	FIUMI DI PAROLE
BRA VIBRATIONER	NEXTLINK	E' DE' DET HäR DU KALLAR KäRLEK?
HELLO FROM MARS	NEXTLINK	DZIESMA PAR LAIMI
TERIAZOUME	NEXTLINK	MI STAMATAS
DZIESMA PAR LAIMI	NEXTLINK	THE WAR IS NOT OVER
THE WAR IS NOT OVER	NEXTLINK	I HEAR YOUR HEART
LOPšINė MYLIMAI	NEXTLINK	STRAZDAS
AMOUR ON T'AIME	NEXTLINK	IO COSì NON CI STO
STRAZDAS	NEXTLINK	YOU GOT STYLE
YOU GOT STYLE	NEXTLINK	HAPPY YOU
HAPPY YOU	NEXTLINK	WHAT'S HAPPENED TO YOUR LOVE?
LITTLE BY LITTLE	NEXTLINK	WE ARE THE WINNERS
NE CROIS PAS	NEXTLINK	LES AMANTS DE MINUIT
LES AMANTS DE MINUIT	NEXTLINK	AMOURS MORTES
AMOURS MORTES	NEXTLINK	UN GRAND AMOUR
UN GRAND AMOUR	NEXTLINK	SO LAANG WE'S DU DO BAST
SO LAANG WE'S DU DO BAST	NEXTLINK	NOUS LES AMOUREUX
NINANAJNA	NEXTLINK	MOJOT SVET
PETIT BONHOMME	NEXTLINK	À FORCE DE PRIER
À FORCE DE PRIER	NEXTLINK	DèS QUE LE PRINTEMPS REVIENT
CE SOIR JE T'ATTENDAIS	NEXTLINK	L'AMOUR EST BLEU
FRäMLING	NEXTLINK	DIGGI-LOO DIGGI-LEY
CATHERINE	NEXTLINK	JE SUIS TOMBé DU CIEL
POMME, POMME, POMME	NEXTLINK	APRèS TOI
TOI	NEXTLINK	CHANSONS POUR CEUX QUI S'AIMENT
FRèRE JACQUES	NEXTLINK	PARLEZ-VOUS FRANçAIS?
J'AI DéJà VU çA DANS TES YEUX	NEXTLINK	PAPA PINGOUIN
PARLEZ-VOUS FRANçAIS%3F	NEXTLINK	J'AI DéJà VU çA DANS TES YEUX
COURS APRèS LE TEMPS	NEXTLINK	SI LA VIE EST CADEAU
C'EST PEUT-êTRE PAS L'AMéRIQUE	NEXTLINK	COURS APRèS LE TEMPS
PAPA PINGOUIN	NEXTLINK	C'EST PEUT-êTRE PAS L'AMéRIQUE
CHILDREN, KINDER, ENFANTS	NEXTLINK	L'AMOUR DE MA VIE
MONSIEUR	NEXTLINK	QUAND JE TE RêVE
UN BAISER VOLé	NEXTLINK	SOU FRäI
SOU FRäI	NEXTLINK	DONNE-MOI UNE CHANCE
100%25 TE LJUBAM	NEXTLINK	OD NAS ZAVISI
NE ZORI, ZORO	NEXTLINK	100
MAKE MY DAY	NEXTLINK	NINANAJNA
MARIJA L-MALTIJA	NEXTLINK	L-IMħABBA
L-IMħABBA	NEXTLINK	SINGING THIS SONG
KEEP ME IN MIND	NEXTLINK	IN A WOMAN'S HEART
IN A WOMAN'S HEART	NEXTLINK	LET ME FLY
LET ME FLY	NEXTLINK	THE ONE THAT I LOVE
THE ONE THAT I LOVE	NEXTLINK	BELIEVE 'N PEACE
DESIRE	NEXTLINK	ANOTHER SUMMER NIGHT
ANOTHER SUMMER NIGHT	NEXTLINK	7
MON AMI PIERROT	NEXTLINK	CE SOIR-Là
ALLONS, ALLONS LES ENFANTS	NEXTLINK	DIS RIEN
DIS RIEN	NEXTLINK	L'AMOUR S'EN VA
L'AMOUR S'EN VA	NEXTLINK	Où SONT-ELLES PASSéES
Où SONT-ELLES PASSéES	NEXTLINK	VA DIRE à L'AMOUR
VA DIRE à L'AMOUR	NEXTLINK	BIEN PLUS FORT
BIEN PLUS FORT	NEXTLINK	BOUM-BADABOUM
BOUM-BADABOUM	NEXTLINK	À CHACUN SA CHANSON
MAMAN, MAMAN	NEXTLINK	MARLèNE
COMME ON S'AIME	NEXTLINK	UN TRAIN QUI PART
UN TRAIN QUI PART	NEXTLINK	CELUI QUI RESTE ET CELUI QUI S'EN VA
CELUI QUI RESTE ET CELUI QUI S'EN VA	NEXTLINK	UNE CHANSON C'EST UNE LETTRE
TOI, LA MUSIQUE ET MOI	NEXTLINK	UNE PETITE FRANçAISE
UNE PETITE FRANçAISE	NEXTLINK	LES JARDINS DE MONACO
LES JARDINS DE MONACO	NEXTLINK	NOTRE VIE C'EST LA MUSIQUE
NOTRE VIE C'EST LA MUSIQUE	NEXTLINK	NOTRE PLANèTE
NOTRE PLANèTE	NEXTLINK	TOUT DE MOI
TOUT DE MOI	NEXTLINK	LA COCO-DANCE
DE VOGELS VAN HOLLAND	NEXTLINK	VOORGOED VOORBIJ
VOORGOED VOORBIJ	NEXTLINK	NET ALS TOEN
HEEL DE WERELD	NEXTLINK	EEN BEETJE
WAT EEN GELUK	NEXTLINK	WAT EEN DAG
KATINKA	NEXTLINK	EEN SPEELDOOS
EEN SPEELDOOS	NEXTLINK	JIJ BENT MIJN LEVEN
JIJ BENT MIJN LEVEN	NEXTLINK	'T IS GENOEG
'T IS GENOEG	NEXTLINK	FERNANDO EN FILIPPO
FERNANDO EN FILIPPO	NEXTLINK	RING-DINGE-DING
MORGEN	NEXTLINK	DE TROUBADOUR
WATERMAN	NEXTLINK	TIJD
TIJD	NEXTLINK	ALS HET OM DE LIEFDE GAAT
DE OUDE MUZIKANT	NEXTLINK	I SEE A STAR
ALS HET OM DE LIEFDE GAAT	NEXTLINK	DE OUDE MUZIKANT
I SEE A STAR	NEXTLINK	DING-A-DONG
THE PARTY'S OVER	NEXTLINK	DE MALLEMOLEN
DE MALLEMOLEN	NEXTLINK	'T IS OK
AMSTERDAM	NEXTLINK	HET IS EEN WONDER
HET IS EEN WONDER	NEXTLINK	JIJ EN IK
JIJ EN IK	NEXTLINK	SING ME A SONG
SING ME A SONG	NEXTLINK	IK HOU VAN JOU
SHANGRI-LA	NEXTLINK	BLIJF ZOALS JE BENT
BLIJF ZOALS JE BENT	NEXTLINK	IK WIL ALLES MET JE DELEN
IK WIL ALLES MET JE DELEN	NEXTLINK	WIJS ME DE WEG
ERES Tú	NEXTLINK	CANTA Y Sé FELIZ
WAAR IS DE ZON	NEXTLINK	DE EERSTE KEER
VREDE	NEXTLINK	WAAR IS DE ZON?
DE EERSTE KEER	NEXTLINK	NIEMAND HEEFT NOG TIJD
NIEMAND HEEFT NOG TIJD	NEXTLINK	HEMEL EN AARDE
NO GOODBYES	NEXTLINK	OUT ON MY OWN
WITHOUT YOU	NEXTLINK	MY IMPOSSIBLE DREAM
MY IMPOSSIBLE DREAM	NEXTLINK	AMAMBANDA
VOI VOI	NEXTLINK	SOMMER I PALMA
SPIRAL	NEXTLINK	KARUSELL
KARUSELL	NEXTLINK	INTET ER NYTT UNDER SOLEN
INTET ER NYTT UNDER SOLEN	NEXTLINK	DUKKEMANN
OJ, OJ, OJ, Så GLAD JEG SKAL BLI	NEXTLINK	LYKKEN ER
VEN A BAILAR CONMIGO	NEXTLINK	HOLD ON BE STRONG
LYKKEN ER	NEXTLINK	SMåTING
SMåTING	NEXTLINK	IT'S JUST A GAME
IT'S JUST A GAME	NEXTLINK	THE FIRST DAY OF LOVE
CASANOVA	NEXTLINK	MIL ETTER MIL
OLIVER	NEXTLINK	SáMIID ÆDNAN
THE FIRST DAY OF LOVE	NEXTLINK	TOUCH MY LIFE
HæGT OG HLJóTT	NEXTLINK	Þú OG þEIR
Þú OG þEIR	NEXTLINK	ÞAð SEM ENGINN SéR
Þá VEISTU SVARIð	NEXTLINK	NæTUR
NEI EðA Já	NEXTLINK	Þá VEISTU SVARIð
DO RE MI	NEXTLINK	LENGE LEVE LIVET
LENGE LEVE LIVET	NEXTLINK	LA DET SWINGE
ROMEO	NEXTLINK	MITT LIV
THEY CAN'T STOP THE SPRING	NEXTLINK	IRELANDE DOUZE POINTE
MITT LIV	NEXTLINK	FOR VåR JORD
FOR VåR JORD	NEXTLINK	VENNERS NæRHET
MRS. THOMPSON	NEXTLINK	VISJONER
VISJONER	NEXTLINK	ALLE MINE TANKAR
ALLE MINE TANKAR	NEXTLINK	DUETT
SAN FRANCISCO	NEXTLINK	ALLTID SOMMER
ALLTID SOMMER	NEXTLINK	LIVING MY LIFE WITHOUT YOU
LIVING MY LIFE WITHOUT YOU	NEXTLINK	MY HEART GOES BOOM
ON MY OWN	NEXTLINK	I'M NOT AFRAID TO MOVE ON
ALVEDANSEN	NEXTLINK	VEN A BAILAR CONMIGO
ALE JESTEM	NEXTLINK	TO TAKIE PROSTE
CHCę ZNAć SWóJ GRZECH...	NEXTLINK	ALE JESTEM
SAMA	NEXTLINK	CHCę ZNAć SWóJ GRZECH...
KINEK MONDJAM EL VéTKEIMET%3F	NEXTLINK	ÚJ NéV A RéGI HáZ FALáN
TO TAKIE PROSTE	NEXTLINK	PRZYTUL MNIE MOCNO
PRZYTUL MNIE MOCNO	NEXTLINK	2
2 LONG	NEXTLINK	KEINE GRENZEN-ŻADNYCH GRANIC
LOVE SONG	NEXTLINK	CZARNA DZIEWCZYNA
CZARNA DZIEWCZYNA	NEXTLINK	FOLLOW MY HEART
ORAçãO	NEXTLINK	SOL DE INVERNO
SOL DE INVERNO	NEXTLINK	ELE E ELA
ELE E ELA	NEXTLINK	O VENTO MUDOU
O VENTO MUDOU	NEXTLINK	VERãO
VERãO	NEXTLINK	DESFOLHADA PORTUGUESA
DESFOLHADA PORTUGUESA	NEXTLINK	MENINA DO ALTO DA SERRA
A FESTA DA VIDA	NEXTLINK	TOURADA
MENINA DO ALTO DA SERRA	NEXTLINK	A FESTA DA VIDA
UMA FLOR DE VERDE PINHO	NEXTLINK	PORTUGAL NO CORAçãO
MADRUGADA	NEXTLINK	UMA FLOR DE VERDE PINHO
PORTUGAL NO CORAçãO	NEXTLINK	DAI LI DOU
PLAYBACK	NEXTLINK	BEM BOM
BEM BOM	NEXTLINK	ESTA BALADA QUE TE DOU
ESTA BALADA QUE TE DOU	NEXTLINK	SILêNCIO E TANTA GENTE
PENSO EM TI, EU SEI	NEXTLINK	NãO SEJAS MAU PARA MIM
NãO SEJAS MAU PARA MIM	NEXTLINK	NESTE BARCO à VELA
NESTE BARCO à VELA	NEXTLINK	VOLTAREI
Há SEMPRE ALGUéM	NEXTLINK	LUSITANA PAIXãO
VAMPIRES ARE ALIVE	NEXTLINK	ERA STUPENDO
LUSITANA PAIXãO	NEXTLINK	AMOR D'áGUA FRESCA
AMOR D'áGUA FRESCA	NEXTLINK	A CIDADE
A CIDADE	NEXTLINK	CHAMAR A MúSICA
CHAMAR A MúSICA	NEXTLINK	BAUNILHA E CHOCOLATE
BAUNILHA E CHOCOLATE	NEXTLINK	O MEU CORAçãO NãO TEM COR
O MEU CORAçãO NãO TEM COR	NEXTLINK	ANTES DO ADEUS
ANTES DO ADEUS	NEXTLINK	SE EU TE PUDESSE ABRAçAR
SE EU TE PUDESSE ABRAçAR	NEXTLINK	COMO TUDO COMEçOU
COMO TUDO COMEçOU	NEXTLINK	Só SEI SER FELIZ ASSIM
DON'T BREAK MY HEART	NEXTLINK	I ADMIT
EN DAG	NEXTLINK	SOM EN VIND
SOM EN VIND	NEXTLINK	FåNGAD AV EN STORMVIND
DANçA COMIGO	NEXTLINK	SENHORA DO MAR
VECHNY STRANNIK	NEXTLINK	KOLIBELNAYA DLYA VULKANA
HEAR MY PLEA	NEXTLINK	ZEMRëN E LAMë PENG
PARTNERS IN CRIME	NEXTLINK	LETO SVET
LOVE POWER	NEXTLINK	O JULISSI
DON'T PLAY THAT SONG AGAIN	NEXTLINK	NO DREAM IMPOSSIBLE
YORGUNUM ANLA	NEXTLINK	SEVGILIYE SON
BANA BANA	NEXTLINK	GöZLERININ HAPSINDEYIM
COLGADO DE UN SUEñO	NEXTLINK	DILE QUE LA QUIERO
LA VITA COS'è%3F	NEXTLINK	DANS LE JARDIN DE MON âME
SEVGILIYE SON	NEXTLINK	LEYLAKLAR SOLDU KALBINDE
NO QUIERO ESCUCHAR	NEXTLINK	COLGADO DE UN SUEñO
ENERGY	NEXTLINK	SAMO LJUBEZEN
LISTEN TO YOUR HEARTBEAT	NEXTLINK	NEVER LET IT GO
CONQUISTADOR	NEXTLINK	Há SEMPRE ALGUéM
SAY WONDERFUL THINGS	NEXTLINK	I LOVE THE LITTLE THINGS
GIVE ME YOUR LOVE	NEXTLINK	DET GöR ONT
ÉL	NEXTLINK	¿QUIéN MANEJA MI BARCA?
BEATLES	NEXTLINK	DET BLIR ALLTID VäRRE FRAMåT NATTEN
LET ME LOVE YOU	NEXTLINK	NEšTO šTO KJE OSTANE
PE-O MARGINE DE LUME	NEXTLINK	THE BALKAN GIRLS
AUGUSTIN	NEXTLINK	ALLA ANDRA FåR VARANN
DIVINE	NEXTLINK	ET S'IL FALLAIT LE FAIRE
QéLé, QéLé	NEXTLINK	JAN JAN
ZAUVIJEK VOLIM TE	NEXTLINK	JUST GET OUT OF MY LIFE
HASTA LA VISTA	NEXTLINK	EYES THAT NEVER LIE
SHOW ME YOUR LOVE	NEXTLINK	DANCING LASHA TUMBAI
IF WE ALL GIVE A LITTLE	NEXTLINK	VAMPIRES ARE ALIVE
SOLO	NEXTLINK	LADY ALPINE BLUE
ROMANCA	NEXTLINK	LIJEPA TENA
BRAZIL	NEXTLINK	LJUBIM TE PESMAMA
RIMI RIMI LEY	NEXTLINK	SüPER STAR
HOLD ONTO OUR LOVE	NEXTLINK	TOUCH MY FIRE
FOR REAL	NEXTLINK	RIMI RIMI LEY
CELEBRATE	NEXTLINK	COOL VIBES
CRY BABY	NEXTLINK	HOLD ONTO OUR LOVE
GO	NEXTLINK	WHY DO I ALWAYS GET IT WRONG?
WHY DO I ALWAYS GET IT WRONG%3F	NEXTLINK	GIVE A LITTLE LOVE BACK TO THE WORLD
GIVE A LITTLE LOVE BACK TO THE WORLD	NEXTLINK	A MESSAGE TO YOUR HEART
BETTER THE DEVIL YOU KNOW	NEXTLINK	LONELY SYMPHONY
SE På MIG	NEXTLINK	DEN VILDA
DEN VILDA	NEXTLINK	BARA HON äLSKAR MIG
NEKONEčNá PIESEň	NEXTLINK	KýM NáS Máš
ZBUDI SE	NEXTLINK	NAJ BOGOVI SLIšIJO
DAN NAJLEPšIH SANJ	NEXTLINK	ZBUDI SE
PRISLUHNI MI	NEXTLINK	DAN NAJLEPšIH SANJ
NAJ BOGOVI SLIšIJO	NEXTLINK	FOR A THOUSAND YEARS
TIH DEžEVEN DAN	NEXTLINK	PRISLUHNI MI
MR NOBODY	NEXTLINK	CVET Z JUGA
MOI, TOUT SIMPLEMENT	NEXTLINK	STO PREGANDO
T'EN VA PAS	NEXTLINK	I MIEI PENSIERI
DINLE	NEXTLINK	UNUTAMAZSıN
NYGAMMAL VALS	NEXTLINK	SOM EN DRöM
DIME	NEXTLINK	PARA LLENARME DE TI
LEYLAKLAR SOLDU KALBINDE	NEXTLINK	EVERYWAY THAT I CAN
BARA HON äLSKAR MIG	NEXTLINK	KäRLEKEN äR
STJäRNORNA	NEXTLINK	SE På MEJ
GIORGIO	NEXTLINK	IRGENDWOHER
NOUS AURONS DEMAIN	NEXTLINK	LE RETOUR
MOITIé, MOITIé	NEXTLINK	NE PARTEZ PAS SANS MOI
CANZONE PER TE	NEXTLINK	MISTER MUSIC MAN
DENTRO DI ME	NEXTLINK	LASS IHN
STO PREGANDO	NEXTLINK	MON COEUR L'AIME
MON CœUR L'AIME	NEXTLINK	DENTRO DI ME
UN BLODYMARY	NEXTLINK	I LOVE YOU MI VIDA
BELIEVE ME	NEXTLINK	NOBODY HURT NO ONE
BREZ BESED	NEXTLINK	VSE ROžE SVETA
VSE ROžE SVETA	NEXTLINK	JEDAN DAN
MUSIK KLINGT IN DIE WELT HINAUS	NEXTLINK	CANZONE PER TE
DILE QUE LA QUIERO	NEXTLINK	EUROPE'S LIVING A CELEBRATION
LIKE THE WIND	NEXTLINK	ENVIE DE VIVRE
YAZ BITTI	NEXTLINK	ESMER YARIM
SU CANCIóN	NEXTLINK	QUéDATE ESTA NOCHE
SAY IT AGAIN	NEXTLINK	DON'T PLAY THAT SONG AGAIN
DöN ARTıK	NEXTLINK	YORGUNUM ANLA
UNUTAMAZSıN	NEXTLINK	DöN ARTıK
¿QUé VOY A HACER SIN TI%3F	NEXTLINK	NO QUIERO ESCUCHAR
IRGENDWOHER	NEXTLINK	CIELO E TERRA
CIELO E TERRA	NEXTLINK	NOUS AURONS DEMAIN
VIVRE	NEXTLINK	TRöDLER UND CO
LES ILLUSIONS DE NOS VINGT ANS	NEXTLINK	C'EST LA CHANSON DE MON AMOUR
IO SENZA TE	NEXTLINK	AMOUR ON T'AIME
DJAMBO, DJAMBO	NEXTLINK	SWISS LADY
LOVE CITY GROOVE	NEXTLINK	OOH AAH... JUST A LITTLE BIT
SENINLE BIR DAKIKA	NEXTLINK	SEVINCE
JUST NU!	NEXTLINK	FåNGAD I EN DRöM
CINéMA	NEXTLINK	IO SENZA TE
PET'R OIL	NEXTLINK	DöNME DOLAP
QUéDATE ESTA NOCHE	NEXTLINK	Y SóLO Tú
LOVE ENOUGH FOR TWO	NEXTLINK	MAKING YOUR MIND UP
MARY ANN	NEXTLINK	LOVE ENOUGH FOR TWO
SIN RENCOR	NEXTLINK	¿QUé VOY A HACER SIN TI?
DöNME DOLAP	NEXTLINK	HANI?
FåNGAD I EN DRöM	NEXTLINK	DAG EFTER DAG
BEşINCI MEVSIM	NEXTLINK	DINLE
MOJA GENERACIJA	NEXTLINK	DAN LJUBEZNI
BAILEMOS UN VALS	NEXTLINK	SU CANCIóN
SEVINCE	NEXTLINK	PET'R OIL
DET BLIR ALLTID VäRRE FRAMåT NATTEN	NEXTLINK	SATELLIT
HANI%3F	NEXTLINK	OPERA
HALO, HALO	NEXTLINK	DžULI
ROCK BOTTOM	NEXTLINK	THE BAD OLD DAYS
ENSéñAME A CANTAR	NEXTLINK	BAILEMOS UN VALS
JAN JAN	NEXTLINK	APRICOT STONE
LADY, LADY	NEXTLINK	LA FIESTA TERMINó
NEšTO šTO KJE OSTANE	NEXTLINK	JAS JA IMAM SILATA
CIPELA	NEXTLINK	OVO JE BALKAN
SOBRAN LAS PALABRAS	NEXTLINK	ENSéñAME A CANTAR
PIANO, PIANO	NEXTLINK	PAS POUR MOI
DAN LJUBEZNI	NEXTLINK	NE MOGU SKRITI SVOJU BOL
LET ME BE THE ONE	NEXTLINK	SAVE YOUR KISSES FOR ME
Tú VOLVERáS	NEXTLINK	SOBRAN LAS PALABRAS
VALENTINO	NEXTLINK	NO ESTáS SOLO
HALLEY	NEXTLINK	ŞARKıM SEVGI ÜSTüNE
CANTA Y Sé FELIZ	NEXTLINK	Tú VOLVERáS
AMOUR, AMOUR	NEXTLINK	CROIRE
NON, à JAMAIS SANS TOI	NEXTLINK	NE VOIS-TU PAS?
APRIL, APRIL	NEXTLINK	SOL OCH VåR
JE VAIS ME MARIER, MARIE	NEXTLINK	MEIN RUF NACH DIR
GORI VATRA	NEXTLINK	MOJA GENERACIJA
SUFI	NEXTLINK	BANA BANA
LA CHICA QUE YO QUIERO	NEXTLINK	NACIDA PARA AMAR
BEG, STEAL OR BORROW	NEXTLINK	POWER TO ALL OUR FRIENDS
MUZIKA I TI	NEXTLINK	GORI VATRA
HäRLIGA SOMMARDAG	NEXTLINK	YOU ARE SUMMER - YOU NEVER TELL ME NO
EN UN MUNDO NUEVO	NEXTLINK	AMANECE
VITA VIDDER	NEXTLINK	HäRLIGA SOMMARDAG
TVOJ DJEčAK JE TUžAN	NEXTLINK	MUZIKA I TI
GöZLERININ HAPSINDEYIM	NEXTLINK	İKI DAKIKA
RETOUR	NEXTLINK	LES ILLUSIONS DE NOS VINGT ANS
GWENDOLYNE	NEXTLINK	EN UN MUNDO NUEVO
İKI DAKIKA	NEXTLINK	YAZ BITTI
BAILAR PEGADOS	NEXTLINK	TODO ESTO ES LA MúSICA
JUDY, MIN VäN	NEXTLINK	VITA VIDDER
BONJOUR, BONJOUR	NEXTLINK	RETOUR
¡AY, QUé DESEO!	NEXTLINK	SIN RENCOR
JEDAN DAN	NEXTLINK	POZDRAV SVIJETU
SOL OCH VåR	NEXTLINK	EN GåNG I STOCKHOLM
EN GåNG I STOCKHOLM	NEXTLINK	ABSENT FRIEND
ABSENT FRIEND	NEXTLINK	NYGAMMAL VALS
QUEL CœUR VAS-TU BRISER%3F	NEXTLINK	GUARDANDO IL SOLE
ESTANDO CONTIGO	NEXTLINK	LLáMAME
LLáMAME	NEXTLINK	ALGO PRODIGIOSO
¡QUé BUENO, QUé BUENO!	NEXTLINK	YO SOY AQUéL
YO SOY AQUéL	NEXTLINK	HABLEMOS DEL AMOR
ELLA NO ES ELLA	NEXTLINK	VUELVE CONMIGO
ŽIVOT JE SKLOPIO KRUG	NEXTLINK	ČEžNJA
A MAN WITHOUT LOVE	NEXTLINK	PUPPET ON A STRING
SEV	NEXTLINK	BEşINCI MEVSIM
I BELONG	NEXTLINK	A MAN WITHOUT LOVE
ČEžNJA	NEXTLINK	BREZ BESED
LOOKING HIGH, HIGH, HIGH	NEXTLINK	ARE YOU SURE?
ARE YOU SURE%3F	NEXTLINK	RING-A-DING GIRL
BRODOVI	NEXTLINK	ŽIVOT JE SKLOPIO KRUG
NE PALI SVETLA U SUMRAK	NEXTLINK	BRODOVI
NEKE DAVNE ZVEZDE	NEXTLINK	NE PALI SVETLO U SUMRAK
ČAROBAN	NEXTLINK	NIJE LJUBAV STVAR
TI SI MOJA PRVA LJUBAV	NEXTLINK	HEJ MALI
PRYYDE VESNA	NEXTLINK	POCHNY Z SEBE
NISI SAM	NEXTLINK	SLOVENIA IN THE JUNIOR EUROVISION SONG CONTEST 2015#JUNIOR EUROVISION 2015
BELARUS IN THE JUNIOR EUROVISION SONG CONTEST 2015	NEXTLINK	BELARUS IN THE JUNIOR EUROVISION SONG CONTEST 2016#ARTIST AND SONG INFORMATION
THIS TIME	NEXTLINK	I'VE BEEN WAITING FOR THIS NIGHT
ONE LAST BREATH	NEXTLINK	UTOPIAN LAND
ALBANIA IN THE JUNIOR EUROVISION SONG CONTEST 2015	NEXTLINK	ALBANIA IN THE JUNIOR EUROVISION SONG CONTEST 2016#PARTICIPANT DETAILS
