Cayuga Lake	outflow	Seneca River (New York)
Roxen	outflow	Motala ström
Lake Tana	outflow	Blue Nile
Lake Ontario	outflow	Saint Lawrence River
Lake Erie	outflow	Niagara River
Lake Superior	outflow	St. Marys River (Michigan–Ontario)
Lake Ladoga	outflow	Neva River
Lake Champlain	outflow	Richelieu River
Lake Balaton	outflow	Sió
Lake Eyre	outflow	Evaporation
Lake Abitibi	outflow	Abitibi River
Lake Nicaragua	outflow	San Juan River (Nicaragua)
Seneca Lake (New York)	outflow	Cayuga–Seneca Canal
Vänern	outflow	Göta älv
Mono Lake	outflow	Evaporation
Dartmouth Dam	outflow	Mitta Mitta River
Lake Huron	outflow	St. Clair River
Lake Baikal	outflow	Angara River
Lake Zug	outflow	Lorze
Lake Chad	outflow	Bodélé Depression
Lake Teletskoye	outflow	Biya River
Lake Zurich	outflow	Limmat
Lake Malawi	outflow	Shire River
Lake Zaysan	outflow	Irtysh River
Sea of Galilee	outflow	Jordan River
Lake Victoria	outflow	White Nile
Lake Constance	outflow	Rhine
Portage Lakes	outflow	Cuyahoga River
Portage Lakes	outflow	Tuscarawas River
Cockshoot Broad	outflow	River Bure
Salhouse Broad	outflow	River Bure
Martham Broad	outflow	River Thurne
Lake Lure, North Carolina  Lake Lure   1	outflow	Rocky Broad River
Lake Taupo	outflow	Waikato River
Lake Tahoe	outflow	Truckee River
Derwentwater	outflow	River Derwent, Cumbria
Lake Titicaca	outflow	Desaguadero River (Bolivia)
Lake Titicaca	outflow	Evaporation
Lady Bird Lake	outflow	Colorado River (Texas)
Lake Austin	outflow	Colorado River (Texas)
Lake Travis	outflow	Colorado River (Texas)
Howden Reservoir	outflow	River Derwent, Derbyshire
Derwent Reservoir (Derbyshire)	outflow	River Derwent, Derbyshire
Ladybower Reservoir	outflow	River Derwent, Derbyshire
Utah Lake	outflow	Jordan River (Utah)
Utah Lake	outflow	Evaporation
Lake Manitoba	outflow	Fairford River
Lake Winnipeg	outflow	Nelson River
Lake Geneva	outflow	Rhone
Lake Tanganyika	outflow	Lualaba River#Tributaries
Lough Corrib	outflow	River Corrib
Lac Saint-Jean	outflow	Saguenay River
Lake Winnipegosis	outflow	Waterhen River
Lake Lucerne	outflow	Reuss (river)
Lake Burtnieks	outflow	Salaca
Lake Winnipesaukee	outflow	Winnipesaukee River
Lake Washington	outflow	Lake Washington Ship Canal
Lake Union	outflow	Lake Washington Ship Canal
Issyk Kul	outflow	Evaporation
Lake Itasca	outflow	Mississippi River
Lake of the Woods	outflow	Winnipeg River
Lake Saint Francis (Canada)	outflow	Saint Lawrence River
Lac Saint-Pierre	outflow	Saint Lawrence River
Laguna de Bay	outflow	Pasig River
Lake Garda	outflow	Mincio
Lake Como	outflow	Adda (river)
Lake Mweru	outflow	Luvua River
Lake Sammamish	outflow	Sammamish River
Detroit Lake	outflow	North Santiam River
Loch Lomond	outflow	River Leven, Dunbartonshire
Lake Maracaibo	outflow	Gulf of Venezuela
Saimaa	outflow	Vuoksi River
Saimaa	outflow	Saimaa Canal
Lac de Serre-Ponçon	outflow	Durance
Serpentine (lake)	outflow	River Westbourne
Lake Manly	outflow	Evaporation
Lake Annecy	outflow	Thiou
Windermere	outflow	River Leven, Cumbria
Lake Lugano	outflow	Tresa
Bull Shoals Lake	outflow	White River (Arkansas)
Pasarel Reservoir	outflow	Iskar
Studen Kladenets	outflow	Arda (Maritsa)
Vacha Reservoir	outflow	Vacha (river)
Yovkovtsi	outflow	Veselina River
Beaver Lake (Arkansas)	outflow	White River (Arkansas)
Clear Lake (California)	outflow	Cache Creek (Sacramento River)
Lake Marble Falls	outflow	Colorado River (Texas)
Lake Lyndon B. Johnson	outflow	Colorado River (Texas)
Inks Lake	outflow	Colorado River (Texas)
Lake Buchanan (Texas)	outflow	Colorado River (Texas)
Dongting Lake	outflow	Yangtze River
Lake Nasser	outflow	Nile
Black Lake (Louisiana)	outflow	Red River (Mississippi River)
Lake Albert (Africa)	outflow	White Nile
Lake Biwa	outflow	Yodo River
Lake Bracciano	outflow	Arrone (river)
Lake Sakakawea	outflow	Missouri River
Yellowstone Lake	outflow	Yellowstone River
Lake Mead	outflow	Colorado River
Lake Powell	outflow	Colorado River
Berg Lake	outflow	Robson River
Lake Hume	outflow	Murray River
Lake Onega	outflow	Svir River
Lake Peipus	outflow	Narva River
Lake Kyoga	outflow	Murchison Falls
Lake Athabasca	outflow	Rivière des Rochers
Lake Athabasca	outflow	Slave River
Martinez Lake	outflow	Colorado River
Coniston Water	outflow	River Crake
Bala Lake	outflow	River Dee (Wales)
Näsijärvi	outflow	Tammerkoski
Senezh Lake	outflow	Sestra River (Moscow Oblast)
Lough Neagh	outflow	River Bann
Lake Wanaka	outflow	Clutha River
Lake Strom Thurmond	outflow	Savannah River
Carsington Water	outflow	River Derwent, Derbyshire
Great Slave Lake	outflow	Mackenzie River
Lake Minnetonka	outflow	Minnehaha Falls
Cedar Lake (Manitoba)	outflow	Saskatchewan River
Lake Okeechobee	outflow	Everglades
Lake Quinault	outflow	Quinault River
Lake Saint Clair (North America)	outflow	Detroit River
Lake Vištytis	outflow	Pissa River
Great Bear Lake	outflow	Great Bear River
Okanagan Lake	outflow	Okanogan River
Lake Turkana	outflow	Evaporation
Lake Balkhash	outflow	Evaporation
Lake Thun	outflow	Aar
Lake Brienz	outflow	Aar
Lake Murten	outflow	Broye
Pyhäjärvi (Tampere region)	outflow	Nokianvirta
Lake Winnebago	outflow	Fox River (Wisconsin)
Lake Mai-Ndombe	outflow	Fimi River
Lake Bangweulu	outflow	Luapula River
Lake Kivu	outflow	Ruzizi River
Lake Edward	outflow	Semliki River
Lake Ngami	outflow	Endorheic basin
Manicouagan Reservoir	outflow	Manicouagan River
Lake Nipissing	outflow	French River (Ontario)
Toledo Bend Reservoir	outflow	Sabine River (Texas–Louisiana)
Lake Tisza	outflow	Tisza
Indian Lake (Ohio)	outflow	Great Miami River
Lake Manapouri	outflow	Waiau River (Southland)
Lake George (New South Wales)	outflow	Evaporation
Cass Lake (Minnesota)	outflow	Mississippi River
Lake Bemidji	outflow	Mississippi River
Elephant Butte Reservoir	outflow	Rio Grande
Oneida Lake	outflow	Oneida River
Lake Burley Griffin	outflow	Molonglo River
Jordan Lake	outflow	Haw River
Wast Water	outflow	River Irt
Warragamba Dam	outflow	Warragamba River
Lake Burragorang	outflow	Warragamba River
Lake Burrendong	outflow	Macquarie River
Elgygytgyn Lake	outflow	Enmyvaam
Lake Inari	outflow	Paatsjoki
Lake Delton	outflow	Wisconsin River
Formarinsee	outflow	Lech (river)
Glenbawn Dam	outflow	Hunter River (New South Wales)
Lake Eildon	outflow	Goulburn River (Victoria)
Lake Meredith	outflow	Canadian River
Loch Awe	outflow	River Awe
Loch Morar	outflow	River Morar
Walensee	outflow	Linth
Lake Hopatcong	outflow	Musconetcong River
Lake Wisconsin	outflow	Wisconsin River
Cahora Bassa	outflow	Zambezi
Wörthersee	outflow	Glanfurt
Loch Lubnaig	outflow	Garbh Uisge
Lough Owel	outflow	River Brosna
Onondaga Lake	outflow	Seneca River (New York)
Lake Rotoroa (Tasman)	outflow	Gowan River
Otsego Lake (New York)	outflow	Susquehanna River
Otisco Lake	outflow	Ninemile Creek (Onondaga Lake)
Lake Te Anau	outflow	Waiau River (Southland)
Bassenthwaite Lake	outflow	River Derwent, Cumbria
Blöndulón	outflow	Blanda
Jökulsárlón	outflow	Atlantic Ocean
Hvítárvatn	outflow	Hvítá
Þingvallavatn	outflow	Sog
Þórisvatn	outflow	Þjórsá
Mývatn	outflow	Laxá
Sultartangalón	outflow	Þjórsá
Sigöldulón	outflow	Tungnaá
Lake Koocanusa	outflow	Kootenay River
Lake Lahontan (reservoir)	outflow	Carson River
Bras d'Or Lake	outflow	Gulf of Saint Lawrence
Great Bitter Lake	outflow	Suez Canal
Henrys Lake	outflow	Henrys Fork (Snake River)
Lake Maggiore	outflow	Ticino (river)
Moosehead Lake	outflow	Kennebec River
Lake Alexandrina (South Australia)	outflow	Murray Mouth
Port Stephens	outflow	Tasman Sea
Bull Sluice Lake	outflow	Chattahoochee River
Bear Lake (Idaho–Utah)	outflow	Bear Lake Outlet Canal
Loktak Lake	outflow	Irrigation
Walker Lake (Nevada)	outflow	Evaporation
Jackson Lake	outflow	Snake River
Upper Klamath Lake	outflow	Link River
Crowley Lake	outflow	Owens River
Maidu Lake	outflow	North Umpqua River
Lake Lappajärvi	outflow	Ähtävänjoki
Lake Wanapitei	outflow	Wanapitei River
Loch Rannoch	outflow	River Tummel
Loch Lochy	outflow	Caledonian Canal
Dow's Lake	outflow	Rideau Canal
Lake Sevan	outflow	Evaporation
Lake Sevan	outflow	Hrazdan River
Lake Bosumtwi	outflow	Endorheic basin
Fourth Connecticut Lake	outflow	Connecticut River
Woodcliff Lake Reservoir	outflow	Pascack Brook
Poopó Lake	outflow	Evaporation
Lake Quinsigamond	outflow	Quinsigamond River
Greifensee	outflow	Glatt (Rhine)
Lake Celilo	outflow	Columbia River
Flaming Gorge Reservoir	outflow	Green River (Utah)
Badwater Basin	outflow	Evaporation
Lake Texoma	outflow	Red River (Mississippi River)
Lake Chelan	outflow	Chelan River
Lake Wakatipu	outflow	Kawarau River
Vihar Lake	outflow	Mithi River
Lake Vyrnwy	outflow	River Vyrnwy
Lake Timiskaming	outflow	Ottawa River
Grand Lake St. Marys State Park	outflow	Beaver Creek
Brandy Pond (Cumberland County, Maine)	outflow	Songo River
Sebago Lake	outflow	Presumpscot River
Lake Cachuma	outflow	Santa Ynez River
Hetch Hetchy Reservoir	outflow	Tuolumne River
Ammersee	outflow	Amper
Derwent Reservoir (North East England)	outflow	River Derwent, North East England
Lake Manitou	outflow	Manitou River (Manitoulin Island)
Pyramid Lake (California)	outflow	California Aqueduct
Pyramid Lake (California)	outflow	Piru Creek
Lesser Slave Lake	outflow	Lesser Slave River
Lough Ennell	outflow	River Brosna
Emerald Lake (British Columbia)	outflow	Emerald River
Rice Lake (Ontario)	outflow	Trent River (Ontario)
Glenmore Reservoir	outflow	Elbow River
Shasta Lake	outflow	Sacramento River
Cropston Reservoir	outflow	River Lin
Lake Wissota	outflow	Chippewa River (Wisconsin)
Lake Isabella	outflow	Kern River
Devils Lake (Lincoln County, Oregon)	outflow	D River
Lake Nacimiento	outflow	Nacimiento River
Lake Scugog	outflow	Scugog River
Lakes Kaban	outflow	Bolaq
Lake Urmia	outflow	Evaporation
Lake George (New York)	outflow	La Chute River
Lake George (Florida)	outflow	St. Johns River
Lake George (Uganda)	outflow	Kazinga Channel
Lake Ilmen	outflow	Volkhov River
Lake Dunstan	outflow	Clutha River
Lake Doré	outflow	Snake River (Renfrew County)
Lake Päijänne	outflow	Kymi River
Lake Ainslie	outflow	Margaree River
Lough Derg (Shannon)	outflow	River Shannon
Kinney Lake	outflow	Robson River
Lake Leelanau	outflow	Leland River
Lake Okutama	outflow	Tama River
Mjøsa	outflow	Vorma
Iliamna Lake	outflow	Kvichak River
Ross Barnett Reservoir	outflow	Pearl River (Mississippi–Louisiana)
Franklin D. Roosevelt Lake	outflow	Columbia River
Naknek Lake	outflow	Naknek River
Lough Allen	outflow	River Shannon
Lough Ree	outflow	River Shannon
Burt Lake	outflow	Indian River (Mullett Lake)
Mullett Lake	outflow	Cheboygan River
Six Mile Lake (Alaska)	outflow	Newhalen River
Lake Houston	outflow	San Jacinto River (Texas)
Lake Waihola	outflow	Waipori River
Lake Neusiedl	outflow	Evaporation
Lake Témiscouata	outflow	Madawaska River (Saint John River)
Attersee (lake)	outflow	Ager
Mondsee (lake)	outflow	Seeache
Lake Roxburgh	outflow	Clutha River
Lake Ohau	outflow	Ohau River
Lake Waitaki	outflow	Waitaki River
Lake Aviemore	outflow	Waitaki River
Lake Pukaki	outflow	Pukaki River
Lake Tekapo	outflow	Tekapo River
Lake Waipori	outflow	Waipori River
Lake Monowai	outflow	Monowai River
Lake Towada	outflow	Oirase River
Lake Iseo	outflow	Oglio
Chew Valley Lake	outflow	River Chew
Lake Brunner	outflow	Arnold River (New Zealand)
Lake McKerrow	outflow	Hollyford River
Lake Alabaster	outflow	Pyke River
Lake Christabel	outflow	Grey River
Lake Kaniere	outflow	Kaniere River
Chilika Lake	outflow	Bay of Bengal
Lake Rotorua	outflow	Ohau Channel
Sun Moon Lake	outflow	Shuili River
Lake Alaotra	outflow	Ambato River (Madagascar)
Donner Lake	outflow	Truckee River
Lake Waikaremoana	outflow	Waikaretaheke River
Lake Ülemiste	outflow	Härjapea River
Lake Koshkonong	outflow	Rock River (Mississippi River)
Lake Arapuni	outflow	Waikato River
Lake Karapiro	outflow	Waikato River
Lake Ohrid	outflow	Black Drin
Lake Wairarapa	outflow	Ruamahanga River
Orava (reservoir)	outflow	Orava (river)
Great Sacandaga Lake	outflow	Sacandaga River
Moses Lake	outflow	Potholes Reservoir
Lake Vidraru	outflow	Argeș River
Kootenay Lake	outflow	Kootenay River
Lake Peigneur	outflow	Delcambre Canal
Königssee	outflow	Königsseer Ache
Rotsee	outflow	Ron (river)
Lake Malta	outflow	Cybina
Priest Lake	outflow	Priest River (Idaho)
Tenkiller Ferry Lake	outflow	Illinois River (Arkansas)
Eufaula Lake	outflow	Canadian River
Tom Steed Reservoir	outflow	West Otter Creek
Ennerdale Water	outflow	River Ehen
Lake Cushman	outflow	Skokomish River
Lake Kokanee	outflow	Skokomish River
Medina Lake	outflow	Medina River
Honeoye Lake	outflow	Honeoye Creek
Raquette Lake	outflow	Raquette River
Cazenovia Lake	outflow	Chittenango Creek
Cross Lake	outflow	Seneca River (New York)
Okamanpeedan Lake	outflow	Des Moines River
Lake Bomoseen	outflow	Castleton River
Lake Izvorul Muntelui	outflow	Bistriţa River (Siret)
Jarun	outflow	Sava
Tempe Town Lake	outflow	Salt River (Arizona)
Saguaro Lake (Arizona)	outflow	Salt River (Arizona)
Candlewood Lake	outflow	Rocky River (Connecticut)
Candlewood Lake	outflow	Housatonic River
Lake McQueeney	outflow	Guadalupe River (Texas)
Kamloops Lake	outflow	Thompson River
Binnenalster	outflow	Elbe
Außenalster	outflow	Binnenalster
Houghton Lake (Michigan)	outflow	Muskegon River
Lake Nipigon	outflow	Nipigon River
Peyto Lake	outflow	Mistaya River
Somerville Lake	outflow	Yegua Creek
Gibbons Creek Reservoir	outflow	Gibbons Creek
Lake Ossiach	outflow	Drava
Silver Lake (Hollis, New Hampshire)	outflow	Pennichuck Brook
Randsfjorden	outflow	Randselva
Tustumena Lake	outflow	Kasilof River
Primrose Lake	outflow	Martineau River
Racetrack Playa	outflow	Evaporation
Fort Peck Lake	outflow	Missouri River
Lake Volta	outflow	Volta River
Lake Sharpe	outflow	Missouri River
Lake Oahe	outflow	Missouri River
Lough Conn	outflow	River Moy
Kawaweogama Lake	outflow	Allan Water (Ontario)
Lake Sonoma	outflow	Dry Creek (Sonoma County, California)
Canyon Lake (Arizona)	outflow	Salt River (Arizona)
Flathead Lake	outflow	Flathead River
Loch Shiel	outflow	River Shiel
Lake Temagami	outflow	Temagami River
Lake Bolsena	outflow	Marta (river)
Lake Mezzano	outflow	Olpeta
Khövsgöl Nuur	outflow	Egiin Gol
Lake Decatur	outflow	Sangamon River
Reindeer Lake	outflow	Reindeer River
Lake Oroville	outflow	Feather River
Loch Shin	outflow	River Shin
Almsee	outflow	Alm (river)
Tittesworth reservoir	outflow	River Churnet
Lake Argyle	outflow	Ord River
Stanford Reservoir	outflow	River Avon (Warwickshire)
Ogston Reservoir	outflow	River Amber
Lake Hemet	outflow	San Jacinto River (California)
Lake Manchar	outflow	Indus River
Claytor Lake	outflow	New River (Kanawha River)
Lesjaskogsvatnet	outflow	Gudbrandsdalslågen
Lesjaskogsvatnet	outflow	Rauma (river)
Oradell Reservoir	outflow	Hackensack River
Tenaya Lake	outflow	Tenaya Canyon
Guntersville Lake	outflow	Tennessee River
Taal Lake	outflow	Pansipit River
Lake Orta	outflow	Nigoglia
Shuswap Lake	outflow	Little River (Little Shuswap Lake)
Oulujärvi	outflow	Oulujoki
Falls Lake	outflow	Neuse River
Caesar Creek State Park  Caesar Creek Lake   1	outflow	Caesar Creek State Park
Cowan Lake (Ohio)	outflow	Cowan Creek (Ohio)
Lake Lemon	outflow	Bean Blossom Creek
Lake Entiat	outflow	Columbia River
Jordanelle Reservoir	outflow	Provo River
Lake Pend Oreille	outflow	Pend Oreille River
Möhne Reservoir	outflow	Möhne
Lake Allatoona	outflow	Etowah River
Caniapiscau Reservoir	outflow	La Grande River
Caniapiscau Reservoir	outflow	Caniapiscau River
Painted Rock Dam	outflow	Gila River
Painted Rock Dam	outflow	Evaporation
Kenyir Lake	outflow	Kenyir River
Cedar Lake (Ontario)	outflow	Petawawa River
Red Cedar Lake (Ontario)	outflow	Temagami River
Cowichan Lake	outflow	Cowichan River
Lake Mendota	outflow	Yahara River
Lough Gill	outflow	River Garavogue
Lake Laberge	outflow	Yukon River
Lake Cumberland	outflow	Cumberland River
Lake Havasu	outflow	Colorado River
Osman Sagar	outflow	Musi River (India)
Shenipsit Lake	outflow	Hockanum River
Coquitlam Lake	outflow	Coquitlam River
Lake Martin	outflow	Tallapoosa River
Lake Louise State Park	outflow	Upper Iowa River
Schwatka Lake	outflow	Yukon River
Gopło	outflow	Noteć
Lake Taneycomo	outflow	White River (Arkansas)
Table Rock Lake	outflow	White River (Arkansas)
Lake of the Ozarks	outflow	Osage River
Baker Lake (Nunavut)	outflow	Chesterfield Inlet
Walter Wirth Lake	outflow	Mill Creek (Marion County, Oregon)
Cranberry Lake	outflow	Oswegatchie River
Lake Murray (Papua New Guinea)	outflow	Herbert River, Papua New Guinea
Black Lake (New York)	outflow	Oswegatchie River
Big Moose Lake	outflow	Moose River (New York)
Squam Lake	outflow	Squam River
Witton Lakes	outflow	Brookvale Park Lake
Lac du Bourget	outflow	Canal de Savières
Lake Claire (Alberta)	outflow	Peace River (Canada)
Lake Pepin	outflow	Mississippi River
Tupper Lake (New York)	outflow	Raquette River
Lake Corangamite	outflow	Evaporation
Wabigoon Lake	outflow	Wabigoon River
Nolin River Lake	outflow	Nolin River
Lochinvar	outflow	Water of Ken
Watts Bar Lake	outflow	Tennessee River
Loch Lyon	outflow	River Lyon
Nicasio Reservoir	outflow	Nicasio Creek
Mascoma Lake	outflow	Mascoma River
Lake Banook	outflow	Shubenacadie Canal
Lake Banook	outflow	Sullivan's Pond
Pathfinder Reservoir	outflow	North Platte River
Bass Lake (California)	outflow	Willow Creek (California)
Jennings Randolph Lake	outflow	Potomac River#North Branch Potomac River
Arcadia Lake (Oklahoma)	outflow	Deep Fork River
Lake Lanao	outflow	Agus River
Lake Taymyr	outflow	Taymyr River
Sam Rayburn Reservoir	outflow	Angelina River
Hollingworth Lake	outflow	Hollingworth Brook
Mazinaw Lake	outflow	Mississippi River (Ontario)
Lake Thirteen	outflow	Runyan Creek
Lake Micmac	outflow	Shubenacadie Canal
Phayao Lake	outflow	Ing River
Loch Ard	outflow	River Forth
Müggelsee	outflow	Spree
Aberdeen Lake (Mississippi)	outflow	Tennessee–Tombigbee Waterway
Aliceville Lake	outflow	Tennessee–Tombigbee Waterway
Gainesville Lake (Alabama)	outflow	Tennessee–Tombigbee Waterway
Lake Vermilion	outflow	Vermilion River (Minnesota)
Tainter Lake	outflow	Red Cedar River (Wisconsin)
Lake Menomin	outflow	Red Cedar River (Wisconsin)
Pactola Lake	outflow	Rapid Creek (South Dakota)
Chini Lake	outflow	Chini River
Bera Lake	outflow	Pahang River
Atlin Lake	outflow	Atlin River
Nong Han Lake	outflow	Huai Nam Khan
Lake Awasa	outflow	Subterranea (geography)
Commanda Lake	outflow	Restoule River
Lake Lanier	outflow	Chattahoochee River
Lake Starnberg	outflow	Würm
Lake Thunderbird	outflow	Little River (Oklahoma)
Truman Reservoir	outflow	Osage River
West Hawk Lake	outflow	Whiteshell River
Lake Michigan-Huron	outflow	St. Clair River
Klingnauer Stausee	outflow	Aar
Lake Jocassee	outflow	Keowee River
Don Pedro Reservoir	outflow	Tuolumne River
Williston Lake	outflow	Peace River (Canada)
Lake Berryessa	outflow	Putah Creek
Lake Borgne	outflow	Gulf of Mexico
Alqueva Dam	outflow	Guadiana
Lake Llanquihue	outflow	Maullín River
Võrtsjärv	outflow	Emajõgi
Lake Whatcom	outflow	Whatcom Creek
Lake Las Vegas	outflow	Las Vegas Wash
Loch Ryan	outflow	North Channel
Lake Revelstoke	outflow	Columbia River
Moyie Lake	outflow	Moyie River
Kluane Lake	outflow	Kluane River
Blanca Lake	outflow	Troublesome Creek (Washington)
Lake Mulwala	outflow	Murray River
Rend Lake	outflow	Big Muddy River
Sullivan's Pond	outflow	Shubenacadie Canal
Naujan Lake	outflow	Lumangbayan River
Lakes of the Clouds	outflow	Ammonoosuc River
Lake Monroe (Indiana)	outflow	Salt Creek (White River)
Pielinen	outflow	Pielisjoki
Barren River Lake	outflow	Barren River
Buckhorn Lake (Kentucky)	outflow	Kentucky River
Umbagog Lake	outflow	Androscoggin River
Newfound Lake	outflow	Newfound River (New Hampshire)
Winnisquam Lake	outflow	Winnipesaukee River
Rudyard Lake	outflow	Caldon Canal
Lake Samish	outflow	Friday Creek
Walloon Lake	outflow	Bear River (Michigan)
Ägerisee	outflow	Lorze
Pushkar Lake	outflow	Luni River
Cedar Creek Lake (Kentucky)	outflow	Cedar Creek (Dix River)
Lake Coeur d'Alene	outflow	Spokane River
Lake Suwa	outflow	Tenryū River
Little Redfish Lake	outflow	Salmon River (Idaho)
Old Hickory Lake	outflow	Cumberland River
Percy Priest Lake	outflow	Stones River
Big Stone Lake	outflow	Minnesota River
Dhebar Lake	outflow	Gomati River,Khodiyo Ka Khera Rajasthan
Sarez Lake	outflow	Bartang River
Chembarambakkam Lake	outflow	Adyar (River)
Kainji Lake	outflow	Niger River
Trappers Lake	outflow	White River (Utah)
Bolmen	outflow	Storån
Bolmen	outflow	Bolmen Water Tunnel
Stevens Creek Reservoir	outflow	Stevens Creek (California)
Rainy Lake	outflow	Rainy River (Minnesota–Ontario)
Adams Lake	outflow	Adams River (British Columbia)
Kokanee Lake	outflow	Kokanee Creek Provincial Park
Kinbasket Lake	outflow	Columbia River
Zorkul	outflow	Pamir River
Tippecanoe Lake	outflow	Oswego Lake
Tippecanoe Lake	outflow	James Lake (Indiana)
Sanford Lake, Michigan	outflow	Tittabawassee River
Lake Santa Fe	outflow	Santa Fe River (Florida)
Sattal  Lake   1	outflow	Gaula River (India)
Searles Lake	outflow	Evaporation
Lake Rusałka	outflow	Bogdanka
Red Indian Lake	outflow	Exploits River
Lake Enriquillo	outflow	Evaporation
Lake Traverse	outflow	Bois de Sioux River
Jungfernsee	outflow	Havel
Jungfernsee	outflow	Sacrow–Paretz Canal
Nahuel Huapi Lake	outflow	Limay River
Lac Vieux Desert	outflow	Wisconsin River
Torneträsk	outflow	Torne River
Viedma Lake	outflow	Santa Cruz River (Argentina)
Tsimlyansk Reservoir	outflow	Don River (Russia)
Lake Oviáchic	outflow	Yaqui River
Lake Zell	outflow	Salzach
Baranof Lake	outflow	Baranof River
Walter F. George Lake	outflow	Chattahoochee River
Lake Success (California)	outflow	Tule River
Greers Ferry Lake	outflow	Little Red River (Arkansas)
Skaha Lake	outflow	Okanogan River
Lake Sabbatia	outflow	Mill River (Taunton River)
Lake of Two Mountains	outflow	Rivière des Mille Îles
Lake of Two Mountains	outflow	Rivière des Prairies
Castle Semple Loch	outflow	River Cart
Lake Paiku	outflow	Endorheic basin
Wachusett Reservoir	outflow	Wachusett Aqueduct
Trinity Lake	outflow	Trinity River (California)
White Rock Lake	outflow	White Rock Creek
Lac de Gras	outflow	Coppermine River
Lake Drwęca	outflow	Drwęca
Lake Roś	outflow	Pisa (river)
Amaravathi Reservoir	outflow	Amaravathi River
Lake Whitney (Texas)	outflow	Brazos River
Cayuta Lake	outflow	Cayuta Creek
Assawompset Pond	outflow	Nemasket River
Long Pond (Lakeville, Massachusetts)	outflow	Long Pond River (Massachusetts)
Barossa Reservoir	outflow	Yettie Creek
Mount Storm Lake	outflow	Stony River (North Branch Potomac River)
Sleepy Creek Lake	outflow	Meadow Branch
Lake Hiawatha	outflow	Minnehaha Falls
Goose Lake (Oregon-California)	outflow	Endorheic basin
Fort Loudoun Lake	outflow	Tennessee River
Mundaring Weir	outflow	Helena River
Lake Umbozero	outflow	Umba River (Russia)
Tangamong Lake	outflow	Crowe River
Lake Izabal	outflow	Dulce River
Eyebrook Reservoir	outflow	Eye Brook
Taylorsville Lake	outflow	Salt River
Windermere Lake (British Columbia)	outflow	Columbia River
Brent Reservoir	outflow	River Brent
Dümmer	outflow	Hunte
Lake Somerset	outflow	Stanley River (Queensland)
Cheakamus Lake	outflow	Cheakamus River
Elliðavatn	outflow	Elliðaá
Chilko Lake	outflow	Chilko River
Seton Lake	outflow	Cayoosh Creek
Seton Lake	outflow	Fraser River
Harrison Lake	outflow	Harrison River
Pitt Lake	outflow	Pitt River
Lake Junín	outflow	Upamayo
Anderson Lake (British Columbia)	outflow	Seton River
Crummock Water	outflow	River Cocker, Cumbria
Shubenacadie Grand Lake	outflow	Shubenacadie River
Burnsville Lake	outflow	Little Kanawha River
R. D. Bailey Lake	outflow	Guyandotte River
Lake Murray (South Carolina)	outflow	Saluda River
Schaalsee	outflow	Schaalsee-Kanal
Schaalsee	outflow	Schaale
Lake Toplitz	outflow	Topliţa
Charles Mill Lake	outflow	Black Fork Mohican River
Harrington Sound, Bermuda	outflow	Flatt's Inlet, Bermuda
Tuxbury Pond	outflow	Powwow River
Kanas Lake	outflow	Kanas River
Hulun Lake	outflow	Argun River (Asia)
Thutade Lake	outflow	Finlay River
Sihlsee	outflow	Sihl
Lake Crescent	outflow	Lyre River
Lake Muir	outflow	Deep River (Western Australia)
Otter Tail Lake	outflow	Otter Tail River
Lake Gibson	outflow	Twelve Mile Creek (Ontario)
Loch Earn	outflow	River Earn
Rondout Reservoir	outflow	Delaware Aqueduct
Altevatnet	outflow	Barduelva
Lake Otún	outflow	Otún River
Winnisook Lake	outflow	Esopus Creek
Laguna Catemaco	outflow	Rio Grande de Catemaco
Lake Macatawa	outflow	Lake Michigan
Lake Muskoka	outflow	Moon River (Ontario)
San Luis Reservoir	outflow	California Aqueduct
Lake Mayfield	outflow	Cowlitz River
Vitus Lake	outflow	Seal River
Ugashik Lakes	outflow	Ugashik River
Peoria Lake	outflow	Illinois River
Miles Lake (Alaska)	outflow	Copper River
Tazlina Lake	outflow	Tazlina River
Lake Amatitlán	outflow	Michatoya River
Upper Peoria Lake	outflow	Illinois River
Coyote Lake (San Bernardino County, California)	outflow	Evaporation
Saunders Lake	outflow	Lake Langdon
Lake Monomonac	outflow	North Branch Millers River
Lake Georgetown	outflow	San Gabriel River (Texas)
Granger Lake	outflow	San Gabriel River (Texas)
Stony River Reservoir	outflow	Stony River (North Branch Potomac River)
Kelso Conservation Area	outflow	Sixteen Mile Creek (Ontario)
Argentino Lake	outflow	Santa Cruz River (Argentina)
Kaunas Reservoir	outflow	Neman River
Akkajaure	outflow	Lule River
Akkajaure	outflow	Suorva
Lake Imandra	outflow	Niva River
Lake Kaweah	outflow	Kaweah River
Sobradinho Reservoir	outflow	São Francisco River
Lake Temescal	outflow	Temescal Creek (Northern California)
Corumbá Lake	outflow	Corumbá River
Tidal Basin (District of Columbia)	outflow	Washington Channel
Lake Butte des Morts	outflow	Fox River (Wisconsin)
Lake Apanás	outflow	Río Tuma
Hinze Dam	outflow	Nerang River
Kuybyshev Reservoir	outflow	Volga River
Bratsk Reservoir	outflow	Angara River
Yew Tree Tarn	outflow	Yewdale Beck
Lake Talquin	outflow	Ochlockonee River
Lake Jackson (Tallahassee, Florida)	outflow	Sinkhole
Lake Carnegie (New Jersey)	outflow	Millstone River
Lake Menmecho	outflow	Rangpo chu
Deer Creek Dam and Reservoir	outflow	Provo River
Red Bluff Reservoir	outflow	Pecos River
Astrolabe Lake (Ontario)	outflow	Buttermilk Creek (Renfrew County, Ontario)
Lake Diefenbaker	outflow	South Saskatchewan River
Lake Ritsa	outflow	Iupshara River
Shannon Pot	outflow	River Shannon
Delta Lake (New York)	outflow	Mohawk River
Clatteringshaws Loch	outflow	River Dee, Galloway
Tegernsee (lake)	outflow	Mangfall
Saylorville Lake	outflow	Des Moines River
Limerick Lake	outflow	Beaver Creek (Hastings County, Ontario)
Marsh Lake	outflow	Yukon River
Lewis and Clark Lake	outflow	Missouri River
Lake Dukan	outflow	Little Zab
Lake Kossou	outflow	Bandama River
Lácar Lake	outflow	Huahum River
Bristol Lake	outflow	Evaporation
Lake Tinaroo	outflow	Barron River (Queensland)
Lake Steilacoom	outflow	Chambers Creek (Washington)
Sarsang reservoir	outflow	Tartar river
Zama Lake	outflow	Hay River (Canada)
Lake Calumet	outflow	Des Plaines River
Blue Mountain Lake	outflow	Petit Jean River
Lake Jindabyne	outflow	Snowy River
Lake Eucumbene	outflow	Eucumbene River
Muncho Lake	outflow	Trout River (British Columbia)
Lac de Vouglans	outflow	Ain (river)
Lake Jackson (Georgia)	outflow	Ocmulgee River
Lake Ouachita	outflow	Ouachita River
Tal-y-llyn Lake	outflow	River Dysynni
Shaver Lake	outflow	Big Creek (San Joaquin River)
Huntington Lake	outflow	Big Creek (San Joaquin River)
Litton Reservoirs	outflow	River Chew
Ada Ciganlija  Sava Lake   1	outflow	Sava
Rogen	outflow	Klarälven
DeGray Lake	outflow	Caddo River
Lake Hazen	outflow	Ruggles River
Llyn Gwynant	outflow	Afon Glaslyn
Llyn Padarn	outflow	Afon Seiont
Guist Creek Lake	outflow	Guist Creek
Ashokan Reservoir	outflow	Esopus Creek
Lake of Egypt	outflow	Saline River (Illinois)
Tinnsjå	outflow	Tinnelva
Fyresvatn	outflow	Fyreselv
Zuni Salt Lake	outflow	Evaporation
Lac Baker (New Brunswick)	outflow	Baker Brook, New Brunswick
Tuttle Creek Lake	outflow	Kansas River
Loch Doon	outflow	River Doon
Vågåvatn	outflow	Otta (river)
Nettilling Lake	outflow	Koukdjuak River
Babine Lake	outflow	Babine River
San Carlos Lake	outflow	Gila River
Møsvatn	outflow	Måna
Møsvatn	outflow	Rjukan
Nisser	outflow	Nisserelva
Ostrander Lake	outflow	Bridalveil Creek Campground
Stockton Lake	outflow	Sac River
Krøderen (lake)	outflow	Snarumselva
Massabesic Lake	outflow	Cohas Brook
Dierks Lake	outflow	Saline River (Little River)
Gillham Lake	outflow	Cossatot River
Baboosic Lake	outflow	Baboosic Brook
Zegrze Reservoir	outflow	Narew
Lake Dardanelle	outflow	Arkansas River
Lake Hartwell	outflow	Richard B. Russell Lake
Lake Hamilton and Lake Catherine	outflow	Ouachita River
Millstätter See	outflow	Lieser (river in Carinthia)
Smallwood Reservoir	outflow	Churchill River (Atlantic)
Chilkoot Lake	outflow	Chilkoot River
Raudvatnet	outflow	Tverråga
Virvatnet	outflow	Virvasselva
Lake Poygan	outflow	Wolf River (Fox River)
Nimrod Lake	outflow	Fourche La Fave River
Llyn Geirionydd	outflow	River Geirionydd
Buttle Lake	outflow	Campbell River (Vancouver Island)
Cami Lake	outflow	Azopardo River
Lake General Carrera/Buenos Aires	outflow	Bertrand Lake
Lake General Carrera/Buenos Aires	outflow	Baker River (Chile)
Villarrica Lake	outflow	Toltén River
Traful Lake	outflow	Traful River
Clinton Lake (Kansas)	outflow	Wakarusa River
Clinton Lake (Illinois)	outflow	Salt Creek (Sangamon River tributary)
O'Higgins/San Martín Lake	outflow	Pascua River
Gjende	outflow	Sjoa
Neversink Reservoir	outflow	Neversink Tunnel
Aursjøen	outflow	Aura, Norway
Mark Twain Lake	outflow	Salt River (Missouri)
Lake Matiri	outflow	Matiri River
Shellmouth Reservoir	outflow	Assiniboine River
Sparrow Lake	outflow	Severn River (central Ontario)
Fontenelle Reservoir	outflow	Green River (Utah)
Soda Lake (San Bernardino County)	outflow	Evaporation
Silver Lake (Mojave)	outflow	Evaporation
Seitz Lake (Nevada)	outflow	Bonanza Creek
Lake San Antonio	outflow	San Antonio River (California)
Pine Flat Lake	outflow	Kings River (California)
Lake Casitas	outflow	Coyote Creek (Ventura County)
Santa Margarita Lake	outflow	Salinas River (California)
Nesjøen	outflow	Nea River
Rien (Norway)	outflow	Glomma
Håsjøen	outflow	Rambergsjøen
Millerton Lake	outflow	Friant-Kern Canal
Millerton Lake	outflow	Madera Canal
Millerton Lake	outflow	San Joaquin River
Llyn Ogwen	outflow	Afon Ogwen
Olstappen	outflow	Vinstra
Mammoth Pool Reservoir	outflow	San Joaquin River
Black Lake (Michigan)	outflow	Black River (Cheboygan County)
Twitchell Reservoir	outflow	Cuyama River
Ennadai Lake	outflow	Kazan River
Rensselaer Lake	outflow	Patroon Creek
Follins Pond	outflow	Bass River (Massachusetts)
Sardis Lake (Mississippi)	outflow	Tallahatchie River
West Point Lake	outflow	Chattahoochee River
Arkabutla Lake	outflow	Coldwater River (Mississippi)
Kremenchuk Reservoir	outflow	Dnieper River
Uldalsåna	outflow	Herefossfjorden
Åraksfjorden	outflow	Byglandsfjorden
Vatndalsvatnet	outflow	Otra
Ogge	outflow	Rettåna
Ormsavatnet	outflow	Vatndalsvatnet
Rore	outflow	Nidelva (Aust-Agder)
Herefossfjorden	outflow	Tovdalselva
Byglandsfjorden	outflow	Otra
Store Urevatn	outflow	Vatndalsvatnet
Syndle	outflow	Rore
Nelaug (lake)	outflow	Nidelva (Aust-Agder)
Kaptai Lake	outflow	Karnaphuli River
Lake Gunn	outflow	Eglinton River
Lake Sherburne	outflow	Swiftcurrent Creek (Montana)
Neely Henry Lake	outflow	Coosa River
Innsvatnet	outflow	Inna (Verdal)
Veresvatnet	outflow	Helgåa
Wilson Lake (Alabama)	outflow	Tennessee River
Wilson Lake (Kansas)	outflow	Saline River (Kansas)
Nickajack Lake	outflow	Tennessee River
Chickamauga Lake	outflow	Tennessee River
Kiev Reservoir	outflow	Dnieper River
Grenada Lake	outflow	Yalobusha River
Lake Washington (Florida)	outflow	St. Johns River
Round Lake (Saskatchewan)	outflow	Qu'Appelle River
Brushy Fork Lake	outflow	Potomac River#South Branch South Fork Potomac River
Movatnet	outflow	Hoklingen
Bangsjøene	outflow	Bongna
Lake Springfield	outflow	Sugar Creek (Sangamon River tributary)
Moore Reservoir	outflow	Connecticut River
Ossipee Lake	outflow	Ossipee River
First Connecticut Lake	outflow	Connecticut River
Lake Francis (Murphy Dam)	outflow	Connecticut River
Pinehurst Lake	outflow	Sand River (Alberta)
DeQueen Lake	outflow	Rolling Fork
Topaz Lake	outflow	West Walker River
Moldevatnet	outflow	Moldeelva
Second Connecticut Lake	outflow	Connecticut River
Conway Lake	outflow	Saco River
Paugus Bay	outflow	Winnipesaukee River
Bow Lake (New Hampshire)	outflow	Isinglass River
Merrymeeting Lake	outflow	Merrymeeting River
Comerford Reservoir	outflow	Connecticut River
Province Lake	outflow	South River (Ossipee River)
Seven Oaks Reservoir	outflow	Santa Ana River
Lake McClure	outflow	Merced River
Rush Lake (Pakistan)	outflow	Miar Glacier
Carpenter Lake	outflow	Bridge River
Union Valley Reservoir	outflow	Silver Creek (California)
Clear Lake Reservoir	outflow	Lost River (California)
El Capitan Reservoir	outflow	San Diego River
Akers Pond	outflow	Clear Stream
Arlington Mill Reservoir	outflow	Spicket River
Ashuelot Pond	outflow	Ashuelot River
Ayers Island Reservoir	outflow	Pemigewasset River
Bellamy Reservoir	outflow	Bellamy River
Broad Bay (New Hampshire)	outflow	Ossipee River
Canaan Street Lake	outflow	Mascoma River
Kakhovka Reservoir	outflow	Dnieper River
Folsom Lake	outflow	American River
Contoocook Lake	outflow	Contoocook River
Country Pond	outflow	Powwow River
Crystal Lake (Gilmanton, New Hampshire)	outflow	Suncook River
Dan Hole Pond	outflow	Dan Hole River
Deering Reservoir	outflow	Piscataquog River
Franklin Pierce Lake	outflow	North Branch Contoocook River
Great East Lake	outflow	Salmon Falls River
North Pine Dam	outflow	North Pine River
New Hogan Lake	outflow	Calaveras River
Highland Lake (Stoddard, New Hampshire)	outflow	Shedd Brook
Highland Lake (Stoddard, New Hampshire)	outflow	North Branch Contoocook River
Island Pond (Derry, New Hampshire)	outflow	Spicket River
Lake Kanasatka	outflow	Lake Winnipesaukee
Little Squam Lake	outflow	Squam River
Little Sunapee Lake	outflow	Lake Sunapee
Lovell Lake	outflow	Branch River (New Hampshire)
Lake Massasecum	outflow	Warner River
McIndoes Reservoir	outflow	Connecticut River
Mendum's Pond	outflow	Little River (Lamprey River)
Mirror Lake (Tuftonboro, New Hampshire)	outflow	Lake Winnipesaukee
Northeast Pond	outflow	Salmon Falls River
Milton Pond	outflow	Salmon Falls River
Northwood Lake	outflow	Little Suncook River
Nubanusit Lake	outflow	Nubanusit Brook
Opechee Bay	outflow	Winnipesaukee River
Pawtuckaway Lake	outflow	Bean River
Pawtuckaway Lake	outflow	Pawtuckaway River
Penacook Lake	outflow	Merrimack River
Pine River Pond	outflow	Pine River (New Hampshire)
Pleasant Lake (Deerfield, New Hampshire)	outflow	Northwood Lake
Pleasant Lake (New London, New Hampshire)	outflow	Blackwater River (Contoocook River)
Tooma Reservoir	outflow	Tooma River
Pontook Reservoir	outflow	Androscoggin River
Powder Mill Pond	outflow	Contoocook River
Silver Lake (Madison, New Hampshire)	outflow	West Branch (New Hampshire)
Skatutakee Lake	outflow	Nubanusit Brook
Spofford Lake	outflow	Partridge Brook
Stump Pond (Balch Pond)	outflow	Little Ossipee River
Success Pond	outflow	Chickwolnepy Stream
Suncook Lakes	outflow	Suncook River
Surry Mountain Lake	outflow	Ashuelot River
Swains Lake	outflow	Bellamy River
New Melones Lake	outflow	Stanislaus River
Langesjøen	outflow	Numedalslågen
Vidra Lake	outflow	Lotru River
Third Connecticut Lake	outflow	Connecticut River
Turkey Ponds	outflow	Turkey River (New Hampshire)
Lake Waukewan	outflow	Lake Winnipesaukee
Weare Reservoir	outflow	Piscataquog River
White Oak Pond	outflow	Squam Lake
Ozette Lake	outflow	Ozette River
Turnabout Lake	outflow	Turnabout River
Cutler Reservoir	outflow	Bear River (Utah)
Rockport Reservoir	outflow	Weber River
Canyon Lake (Texas)	outflow	Guadalupe River (Texas)
Lake Tillery	outflow	Pee Dee River
Badin Lake	outflow	Yadkin River
High Rock Lake	outflow	Tuckertown Reservoir
Lake Macquarie (New South Wales)	outflow	Tasman Sea
Lake Almanor	outflow	Feather River
Lough Gowna	outflow	River Erne
Choke Canyon Reservoir	outflow	Frio River
Whiskeytown Lake	outflow	Clear Creek#In California
Grand Lake (New Brunswick)	outflow	Jemseg River
Blue Mesa Reservoir	outflow	Gunnison River
Hok Tau Reservoir	outflow	Tan Shan River
Cultus Lake, British Columbia	outflow	Sweltzer River
Llyn Dinas	outflow	Afon Glaslyn
Dniprodzerzhynsk Reservoir	outflow	Dnieper River
Kaniv Reservoir	outflow	Dnieper River
Dnieper Reservoir	outflow	Dnieper River
Brokopondo Reservoir	outflow	Suriname River
Rushford Lake	outflow	Genesee River
Iskar Reservoir	outflow	Iskar (river)
Schoharie Reservoir	outflow	Schoharie Creek
Usk Reservoir	outflow	River Usk
Poulaphouca	outflow	River Liffey
Lake Asveja	outflow	Dubinga River
Cold Lake (Alberta)	outflow	Cold River (Saskatchewan)
Lake Walter E. Long	outflow	Decker Creek (Texas)
Lough Dan	outflow	River Avonmore
Brady Creek Reservoir	outflow	Brady Creek
Lake Bastrop	outflow	Spicer Creek
Lake Gonzales	outflow	Guadalupe River (Texas)
Lake Placid (Texas)	outflow	Guadalupe River (Texas)
Zeya Reservoir	outflow	Zeya River
Lac Seul	outflow	English River (Ontario)
Abbey Village Reservoir	outflow	River Roddlesworth
Yarrow Reservoir	outflow	River Yarrow (Lancashire)
Cannonsville Reservoir	outflow	West Delaware Tunnel
Lake Wood	outflow	Guadalupe River (Texas)
Meadow Lake (Texas)	outflow	Guadalupe River (Texas)
Lake Dunlap	outflow	Guadalupe River (Texas)
Calaveras Lake (Texas)	outflow	Calaveras Creek
Notch Lake	outflow	Stony Clove Creek
Lake Findley	outflow	Chiltipin Creek
Falcon International Reservoir	outflow	Rio Grande
Lake Casa Blanca	outflow	Chacon Creek
Averhoff Reservoir	outflow	Nueces River
Balmorhea Lake	outflow	Sandia Creek
Lake Corpus Christi	outflow	Nueces River
Boyds Corner Reservoir	outflow	Croton River
Middle Branch Reservoir	outflow	Croton River
Cross River Reservoir	outflow	Cross River (New York)
Lake Texana	outflow	Navidad River
Sheldon Reservoir	outflow	Carpenters Bayou
Stillhouse Hollow Lake	outflow	Lampasas River
Belton Lake	outflow	Leon River
New Croton reservoir	outflow	Croton River
Vermilion Lakes	outflow	Bow River
Lake Needwood	outflow	Rock Creek (Potomac River)
Lake Bernard Frank	outflow	Rock Creek (Potomac River)
Dalešice Dam	outflow	Jihlava (river)
Carlyle Lake	outflow	Kaskaskia River
Lake Nemiscau	outflow	Rupert River
Lake Evans (Quebec)	outflow	Broadback River
Lake Mistassini	outflow	Rupert River
Burnt Lake (Canada)	outflow	Romaine River
Lake Kipawa	outflow	Kipawa River
Lac Dumoine	outflow	Kipawa River
Lake Burton (Georgia)	outflow	Tallulah River
Crystal Springs Reservoir	outflow	San Mateo Creek
Egenolf Lake	outflow	North Seal
Manasquan Reservoir	outflow	Timber Swamp Brook
Broken Bow Lake	outflow	Mountain Fork
Kingman Lake	outflow	Anacostia River
Kingman Lake	outflow	Evaporation
Lake Braddock	outflow	Pohick Creek
Stonewall Jackson Lake	outflow	West Fork River
Lake Waco	outflow	Bosque River
Bay Springs Lake	outflow	Tennessee–Tombigbee Waterway
Kerr Lake	outflow	Roanoke River
Waldo Lake	outflow	North Fork Middle Fork Willamette River
Lake Mendocino	outflow	Russian River (California)
Angram Reservoir	outflow	River Nidd
Cod Beck Reservoir	outflow	Cod Beck, North Yorkshire
Lac qui Parle	outflow	Minnesota River
Stocks Reservoir	outflow	River Hodder
Saugatuck Reservoir	outflow	Saugatuck River
Lake Sempach	outflow	Suhre
Lake Sarnen	outflow	Sarner Aa
Lake Baldegg	outflow	Aabach
Lake Hallwil	outflow	Aabach
Lake of Gruyère	outflow	Saane/Sarine
Lake Wohlen	outflow	Aar
Faaker See	outflow	Gail (river)
Traunsee	outflow	Traun (river)
Hallstätter See	outflow	Traun (river)
Plansee	outflow	Archbach
Plauer See (Mecklenburg-Vorpommern)	outflow	Müritz–Elde–Wasserstraße
Lake Vygozero	outflow	Vyg River
Lake Segozero	outflow	Segezha River
Lake Syamozero	outflow	Shuya River (Karelia)
Lake Vodlozero	outflow	Vodla River
Lake Labaz	outflow	Boganida River
Lake Lama	outflow	Lama (river, Taimyr)
Melakwa Lake	outflow	Pratt River
Lake Pyasino	outflow	Pyasina River
Lake Keta	outflow	Rybnaya River
Lake Beloye (Vologda Oblast)	outflow	Sheksna River
Lake Sinclair	outflow	Oconee River
Lake Oconee	outflow	Oconee River
Lake Quannapowitt	outflow	Saugus River
Salerno Lake	outflow	Irondale River
Mason Lake	outflow	Sherwood Creek
Kangaroo Lake	outflow	Heins Creek
Lake Lyndon	outflow	Acheron River (Canterbury)
Lake Sterzh	outflow	Volga River
Green Lake (Alaska)	outflow	Vodopad River
Wright Patman Lake	outflow	Sulphur River
Burdekin Dam	outflow	Burdekin River
Lake Solina	outflow	San (river)
Lake Žuvintas	outflow	Dovinė River
Brûlé Lake	outflow	Athabasca River
Capilano Lake	outflow	Capilano River
Lake Nottely	outflow	Nottely River
Lake Kubenskoye	outflow	Sukhona River
Lough Derravaragh	outflow	River Inny
Lake Ianthe	outflow	Wanganui River
Lake Poerua	outflow	Poerua River
Stillwater Lake (Pennsylvania)	outflow	Tunkhannock Creek (Tobyhanna Creek)
Lake Lubāns	outflow	Aiviekste River
Red Deer Lake (Alberta)	outflow	Battle River
Scituate Reservoir	outflow	North Branch Pawtuxet River
Lake Keowee	outflow	Keowee River
Lake Keowee	outflow	Little River (Oconee County, South Carolina)
Breckenridge Reservoir	outflow	Chopawamsic Creek
Jenny Lake	outflow	Snake River
Mendenhall Lake	outflow	Mendenhall River
Crab Orchard Lake	outflow	Crab Orchard Creek
Lake Freeman	outflow	Tippecanoe River
Fewston Reservoir	outflow	Swinsty Reservoir
Lake Wenatchee State Park	outflow	Wenatchee River
Pelican Lake (Minnesota)	outflow	Pelican River
Upper Peirce Reservoir	outflow	Kallang River
Lower Peirce Reservoir	outflow	Kallang River
Gods Lake	outflow	God's River
Nakaumi	outflow	Sakai Channel
Prospect reservoir	outflow	Prospect Creek (New South Wales)
Eagle Mountain Lake	outflow	Lake Worth (Texas)
Richard B. Russell Lake	outflow	Savannah River
Bistcho Lake	outflow	Petitot River
Bow Lake (Alberta)	outflow	Bow River
Hector Lake	outflow	Bow River
San Andreas Lake	outflow	San Andreas Creek
Lac la Biche (Alberta)	outflow	La Biche River
Clearwater Lakes	outflow	Clearwater River (Quebec)
East Lynn Lake	outflow	Twelvepole Creek
Lake Chabot	outflow	San Leandro Creek
Großer Wannsee	outflow	Havel
Sutton Lake	outflow	Elk River (West Virginia)
Wapta Lake	outflow	Kicking Horse River
Abraham Lake	outflow	North Saskatchewan River
Hiwassee, North Carolina	outflow	Hiwassee River
Lake Seminole	outflow	Apalachicola River
Woodhead Reservoir	outflow	River Etherow
Torside Reservoir	outflow	River Etherow
Rhodeswood Reservoir	outflow	River Etherow
Valehouse Reservoir	outflow	River Etherow
Arnfield Reservoir	outflow	River Etherow
Hollingworth Reservoir	outflow	Arnfield Reservoir
Lake Kagawong	outflow	Kagawong River
Lake Bohinj	outflow	Sava Bohinjka
Abyss Lake (Alaska)	outflow	Dundas River
Furesø (lake)	outflow	Mølleåen
Sylvan Lake (Alberta)	outflow	Red Deer River
Upper Roddlesworth Reservoir	outflow	River Roddlesworth
Lower Roddlesworth Reservoir	outflow	River Roddlesworth
Étang de Berre	outflow	Canal de Caronte
Étang de Berre	outflow	Canal du Rove
Aberdeen Lake (Nunavut)	outflow	Thelon River
Orlík Dam	outflow	Vltava
Vartry Reservoir	outflow	River Vartry
Kastraki (lake)	outflow	Achelous River
Stratos (lake)	outflow	Achelous River
Brule Lake	outflow	Brule River
Possum Kingdom Lake	outflow	Brazos River
San Antonio Reservoir (Alameda County)	outflow	San Antonio Creek
Flagstaff Lake (Maine)	outflow	Dead River (Kennebec River)
Chatfield Reservoir	outflow	South Platte River
Rangeley Lake	outflow	Rangeley River
Barrier Lake	outflow	Kananaskis River
Upper Kananaskis Lake	outflow	Lower Kananaskis Lake
Lower Kananaskis Lake	outflow	Kananaskis River
Ajawaan Lake	outflow	Churchill River
Lake Vico	outflow	Rio Vicano
Elbow Lake (Alberta)	outflow	Elbow River
Mingachevir reservoir	outflow	Kura River
Lake William Hovell	outflow	King River (Victoria)
Aotea Lagoon	outflow	Porirua Harbour
Paudash Lake	outflow	Crowe River
Wollaston Lake	outflow	Fond du Lac River
Wollaston Lake	outflow	Cochrane River (Canada)
Winefred Lake	outflow	Winefred River
Lake Awoonga	outflow	Boyne River (Queensland)
Lipno Dam	outflow	Vltava
Sturgeon Pool	outflow	Wallkill River
Lake Accotink	outflow	Accotink Creek
Fishtrap Lake	outflow	Levisa Fork
Lake Péligre	outflow	Artibonite River
Lac Ste. Anne (Alberta)	outflow	Sturgeon River (Alberta)
Blewett Falls Lake	outflow	Pee Dee River
Lake Musconetcong	outflow	Musconetcong River
Wahwashkesh Lake	outflow	Magnetawan River
Prashar Lake	outflow	Evaporation
Grayson Lake	outflow	Little Sandy River (Kentucky)
Alamo Lake State Park  Alamo Lake   1	outflow	Bill Williams River
Alamo Lake State Park  Alamo Lake   1	outflow	Evaporation
Lake Cootharaba	outflow	Noosa River
Lower Lough MacNean	outflow	Arney River
Ladon Lake	outflow	Ladon (river)
Yan Yean Reservoir	outflow	Plenty River (Victoria)
Glenlyon Dam	outflow	Pike Creek (Queensland)
Lake Moawhango	outflow	Tongariro River
Lake Nockamixon	outflow	Tohickon Creek
Silver Creek Reservoir	outflow	Silver Creek (Oregon)
Thief Valley Reservoir	outflow	Powder River
Mountain Creek Lake	outflow	Mountain Creek, Dallas, Texas
Lake Sils	outflow	Inn (river)
Lake Silvaplana	outflow	Lake Champfer
Pfäffikersee	outflow	Ustermer Aa
Mauensee	outflow	Ron
Yelcho Lake	outflow	Yelcho River
Schiffenensee	outflow	Saane/Sarine
Lago di Lei	outflow	Reno di Lei
Thruscross Reservoir	outflow	River Washburn
Lake Independence	outflow	Iron River (Marquette County, Michigan)
Squint Lake	outflow	Eagle Creek (Burnaby)
Skootamatta Lake	outflow	Skootamatta River
Lake Sacajawea	outflow	Snake River
Guelph Lake	outflow	Speed River
Llyn Eigiau	outflow	Afon Porth-llwyd
Llyn Dulyn	outflow	Afon Dulyn
Lindley Wood Reservoir	outflow	River Washburn
Lake Ioannina	outflow	Thyamis
Lake Rotorangi	outflow	Patea River
Lake Granbury	outflow	Brazos River
Llyn Conwy	outflow	River Conwy
Apache Lake (Arizona)	outflow	Salt River (Arizona)
Lake Manych-Gudilo	outflow	Sea of Azov
Lake Vyalozero	outflow	Vyala River
Lake Yonozero	outflow	Varzina River
Lake Kolvitskoye	outflow	Kolvitsa River
Squaw Creek Reservoir	outflow	Squaw Creek
Köyliönjärvi	outflow	Köyliönjoki
Lake Columbia	outflow	Goose Creek
Panguipulli Lake	outflow	Enco River
Llyn Melynllyn	outflow	Afon Melynllyn
Ffynnon Llugwy	outflow	River Llugwy
Riñihue Lake	outflow	San Pedro River (Chile)
Walker Lake (Northwest Arctic, Alaska)	outflow	Kobuk River
Lake Misurina	outflow	Ansiei
Jaffna Lagoon	outflow	Indian Ocean
Pandan Reservoir	outflow	List of rivers of Singapore#Canalised
Geist Reservoir	outflow	Fall Creek (Indiana)
Christine Lake	outflow	Upper Ammonoosuc River
Loch Scaven	outflow	River Carron, Wester Ross
Loch Dùghaill	outflow	River Carron, Wester Ross
Lake Cochichewick	outflow	Cochichewick River
Navajo Lake	outflow	San Juan River (Colorado River)
Thousand Island Lake	outflow	San Joaquin River
Silver Lake (Serbia)	outflow	Danube
Abiquiu Lake	outflow	Rio Chama (Rio Grande)
Playgreen Lake	outflow	Nelson River
Wägitalersee	outflow	Wägitaler Aa
Ranco Lake	outflow	Bueno River
Rupanco Lake	outflow	Rahue River
Puyehue Lake	outflow	Pilmaiquén River
Ffynnon Lloer	outflow	Afon Lloer
Lake Arpi	outflow	Akhurian River
Tranque Puclaro	outflow	Elqui River
Lac Beauvert	outflow	Athabasca River
Calafquén Lake	outflow	Pullinque River
Virginia Water Lake	outflow	River Bourne, Chertsey
El Atazar Dam	outflow	Lozoya (river)
Mystic Lakes (Boston, Massachusetts)	outflow	Mystic River
Großer Plöner See	outflow	Schwentine
Profile Lake	outflow	Pemigewasset River
Lac de Joux	outflow	Orbe River
Lungerersee	outflow	Sarner Aa
Liberty Reservoir	outflow	Patapsco River
Lake Rosebery (Tasmania)	outflow	Pieman River
Klöntalersee	outflow	Löntsch
Lake Der-Chantecoq	outflow	Marne (river)
Lake Poinsett	outflow	St. Johns River
Lake Winder	outflow	St. Johns River
Lake Osakis	outflow	Sauk River (Minnesota)
Cochrane/Pueyrredón Lake	outflow	Cochrane River
Grimselsee	outflow	Aar
Lago di Poschiavo	outflow	Poschiavino
Dubawnt Lake	outflow	Dubawnt Lake
Stranger Pond	outflow	Murrumbidgee River
Robert-Bourassa Reservoir	outflow	La Grande River
Blue Cypress Lake	outflow	St. Johns River
Albigna lake	outflow	Albigna
Gouin Reservoir	outflow	Saint-Maurice River
Lake Monroe (Florida)	outflow	St. Johns River
Lake Livingston	outflow	Trinity River (Texas)
Pymatuning Reservoir	outflow	Shenango River
Ross River Dam	outflow	Ross River
Lake St. Moritz	outflow	Inn (river)
Contwoyto Lake	outflow	Burnside River
Loch Arkaig	outflow	River Arkaig
Lake Żarnowiec	outflow	Piaśnica
Mystic Lake (California)	outflow	San Jacinto River (California)
Lake Ozhogino	outflow	Ozhogin River
Herzsee (Tyrol)	outflow	Herzsee (Tyrol)
Leigh Lake	outflow	String Lake
Puzzle Lake	outflow	St. Johns River
Grand Pond	outflow	Aldranser Bach
Christina Lake (British Columbia)	outflow	Christina Creek
Lake Galena (Pennsylvania)	outflow	Neshaminy Creek
Garibaldi Lake	outflow	Rubble Creek
Cedar Creek Reservoir (Alabama)	outflow	Cedar Creek (Alabama)
Last Mountain Lake	outflow	Last Mountain Creek (Saskatchewan)
Lac Saint-François (Estrie)	outflow	Saint-François River
Laja Lake	outflow	Laja River (Chile)
Lake Pat Cleburne	outflow	Nolan River (Texas)
Saadjärv	outflow	Mudajõgi
Caburgua Lake	outflow	Ojos del Caburgua
Colico Lake	outflow	Colico River
Thiersee Lake	outflow	Thiersee Lake
Lake Conlin	outflow	Econlockhatchee River
Ingraham Lake	outflow	East Cape Canal
Lake Nillahcootie	outflow	Broken River (Victoria)
Lake Qaraoun	outflow	Litani River
Cagles Mill Lake	outflow	Mill Creek
Lake Assad	outflow	Euphrates
Lake Buhi	outflow	Tabao River
Pirihueico Lake	outflow	Fui River
Himayat Sagar	outflow	Musi River (India)
Deer Lake (Newfoundland and Labrador)	outflow	Humber River (Newfoundland and Labrador)
Lake Chivero	outflow	Manyame River
Zervreilasee	outflow	Valser Rhein
East Branch Clarion River Lake	outflow	East Branch Clarion River
Buntzen Lake	outflow	Indian Arm
San Rafael Lagoon	outflow	Témpanos River
Lake Narracan	outflow	La Trobe River
Golden Lake	outflow	Bonnechere River
Green River Lake	outflow	Green River (Kentucky)
Martins Fork Lake	outflow	Cumberland River
Paintsville Lake	outflow	Paint Creek (Johnson County, Kentucky)
Rough River Lake	outflow	Rough River
Lake Tegel	outflow	Havel
Lac d'Emosson	outflow	Barberine
Lake Sukhodolskoye	outflow	Burnaya River
Grasmere (lake)	outflow	River Rothay
Rapoldi-Weiher	outflow	Sill (river)
Pocono Peak Lake	outflow	Lehigh River
Tolay Lake	outflow	Tolay Creek
Maihue Lake	outflow	Calcurrupe River
Otter Lake (Illinois)	outflow	Otter Creek
Lake Shikotsu	outflow	Chitose River
Malheur Lake	outflow	Soil mechanics#Seepage: steady state flow of water
Malheur Lake	outflow	Evaporation
Türlersee	outflow	Reppisch
Budi Lake	outflow	Budi River
Lake Viljandi	outflow	Raudna
Brennersee	outflow	Sill (river)
Lake Campotosto	outflow	Fucino River
Grünsee (Pflersch)	outflow	Pflerscher Bach
Conguillío Lake	outflow	Trufultruful River
Seealpsee	outflow	Schwendibach
Müritz	outflow	Elde
Kettle Creek Reservoir	outflow	Kettle Creek (Pennsylvania)
Fountaingrove Lake	outflow	Piner Creek
Lac des Brenets	outflow	Doubs (river)
Lake Madawaska	outflow	Madawaska River (Ontario)
Lac de Moiry	outflow	Gougra
Llyn Cefni	outflow	Afon Cefni
Quail Lake	outflow	California Aqueduct
Gouthwaite Reservoir	outflow	River Nidd
Lake Shelbyville	outflow	Kaskaskia River
Lake Ilsanjo	outflow	Spring Creek (Sonoma County, California)
Štěchovice Reservoir	outflow	Vltava
Shivasagar lake	outflow	Koyna River
Lake Nordenskjöld	outflow	Paine River
Clearwater Lake (Missouri)	outflow	Black River (Arkansas)
C. J. Strike Reservoir	outflow	Snake River
Eikesdalsvatnet	outflow	Eira River
Quesnel Lake	outflow	Quesnel River
Lake Winneshiek	outflow	Upper Mississippi River
San Pablo Reservoir	outflow	San Pablo Creek
Gråsjøen	outflow	Foldsjøen
Lake Kanozero	outflow	Umba River (Russia)
Lake Ponchozero	outflow	Umba River (Russia)
Lago del Sambuco	outflow	Maggia (river)
Lake Rousseau	outflow	Withlacoochee River (Florida)
Lake Vallülasee	outflow	Lake Vallülasee
Krasno-Oskol Reservoir	outflow	Oskol River
Russvatnet	outflow	Sjoa
Ogden Reservoir (Greater Manchester)	outflow	Piethorne Brook
Duck Lake (Iowa)	outflow	Upper Mississippi River
Big Lake (Iowa)	outflow	Upper Mississippi River
Poulaphouca Reservoir	outflow	River Liffey
Great Pond (New Hampshire)	outflow	Powwow River
Swan Lake (Carroll County, Iowa)	outflow	Raccoon River
Lai da Marmorera	outflow	Julia (river)
Zasavica (bog)	outflow	Zasavica (river)
Lows Lake	outflow	Bog River
Limmernsee	outflow	Limmernbach
Chester Morse Lake	outflow	Cedar River (Washington)
Del Toro Lake	outflow	Serrano River
Lake Blackshear	outflow	Flint River (Georgia)
Baskatong Reservoir	outflow	Gatineau River
Powwow Pond	outflow	Powwow River
Black Hawk Lake (Sac County, Iowa)	outflow	Indian Creek (Sac County Iowa)
Lake Pehoe	outflow	Paine River
Grey Lake	outflow	Grey River (Chile)
Sunset Lake (Lakes Region, New Hampshire)	outflow	Suncook River
Lago di Mergozzo	outflow	Lake Maggiore
Lake Kutubu	outflow	Soro River
Lake Walcott	outflow	Snake River
Lake Vivi	outflow	Vivi River (Russia)
Laguna del Carbón	outflow	Evaporation
Lake Jesup	outflow	St. Johns River
Toktogul Reservoir	outflow	Naryn River
Lake Tanzawa	outflow	Kōsagawa
Lake Lou Yaeger	outflow	Shoal Creek (Illinois)
Randleman Lake	outflow	Deep River (North Carolina)
Lake Red Rock (Des Moines River)	outflow	Des Moines River
Lake Langdon	outflow	Langdon Bay Creek
Wimbleball Lake	outflow	River Haddeo
Alplersee	outflow	Wiktionary:subterranean
Arnensee	outflow	Tschärzisbach
Robert S. Kerr Reservoir	outflow	Arkansas River
Räterichsbodensee	outflow	Aar
Pat Mayse Lake	outflow	Sanders Creek
Lake Herbert G. West	outflow	Snake River
Lake Eupen	outflow	Vesdre
Black Butte Lake	outflow	Stony Creek
Alum Creek Lake	outflow	Alum Creek
Lake Skegemog	outflow	Elk Lake (Michigan)
Lake Idro	outflow	Chiese
Baldwin Lake (Illinois)	outflow	Kaskaskia River
Rimrock Lake	outflow	Tieton River
Bumping Lake	outflow	Bumping River
Cle Elum Lake	outflow	Cle Elum River
Kachess Lake	outflow	Kachess River
Keechelus Lake	outflow	Yakima River
Lac de Mauvoisin	outflow	Dranse de Bagnes
Tolken	outflow	Viskan
Deal Lake	outflow	Atlantic Ocean
Nimpo Lake	outflow	Dean River
Lake Rotoiti (Tasman)	outflow	Buller River
Lake Rotoiti (Bay of Plenty)	outflow	Kaituna River
Fern Ridge Reservoir	outflow	Long Tom River
Lago di Vogorno	outflow	Valle Verzasca
Benbrook Lake	outflow	Trinity River (Texas)
Lake Tali Karng	outflow	Wellington River
Judarn	outflow	Mälaren
Kyrksjön	outflow	Mälaren
Columbia Lake	outflow	Columbia River
Råcksta Träsk	outflow	Mälaren
Lillsjön (Ulvsunda)	outflow	Ulvsundasjön
Laduviken	outflow	Husarviken
Laduviken	outflow	Lilla Värtan
Boysen Reservoir	outflow	Wind River (Wyoming)
Lake Panache	outflow	Whitefish River (Sudbury District, Ontario)
Lost Creek Lake	outflow	Rogue River (Oregon)
Lappkärret	outflow	Lilla Värtan
Lake Letas	outflow	Siri Waterfall
Lake Winnibigoshish	outflow	Mississippi River
Lake Matapedia	outflow	Matapédia River
Spegeldammen	outflow	Husarviken
Spegeldammen	outflow	Lilla Värtan
Uggleviken	outflow	Husarviken
Uggleviken	outflow	Lilla Värtan
Magelungen	outflow	Forsån
Magelungen	outflow	Drevviken
Little Rock Lake	outflow	Mississippi River
Swan Lake (Alaska)	outflow	Kettleson Memorial Library culvert
Drevviken	outflow	Gudö å
Drevviken	outflow	Långsjön (Skälsätra-Tutviken)
Flaten	outflow	Drevviken
Ältasjön	outflow	Sicklaån
Sicklasjön	outflow	Järlasjön
François Lake	outflow	Stellako River
Lac la Nonne	outflow	MacDonald Creek
Lac la Nonne	outflow	Pembina River (Alberta)
Lake Skadar	outflow	Bojana (river)
Långsjön	outflow	Mälaren
Trekanten (Stockholm)	outflow	Liljeholmsviken
Trekanten (Stockholm)	outflow	Mälaren
Mansfield Hollow Lake	outflow	Natchaug River
Applegate Lake	outflow	Applegate River
Gömmaren	outflow	Trehörningen (Sjödalen)
Gömmaren	outflow	Mälaren
Lokka Reservoir	outflow	Luiro
Zemplínska šírava	outflow	Laborec
Trehörningen (Sjödalen)	outflow	Ågestasjön
Grassholme Reservoir	outflow	River Lune (Durham)
Selset Reservoir	outflow	River Lune (Durham)
Balderhead Reservoir	outflow	Blackton Reservoir
Hacksjön	outflow	Kvarnsjön-Gladö
Hacksjön	outflow	Tyresån
Lake Glenn Shoals	outflow	Shoal Creek (Illinois)
Lake No	outflow	White Nile
Tantangara Reservoir	outflow	Murrumbidgee River
Lake Taylorville	outflow	Sangamon River
Vlasina Lake	outflow	Vlasina (river)
Lake Galena (Illinois)	outflow	Smallpox Creek
Lough Oughter	outflow	River Erne
Åsunden (Västergötland)	outflow	Ätran (river)
Cross Lake (Temagami)	outflow	Temagami River
Fern Lake	outflow	Big Thompson River
Lake Vermilion (Illinois)	outflow	Vermilion River (Wabash River tributary)
Sturgeon Lake (Northwestern Ontario)	outflow	Sturgeon River (Marchington River)
Smithville Lake	outflow	Platte River (Missouri)
Lake Rapel	outflow	Rapel River
Lago di Livigno	outflow	Spöl
Lai da Sontga Maria	outflow	Fróði
Vaseux Lake	outflow	Okanogan River
Lake Kasumigaura	outflow	Tone River
Paravani Lake	outflow	Paravani river
Gull Lake (Alberta)	outflow	Blindman River
Upemba Depression	outflow	Lualaba
Lake Holiday (Illinois)	outflow	Somonauk Creek
Lake Holiday, Virginia	outflow	Isaacs Creek (Back Creek)
Henry Hagg Lake	outflow	Tualatin River
Embalse La Paloma	outflow	Grande River (Coquimbo Chile)
Embalse Recoleta	outflow	Hurtado River
Lough Tay	outflow	Cloghoge River
Oologah Lake	outflow	Verdigris River
Dood Tsagaan nuur	outflow	Shishged Gol River
Lake Dysnai	outflow	Dysna River
Lake Pillsbury	outflow	Eel River (California)
Lake Francis Case	outflow	Missouri River
Chatyr-Kul	outflow	Evaporation
Głuszyńskie	outflow	Zgłowiączka, Kuyavian-Pomeranian Voivodeship
Song Kol Lake	outflow	Evaporation
Embalse El Yeso	outflow	Yeso River
Dassower See	outflow	Trave
Stony Lake (Ontario)	outflow	Katchewanooka Lake
Stony Lake (Ontario)	outflow	White/Dummer Lake
Lake Siriu	outflow	Buzău River
Lake Mattoon	outflow	Little Wabash River
Fena Lake	outflow	Talofofo River
Lake Anza	outflow	Wildcat Creek
Swan Lake Nature Study Area	outflow	Evaporation
Lake Connewarre	outflow	Barwon River (Victoria)
Reschensee	outflow	Adige
Ludaš Lake	outflow	Körös-ér
Jablanica lake	outflow	Neretva
Long Pond (Plymouth, Massachusetts)	outflow	Halfway Pond (Massachusetts)
Halfway Pond (Massachusetts)	outflow	Agawam River
Lake Khasan	outflow	Tanbogatyi River
Great Herring Pond	outflow	Herring River (Bourne, Massachusetts)
Lugu Lake	outflow	Yalong River
Těrlicko Dam	outflow	Stonávka
Stony Lake (Manitoba)	outflow	North Seal River
Lake Piru	outflow	Piru Creek
Billington Sea	outflow	Town Brook (Massachusetts)
Bear Island (Minnesota)	outflow	Bear Island River
Flachsee	outflow	Reuss (river)
Stausee Gibidum	outflow	Massa (river)
Steinhuder Meer	outflow	Weser
Sufnersee	outflow	Hinterrhein (river)
Lac de Moron	outflow	Doubs (river)
Lac des Toules	outflow	La Dranse d'Entremont
Nong Han Kumphawapi Lake	outflow	Pao River, Thailand
Robbins Pond (Massachusetts)	outflow	Satucket River
Winnecunnet Pond	outflow	Mill River (Taunton River)
Deadwood Reservoir	outflow	Deadwood River
Clifton Court Forebay	outflow	California Aqueduct
Clifton Court Forebay	outflow	Delta–Mendota Canal
Lake Lauerz	outflow	Seeweren
Lac de Pérolles	outflow	Saane/Sarine
Little Herring Pond	outflow	Great Herring Pond
McGregor Lake	outflow	Bow River
Stausee Ferden	outflow	Lonza (river)
Lake Orivesi	outflow	Savonlinna
Lake Orivesi	outflow	Tappuvirta
Höytiäinen	outflow	Puntarikoski
Yli-Kitka	outflow	Kitkanjoki
Lake Kemijärvi	outflow	Kemijoki
Clear Lake (Linn County, Oregon)	outflow	McKenzie River
Pyhäjärvi (Satakunta)	outflow	Eurajoki River
Lake Kilpisjärvi	outflow	Könkämäeno
Gutiérrez Lake	outflow	Gutiérrez River
Russell Millpond	outflow	Eel River (Massachusetts)
Split Rock Dam	outflow	Manilla River
Chaffey Dam	outflow	Peel River (New South Wales)
Chichester Dam	outflow	Chichester River
Brantley Lake	outflow	Pecos River
Eliburn Reservoir	outflow	Eliburn
Palena/General Vintter Lake	outflow	Corcovado River
East Head Reservoir	outflow	Wankinco River
Veliki Galijaš	outflow	Danube
Kent Lake	outflow	Lagunitas Creek
Lake Wyola	outflow	Sawmill River
Lake Crabtree	outflow	Crabtree Creek
Round Lake (Ontario)	outflow	Bonnechere River
Chip Lake (Alberta)	outflow	Lobstick River
Pellaifa Lake	outflow	Llancahue River
Pullinque Lake	outflow	Guanehue River
Gunners Exchange Pond	outflow	Hoyts Pond (Massachusetts)
Weslemkoon Lake	outflow	Little Mississippi River (Ontario)
Wallowa Lake	outflow	Wallowa River
Beacon Reservoir (Dutchess County, New York)	outflow	Dry Brook (Dutchess County, New York)
Niederriedsee	outflow	Aar
Lake Karla	outflow	Evaporation
Silver Lake (Plymouth County, Massachusetts)	outflow	Jones River
Glen Charlie Pond	outflow	Agawam River
Gübsensee	outflow	Sitter
Little Long Pond (Plymouth, Massachusetts)	outflow	Long Pond (Plymouth, Massachusetts)
Horseshoe Lake (Arizona)	outflow	Verde River
Bartlett Lake	outflow	Verde River
Lexington Reservoir	outflow	Los Gatos Creek (Santa Clara County, California)
Manchester Bolton & Bury reservoir	outflow	Manchester Bolton & Bury Canal
Laguna de Leche	outflow	Bay of Buena Vista
Nussbaumersee	outflow	Hüttwilersee
Tihonet Pond	outflow	Wankinco River
Fawn Pond (Massachusetts)	outflow	Agawam River
Mir Alam Tank	outflow	Musi River (India)
Lake Greenwood (South Carolina)	outflow	Saluda River
Ekityki Lake	outflow	Ekityki River
Lower Saranac Lake	outflow	Saranac River
Middle Saranac Lake	outflow	Saranac River
Upper Saranac Lake	outflow	Middle Saranac Lake
Snipatuit Pond	outflow	Mattapoisett River
Long Pond (Rochester, Massachusetts)	outflow	Snipatuit Pond
Lago di Palagnedra	outflow	Melezzo Orientale
Lauwersmeer	outflow	Wadden Sea
Spectacle Pond (Wareham, Massachusetts)	outflow	Agawam River
Blue Lake (Tasman)	outflow	Sabine River (New Zealand)
Blue Lake (Canterbury)	outflow	Tasman River
Lake Michie	outflow	Flat River (North Carolina)
Parker Mills Pond	outflow	Wankinco River
Mill Pond (Wareham, Massachusetts)	outflow	Agawam River
Tremont Mill Pond	outflow	Weweantic River
Mary's Pond	outflow	Sippican River
Leonards Pond (Rochester, Massachusetts)	outflow	Sippican River
Canim Lake (British Columbia)	outflow	Canim River
Tomahawk Lake	outflow	Cromline Creek
Lake Atsion	outflow	Mullica River
Pine Lake (Duxbury, Massachusetts)	outflow	Round Pond (Duxbury, Massachusetts)
Lake Hazar	outflow	Tigris
Lake Wappapello	outflow	St. Francis River
Schwielochsee (lake)	outflow	Spree
Source Lake (Ontario)	outflow	Madawaska River (Ontario)
Bark Lake (Ontario)	outflow	Madawaska River (Ontario)
Branch Lake (Ontario)	outflow	York River (Ontario)
Little Branch Lake (Ontario)	outflow	North York River (Ontario)
Yorkend Lake (Ontario)	outflow	York River (Ontario)
Kashaweogama Lake (Ontario)	outflow	Marchington River (Ontario)
Island Pond (Stoddard, New Hampshire)	outflow	North Branch Contoocook River
Abram Lake (Kenora District, Ontario)	outflow	English River (Ontario)
Sturgeon Lake (Nipissing District, Ontario)	outflow	Little Tomiko Lake (Ontario)
Sturgeon Lake (Hayes Watershed – Kenora District, Ontario)	outflow	Sturgeon River (Manitoba)
Watuppa Ponds	outflow	Quequechan River
Beira Lake	outflow	Indian Ocean
Lake Wateree	outflow	Wateree River
Marchington Lake (Ontario)	outflow	Marchington River (Ontario)
Lake Vozhe	outflow	Svid River
Brădişor Dam	outflow	Lotru River
Lotru-Ciunget Hydroelectric Power Station	outflow	Lotru River
Alumine Lake	outflow	Aluminé River
Lac de Lessoc	outflow	Saane/Sarine
Lai da Palpuogna	outflow	Albula (river)
Lake Elwell	outflow	Marias River
Loch Raven Reservoir	outflow	Gunpowder River
Piethorne Reservoir	outflow	Piethorne Brook
Norman Hill Reservoir	outflow	Piethorne Brook
Franklin Falls Pond	outflow	Saranac River
Lough Eske	outflow	River Eske
Gibson Lake (Indiana)	outflow	Patoka River
Lake Hamana	outflow	Pacific Ocean
Small Pond (Innsbruck)	outflow	Aldranser Bach
Oberer Murgsee	outflow	Murgbach
Swithland Reservoir	outflow	Buddon Brook
Lake Sartai	outflow	Šventoji
Perseverance Dam	outflow	Perseverance Creek
Fairbairn Dam	outflow	Nogoa River
Fred Haigh Dam	outflow	Kolan River
Boondooma Dam	outflow	Boyne River (Queensland)
Wuruma Dam	outflow	Nogo River
Gold Creek Dam	outflow	Gold Creek (Queensland)
E.J. Beardmore Dam	outflow	Balonne River
Lake Harku	outflow	Gulf of Finland
Baroon Pocket Dam	outflow	Obi Obi Creek
Lake Manchester Dam	outflow	Cabbage Tree Creek
Lenthalls Dam	outflow	Burrum River
Lake Worth (Texas)	outflow	Trinity River (Texas)
Lac du Vernex	outflow	Saane/Sarine
Lake Gregory (California)	outflow	Houston Creek
Clearwater Lake (British Columbia)	outflow	Clearwater River (British Columbia)
Lake Ngardok	outflow	Ngerdorch River
Lac des Rousses	outflow	Orbe River
Lake Siskiyou	outflow	Sacramento River
Lake Cadillac	outflow	Clam River
Mărişelu Hydroelectric Power Station	outflow	Someş River
Loch Kinord	outflow	River Dee, Aberdeenshire
Loch Lee	outflow	River Esk
Ghost Lake (Alberta)	outflow	Bow River
Lai da Ova Spin	outflow	Spöl
Lake McCloud	outflow	McCloud River
Lewiston Lake	outflow	Trinity River (California)
Manyuchi Dam	outflow	Mwenezi River
Beverly Lake (Nunavut)	outflow	Aberdeen Lake (Nunavut)
Fontana Lake	outflow	Little Tennessee River
Yathkyed Lake	outflow	Kazan River
Kaminak Lake	outflow	Hudson Bay
Ferguson Lake (Kitikmeot Region)	outflow	Ekalluk River
Ferguson Lake (Kivalliq Region)	outflow	Ferguson River (Nunavut)
Owyhee Reservoir	outflow	Owyhee River
Lake Ralphine	outflow	Spring Creek (Sonoma County, California)
Santa Rosa Creek Reservoir	outflow	Spring Creek (Sonoma County, California)
Lac Lioson	outflow	Hongrin
Littleville Lake (Massachusetts)	outflow	Westfield River
Number 7 Dam	outflow	Dee River (Queensland)
Qamanirjuaq Lake	outflow	Ferguson River (Nunavut)
Lake Ohakuri	outflow	Waikato River
La Poudre Pass Lake	outflow	Colorado River
Rabbit Lake (Ontario)	outflow	Matabitchuan River
Ardleigh Reservoir	outflow	Salary Brook, Essex
Petaluma Reservoir	outflow	Adobe Creek (near Petaluma, California)
Chadwick Lake	outflow	Quassaick Creek
Agency Lake (Oregon)	outflow	Upper Klamath Lake
Coyote Lake (Santa Clara County, California)	outflow	Coyote Creek (Santa Clara County)
Lake Kerkini	outflow	Struma (river)
Albysjön (Botkyrka)	outflow	Vårbyfjärden
Albysjön (Tyresö)	outflow	Kalvfjärden
Tyresö-Flaten	outflow	Albysjön (Tyresö)
Barnsjön	outflow	Tyresö-Flaten
Lago di Mezzola	outflow	Mera (river)
Ågestasjön	outflow	Magelungen
Warm Springs Reservoir	outflow	Malheur River
Orlången	outflow	Ågestasjön
Mörtsjön	outflow	Orlången
Goat Rock Lake	outflow	Chattahoochee River
Lake Harding	outflow	Chattahoochee River
Candle Lake (Saskatchewan)	outflow	Torch River (Saskatchewan)
Sturgeon Lake (Saskatchewan)	outflow	Sturgeon River (Saskatchewan)
Lake Oliver	outflow	Chattahoochee River
Lake Chehaw	outflow	Flint River (Georgia)
Grändalssjön	outflow	Albysjön (Tyresö)
Långsjön (Skälsätra-Tutviken)	outflow	Tyresö-Flaten
Ypacaraí Lake	outflow	Salado River (Paraguay)
Fatburen	outflow	Kalvfjärden
George W. Andrews Lake	outflow	Chattahoochee River
Lake Manantali	outflow	Bafing River
Dammträsk	outflow	Drevviken
Llyn y Fan Fach	outflow	Sawdde
Lake Bonney (Riverland)	outflow	Murray River
Lake Piso	outflow	Inlet
Little Seneca Lake	outflow	Little Seneca Creek
Garry Lake	outflow	Back River
Angikuni Lake	outflow	Kazan River
Dickson Lake	outflow	Paine River
Lake Newell	outflow	Bow River
McFaulds Lake	outflow	Attawapiskat River
Nora Mill Dam	outflow	Chattahoochee River
Langdale Dam	outflow	Chattahoochee River
Crow Hop Dam	outflow	Chattahoochee River
Riverview Dam	outflow	Chattahoochee River
North Highlands Dam	outflow	Chattahoochee River
City Mills Dam	outflow	Chattahoochee River
Eagle & Phenix Dam	outflow	Chattahoochee River
Guadalupe Reservoir	outflow	Guadalupe River (California)
Weissensee (Carinthia)	outflow	Drava
Lake Chad (Antarctica)	outflow	Lake Hoare
Loch Chon	outflow	Chon Water
Senecaville Lake	outflow	Wills Creek (Ohio)
Žermanice Dam	outflow	Lučina (river)
Morávka Dam	outflow	Morávka (river)
Šance Dam	outflow	Ostravice (river)
Rocky Gorge Reservoir	outflow	Patuxent River
Triadelphia Reservoir	outflow	Patuxent River
Lake Suttonfield	outflow	Sonoma Creek
Sherbrooke Lake (British Columbia)	outflow	Sherbrooke Creek
Oswego Lake	outflow	Willamette River
Lake Forsyth	outflow	Soil mechanics#Seepage: steady state flow of water
Lake Luodis	outflow	Šventoji
Charvak Lake	outflow	Chirchiq
Takla Lake	outflow	Middle River (British Columbia)
Lake Ibsen	outflow	Little Coulee
Dunlewey Lough	outflow	Clady River
Obabika Lake	outflow	Obabika River
Elektrėnai Reservoir	outflow	Strėva River
Imperial Reservoir	outflow	Colorado River
Bacino di Val Malvaglia	outflow	Orino
Lago di Malciaussia	outflow	Stura di Viù
Lake Aldwell	outflow	Elwha River
Lake Roland (Maryland)	outflow	Jones Falls
Zaovine Lake	outflow	Rzav (Zlatibor)
Knapp Lake	outflow	Papakeechie watershed
Indian Valley Reservoir	outflow	Cache Creek (Sacramento River)
Lago di Alserio	outflow	Lambro
Lake Yoa	outflow	Evaporation
Lake Yoa	outflow	Drainage
Imperial Reservoir (Texas)	outflow	Pecos River
Lake Fianga	outflow	Mayo Kébbi
Lake Markakol	outflow	Kaldzhir River
Lake Pieman	outflow	Pieman River
Lake Cecebe	outflow	Magnetawan River
Doe Lake (Parry Sound District, Ontario)	outflow	Magnetawan River
Lake Santeetlah	outflow	Cheoah River
Little Shuswap Lake	outflow	Thompson River
Lamberton Lake	outflow	Lamberton Creek
Owikeno Lake	outflow	Wannock River
Diexi Lake	outflow	Min River (Sichuan)
Gates Lake	outflow	Gates River
Hardy Lake	outflow	Quick's Creek
Lac d'Apremont	outflow	Vie (river)
Lake Palmdale	outflow	Una Lake
Shawano Lake	outflow	Wolf River (Fox River)
Bang Lang Reservoir	outflow	Pattani River
Lake Massapoag	outflow	Canoe River
Lake Massapoag	outflow	Massapoag Brook
Laguna del Maule	outflow	Maule River
Sand Lake (Kearney, Ontario)	outflow	Magnetawan River
Lake Musters and Lake Colhue Huapi	outflow	Senguerr River
Lake Musters and Lake Colhue Huapi  Lake Colhué Huapi   1	outflow	Evaporation
Lake Ovid	outflow	Little Maple River
Loch Snizort	outflow	The Minch
Trylen	outflow	Övre Rudasjön
Övre Rudasjön	outflow	Dammträsk
Övre Rudasjön	outflow	Drevviken
Bertrand Lake	outflow	Baker River (Chile)
Boone Lake	outflow	Holston River
Coralville Lake	outflow	Iowa River
Ashurst Lake	outflow	Evaporation
Slocan Lake	outflow	Slocan River
Green Lake (Whistler)	outflow	Green River (British Columbia)
Mahood Lake	outflow	Mahood River
Bridge Lake (British Columbia)	outflow	Bridge Creek (British Columbia)
Douglas Lake	outflow	French Broad River
Chapman Lake	outflow	Tionesta Creek
Oseetah Lake	outflow	Saranac River
Long Lake (New York)	outflow	Raquette River
Alcona Dam Pond	outflow	Au Sable River (Michigan)
El Golfete	outflow	Dulce River
Lake Yonah	outflow	Tugaloo River
Antietam Lake	outflow	Antietam Creek (Schuylkill River)
Lake Elkhorn	outflow	Patuxent River
Lake Sunapee	outflow	Sugar River (New Hampshire)
Lake Sarysu	outflow	Kura River
Farrington Lake	outflow	Lawrence Brook
Khar-Us Nuur	outflow	Chono Kharaikh Gol
Tatla Lake	outflow	Tatla Lake Creek
Alexander Lake (southcentral Alaska)	outflow	Alexander Creek (Susitna River)
Kepler Lake	outflow	Black Lake Bayou
Ena Lake  na Lake   1	outflow	MacFarlane River (Ontario)
Lake Varese	outflow	Bardello
Lac de Bonlieu	outflow	Hérisson
Lac de Chalain	outflow	Ain (river)
Lake Lila	outflow	Beaver River
Scofield Reservoir	outflow	Price River
Baddinsgill Reservoir	outflow	Lyne Water
Lake Edgar	outflow	Huon River
Orange Lake (New York)	outflow	Bushfield Creek
Zavoj Lake	outflow	Temštica#Visočica
Monticello Reservoir	outflow	Parr Reservoir
Parr Reservoir	outflow	Broad River (Carolinas)
Graham Lake (Maine)	outflow	Union River (Maine)
Lake Carmel (New York)	outflow	Croton River
Spednic Lake	outflow	Saint Croix River (Maine – New Brunswick)
Daisy Lake (British Columbia)	outflow	Cheakamus River
Tallulah Falls Lake	outflow	Tallulah River
Nizhnekamsk Reservoir	outflow	Kama River
Harlan County Lake	outflow	Republican River
Santiam Lake	outflow	North Santiam River
Kochelsee	outflow	Loisach
Walchensee	outflow	Jachen
Walchensee	outflow	Walchensee Hydroelectric Power Station
Llanishen Reservoir	outflow	Drainage
Lake Heron	outflow	Lake Stream
Ray Lake	outflow	Falls Creek
Lac d'Aiguebelette	outflow	Tiers
Lake Tshangalele	outflow	Lualaba River
Kama Reservoir	outflow	Kama River
Votkinsk Reservoir	outflow	Kama River
Argazi Reservoir	outflow	Miass River
Grimwith Reservoir	outflow	River Dibb
Todzha Lake	outflow	Toora-Khem River
Duncan Lake (British Columbia)	outflow	Duncan River
Lake Beechey	outflow	Back River
Missinaibi Lake	outflow	Missinaibi River
Mississippi Lake	outflow	Mississippi River (Ontario)
Lake Lupche	outflow	Lupche-Savino River
Lake Chudzyavr	outflow	Chudzjok River
Lake Yurkhyamyayarvi	outflow	Karelsky Bashkaus River
Lake Notozero	outflow	Tuloma River
Lake Umatilla	outflow	Columbia River
Lake Wallula	outflow	Columbia River
Lake Pateros	outflow	Columbia River
Åsnen	outflow	Mörrumsån
Falls Reservoir	outflow	Yadkin River
Seeburger See	outflow	Aue
Lake Niangua	outflow	Niangua River
Bull Run Lake	outflow	Bull Run River (Oregon)
Lake Humboldt	outflow	Humboldt Sink
Mess Lake	outflow	Mess Creek
Lake Sagami	outflow	Sagami River
Laudachsee	outflow	Laudach
Riffe Lake	outflow	Cowlitz River
Little Cedar Lake (Wisconsin)	outflow	Cedar Creek, Wisconsin
Cabonga Reservoir	outflow	Gens de Terre River
Cabonga Reservoir	outflow	Ottawa River
Lake Michigamme	outflow	Michigamme River
Lake Balanan	outflow	Balanan River
Lake Wedowee	outflow	Tallapoosa River
Llyn Cwm Bychan	outflow	River Artro
Brantley Lake State Park  Brantley Lake   1	outflow	Pecos River
Lake Merwin	outflow	Lewis River (Washington)
Yale Lake	outflow	Lewis River (Washington)
Swift Reservoir	outflow	Lewis River (Washington)
Đeravica Lake	outflow	Erenik
Rock Island Pool	outflow	Columbia River
Lake Wanapum	outflow	Columbia River
Priest Rapids Lake	outflow	Columbia River
Lake Bonneville (Oregon)	outflow	Columbia River
Cougar Reservoir	outflow	McKenzie River
Lookout Point Lake	outflow	Middle Fork Willamette River
Lucky Peak Lake	outflow	Boise River
Head Lake (Haliburton County)	outflow	Drag River
Redfish Lake	outflow	Salmon River (Idaho)
Head Lake (Kawartha Lakes)	outflow	Head River
Gaspereau Lake	outflow	Gaspereau River
Caspian Sea	outflow	Evaporation
Tims Ford Lake	outflow	Elk River (Tennessee)
Lake Baao	outflow	Bicol River
Radonjićko Lake	outflow	Bistrica river
Lake of Sainte-Croix	outflow	Verdon (river)
Runn	outflow	Dalälven
Cherokee Reservoir	outflow	Holston River
Lac des Arcs (Alberta)	outflow	Bow River
Lake Colden	outflow	Flowed Lands
Avalanche Lake (New York)	outflow	Lake Colden
Styggevatnet	outflow	Jostedøla
Lake Minto	outflow	Leaf River (Quebec)
Teslin Lake	outflow	Teslin River
Lac Nedlouc	outflow	Charpentier River
Lille Rostavatn	outflow	Målselva
Lake Charles (Nova Scotia)	outflow	Shubenacadie Canal
Lac de Chambon	outflow	Creuse (river)
Dozois Reservoir	outflow	Ottawa River
Loch Alsh	outflow	Inner Sound, Scotland
Chogray Reservoir	outflow	Manych River
Stanley Lake	outflow	Salmon River (Idaho)
Hayward Lake	outflow	Stave River
Alouette Lake	outflow	Alouette River
Chilliwack Lake	outflow	Vedder River
Winthrop Rockefeller Lake	outflow	Arkansas River
Tatlayoko Lake	outflow	Homathko River
Russell Lake (Nova Scotia)	outflow	Morris Lake (Nova Scotia)
Chehalis Lake	outflow	Chehalis River (British Columbia)
Lake Seymour (Vermont)	outflow	Clyde River (Vermont)
Echo Lake (Charleston, Vermont)	outflow	Clyde River (Vermont)
Chocorua Lake	outflow	Chocorua River
Volgograd Reservoir	outflow	Volga River
Maguse Lake	outflow	Maguse River
Loch Ness	outflow	River Ness
Loch Ness	outflow	Caledonian Canal
Thompson Pond	outflow	Wappinger Creek
Dismal Lakes	outflow	Kendall River
Harlan County Reservoir	outflow	Republican River
Godley Reservoir	outflow	Audenshaw
Lake Onslow	outflow	Teviot River
Skilak Lake	outflow	Kenai River
Kenai Lake	outflow	Kenai River
Lake Shawnee (New Jersey)	outflow	Beaver Brook (New Jersey)
Jewel Lake	outflow	Wildcat Creek
Dove Lake (Pennsylvania)	outflow	Mill Creek (Montgomery County, Pennsylvania)
Taseko Lakes	outflow	Taseko River
Lajoie Lake	outflow	Lajoie Creek
Bully Creek Reservoir	outflow	Bully Creek (Malheur River)
Lagdo Reservoir	outflow	Benue River
Llyn y Fan Fawr	outflow	River Tawe
Narva Reservoir	outflow	Narva River
South Cascade Lake	outflow	Cascade River (Washington)
Lac d'Avoriaz	outflow	Dranse de Morzine
Lac du Jotty	outflow	Dranse de Morzine
Alvarado Park Lake	outflow	Turkey Creek (Johnson County, Texas)
Chilcotin Lake	outflow	Chilcotin River
Upper Melakwa Lake	outflow	Pratt River
Dease Lake (British Columbia)	outflow	Dease River
Bear Lake (Washington)	outflow	Taylor River (Washington)
Bear Lake (Bear River)	outflow	Bear River (Sustut River)
Lough Cullin	outflow	River Moy
Embalse de Salime	outflow	Navia (river)
Lake Padden	outflow	Padden Creek
Hilltop Lake	outflow	Garrity Creek
Lake Stamford	outflow	California Creek
Hariksee	outflow	Schwalm
Dümmer See	outflow	Sude
Kleiner Arbersee	outflow	Weißer Regen
Ratzeburger See	outflow	Wakenitz
Selenter See	outflow	Hohenfelder Mühlenau
Selenter See	outflow	Salzau
Haddebyer Noor	outflow	Schlei
Speicherbecken Lohsa	outflow	Spree
Peruća Lake	outflow	Cetina
Deer Lake (Taylor River)	outflow	Taylor River (Washington)
Bärwalder See	outflow	Schwarzer Schöps
Aasee (Münster)	outflow	Münstersche Aa
Waginger See	outflow	Götzinger Achen
Werbellinsee	outflow	Oder–Havel Canal
Lanker See	outflow	Schwentine
Behler See	outflow	Schwentine
Kleiner Plöner See	outflow	Schwentine
Fuhlensee	outflow	Schwentine
Dieksee	outflow	Schwentine
Kronsee	outflow	Schwentine
Kirchsee (Schleswig-Holstein)	outflow	Schwentine
Postsee	outflow	Schwentine
Klostersee (Lehnin)	outflow	Emster
Sibbersdorfer See	outflow	Schwentine
Simssee	outflow	SIMS
Fahrlander See	outflow	Sacrow–Paretz Canal
Heiliger See	outflow	Hasengraben
Templiner See	outflow	Havel
Weißer See (Potsdam)	outflow	Sacrow–Paretz Canal
Grössinsee	outflow	Nieplitz
Weißensee (Füssen)	outflow	Füssener Achen
Großer Alpsee	outflow	Konstanzer Ach
Fleesensee	outflow	Elde
Kummerower See	outflow	Peene
Kölpinsee	outflow	Elde
Senftenberger See	outflow	Black Elster
Gudelacksee	outflow	Lindower Rhin
Einfelder See	outflow	Aalbek
Hemmelsdorfer See	outflow	Aalbek
Belauer See	outflow	Alte Schwentine
Tempziner See	outflow	Brüeler Bach
Damerower See	outflow	Mildenitz
Alatsee	outflow	Faulenbach
Goldberger See	outflow	Mildenitz
Krakower See	outflow	Nebel
Barniner See	outflow	Warnow
Neumühler See	outflow	Nuddelbach
Mickowsee	outflow	Warnow
Großer Wariner See	outflow	Muhlenbach
Großer Stechlinsee	outflow	Polzowkanal
Zierker See	outflow	Kammer Canal
Borgwallsee	outflow	Barthe
Hücker Moor	outflow	Moorbach
Taschensee	outflow	Gösebek
Max-Eyth-See	outflow	Neckar
Großer Labussee	outflow	Havel
Baberowsee	outflow	Strom
Nonnensee	outflow	Duwenbeek
Soinsee	outflow	Soingraben
Woblitzsee	outflow	Havel
Großer Auesee	outflow	Große Aue
Grüner See (Lower Saxony)	outflow	Hunte
Kuhsee	outflow	Lech (river)
Stendorfer See	outflow	Schwentine
Wardersee	outflow	Trave
Drüsensee	outflow	Hellbachtal
Wuhlebecken	outflow	Wuhle
Naturschutzsee Füssenich	outflow	Neffelbach
Dämeritzsee	outflow	Spree
Ilsesee	outflow	Grundwasser
Schulensee	outflow	Eider
Tietzowsee	outflow	Jagowkanal
Useriner See	outflow	Havel
Großer Dambecker See	outflow	Aubach
Medeweger See	outflow	Aubach
Pätzer Vordersee	outflow	Glunze
Ruppiner See	outflow	Rhin
Wanzkaer See	outflow	Nonne
Rödliner See	outflow	Nonnenbach
Spitzingsee	outflow	Rote Valepp
Gülper See	outflow	Rhin
Lanzer See	outflow	Elbe–Lübeck Canal
Köthener See	outflow	Dahme Flood Relief Canal
Ivenacker See	outflow	Augraben
Glammsee	outflow	Brüeler Bach
Barner Stücker See	outflow	Aubach
Trammer See	outflow	Schwentine
Wangnitzsee	outflow	Havel
Parsteiner See	outflow	Nettelgraben
Tollensesee	outflow	Tollense
Stolper See	outflow	Alte Schwentine
Sumpfsee	outflow	Nebel
Ellbogensee	outflow	Havel
Großer Priepertsee	outflow	Havel
Labussee	outflow	Müritz–Havel–Wasserstraße
Rätzsee	outflow	Drosedower Bek
Gobenowsee	outflow	Dollbek
Amtssee	outflow	Ragöse
Nehmitzsee	outflow	Polzowkanal
Süseler See	outflow	Gösebek
Großer Pönitzer See	outflow	Gösebek
Barkauer See	outflow	Bad Schwartau
Zeuthener See	outflow	Dahme (river)
Norderteich	outflow	Napte
Norderteich	outflow	Emmer (Weser)
Canower See	outflow	Müritz–Havel–Wasserstraße
Kleiner Pälitzsee	outflow	Müritz–Havel–Wasserstraße
Plätlinsee	outflow	Schwaanhavel
Großer Pälitzsee	outflow	Müritz–Havel–Wasserstraße
Tiefer Trebbower See	outflow	Floßgraben
Woseriner See	outflow	Bresenitz
Pomelsee	outflow	Schwaanhavel
Großer Sternberger See	outflow	Mildenitz
Borkower See	outflow	Mildenitz
Selker Noor	outflow	Haddebyer Noor
Torgelower See	outflow	Ostpeene
Radener See	outflow	Aalbach
Ludwigshofer See	outflow	Neuwarper See
Warinsee	outflow	Aalbach
Großer Mützelburger See	outflow	Mützelburger Beeke
Trenter See	outflow	Schwentine
Roofensee	outflow	Polzowkanal
Woezer See	outflow	Schilde
Drewensee	outflow	Havel
Große Wünnow	outflow	Müritz
Cramoner See	outflow	Stepenitz
Mühlenteich (Wismar)	outflow	Wallensteingraben
Rittmannshagener See	outflow	Ostpeene
Malliner See	outflow	Aalbach
Käbelicksee	outflow	Havel
Nietingsee	outflow	Hofsee (Kargow)
Lac de Longemer	outflow	Vologne
Lac de Pareloup	outflow	Vioulou
Lac de Gérardmer	outflow	Jamagne
Lac Chambon	outflow	Couze Chambon
Lac de Retournemer	outflow	Vologne
Lac de Bouzey	outflow	Canal de l'Est
Lac de Bouzey	outflow	Avière
Lac de Grand-Lieu	outflow	Acheneau
Lac d'Aumar	outflow	Neste Oil
Lac de Grandval	outflow	Truyère
Lac d'Orédon	outflow	Neste Oil
Lac de Cap-de-Long	outflow	Neste Oil
Lac de Capitellu	outflow	Tavignano
Lac de Nino	outflow	Tavignano
Lac d'Aubert	outflow	Neste Oil
Lac de Matemale	outflow	Aude (river)
Lac du Chambon	outflow	Romanche
Lac des Bouillouses	outflow	Têt (fleuve)
Lac Blanc (Vosges)	outflow	Weiss (rivière)
Lake Guerlédan	outflow	Blavet
Lac de Kruth-Wildenstein	outflow	Thur (France)
Lac de Madine	outflow	Madine (rivière)
Snoqualmie Lake	outflow	Taylor River (Washington)
Lac de Melu	outflow	Restonica
Lac de Saint-Cassien	outflow	Biançon
Lac de la Lauch	outflow	Lauch
Lac de Maury	outflow	Self
Lac de Maury	outflow	Selvet
Lac de Lispach	outflow	Chajoux
Lac Besson	outflow	Eau d'Olle
Lac de Pannecière	outflow	Yonne (river)
Lac d'Aude	outflow	Aude (river)
Étang Saint-Nicolas	outflow	Brionneau (ruisseau)
Étang d'Aureilhan	outflow	Courant de Mimizan
Lac de Pinet	outflow	Tarn (river)
Lac de Villefranche-de-Panat	outflow	Alrance (river)
Lac de Pont-de-Salars	outflow	Viaur
Lac des Estaris	outflow	Drac
Lac des Settons	outflow	Cure (river)
Étang de Lachamp	outflow	Morge
Lac Bleu d'Ilhéou	outflow	Gave d'Ilhéou
Lac du Lauzanier	outflow	Ubayette
Lac de Castillon	outflow	Verdon (river)
Lac de Vaivre	outflow	Durgeon
Lac de Mondély	outflow	Lèze (river)
Lac du Laouzas	outflow	Agout
Lac de la Ganguise	outflow	Hers-Mort
Lac d'Avène	outflow	Orb
Lac du Crescent	outflow	Cure (river)
Lac de Chaumeçon	outflow	Chalaux
Lac de Saint-Agnan	outflow	Cousin (river)
Lac d'Esparron	outflow	Verdon (river)
Lac du Tolerme	outflow	Tolerme
Lac Vert (Lot)	outflow	Vert (river)
Lac d'Orcières-Merlette	outflow	Drac
Lac de Suyen	outflow	Gave d'Arrens
Amisk Lake (Alberta)	outflow	Amisk River
Lake Băneasa	outflow	Colentina River
Lake Dorothy	outflow	Miller River
Shenango River Lake	outflow	Shenango River
William "Bill" Dannelly Reservoir	outflow	Alabama River
Glendoe Hydro Scheme	outflow	River Tarff, Fort Augustus
Uru Uru Lake	outflow	Desaguadero River
Uru Uru Lake	outflow	Río Laca Jahuira
Concepción Lake	outflow	Río San Julian
Concepción Lake	outflow	Río San Pablo
Cáceres Lake	outflow	Canal Tamengo
Bellavista Lake	outflow	Guaporé River
Guachuna Lake	outflow	Río San Miguel
Mentiroso Lake	outflow	Madre de Dios River
Aguallamaya Lake	outflow	Desaguadero River
Mandioré Lake	outflow	Paraguay River
Mirim Lake (Bolivia)	outflow	La Gaiba Lake
Suches Lake	outflow	Río Suches
La Gaiba Lake	outflow	Paraguay River
Broad Water	outflow	Cardigan Bay
Brazeau Reservoir	outflow	Brazeau River
Bluenose Lake	outflow	Croker River
Lake Onalaska	outflow	Mississippi River
Lake Bato	outflow	Bicol River
Big Lake (Alberta)	outflow	Sturgeon River (Alberta)
Lago del Turano	outflow	Turano
Lago di San Domenico	outflow	Sagittario River
Lago di Tenno	outflow	Picinino
Lago di Salarno	outflow	Torrente Salarno
Lago di Scanno	outflow	Sagittario River
Lago di Nicito	outflow	Amenano
Lago Ampollino	outflow	Ampollino
Lago Verney	outflow	Dora di Verney
Lago di Montepulciano	outflow	Canale Maestro della Chiana
Lago di Pontesei	outflow	Maè
Lago d'Arno	outflow	Rio Piz
Lago di Posta Fibreno	outflow	Fibreno
Lago Nero (Piacenza)	outflow	Nure
Lago Arancio	outflow	Carboj
Lago Gerundo	outflow	Adda
Lago di Occhito	outflow	Fortore
Lago di Burano	outflow	Canale emissario del Lago di Burano
Lago di Chiusi	outflow	Canale Maestro della Chiana
Lago Disueri	outflow	Gela (river)
Lago di Centro Cadore	outflow	Piave
Lago del Barbellino	outflow	Serio (river)
Lago di Ledro	outflow	Ponale
Lago dell'Ancipa	outflow	Troina (torrente)
Lago di Levico	outflow	Fiume Brenta
Lago di Ceresole	outflow	Orco
Lago della Vecchia	outflow	Cervo (torrent}
Lago di Pietra del Pertusillo	outflow	Agri (river)
Lago della Serraia	outflow	Silla
Lago dell'Accesa	outflow	Bruna River
Lago Nero (Pistoia)	outflow	Lima (fiume italiano)
Lago di Cei	outflow	Rio Arione
Lago di Trebecco	outflow	Tidone
Lago di Bientina	outflow	Canale Imperiale
Lago di Acerenza	outflow	Bradano
Lago di Ortiglieto	outflow	Orba (river)
Lago Serrù	outflow	Orco
Lago di Lentini	outflow	Fiume San Leonardo
Lago di Poggio Perotto	outflow	Osa River
Lago di Santa Rosalia	outflow	Irminio
Lago del Salto	outflow	Salto River (Italy)
Lago Santo parmense	outflow	Parma (river)
Lago Agnel	outflow	Orco
Lago di Santa Giustina	outflow	Noce (fiume del Trentino-Alto Adige)
Lago di Ogliastro	outflow	Gornalunga
Lago del Mucrone	outflow	Biella
Lago Nero (Bergamo)	outflow	Goglio
Lago di Bomba	outflow	Sangro
Lago Nicoletti	outflow	Dittaino
Lago Costantino	outflow	Bonamico (river)
Laghi di Lavagnina	outflow	Gorzente
Lago di Piana degli Albanesi	outflow	Belice
Lago di Gramolazzo	outflow	Serchio di Gramolazzo
Lago di Bilancino	outflow	Sieve
Lago di Caldonazzo	outflow	Brenta (river)
Lago d'Ampola	outflow	Palvico
Lago di Monate	outflow	Canale Acqua Nera
Lake Bugeac	outflow	Danube
Lac de Monteynard-Avignonet	outflow	Drac (river)
Lake Paatari	outflow	Juutuanjoki
Umsaskis Lake	outflow	Allagash River
Aasee (Bocholt)	outflow	Bocholter Aa
Burgsee (Schleswig)	outflow	Schlei
Selliner See (Rügen)	outflow	Having
Melzer See (Melz)	outflow	Elde
Schwarzer See (Mildenitz)	outflow	Mildenitz
Sunfish Pond	outflow	Delaware River
South Shore Estuary	outflow	Atlantic Ocean
Coal Lake	outflow	Pipestone Creek
Savalen	outflow	Sivilla
Rodman Reservoir	outflow	Ocklawaha River
Gleniffer Lake (Alberta)	outflow	Red Deer River
Mara Lake	outflow	Sicamous Narrows
Nyskie Lake	outflow	Nysa Kłodzka
Murphy Lake (Tuscola County, Michigan)	outflow	Goodings Creek
Murphy Lake (Lake County, Minnesota)	outflow	Murphy Creek
Lower Otay Reservoir	outflow	Otay River
John Redmond Dam and Reservoir	outflow	Arkansas River
Lago Bayano	outflow	Bayano River
Clendinning Lake	outflow	Clendinning Creek
Lake Magenta	outflow	Fitzgerald River
Hernandez Reservoir	outflow	San Benito River
Richland-Chambers Reservoir	outflow	Richland Creek (Texas)
Solar Lake	outflow	Soil mechanics#Seepage: steady state flow of water
Solar Lake	outflow	Evaporation
Durnholzer See	outflow	Durnholzer Bach
Silver Lake (Woodridge, New York)	outflow	Sandburg Creek
O'Neill Forebay	outflow	California Aqueduct
Bogstadvannet	outflow	Lysakerelven
Lakhtinsky Razliv	outflow	Bobylka River
Colbún Lake	outflow	Maule River
Lake Abashiri	outflow	Abashiri River
Clowhom Lake	outflow	Clowhom River
Lake Akan	outflow	Akan River
Lake Hodges	outflow	San Dieguito River
Mabel Lake	outflow	Shuswap River
Little Dell Reservoir	outflow	Dell Creek
Nanthi Lagoon	outflow	Indian Ocean
Kokkilai Lagoon	outflow	Indian Ocean
Uppu Aru Lagoon	outflow	Jaffna Lagoon
Vadamarachchi Lagoon	outflow	Indian Ocean
Chalai Lagoon	outflow	Indian Ocean
Nai Aru Lagoon	outflow	Indian Ocean
Ullackalie Lagoon	outflow	Indian Ocean
Upaar Lagoon	outflow	Indian Ocean
Batticaloa Lagoon	outflow	Indian Ocean
Lake Nasworthy	outflow	South Concho River
Negombo Lagoon	outflow	Indian Ocean
Mundal Lagoon	outflow	Indian Ocean
Summit Lake (Crooked River)	outflow	Crooked River (British Columbia)
E.V. Spence Reservoir	outflow	Colorado River (Texas)
Moose Lake (British Columbia)	outflow	Fraser River
Barbee Lake	outflow	Tippecanoe Lake
Causey Reservoir	outflow	Ogden River
Lake Easton	outflow	Kachess River
Shoe Lake (Indiana)	outflow	Banning Lake
Robson Lake	outflow	Robson River
Lake Coghinas	outflow	Coghinas
Ninigret Pond	outflow	Block Island Sound
Tatlatui Lake	outflow	Firesteel River (British Columbia)
Khar Nuur (Khovd)	outflow	Teeliin Gol
Vättern	outflow	Motala ström
Clarrie Hall Dam	outflow	Doon Doon Creek
Toonumbar Dam	outflow	Iron Pot Creek
Lake Virginia (California)	outflow	Fish Creek
Ligovsky Pond	outflow	Dudergofka river
Battle Lake (Alberta)	outflow	Battle River
Beaver Lake (Alberta)	outflow	Beaver River (Canada)
Cree Lake	outflow	Cree River
Lac la Ronge	outflow	Rapid River (Churchill River)
Peter Pond Lake	outflow	Churchill Lake
Churchill Lake	outflow	Churchill River (Hudson Bay)
Cumberland Lake	outflow	Saskatchewan River
Montreal Lake (Saskatchewan)	outflow	Montreal River (Saskatchewan)
Tobin Lake	outflow	Saskatchewan River
Bamaji Lake	outflow	Cat River (Ontario)
Bass Lake (Ontario)	outflow	Sand Creek (Ontario)
Attawapiskat Lake	outflow	Attawapiskat River
Lac des Chats	outflow	Ottawa River
Dog Lake (Ontario)	outflow	Kaministiquia River
Esnagi Lake	outflow	Magpie River (Ontario)
Four Mile Lake (Ontario)	outflow	Balsam Lake (Ontario)
Kabinakagami Lake	outflow	Kabinakagami River
Lady Evelyn Lake	outflow	Lady Evelyn River
Restoule Lake	outflow	Restoule River
Sand Lake (Patterson Township, Ontario)	outflow	Sand Creek (Ontario)
Stoco Lake	outflow	Moira River
Kidston Lake	outflow	Herring Cove, Nova Scotia
Dexter Reservoir	outflow	Middle Fork Willamette River
Dorena Reservoir	outflow	Row River
Heathcote Lake	outflow	Heafur Lake
Eugenisee	outflow	Engelberger Aa
Lake Cheybek-Kohl	outflow	Chibit River
O.C. Fisher Reservoir	outflow	North Concho River
Twin Buttes Reservoir	outflow	Lake Nasworthy
Lake Omodeo	outflow	Tirso (river)
Streatfeild Lake	outflow	Streatfeild River
Buffalo Pound Lake	outflow	Qu'Appelle River
Lake Shannon	outflow	Baker River (Washington)
San Vicente Reservoir	outflow	San Diego River
Bruce Eastick North Para Flood Mitigation Dam	outflow	Yettie Creek
Katchewanooka Lake	outflow	Otonabee River
McCombe Lake	outflow	Indian Arm
Nelson Lake (San Bernardino County)	outflow	Evaporation
Goldstone Lake	outflow	Evaporation
Cuddeback Lake	outflow	Evaporation
Koehn Lake	outflow	Evaporation
Bicycle Lake	outflow	Evaporation
Red Pass Lake	outflow	Evaporation
Emerson Lake	outflow	Evaporation
Lake Liscia	outflow	Liscia (river)
Lucerne Lake (California)	outflow	Evaporation
Superior Lake (California)	outflow	Evaporation
Lake Manix	outflow	Mojave River
Kamut Lake	outflow	Coppermine River
Broadwell Lake	outflow	Evaporation
Sawtooth Lake	outflow	Salmon River (Idaho)
Danby Lake	outflow	Evaporation
Laguna Salada (Mexico)	outflow	Evaporation
R.E. "Bob" Woodruff Lake	outflow	Alabama River
Lake Moomaw	outflow	Jackson River (Virginia)
Lake Leśnia	outflow	Kwisa
Canyon Lake (California)	outflow	San Jacinto River (California)
Eastman Lake	outflow	Chowchilla River
Salt Spring Valley Reservoir	outflow	Mokelumne River
Keith Sebelius Lake	outflow	Prairie Dog Creek (Kansas)
Boca Reservoir	outflow	Little Truckee River
Lindores Loch	outflow	Lindores Burn
Lake Barombi Mbo	outflow	Mungo River, Cameroon
Waconda Lake	outflow	Smoky Hill River
Huishue Lake	outflow	Melpue River
Lewis Lake (Wyoming)	outflow	Lewis River (Wyoming)
Clear Lake (Galveston Bay)	outflow	Galveston Bay
Moses Lake (Texas)	outflow	Galveston Bay
Fisk Lake	outflow	Coldbrook Creek (Michigan)
Lava Lakes	outflow	Lava Fork
Lake Ogawara	outflow	Pacific Ocean
Canoe Lake (Kenora District, Ontario)	outflow	Shoal Lake
Longcanoe Lake	outflow	Hornblende Lake
Freshwater Lagoon	outflow	Pacific Ocean
Stone Lagoon	outflow	Pacific Ocean
Big Lagoon (California)	outflow	Pacific Ocean
Whitesand Lake (Hewitson River)	outflow	Hewitson River
Mount Crosby Weir	outflow	Brisbane River
Newark Reservoir	outflow	White Clay Creek
Madron Lake	outflow	Galien River
Kalhovdfjorden	outflow	Mår (River)
Abbotts Lagoon	outflow	Pacific Ocean
Canoe Lake (Highland Creek)	outflow	Highland Creek
Selassie Lake	outflow	Whitesand River (Lake Nipigon)
Langdon Lake (Oregon)	outflow	Lookingglass Creek
Grebe Lake	outflow	Gibbon River
Lake Aurora	outflow	Kissimmee River
Whitesand Lake (Lake Nipigon)	outflow	Whitesand River (Lake Nipigon)
North Whitesand Lake	outflow	Whitesand River (Hewitson River)
JoJo Lake (Ontario)	outflow	Whitesand River (Lake Nipigon)
Lake Bagsværd	outflow	Mølleåen
Lyne Lake (Ontario)	outflow	Whitesand River (Hewitson River)
Hornblende Lake	outflow	Whitesand River (Hewitson River)
Demijohn Lake (Ontario)	outflow	Whitesand River (Hewitson River)
Zenith Lake (Ontario)	outflow	Whitesand River (Hewitson River)
Cleaver Lake (Thunder Bay District)	outflow	Whitesand River (Hewitson River)
Gumboot Lake (Ontario)	outflow	Whitesand River (Hewitson River)
Pick Lake (Thunder Bay District)	outflow	Whitesand River (Hewitson River)
Toothpick Lake	outflow	English River (Ontario)
Ambrose Lake (Thunder Bay District)	outflow	Whitesand River (Hewitson River)
Bull Lake (Thunder Bay District)	outflow	Whitesand River (Hewitson River)
Winston Lake (Thunder Bay District)	outflow	Winston Creek (Thunder Bay District)
Winston Lake (Kenora District, Ontario)	outflow	Winston Creek (Kenora District, Ontario)
Spray Lakes Reservoir	outflow	Spray River
Lake Verevi	outflow	Emajõgi
Blackett Lake (Ontario)	outflow	Blackett Creek
Nicholls Lake	outflow	Whitesand River (Lake Nipigon)
Whiddon Lake (Ontario)	outflow	Whitesand River (Lake Nipigon)
Lindeman Lake (Chilliwack)	outflow	Post Creek
Little Bull Lake (Sudbury District, Ontario)	outflow	Bull Lake (Yorston River)
Shoshone Lake	outflow	Lewis River (Wyoming)
Bull Lake (Low Creek)	outflow	Little Bull Lake (Algoma District, Ontario)
Heart Lake (Wyoming)	outflow	Heart River (Wyoming)
Lake Jacomo	outflow	Blue Springs Lake
Aswapiswanan Lake	outflow	Mink River (Manitoba)
Musketasonan Lake	outflow	Bolton River (Manitoba)
Touchwood Lake (Manitoba)	outflow	Vermilyea Lake
Vermilyea Lake	outflow	Wesachewan River
Bolton Lake (Kenora District, Ontario)	outflow	Lower Manitou Lake (Ontario)
Bolton Lake (Cochrane District, Ontario)	outflow	Black River (Ontario)
Little Bolton Lake (Manitoba)	outflow	Bolton River (Manitoba)
Bolton Lake (Manitoba)	outflow	Bolton River (Manitoba)
Kakwusis Lake	outflow	Bolton River (Manitoba)
Rushforth Lake	outflow	Bolton River (Manitoba)
Bellandur Lake	outflow	Varthur#Varthur Lake
Zumar Lake	outflow	Ekwan River
Atwood Lake	outflow	Conotton Creek#Named Tributaries and sub-Tributaries
Snowshoe Lake (Thunder Bay District)	outflow	Lake Nipigon
Leesville Lake (Ohio)	outflow	Conotton Creek#Named Tributaries and sub-Tributaries
Großes Meer	outflow	Kleines Meer
Großes Meer	outflow	Knockster Tief
Blue Marsh Lake	outflow	Tulpehocken Creek (Pennsylvania)
Martha Lake (California)	outflow	San Joaquin River
Seymour Lake (Algoma District, Ontario)	outflow	Rapid River (Algoma District, Ontario)
Black Lake (Fond du Lac River, Saskatchewan)	outflow	Fond du Lac River (Saskatchewan)
Tbilisi sea	outflow	Iori River
Lake Evijärvi	outflow	Ähtävänjoki
Lake Iijärvi (Inari)	outflow	Näätämö River
Lake Iijärvi (Inari)	outflow	Näätämö River
Vanajavesi	outflow	Pyhäjärvi (Tampere region)
Kulovesi	outflow	Rautavesi (Sastamala)
Lake Kuorevesi	outflow	Lake Ruovesi
Leppävesi	outflow	Vaajavirta
Pöyrisjärvi	outflow	Pöyrisjoki
Lake Ruovesi	outflow	Palovesi
Simojärvi	outflow	Simojoki
Drive Lake (Ontario)	outflow	Drive Creek (Ontario)
Botsford Lake (Ontario)	outflow	Marchington River (Ontario)
Pelican Lake (Kenora District, Ontario)	outflow	English River (Ontario)
Tripoli Lake (Kenora District, Ontario)	outflow	Tripoli Creek (Kenora District, Ontario)
Tripoli Lake (Algoma District, Ontario)	outflow	Tripoli Creek (Algoma District, Ontario)
West Tripoli Lake (Ontario)	outflow	Tripoli Lake (Algoma District, Ontario)
Lake Amtkel	outflow	Jampal River
Lake Amtkel	outflow	Amtkel River
Upper Magpie Lake (Ontario)	outflow	Magpie River (Ontario)
Wejinabikun Lake (Ontario)	outflow	Magpie River (Ontario)
North Wejinabikun Lake (Ontario)	outflow	Magpie River (Ontario)
Mosambik Lake (Ontario)	outflow	Magpie River (Ontario)
Kabiskagami Lake (Ontario)	outflow	Mosambik Lake (Ontario)
Water resources management in Nicaragua  Lake Nicaragua   1	outflow	San Juan River (Nicaragua)
Summit Lake (Kabinakagami River)	outflow	Kabinakagami River
Summit Lake (Lochalsh River)	outflow	Lochalsh River
Summit Lake (Thunder Bay District)	outflow	Ombabika River
Summit Lake (Thunder Bay District)	outflow	Powitik River
Casummit Lake (Ontario)	outflow	Casummit Creek
Upper Summit Lake (British Columbia)	outflow	Summit Lake (Crooked River)
Fourbass Lake (Ontario)	outflow	Matabitchuan River
Gorrie Lake (Ontario)	outflow	Fourbass Lake (Ontario)
Lake Dem	outflow	White Volta
Surveyor Lake (Nipissing District, Ontario)	outflow	Temagami River
Cross Lake (Moore Creek)	outflow	Moore Creek (Nipissing District, Ontario)
McKenzie Lake (Moore Creek)	outflow	Moore Creek (Nipissing District, Ontario)
Reedy Lake	outflow	Barwon River (Victoria)
Joeperry Lake	outflow	Skootamatta River
Elzevir Lake	outflow	Elzevir Creek
Grimsthorpe Lake (Ontario)	outflow	Partridge Creek (Ontario)
Deerock Lake	outflow	Partridge Creek (Ontario)
Partridge Lake (Lennox and Addington County, Ontario)	outflow	Partridge Creek (Ontario)
Lake Muhazi	outflow	Nyabugogo River
Merrill Lake (Merrill Creek)	outflow	Merrill Creek (Ontario)
Little Merrill Lake (Merrill Creek)	outflow	Merrill Creek (Ontario)
Whitefish Lake (Merrill Creek)	outflow	Merrill Creek (Ontario)
Pearson Lake (Lennox and Addington County, Ontario)	outflow	Skootamatta River
Todd Lakes (Lennox and Addington County, Ontario)	outflow	Merrill Creek (Ontario)
Rainy Lake (Moira drainage basin)	outflow	Rainy Creek (Lennox and Addington County, Ontario)
Killer Lake (Ontario)	outflow	Killer Creek (Ontario)
Lake Higa	outflow	Babangou River
Mephisto Lake	outflow	Dark Lake (Hastings County, Ontario)
Steenburg Lake (Ontario)	outflow	Bass Creek (Hastings County, Ontario)
Paddy's Lake (Hastings County, Ontario)	outflow	Mud Creek (Hastings County, Ontario)
Lake Harney	outflow	St. Johns River
Gaube Lake	outflow	Gaube River
Lake Munson	outflow	Munson Slough
Lake Ming	outflow	Kern River
Angostura Reservoir	outflow	Cheyenne River
Shadehill Reservoir	outflow	Grand River (South Dakota)
Lake Pflugerville	outflow	Colorado River (Texas)
Lake Kununurra	outflow	Ord River
Rathbun Lake	outflow	Chariton River
Slezská Harta Dam	outflow	Moravice (river)
Lake Byron (South Dakota)	outflow	James River (Dakotas)
Wienerwaldsee	outflow	Wien (river)
Lake Surprise (New Jersey)	outflow	Blue Brook (Green Brook)
Vombsjön	outflow	Kävlinge River
Lake Ocheda, Minnesota	outflow	Ocheyedan River
Loch Voil	outflow	River Balvaig
Montreal Lake (Ontario)	outflow	Montreal River (Algoma–Sudbury, Ontario)
Molson Lake (Manitoba)	outflow	Hayes River
Alder Lake	outflow	Nisqually River
Llyn Nantlle Uchaf	outflow	Afon Llyfni
Lake Qattinah	outflow	Orontes River
Iro Lake	outflow	Evaporation
Léré Lake	outflow	Mayo Kébbi
Tixall Wide	outflow	Staffordshire
Lake Ermistu	outflow	Tõstamaa River
Lake Tõhela	outflow	Paadrema River
Lake Tamula	outflow	Võhandu River
Lake Arbi	outflow	Elva River
Lake Kavadi	outflow	Iskna
Lake Maardu	outflow	Kroodi stream
Lake Murati	outflow	Vaidava
Lake Porkuni	outflow	Valgejõgi
Ruth Reservoir	outflow	Mad River (California)
Orto-Tokoy Reservoir	outflow	Chu River
Otter Lake (Seguin, Parry Sound District, Ontario)	outflow	Boyne River (Ontario)
Lake Amador	outflow	Jackson Creek
Almaden Reservoir	outflow	Los Alamitos Creek
Calero Reservoir	outflow	Calero Creek
Åresjön	outflow	Indalsälven
Lake Krasnoye (Chukotka)	outflow	Anadyr River
Lake Van Arsdale	outflow	Eel River (California)
Lake Hancock	outflow	Peace River (Florida)
Lake Hollingsworth	outflow	Peace River (Florida)
Crooked Lake (Florida)	outflow	Kissimmee River
Lake Blue Ridge	outflow	Toccoa/Ocoee River
Lake Amaramba	outflow	Lugenda River
Shamkir reservoir	outflow	Kura River
Imja Tsho, Nepal	outflow	Ganges
Agstafachay reservoir	outflow	Aghstafa River
Khanbulanchay reservoir	outflow	Bəşəriçay
Yenikend reservoir	outflow	Kura River
Lake Dulverton	outflow	Dulverton Rivulet
Dauniškis	outflow	Vyžuona River
Chard Reservoir	outflow	River Isle
Hawkridge Reservoir	outflow	Cannington Brook
Otterhead Lakes	outflow	River Otter
Devils Den Lake	outflow	Heath Creek
Lake Burton, Antarctica	outflow	Crooked Fjord
Hobson Lake	outflow	Clearwater River (British Columbia)
Murtle Lake	outflow	Murtle River
Twin Lakes (Mono County, California)	outflow	Hot Creek (Mono County, California)#Mammoth Creek
Marion Reservoir	outflow	Cottonwood River (Kansas)
Pipmuacan Reservoir	outflow	Betsiamites River
Pipmuacan Reservoir	outflow	Shipshaw River
Włocławek Reservoir	outflow	Vistula
Epulafquén Lake	outflow	Huechulafquen Lake
Lake Alajuela	outflow	Panama Canal
Lygnern	outflow	Rolfsån
Pray Lake	outflow	Two Medicine Creek
Two Medicine Lake	outflow	Two Medicine Creek
Long Lake (Englehart River)	outflow	Englehart River
Ellis Lake (Timiskaming District, Ontario)	outflow	Sarsfield Creek
Little Sarsfield Lake	outflow	Sarsfield Creek
Long Lake (Kearney, Nipissing District, Ontario)	outflow	Round Lake (Kearney, Ontario)
Long Lake (East Ferris, Ontario)	outflow	Mattawa River
Long Lake (Lanark County, Ontario)	outflow	Adams Lake (Lanark County, Ontario)
Rescobie Loch	outflow	Lunan Water
Ticha Reservoir	outflow	Kamchia
Baker Lake (Washington)	outflow	Baker River (Washington)
Sweetwater Reservoir	outflow	Sweetwater River (California)
Helen Lake	outflow	Belly River
Elizabeth Lake (Glacier County, Montana)	outflow	Belly River
Ziernsee	outflow	Havel
Röblinsee	outflow	Havel
Baalensee	outflow	Havel
Schwedtsee	outflow	Havel
Stolpsee	outflow	Havel
Helenton Loch	outflow	Pow Burn
Schwielowsee	outflow	Havel
Trindlemoss Loch	outflow	Annick Water
Little Langdale  Tarn   1	outflow	River Brathay
Plauer See (Brandenburg)	outflow	Havel
Breitlingsee	outflow	Plauer See (Brandenburg)
Quenzsee	outflow	Plauer See (Brandenburg)
Wendsee	outflow	Plauer See (Brandenburg)
Beetzsee	outflow	Havel
Jiangkou Reservoir	outflow	Furong River
Mille Lacs Lake	outflow	Rum River
Danjiangkou Reservoir	outflow	Han River (Yangtze River tributary)
Lake Varaždin	outflow	Drava
Lake Dubrava	outflow	Drava
Lake Sonfon	outflow	Pampana River
Lake Chusovskoe	outflow	Visherka River
Lake Bridgeport (Texas)	outflow	Eagle Mountain Lake
Forggensee	outflow	Lech (river)
Maridalsvannet	outflow	Akerselva
Skjærsjøen	outflow	Skjærsjøelva
Lake Bermin	outflow	Cross River (Nigeria)
Lake Ejagham	outflow	Cross River (Nigeria)
Mascardi Lake	outflow	Manso River (Argentina)
Marion County Park and Lake	outflow	Cottonwood River (Kansas)
Yen Lap Lake	outflow	Yen Lap River
Frentress Lake, Illinois	outflow	Mississippi River
Quicksand Pond	outflow	Rhode Island Sound
Lac Deschênes	outflow	Ottawa River
Lake Lekshmozero	outflow	Lekshma River
Laanecoorie Weir	outflow	Loddon River
Lake Cachí	outflow	Reventazón River
Grassi Lakes	outflow	Spray River
Lake of the Clouds	outflow	Carp River (Gogebic-Ontonagon counties)
Lake Albanel	outflow	Rupert River
Lake Kenozero	outflow	Kena River
Lake Undozero	outflow	Undosha River
Lac du Verney	outflow	Romanche
