CORNWALL WILDLIFE TRUST	PARENTORGANIZATION	WILDLIFE TRUSTS PARTNERSHIP
COMMUNITY EMERGENCY RESPONSE TEAM	PARENTORGANIZATION	CITIZEN CORPS
COMMITTEE ON DATA FOR SCIENCE AND TECHNOLOGY	PARENTORGANIZATION	INTERNATIONAL COUNCIL FOR SCIENCE
EUROPEAN SPACE OPERATIONS CENTRE	PARENTORGANIZATION	EUROPEAN SPACE AGENCY
INTERNATIONAL MATHEMATICAL UNION	PARENTORGANIZATION	INTERNATIONAL COUNCIL FOR SCIENCE
INTERNATIONAL MONETARY FUND	PARENTORGANIZATION	UNITED NATIONS
INTERNET ENGINEERING TASK FORCE	PARENTORGANIZATION	INTERNET SOCIETY
UEFA	PARENTORGANIZATION	FIFA
INTERNATIONAL BANK FOR RECONSTRUCTION AND DEVELOPMENT	PARENTORGANIZATION	WORLD BANK GROUP
INTERNATIONAL FINANCE CORPORATION	PARENTORGANIZATION	WORLD BANK GROUP
INTERNATIONAL DEVELOPMENT ASSOCIATION	PARENTORGANIZATION	WORLD BANK GROUP
OPUS DEI	PARENTORGANIZATION	CATHOLIC CHURCH
IUCN RED LIST	PARENTORGANIZATION	INTERNATIONAL UNION FOR CONSERVATION OF NATURE
JESUS SEMINAR	PARENTORGANIZATION	WESTAR INSTITUTE
SKULL AND BONES	PARENTORGANIZATION	RUSSELL TRUST ASSOCIATION
RADIO LIBERTY	PARENTORGANIZATION	BROADCASTING BOARD OF GOVERNORS
INTERNET RESEARCH TASK FORCE	PARENTORGANIZATION	INTERNET ARCHITECTURE BOARD
HITLER YOUTH	PARENTORGANIZATION	NAZI PARTY
LEAGUE OF GERMAN GIRLS	PARENTORGANIZATION	NAZI PARTY
WORLDFISH	PARENTORGANIZATION	CONSULTATIVE GROUP ON INTERNATIONAL AGRICULTURAL RESEARCH
NATIONAL INSTITUTE OF NEUROLOGICAL DISORDERS AND STROKE	PARENTORGANIZATION	NATIONAL INSTITUTES OF HEALTH
EUROPEAN PATENT OFFICE	PARENTORGANIZATION	EUROPEAN PATENT ORGANISATION
UNIVERSITY SYSTEM OF MARYLAND	PARENTORGANIZATION	GOVERNMENT OF MARYLAND
CONCACAF	PARENTORGANIZATION	FIFA
INTER-AMERICAN COMMISSION ON HUMAN RIGHTS	PARENTORGANIZATION	ORGANIZATION OF AMERICAN STATES
FOREIGN AFFAIRS LEADING GROUP	PARENTORGANIZATION	CENTRAL COMMITTEE OF THE COMMUNIST PARTY OF CHINA
AMERICAN WHIG–CLIOSOPHIC SOCIETY	PARENTORGANIZATION	PRINCETON UNIVERSITY
DLRG	PARENTORGANIZATION	INTERNATIONAL LIFE SAVING FEDERATION
BBC MONITORING	PARENTORGANIZATION	BBC
NATIONAL CENTER FOR COMPLEMENTARY AND INTEGRATIVE HEALTH	PARENTORGANIZATION	NATIONAL INSTITUTES OF HEALTH
4-H	PARENTORGANIZATION	UNITED STATES DEPARTMENT OF AGRICULTURE
RELIEF SOCIETY	PARENTORGANIZATION	THE CHURCH OF JESUS CHRIST OF LATTER-DAY SAINTS
BRITISH GEOPHYSICAL ASSOCIATION	PARENTORGANIZATION	*
BRITISH GEOPHYSICAL ASSOCIATION	PARENTORGANIZATION	ROYAL ASTRONOMICAL SOCIETY
BRITISH GEOPHYSICAL ASSOCIATION	PARENTORGANIZATION	GEOLOGICAL SOCIETY OF LONDON
NATIONAL EYE INSTITUTE	PARENTORGANIZATION	NATIONAL INSTITUTES OF HEALTH
ROYAL MONTREAL GOLF CLUB	PARENTORGANIZATION	ROYAL CANADIAN GOLF ASSOCIATION
NEAR-EARTH ASTEROID TRACKING	PARENTORGANIZATION	JET PROPULSION LABORATORY
WORLD CLIMATE RESEARCH PROGRAMME	PARENTORGANIZATION	WORLD METEOROLOGICAL ORGANIZATION
FOUNDATION FOR ANCIENT RESEARCH AND MORMON STUDIES	PARENTORGANIZATION	NEAL A. MAXWELL INSTITUTE FOR RELIGIOUS SCHOLARSHIP
INTERNATIONAL UNION OF RADIO SCIENCE	PARENTORGANIZATION	INTERNATIONAL COUNCIL FOR SCIENCE
CONCORDIA UNIVERSITY SYSTEM	PARENTORGANIZATION	LUTHERAN CHURCH–MISSOURI SYNOD
NORTH AMERICAN FEDERATION OF TEMPLE YOUTH	PARENTORGANIZATION	UNION FOR REFORM JUDAISM
WORLD DATA CENTER	PARENTORGANIZATION	INTERNATIONAL COUNCIL FOR SCIENCE
MUSLIM AMERICAN SOCIETY	PARENTORGANIZATION	MUSLIM BROTHERHOOD
NATIONAL COLLEGE FOR TEACHING AND LEADERSHIP	PARENTORGANIZATION	DEPARTMENT FOR EDUCATION
ASIAN CRICKET COUNCIL	PARENTORGANIZATION	INTERNATIONAL CRICKET COUNCIL
INTERNATIONAL MAIZE AND WHEAT IMPROVEMENT CENTER	PARENTORGANIZATION	CONSULTATIVE GROUP ON INTERNATIONAL AGRICULTURAL RESEARCH
ALMA MATER SOCIETY OF QUEEN'S UNIVERSITY	PARENTORGANIZATION	QUEEN'S UNIVERSITY
UNITED FRONT WORK DEPARTMENT	PARENTORGANIZATION	CENTRAL COMMITTEE OF THE COMMUNIST PARTY OF CHINA
PRIMARY	PARENTORGANIZATION	THE CHURCH OF JESUS CHRIST OF LATTER-DAY SAINTS
MEDICAL RESEARCH COUNCIL	PARENTORGANIZATION	DEPARTMENT FOR BUSINESS, INNOVATION AND SKILLS
MEDICAL RESEARCH COUNCIL	PARENTORGANIZATION	RESEARCH COUNCILS UK
CHILDREN AND FAMILY COURT ADVISORY AND SUPPORT SERVICE	PARENTORGANIZATION	MINISTRY OF JUSTICE
COMMITTEE OF SAFETY	PARENTORGANIZATION	HAWAII REPUBLICAN PARTY
CIVIL AVIATION AUTHORITY	PARENTORGANIZATION	DEPARTMENT FOR TRANSPORT
PEOPLE TO PEOPLE STUDENT AMBASSADOR PROGRAM	PARENTORGANIZATION	AMBASSADORS GROUP
ASIAN FOOTBALL CONFEDERATION	PARENTORGANIZATION	FIFA
LEARNING AND SKILLS COUNCIL	PARENTORGANIZATION	BIS AND DCSF
SOCIETY OF WRITERS TO HER MAJESTY'S SIGNET	PARENTORGANIZATION	COLLEGE OF JUSTICE
OXFORD, CAMBRIDGE AND RSA EXAMINATIONS	PARENTORGANIZATION	CAMBRIDGE ASSESSMENT
UNIVERSITY OF CAMBRIDGE LOCAL EXAMINATIONS SYNDICATE	PARENTORGANIZATION	UNIVERSITY OF CAMBRIDGE
SOMERSET WILDLIFE TRUST	PARENTORGANIZATION	WILDLIFE TRUSTS PARTNERSHIP
SHROPSHIRE WILDLIFE TRUST	PARENTORGANIZATION	THE WILDLIFE TRUSTS
AUTOMOBILE CLUB OF SOUTHERN CALIFORNIA	PARENTORGANIZATION	AMERICAN AUTOMOBILE ASSOCIATION
NATURAL ENVIRONMENT RESEARCH COUNCIL	PARENTORGANIZATION	*DEPARTMENT FOR BUSINESS, INNOVATION AND SKILLS \N* RESEARCH COUNCILS UK
BIOTECHNOLOGY AND BIOLOGICAL SCIENCES RESEARCH COUNCIL	PARENTORGANIZATION	*DEPARTMENT FOR BUSINESS, INNOVATION AND SKILLS \N*RESEARCH COUNCILS UK
RADIO FREE ASIA	PARENTORGANIZATION	BROADCASTING BOARD OF GOVERNORS
INTERNATIONAL COMMISSION ON STRATIGRAPHY	PARENTORGANIZATION	INTERNATIONAL UNION OF GEOLOGICAL SCIENCES
ATHLETES IN ACTION	PARENTORGANIZATION	CRU
AMERICAN PUBLIC MEDIA	PARENTORGANIZATION	AMERICAN PUBLIC MEDIA GROUP
NORTH AMERICAN DIVISION OF SEVENTH-DAY ADVENTISTS	PARENTORGANIZATION	GENERAL CONFERENCE OF SEVENTH-DAY ADVENTISTS
EAST-CENTRAL AFRICA DIVISION OF SEVENTH-DAY ADVENTISTS	PARENTORGANIZATION	GENERAL CONFERENCE OF SEVENTH-DAY ADVENTISTS
INTER-EUROPEAN DIVISION OF SEVENTH-DAY ADVENTISTS	PARENTORGANIZATION	GENERAL CONFERENCE OF SEVENTH-DAY ADVENTISTS
EURO-ASIA DIVISION OF SEVENTH-DAY ADVENTISTS	PARENTORGANIZATION	GENERAL CONFERENCE OF SEVENTH-DAY ADVENTISTS
NORTHERN ASIA-PACIFIC DIVISION OF SEVENTH-DAY ADVENTISTS	PARENTORGANIZATION	GENERAL CONFERENCE OF SEVENTH-DAY ADVENTISTS
INTER-AMERICAN DIVISION OF SEVENTH-DAY ADVENTISTS	PARENTORGANIZATION	GENERAL CONFERENCE OF SEVENTH-DAY ADVENTISTS
SOUTHERN AFRICA-INDIAN OCEAN DIVISION OF SEVENTH-DAY ADVENTISTS	PARENTORGANIZATION	GENERAL CONFERENCE OF SEVENTH-DAY ADVENTISTS
CANADIAN JEWISH CONGRESS	PARENTORGANIZATION	CANADIAN COUNCIL FOR ISRAEL AND JEWISH ADVOCACY
UNIVERSITY OF ST ANDREWS UNION DEBATING SOCIETY	PARENTORGANIZATION	UNIVERSITY OF ST ANDREWS
HORTA FOOTBALL ASSOCIATION	PARENTORGANIZATION	PORTUGUESE FOOTBALL FEDERATION
PONTA DELGADA FOOTBALL ASSOCIATION	PARENTORGANIZATION	PORTUGUESE FOOTBALL FEDERATION
ANGRA DO HEROíSMO FOOTBALL ASSOCIATION	PARENTORGANIZATION	PORTUGUESE FOOTBALL FEDERATION
JAPAN SUMO ASSOCIATION	PARENTORGANIZATION	MINISTRY OF EDUCATION, CULTURE, SPORTS, SCIENCE AND TECHNOLOGY
ORDER OF THE HOLY SEPULCHRE	PARENTORGANIZATION	16
INTERNATIONAL BASEBALL FEDERATION	PARENTORGANIZATION	WORLD BASEBALL SOFTBALL CONFEDERATION
PAN EUROPEAN GAME INFORMATION	PARENTORGANIZATION	INTERACTIVE SOFTWARE FEDERATION OF EUROPE
PIRBRIGHT INSTITUTE	PARENTORGANIZATION	BIOTECHNOLOGY AND BIOLOGICAL SCIENCES RESEARCH COUNCIL
WORLD CLIMATE PROGRAMME	PARENTORGANIZATION	WORLD METEOROLOGICAL ORGANIZATION
B'NAI BRITH CANADA	PARENTORGANIZATION	B'NAI B'RITH INTERNATIONAL
INTERNATIONAL UNION OF SOIL SCIENCES	PARENTORGANIZATION	INTERNATIONAL COUNCIL FOR SCIENCE
TRANSPORT FOR WEST MIDLANDS	PARENTORGANIZATION	WEST MIDLANDS COMBINED AUTHORITY
OHIO MILITARY RESERVE	PARENTORGANIZATION	OHIO NATIONAL GUARD
DRIVING STANDARDS AGENCY	PARENTORGANIZATION	DEPARTMENT FOR TRANSPORT
LEAGUE OF THE SOUTH	PARENTORGANIZATION	MILITARY ORDER OF THE STARS AND BARS
CANADIAN PEACE CONGRESS	PARENTORGANIZATION	WORLD PEACE COUNCIL
STUDENTS' SOCIETY OF MCGILL UNIVERSITY	PARENTORGANIZATION	MCGILL UNIVERSITY
GEORGIA 4-H	PARENTORGANIZATION	UNITED STATES DEPARTMENT OF AGRICULTURE
CAMBRIDGE ENGLISH LANGUAGE ASSESSMENT	PARENTORGANIZATION	CAMBRIDGE ASSESSMENT
MUCHFACT	PARENTORGANIZATION	BELL CANADA
MONETARY POLICY COMMITTEE	PARENTORGANIZATION	BANK OF ENGLAND
DEPARTAMENTO DE JUSTIçA, CLASSIFICAçãO, TíTULOS E QUALIFICAçãO	PARENTORGANIZATION	MINISTRY OF JUSTICE
NASA ASTROBIOLOGY INSTITUTE	PARENTORGANIZATION	NATIONAL AERONAUTICS AND SPACE ADMINISTRATION
UK SPORT	PARENTORGANIZATION	DEPARTMENT FOR CULTURE, MEDIA AND SPORT
MAX PLANCK INSTITUTE FOR MATHEMATICS	PARENTORGANIZATION	MAX PLANCK SOCIETY
AMERICAN DIALECT SOCIETY	PARENTORGANIZATION	AMERICAN COUNCIL OF LEARNED SOCIETIES
UNITED SYNAGOGUE YOUTH	PARENTORGANIZATION	UNITED SYNAGOGUE OF CONSERVATIVE JUDAISM
NATIONAL SOFTWARE REFERENCE LIBRARY	PARENTORGANIZATION	NATIONAL INSTITUTE OF STANDARDS AND TECHNOLOGY
BNEI AKIVA	PARENTORGANIZATION	HAPOEL HAMIZRACHI
EUZKO GAZTEDI	PARENTORGANIZATION	EAJ-PNV
ORDER OF SAINT LAZARUS	PARENTORGANIZATION	ROMAN CATHOLIC CHURCH
SCUBA SCHOOLS INTERNATIONAL	PARENTORGANIZATION	HEAD
KUKKIWON	PARENTORGANIZATION	MINISTRY OF CULTURE, SPORTS AND TOURISM
COMMITTEE ON SPACE RESEARCH	PARENTORGANIZATION	INTERNATIONAL COUNCIL FOR SCIENCE
PORTSTORONTO	PARENTORGANIZATION	TRANSPORT CANADA
INTERNATIONAL CENTRE FOR SETTLEMENT OF INVESTMENT DISPUTES	PARENTORGANIZATION	WORLD BANK GROUP
EUROPEAN ATHLETIC ASSOCIATION	PARENTORGANIZATION	IAAF
RELAY FOR LIFE	PARENTORGANIZATION	AMERICAN CANCER SOCIETY
FACULTY OF ADVOCATES	PARENTORGANIZATION	COLLEGE OF JUSTICE
YOUNG LIBERALS OF CANADA	PARENTORGANIZATION	LIBERAL PARTY OF CANADA
WATSON INSTITUTE FOR INTERNATIONAL AND PUBLIC AFFAIRS	PARENTORGANIZATION	BROWN UNIVERSITY
PEN AMERICAN CENTER	PARENTORGANIZATION	PEN INTERNATIONAL
SISTERS OF CHARITY OF LEAVENWORTH	PARENTORGANIZATION	SISTERS OF CHARITY FEDERATION
HEALTH AND CARE PROFESSIONS COUNCIL	PARENTORGANIZATION	PROFESSIONAL STANDARDS AUTHORITY
INSTITUTE OF MOLECULAR AND CELL BIOLOGY	PARENTORGANIZATION	AGENCY FOR SCIENCE, TECHNOLOGY AND RESEARCH
ANSMET	PARENTORGANIZATION	OFFICE OF POLAR PROGRAMS OF THE NATIONAL SCIENCE FOUNDATION
GLASGOW UNIVERSITY DIALECTIC SOCIETY	PARENTORGANIZATION	UNIVERSITY OF GLASGOW
NATIONAL JUNIOR CLASSICAL LEAGUE	PARENTORGANIZATION	AMERICAN CLASSICAL LEAGUE
EUROPEAN MOVEMENT IRELAND	PARENTORGANIZATION	EUROPEAN MOVEMENT INTERNATIONAL
DEUTSCHES PATENT- UND MARKENAMT	PARENTORGANIZATION	FEDERAL MINISTRY OF JUSTICE AND CONSUMER PROTECTION
RUGBY LEAGUE EUROPEAN FEDERATION	PARENTORGANIZATION	RLIF
CANONS REGULAR OF THE HOLY SEPULCHRE	PARENTORGANIZATION	CATHOLIC CHURCH
EUROPEAN BIOINFORMATICS INSTITUTE	PARENTORGANIZATION	EUROPEAN MOLECULAR BIOLOGY LABORATORY
NEW DEMOCRATIC YOUTH OF CANADA	PARENTORGANIZATION	NEW DEMOCRATIC PARTY
THE WAY TO HAPPINESS	PARENTORGANIZATION	ASSOCIATION FOR BETTER LIVING AND EDUCATION
SCIENTIFIC COMMITTEE ON ANTARCTIC RESEARCH	PARENTORGANIZATION	INTERNATIONAL COUNCIL FOR SCIENCE
GENIUS BAR	PARENTORGANIZATION	APPLE INC.
INTERNATIONAL WATER MANAGEMENT INSTITUTE	PARENTORGANIZATION	CGIAR
NATIONAL INSTITUTE FOR MEDICAL RESEARCH	PARENTORGANIZATION	MEDICAL RESEARCH COUNCIL
INDEPENDENT POLICE COMPLAINTS COMMISSION	PARENTORGANIZATION	HOME OFFICE
CHINA FOOD AND DRUG ADMINISTRATION	PARENTORGANIZATION	STATE COUNCIL OF THE PEOPLE'S REPUBLIC OF CHINA
GLOBAL METHANE INITIATIVE	PARENTORGANIZATION	UNITED STATES ENVIRONMENTAL PROTECTION AGENCY
EUROPEAN SPACE RESEARCH AND TECHNOLOGY CENTRE	PARENTORGANIZATION	EUROPEAN SPACE AGENCY
PIARISTS	PARENTORGANIZATION	CATHOLIC CHURCH
CONSERVATOIRE DE MUSIQUE DU QUéBEC à SAGUENAY	PARENTORGANIZATION	CONSERVATOIRE DE MUSIQUE ET D'ART DRAMATIQUE DU QUéBEC
ENGLISH INSTITUTE OF SPORT	PARENTORGANIZATION	DEPARTMENT FOR CULTURE, MEDIA AND SPORT
FOOTBALL FEDERATION VICTORIA	PARENTORGANIZATION	FOOTBALL FEDERATION AUSTRALIA
FOOTBALL FEDERATION TASMANIA	PARENTORGANIZATION	FOOTBALL FEDERATION AUSTRALIA
COMMONWEALTH BUSINESS COUNCIL	PARENTORGANIZATION	COMMONWEALTH OF NATIONS
NATIONAL EXTREMISM TACTICAL CO-ORDINATION UNIT	PARENTORGANIZATION	ASSOCIATION OF CHIEF POLICE OFFICERS
FOOTBALL QUEENSLAND	PARENTORGANIZATION	FOOTBALL FEDERATION AUSTRALIA
ARTS AND HUMANITIES RESEARCH COUNCIL	PARENTORGANIZATION	*DEPARTMENT FOR BUSINESS, INNOVATION AND SKILLS \N*RESEARCH COUNCILS UK
ENGINEERING AND PHYSICAL SCIENCES RESEARCH COUNCIL	PARENTORGANIZATION	*DEPARTMENT FOR BUSINESS, INNOVATION AND SKILLS \N*RESEARCH COUNCILS UK
RADIO AZADI	PARENTORGANIZATION	RADIO LIBERTY
NATIONAL COUNCIL FOR SCIENTIFIC AND TECHNOLOGICAL DEVELOPMENT	PARENTORGANIZATION	MINISTRY OF SCIENCE AND TECHNOLOGY
FORENSIC SCIENCE SERVICE	PARENTORGANIZATION	HOME OFFICE
INTERNATIONAL MINERALOGICAL ASSOCIATION	PARENTORGANIZATION	INTERNATIONAL COUNCIL FOR SCIENCE
CAMBRIDGE UNIVERSITIES LABOUR CLUB	PARENTORGANIZATION	LABOUR PARTY
POLICE COMPLAINTS BOARD	PARENTORGANIZATION	HOME OFFICE
TEENSCREEN	PARENTORGANIZATION	DIVISION OF CHILD AND ADOLESCENT PSYCHIATRY AT COLUMBIA UNIVERSITY
GAUTENG AND ENVIRONS LIBRARY CONSORTIUM	PARENTORGANIZATION	FOUNDATION OF TERTIARY INSTITUTIONS OF THE NORTHERN METROPOLIS
EUROPEAN DEMOCRAT STUDENTS	PARENTORGANIZATION	EUROPEAN PEOPLE'S PARTY
UK YOUTH PARLIAMENT	PARENTORGANIZATION	BRITISH YOUTH COUNCIL
NATIONAL OCEANOGRAPHY CENTRE	PARENTORGANIZATION	NATURAL ENVIRONMENT RESEARCH COUNCIL
INTERNATIONAL ARCTIC SCIENCE COMMITTEE	PARENTORGANIZATION	INTERNATIONAL COUNCIL FOR SCIENCE
GENERAL BOARD OF CHURCH AND SOCIETY	PARENTORGANIZATION	UNITED METHODIST CHURCH
GENERATION PROGRESS	PARENTORGANIZATION	CENTER FOR AMERICAN PROGRESS
NEW CASTLE PRESBYTERY	PARENTORGANIZATION	SYNOD OF THE TRINITY
RADIO FARDA	PARENTORGANIZATION	BROADCASTING BOARD OF GOVERNORS
COLUMBIAN SQUIRES	PARENTORGANIZATION	KNIGHTS OF COLUMBUS
ASIAN SQUASH FEDERATION	PARENTORGANIZATION	WORLD SQUASH FEDERATION
TURKISH NATIONAL RESEARCH INSTITUTE OF ELECTRONICS AND CRYPTOLOGY	PARENTORGANIZATION	TÜBİTAK INFORMATICS AND INFORMATION SECURITY RESEARCH CENTER
KHALISTAN LIBERATION FORCE	PARENTORGANIZATION	KHALISTAN MOVEMENT
PUBLICITY DEPARTMENT OF THE COMMUNIST PARTY OF CHINA	PARENTORGANIZATION	CENTRAL COMMITTEE OF THE COMMUNIST PARTY OF CHINA
DEUTSCHES JUNGVOLK	PARENTORGANIZATION	NAZI PARTY
NATO PARLIAMENTARY ASSEMBLY	PARENTORGANIZATION	NATO
FREEDOMWORKS	PARENTORGANIZATION	CITIZENS FOR A SOUND ECONOMY
WORLD BODYBUILDING FEDERATION	PARENTORGANIZATION	WWE
MEDIA MINISTRIES OF THE SEVENTH-DAY ADVENTIST CHURCH	PARENTORGANIZATION	GENERAL CONFERENCE OF SEVENTH-DAY ADVENTISTS
FEDERAL NETWORK AGENCY	PARENTORGANIZATION	GERMAN FEDERAL MINISTRY OF ECONOMICS AND TECHNOLOGY
ALLIED ELECTRONICS	PARENTORGANIZATION	ELECTROCOMPONENTS PLC
INTERNATIONAL UNION OF BIOCHEMISTRY AND MOLECULAR BIOLOGY	PARENTORGANIZATION	INTERNATIONAL COUNCIL FOR SCIENCE
COMMISSION ON ACCREDITATION FOR LAW ENFORCEMENT AGENCIES	PARENTORGANIZATION	INTERNATIONAL ASSOCIATION OF CHIEFS OF POLICE
COMMISSION ON ACCREDITATION FOR LAW ENFORCEMENT AGENCIES	PARENTORGANIZATION	NATIONAL ORGANIZATION OF BLACK LAW ENFORCEMENT EXECUTIVES
COMMISSION ON ACCREDITATION FOR LAW ENFORCEMENT AGENCIES	PARENTORGANIZATION	NATIONAL SHERIFFS' ASSOCIATION
COMMISSION ON ACCREDITATION FOR LAW ENFORCEMENT AGENCIES	PARENTORGANIZATION	POLICE EXECUTIVE RESEARCH FORUM
INTERNATIONAL POLITICAL SCIENCE ASSOCIATION	PARENTORGANIZATION	INTERNATIONAL SOCIAL SCIENCE COUNCIL
ASSOCIATION OF GREATER MANCHESTER AUTHORITIES	PARENTORGANIZATION	GREATER MANCHESTER COMBINED AUTHORITY
KNOWLEDGE TRANSFER PARTNERSHIPS	PARENTORGANIZATION	INNOVATE UK
CANADIAN CONFERENCE OF CATHOLIC BISHOPS	PARENTORGANIZATION	HOLY SEE
PAKISTAN COUNCIL OF SCIENTIFIC AND INDUSTRIAL RESEARCH	PARENTORGANIZATION	MINISTRY OF SCIENCE AND TECHNOLOGY
INSTITUTE OF POLICY STUDIES	PARENTORGANIZATION	LEE KUAN YEW SCHOOL OF PUBLIC POLICY
SODALITIUM CHRISTIANAE VITAE	PARENTORGANIZATION	CATHOLIC CHURCH
SISTERS OF CHARITY OF NEW YORK	PARENTORGANIZATION	SISTERS OF CHARITY FEDERATION IN THE VINCENTIAN-SETONIAN TRADITION
STATE INSURANCE	PARENTORGANIZATION	IAG NEW ZEALAND LTD
GREATER MANCHESTER WASTE DISPOSAL AUTHORITY	PARENTORGANIZATION	GREATER MANCHESTER COMBINED AUTHORITY
NATIONAL ENGINEERING AND SCIENTIFIC COMMISSION	PARENTORGANIZATION	STRATEGIC PLANS DIVISION
NATIONAL ENGINEERING AND SCIENTIFIC COMMISSION	PARENTORGANIZATION	MINISTRY OF DEFENCE
PASCHIMBANGA BANGLA AKADEMI	PARENTORGANIZATION	DEPARTMENT OF CULTURE AND INFORMATION AFFAIRS, WEST BENGAL GOVERNMENT
HIGHER EDUCATION ACADEMY	PARENTORGANIZATION	UNIVERSITIES UK
HIGHER EDUCATION ACADEMY	PARENTORGANIZATION	GUILDHE
INSTITUTE OF HISTORICAL RESEARCH	PARENTORGANIZATION	SCHOOL OF ADVANCED STUDY
INSTITUTE OF HISTORICAL RESEARCH	PARENTORGANIZATION	UNIVERSITY OF LONDON
CENTRE FOR ECOLOGY AND HYDROLOGY	PARENTORGANIZATION	NATURAL ENVIRONMENT RESEARCH COUNCIL
EUROPEAN FREE ALLIANCE YOUTH	PARENTORGANIZATION	EUROPEAN FREE ALLIANCE
FEDERATION OF YOUNG EUROPEAN GREENS	PARENTORGANIZATION	EUROPEAN GREEN PARTY
BAFTA CYMRU	PARENTORGANIZATION	BRITISH ACADEMY OF FILM AND TELEVISION ARTS
TOLEDO TRANSMISSION	PARENTORGANIZATION	GENERAL MOTORS
INTERNATIONAL MUSIC COUNCIL	PARENTORGANIZATION	UNESCO
OPERA NAZIONALE BALILLA	PARENTORGANIZATION	NATIONAL FASCIST PARTY
ARMENIAN NATIONAL COMMITTEE OF AMERICA	PARENTORGANIZATION	ARMENIAN REVOLUTIONARY FEDERATION
WOMEN'S FOOTBALL ASSOCIATION OF IRELAND	PARENTORGANIZATION	FOOTBALL ASSOCIATION OF IRELAND
COUNCIL OF CHRISTIAN HOSPITALS	PARENTORGANIZATION	CANADIAN BAPTIST MINISTRIES
BIBLE SOCIETY OF INDIA	PARENTORGANIZATION	UNITED BIBLE SOCIETIES
PISTOL NEW ZEALAND	PARENTORGANIZATION	INTERNATIONAL METALLIC SILHOUETTE SHOOTING UNION
PISTOL NEW ZEALAND	PARENTORGANIZATION	INTERNATIONAL PRACTICAL SHOOTING CONFEDERATION
PISTOL NEW ZEALAND	PARENTORGANIZATION	INTERNATIONAL SHOOTING SPORT FEDERATION
PISTOL NEW ZEALAND	PARENTORGANIZATION	MUZZLE LOADERS ASSOCIATIONS INTERNATIONAL COMMITTEE
PISTOL NEW ZEALAND	PARENTORGANIZATION	PRECISION PISTOL COMPETITION
INTERNATIONAL NETWORK FOR THE AVAILABILITY OF SCIENTIFIC PUBLICATIONS	PARENTORGANIZATION	INTERNATIONAL COUNCIL FOR SCIENCE
BRITISH NATIONAL COMMITTEE FOR SPACE RESEARCH	PARENTORGANIZATION	ROYAL SOCIETY
NATIONAL WRITERS UNION	PARENTORGANIZATION	INTERNATIONAL FEDERATION OF JOURNALISTS
NATIONAL SENIOR CLASSICAL LEAGUE	PARENTORGANIZATION	AMERICAN CLASSICAL LEAGUE
NATIONAL RESIDENCE HALL HONORARY	PARENTORGANIZATION	NACURH
CONFERENCE ON WORLD AFFAIRS	PARENTORGANIZATION	UNIVERSITY OF COLORADO BOULDER
PARIS CHAMBER OF COMMERCE	PARENTORGANIZATION	PARIS ÎLE-DE-FRANCE REGIONAL CHAMBER OF COMMERCE AND INDUSTRY
NATURE AND YOUTH SWEDEN	PARENTORGANIZATION	SWEDISH SOCIETY FOR NATURE CONSERVATION
ONTARIO YOUNG LIBERALS	PARENTORGANIZATION	ONTARIO LIBERAL PARTY
ONTARIO YOUNG LIBERALS	PARENTORGANIZATION	LIBERAL PARTY OF CANADA
INTERNATIONAL ISLAMIC RELIEF ORGANIZATION	PARENTORGANIZATION	MUSLIM WORLD LEAGUE
NATIONAL SOCIALIST WOMEN'S LEAGUE	PARENTORGANIZATION	NAZI PARTY
LIST OF SEVENTH-DAY ADVENTIST SECONDARY SCHOOLS	PARENTORGANIZATION	GENERAL CONFERENCE OF SEVENTH-DAY ADVENTISTS
INTERNATIONAL ASSOCIATION OF VOLCANOLOGY AND CHEMISTRY OF THE EARTH'S INTERIOR	PARENTORGANIZATION	INTERNATIONAL UNION OF GEODESY AND GEOPHYSICS
RESISTANCE	PARENTORGANIZATION	BRITISH NATIONAL PARTY
LABORATORY OF MOLECULAR BIOLOGY	PARENTORGANIZATION	MEDICAL RESEARCH COUNCIL
MAX PLANCK INSTITUTE FOR THE SCIENCE OF HUMAN HISTORY	PARENTORGANIZATION	MAX PLANCK SOCIETY
DOCARE	PARENTORGANIZATION	AMERICAN OSTEOPATHIC ASSOCIATION
GREENPEACE NORDIC	PARENTORGANIZATION	GREENPEACE
DIGITAL UK	PARENTORGANIZATION	BBC
DIGITAL UK	PARENTORGANIZATION	ITV PLC
DIGITAL UK	PARENTORGANIZATION	CHANNEL 4
DIGITAL UK	PARENTORGANIZATION	ARQIVA
INTERNATIONAL ASSOCIATION FOR HYDRO-ENVIRONMENT ENGINEERING AND RESEARCH	PARENTORGANIZATION	INTERNATIONAL COUNCIL FOR SCIENCE
WORLD ASSOCIATION OF NEWSPAPERS AND NEWS PUBLISHERS	PARENTORGANIZATION	UNESCO
CENDANA EDUCATION FOUNDATION	PARENTORGANIZATION	PT. CHEVRON PACIFIC INDONESIA
USA GYMNASTICS	PARENTORGANIZATION	INTERNATIONAL FEDERATION OF GYMNASTICS
WESTPAC LIFE SAVER RESCUE HELICOPTER SERVICE	PARENTORGANIZATION	SURF LIFE SAVING AUSTRALIA
INTERNATIONAL PERMAFROST ASSOCIATION	PARENTORGANIZATION	INTERNATIONAL UNION OF GEOLOGICAL SCIENCES
MAX PLANCK INSTITUTE FOR SOLAR SYSTEM RESEARCH	PARENTORGANIZATION	MAX PLANCK SOCIETY
NEW YORK'S 99TH STATE ASSEMBLY DISTRICT	PARENTORGANIZATION	NEW YORK STATE LEGISLATURE
ANNA UNIVERSITY K B CHANDRASHEKAR RESEARCH CENTRE	PARENTORGANIZATION	ANNA UNIVERSITY
GRAND ORANGE LODGE OF SCOTLAND	PARENTORGANIZATION	ORANGE INSTITUTION
YESHIVA UNIVERSITY MEDICAL ETHICS SOCIETY	PARENTORGANIZATION	YESHIVA UNIVERSITY CENTER FOR THE JEWISH FUTURE
INTERNATIONAL ISLAMIC FIQH ACADEMY, JEDDAH	PARENTORGANIZATION	ORGANISATION OF THE ISLAMIC CONFERENCE
INTERNATIONAL UNION OF MICROBIOLOGICAL SOCIETIES	PARENTORGANIZATION	INTERNATIONAL COUNCIL FOR SCIENCE
PI ALPHA ALPHA	PARENTORGANIZATION	NASPAA
CONSERVATIVE CHRISTIAN FELLOWSHIP	PARENTORGANIZATION	CONSERVATIVE PARTY
MIC MAC AAC	PARENTORGANIZATION	CANOE KAYAK CANADA
MIC MAC AAC	PARENTORGANIZATION	ROWING CANADA
CONGRESS OF THE COUNCIL OF EUROPE	PARENTORGANIZATION	COUNCIL OF EUROPE
ONE NORTHEAST	PARENTORGANIZATION	DEPARTMENT FOR BUSINESS, INNOVATION AND SKILLS
HECSU	PARENTORGANIZATION	UNIVERSITIES UK AND GUILDHE
OIL AND PIPELINES AGENCY	PARENTORGANIZATION	MINISTRY OF DEFENCE
INTERNATIONAL OLD CATHOLIC BISHOPS' CONFERENCE	PARENTORGANIZATION	UNION OF UTRECHT OF THE OLD CATHOLIC CHURCHES
CANADA-ISRAEL COMMITTEE	PARENTORGANIZATION	CANADIAN COUNCIL FOR ISRAEL AND JEWISH ADVOCACY
INTERNATIONAL UNION OF BASIC AND CLINICAL PHARMACOLOGY	PARENTORGANIZATION	INTERNATIONAL COUNCIL FOR SCIENCE
NEW YORK'S 41ST STATE SENATE DISTRICT	PARENTORGANIZATION	NEW YORK STATE LEGISLATURE
MAX PLANCK INSTITUTE FOR SOLID STATE RESEARCH	PARENTORGANIZATION	MAX PLANCK SOCIETY
DIGITAL CURATION CENTRE	PARENTORGANIZATION	JISC
MAX PLANCK INSTITUTE FOR SOCIAL ANTHROPOLOGY	PARENTORGANIZATION	MAX PLANCK SOCIETY
IUAES	PARENTORGANIZATION	INTERNATIONAL COUNCIL FOR SCIENCE
MAX PLANCK INSTITUTE FOR POLYMER RESEARCH	PARENTORGANIZATION	MAX PLANCK SOCIETY
MAX PLANCK INSTITUTE FOR EXPERIMENTAL MEDICINE	PARENTORGANIZATION	MAX PLANCK SOCIETY
PONTIFICAL COUNCIL FOR CULTURE	PARENTORGANIZATION	ROMAN CURIA
MAX PLANCK INSTITUTE FOR RESEARCH ON COLLECTIVE GOODS	PARENTORGANIZATION	MAX PLANCK SOCIETY
MAX PLANCK INSTITUTE OF COLLOIDS AND INTERFACES	PARENTORGANIZATION	MAX PLANCK SOCIETY
MAX PLANCK INSTITUTE FOR TERRESTRIAL MICROBIOLOGY	PARENTORGANIZATION	MAX PLANCK SOCIETY
UNITED NATIONS ASSOCIATION OF AUSTRALIA	PARENTORGANIZATION	UNITED NATIONS
INTERNATIONAL UNION FOR QUATERNARY RESEARCH	PARENTORGANIZATION	INTERNATIONAL COUNCIL FOR SCIENCE
POTATO COUNCIL	PARENTORGANIZATION	AGRICULTURE AND HORTICULTURE DEVELOPMENT BOARD
ILOILO F.A.	PARENTORGANIZATION	PHILIPPINE FOOTBALL FEDERATION
NEGROS OCCIDENTAL F.A.	PARENTORGANIZATION	PHILIPPINE FOOTBALL FEDERATION
ZAMBOANGA F.A.	PARENTORGANIZATION	PHILIPPINE FOOTBALL FEDERATION
GATOR GROWL	PARENTORGANIZATION	FLORIDA BLUE KEY
GOOGLE.ORG	PARENTORGANIZATION	GOOGLE
SISTERS OF CHARITY OF SAINT VINCENT DE PAUL	PARENTORGANIZATION	SISTERS OF CHARITY FEDERATION
EUROPEAN UNION MONITORING MISSION	PARENTORGANIZATION	EUROPEAN UNION
RUSSIAN SPACE RESEARCH INSTITUTE	PARENTORGANIZATION	RUSSIAN ACADEMY OF SCIENCES
ALZHEIMER SOCIETY OF ONTARIO	PARENTORGANIZATION	ALZHEIMER SOCIETY OF CANADA
INSTITUTO BENJAMIN CONSTANT	PARENTORGANIZATION	MINISTRY OF EDUCATION
MOSCOW HELSINKI GROUP	PARENTORGANIZATION	HELSINKI COMMITTEE FOR HUMAN RIGHTS
EAST MALLING RESEARCH STATION	PARENTORGANIZATION	WWW.EASTMALLINGTRUST.ORG
FAIREY BAND	PARENTORGANIZATION	FAIREY AVIATION COMPANY
INTERNATIONAL UNION OF FOOD SCIENCE AND TECHNOLOGY	PARENTORGANIZATION	INTERNATIONAL COUNCIL FOR SCIENCE
UK ASTRONOMY TECHNOLOGY CENTRE	PARENTORGANIZATION	SCIENCE AND TECHNOLOGY FACILITIES COUNCIL
LGC	PARENTORGANIZATION	BRIDGEPOINT CAPITAL
FEDERAL INSTITUTE FOR MATERIALS RESEARCH AND TESTING	PARENTORGANIZATION	FEDERAL MINISTRY FOR ECONOMIC AFFAIRS AND ENERGY
INTER-SERVICES PUBLIC RELATIONS	PARENTORGANIZATION	PAKISTAN ARMED FORCES
MIRA LTD.	PARENTORGANIZATION	HORIBA
ORDER OF THE STAR IN THE EAST	PARENTORGANIZATION	THEOSOPHICAL SOCIETY
RESEARCH COUNCILS UK	PARENTORGANIZATION	DEPARTMENT FOR BUSINESS, INNOVATION AND SKILLS
ECONOMIC AND SOCIAL RESEARCH COUNCIL	PARENTORGANIZATION	*DEPARTMENT FOR BUSINESS, INNOVATION AND SKILLS \N*RESEARCH COUNCILS UK
INTERNATIONAL CARTOGRAPHIC ASSOCIATION	PARENTORGANIZATION	INTERNATIONAL COUNCIL FOR SCIENCE
UNITED STATES PRACTICAL SHOOTING ASSOCIATION	PARENTORGANIZATION	INTERNATIONAL PRACTICAL SHOOTING CONFEDERATION
ICC EAST ASIA-PACIFIC	PARENTORGANIZATION	INTERNATIONAL CRICKET COUNCIL
MAX PLANCK INSTITUTE OF MOLECULAR PHYSIOLOGY	PARENTORGANIZATION	MAX PLANCK SOCIETY
COSIC	PARENTORGANIZATION	INTERDISCIPLINARY INSTITUTE FOR BROADBAND TECHNOLOGY
COSIC	PARENTORGANIZATION	KATHOLIEKE UNIVERSITEIT LEUVEN
AFL PNG	PARENTORGANIZATION	PNG RULES FOOTBALL COUNCIL
PNG RULES FOOTBALL COUNCIL	PARENTORGANIZATION	AUSTRALIAN FOOTBALL LEAGUE
ARMENIA TREE PROJECT	PARENTORGANIZATION	ARMENIAN ASSEMBLY OF AMERICA
INTERNATIONAL GEOSPHERE-BIOSPHERE PROGRAMME	PARENTORGANIZATION	INTERNATIONAL COUNCIL FOR SCIENCE
FUTURE OF HUMANITY INSTITUTE	PARENTORGANIZATION	FACULTY OF PHILOSOPHY, UNIVERSITY OF OXFORD
FUTURE OF HUMANITY INSTITUTE	PARENTORGANIZATION	UNIVERSITY OF OXFORD
ASPEN EDUCATION GROUP	PARENTORGANIZATION	CRC HEALTH GROUP
MOSHE DAYAN CENTER FOR MIDDLE EASTERN AND AFRICAN STUDIES	PARENTORGANIZATION	TEL AVIV UNIVERSITY
OSS WATCH	PARENTORGANIZATION	UNIVERSITY OF OXFORD
INTERNATIONAL ASSOCIATION OF GEOCHEMISTRY	PARENTORGANIZATION	INTERNATIONAL UNION OF GEOLOGICAL SCIENCES
INTERNET ARCHAEOLOGY	PARENTORGANIZATION	UNIVERSITY OF YORK
MACCABI AUSTRALIA	PARENTORGANIZATION	MACCABI WORLD UNION
MRC MITOCHONDRIAL BIOLOGY UNIT	PARENTORGANIZATION	MEDICAL RESEARCH COUNCIL
HOSTELLING INTERNATIONAL USA	PARENTORGANIZATION	HOSTELLING INTERNATIONAL
INTERNATIONAL UNION OF NUTRITIONAL SCIENCES	PARENTORGANIZATION	INTERNATIONAL COUNCIL FOR SCIENCE
NATIONAL SOCIALIST GERMAN STUDENTS' LEAGUE	PARENTORGANIZATION	NAZI PARTY
SOUTHEAST ASIA BASKETBALL ASSOCIATION	PARENTORGANIZATION	FIBA ASIA
WORLD TRADE CENTER NEW ORLEANS	PARENTORGANIZATION	WORLD TRADE CENTERS ASSOCIATION
INTERNATIONAL FEDERATION OF RED CROSS AND RED CRESCENT SOCIETIES	PARENTORGANIZATION	INTERNATIONAL RED CROSS AND RED CRESCENT MOVEMENT
IDOL GIVES BACK	PARENTORGANIZATION	AMERICAN IDOL
COMMISSIONER FOR HUMAN RIGHTS	PARENTORGANIZATION	COUNCIL OF EUROPE
NATIONAL CAPITAL REGION F.A.	PARENTORGANIZATION	PHILIPPINE FOOTBALL FEDERATION
YOUNG GREENS OF CANADA	PARENTORGANIZATION	GREEN PARTY OF CANADA
MAX PLANCK INSTITUTE FOR MEDICAL RESEARCH	PARENTORGANIZATION	MAX PLANCK SOCIETY
MAX PLANCK INSTITUTE FOR COAL RESEARCH	PARENTORGANIZATION	MAX PLANCK SOCIETY
ASEAN UNIVERSITY NETWORK	PARENTORGANIZATION	ASSOCIATION OF SOUTHEAST ASIAN NATIONS
MAX PLANCK INSTITUTE FOR HUMAN DEVELOPMENT	PARENTORGANIZATION	MAX PLANCK SOCIETY
MAX PLANCK INSTITUTE FOR THE STUDY OF RELIGIOUS AND ETHNIC DIVERSITY	PARENTORGANIZATION	MAX PLANCK SOCIETY
SOCIETY FOR SOCIAL STUDIES OF SCIENCE	PARENTORGANIZATION	INTERNATIONAL SOCIAL SCIENCE COUNCIL
PEN CANADA	PARENTORGANIZATION	INTERNATIONAL PEN
MAX PLANCK INSTITUTE OF IMMUNOBIOLOGY AND EPIGENETICS	PARENTORGANIZATION	MAX PLANCK SOCIETY
AAA MID-ATLANTIC	PARENTORGANIZATION	AMERICAN AUTOMOBILE ASSOCIATION
SCIENCE AND TECHNOLOGY FACILITIES COUNCIL	PARENTORGANIZATION	*DEPARTMENT FOR BUSINESS, INNOVATION AND SKILLS \N*RESEARCH COUNCILS UK
STATISTICAL ASSESSMENT SERVICE	PARENTORGANIZATION	GEORGE MASON UNIVERSITY
NEAL A. MAXWELL INSTITUTE FOR RELIGIOUS SCHOLARSHIP	PARENTORGANIZATION	BRIGHAM YOUNG UNIVERSITY
MAX PLANCK INSTITUTE OF MOLECULAR PLANT PHYSIOLOGY	PARENTORGANIZATION	MAX PLANCK SOCIETY
INTERNATIONAL UNION OF CRYSTALLOGRAPHY	PARENTORGANIZATION	INTERNATIONAL COUNCIL FOR SCIENCE
YOUNG WOMEN	PARENTORGANIZATION	THE CHURCH OF JESUS CHRIST OF LATTER-DAY SAINTS
YOUNG MEN	PARENTORGANIZATION	THE CHURCH OF JESUS CHRIST OF LATTER-DAY SAINTS
SUNDAY SCHOOL	PARENTORGANIZATION	THE CHURCH OF JESUS CHRIST OF LATTER-DAY SAINTS
EDUROAM	PARENTORGANIZATION	TERENA
BANDIM HEALTH PROJECT	PARENTORGANIZATION	STATENS SERUM INSTITUTHTTP://WWW.SSI.DK
INTERNATIONAL GEOSCIENCE PROGRAMME	PARENTORGANIZATION	INTERNATIONAL UNION OF GEOLOGICAL SCIENCES
MALARIA ATLAS PROJECT	PARENTORGANIZATION	UNIVERSITY OF OXFORD
UNION MONDIALE DE BILLARD	PARENTORGANIZATION	WORLD CONFEDERATION OF BILLIARD SPORTS
INTERNATIONAL ASSOCIATION OF HYDROGEOLOGISTS	PARENTORGANIZATION	INTERNATIONAL COUNCIL FOR SCIENCE
INTERNATIONAL ASSOCIATION OF HYDROGEOLOGISTS	PARENTORGANIZATION	INTERNATIONAL SOCIAL SCIENCE COUNCIL
CHINESE VOLLEYBALL ASSOCIATION	PARENTORGANIZATION	STATE GENERAL ADMINISTRATION OF SPORTS
REGIONAL PLANETARY IMAGE FACILITY	PARENTORGANIZATION	NASA
SEVENTH-DAY ADVENTIST COMMENTARY REFERENCE SERIES	PARENTORGANIZATION	GENERAL CONFERENCE OF SEVENTH-DAY ADVENTISTS
ONTARIO SOCCER ASSOCIATION	PARENTORGANIZATION	CANADIAN SOCCER ASSOCIATION
SCOTTISH POLICE SERVICES AUTHORITY	PARENTORGANIZATION	SCOTTISH GOVERNMENT
INSTITUTO SUPERIOR DE AGRONOMIA	PARENTORGANIZATION	UNIVERSITY OF LISBON
MOCIDADE PORTUGUESA	PARENTORGANIZATION	NATIONAL UNION
STRANGERS INTO CITIZENS	PARENTORGANIZATION	CITIZEN ORGANISING FOUNDATION
STRANGERS INTO CITIZENS	PARENTORGANIZATION	LONDON CITIZENS
STRANGERS INTO CITIZENS	PARENTORGANIZATION	CITIZENS UK
ORIENTAL INSTITUTE IN SARAJEVO	PARENTORGANIZATION	UNIVERSITY OF SARAJEVO
LEGISLATIVE BLACK CAUCUS OF MARYLAND	PARENTORGANIZATION	NATIONAL BLACK CAUCUS OF STATE LEGISLATORS
PONTIFICAL COUNCIL FOR SOCIAL COMMUNICATIONS	PARENTORGANIZATION	ROMAN CURIA
EXTRA MILE EDUCATION FOUNDATION	PARENTORGANIZATION	CATHOLIC CHURCH
BANCROFT LITERARY ASSOCIATION AND CARROLLTON-WIGHT LITERARY SOCIETY	PARENTORGANIZATION	BALTIMORE CITY COLLEGE
AUSTRIAN RED CROSS	PARENTORGANIZATION	INTERNATIONAL FEDERATION OF RED CROSS AND RED CRESCENT SOCIETIES
CONFEDERATION OF EUROPEAN BASEBALL	PARENTORGANIZATION	INTERNATIONAL BASEBALL FEDERATION
MCGHEE CENTER FOR EASTERN MEDITERRANEAN STUDIES	PARENTORGANIZATION	GEORGETOWN UNIVERSITY
MISSISSIPPI STATE GUARD	PARENTORGANIZATION	MISSISSIPPI MILITARY DEPARTMENT
CAMP STONE	PARENTORGANIZATION	B'NEI AKIVA
MAX PLANCK INSTITUTE FOR PSYCHOLINGUISTICS	PARENTORGANIZATION	MAX PLANCK SOCIETY
CENTRAL COMPUTER AND TELECOMMUNICATIONS AGENCY	PARENTORGANIZATION	HM TREASURY
MULTILATERAL INVESTMENT GUARANTEE AGENCY	PARENTORGANIZATION	WORLD BANK GROUP
NATIONAL POLICE ACADEMY OF PAKISTAN	PARENTORGANIZATION	GOVERNMENT OF PAKISTAN
KARELIAN RESEARCH CENTRE OF RAS	PARENTORGANIZATION	RUSSIAN ACADEMY OF SCIENCES
KARELIAN RESEARCH CENTRE OF RAS	PARENTORGANIZATION	FEDERAL AGENCY FOR SCIENTIFIC ORGANIZATIONS
IEC JTC 1	PARENTORGANIZATION	INTERNATIONAL ORGANIZATION FOR STANDARDIZATION  AND INTERNATIONAL ELECTROTECHNICAL COMMISSION
MARCHé DU FILM	PARENTORGANIZATION	FESTIVAL DE CANNES
EUROPEAN SOFTBALL FEDERATION	PARENTORGANIZATION	INTERNATIONAL SOFTBALL FEDERATION
ORGANIZATION DEPARTMENT OF THE COMMUNIST PARTY OF CHINA	PARENTORGANIZATION	CENTRAL COMMITTEE OF THE COMMUNIST PARTY OF CHINA
INTERNATIONAL COUNCIL FOR INDUSTRIAL AND APPLIED MATHEMATICS	PARENTORGANIZATION	INTERNATIONAL COUNCIL FOR SCIENCE
NATIONAL FOUNDATION FOR WOMEN LEGISLATORS	PARENTORGANIZATION	NATIONAL ORDER OF WOMEN LEGISLATORS
SOYUZIVKA	PARENTORGANIZATION	UKRAINIAN NATIONAL ASSOCIATION
YOUNG DEMOCRATS FOR EUROPE	PARENTORGANIZATION	EUROPEAN DEMOCRATIC PARTY
SOUTH ASIAN FOOTBALL FEDERATION	PARENTORGANIZATION	ASIAN FOOTBALL CONFEDERATION
MAX PLANCK INSTITUTE FOR THE SCIENCE OF LIGHT	PARENTORGANIZATION	MAX PLANCK SOCIETY
SEVENTH-DAY ADVENTIST EDUCATION	PARENTORGANIZATION	GENERAL CONFERENCE OF SEVENTH-DAY ADVENTISTS
CENTRAL POLITICAL AND LEGAL AFFAIRS COMMISSION	PARENTORGANIZATION	CENTRAL COMMITTEE OF THE COMMUNIST PARTY OF CHINA
LEGIãO PORTUGUESA	PARENTORGANIZATION	NATIONAL UNION
SCIENTIFIC COMMITTEE ON HEALTH AND ENVIRONMENTAL RISKS	PARENTORGANIZATION	DIRECTORATE-GENERAL FOR HEALTH AND CONSUMER PROTECTION
TURKISH PATENT INSTITUTE	PARENTORGANIZATION	MINISTRY OF INDUSTRY AND COMMERCE
SYNOD OF THE TRINITY	PARENTORGANIZATION	PRESBYTERIAN CHURCH
OPEN HANDSET ALLIANCE	PARENTORGANIZATION	GOOGLE
SPECIAL INTEREST GROUP ON INFORMATION RETRIEVAL	PARENTORGANIZATION	ASSOCIATION FOR COMPUTING MACHINERY
HIGH PERFORMANCE COMPUTING MODERNIZATION PROGRAM	PARENTORGANIZATION	ERDC
ASIATIC SOCIETY OF BANGLADESH	PARENTORGANIZATION	ASIATIC SOCIETY
ORGANIZATION OF CANADIAN SYMPHONY MUSICIANS	PARENTORGANIZATION	AMERICAN FEDERATION OF MUSICIANS
LEO CLUBS	PARENTORGANIZATION	LIONS CLUBS INTERNATIONAL
CENTRE FOR DEVELOPMENT AND THE ENVIRONMENT	PARENTORGANIZATION	UNIVERSITY OF OSLO
INNOVATE UK	PARENTORGANIZATION	DEPARTMENT FOR BUSINESS, INNOVATION AND SKILLS
UKRAINIAN HELSINKI GROUP	PARENTORGANIZATION	HELSINKI COMMITTEE FOR HUMAN RIGHTS
FIRST NATIONS UNIVERSITY STUDENTS' ASSOCIATION	PARENTORGANIZATION	FIRST NATIONS UNIVERSITY OF CANADA
CENTER FOR WOMEN IN TECHNOLOGY	PARENTORGANIZATION	UNIVERSITY OF MARYLAND, BALTIMORE COUNTY
WORLD POLICY COUNCIL	PARENTORGANIZATION	ALPHA PHI ALPHA
IAG NEW ZEALAND LTD	PARENTORGANIZATION	INSURANCE AUSTRALIA GROUP
CENTRAL SECURITY BUREAU OF THE COMMUNIST PARTY OF CHINA	PARENTORGANIZATION	GENERAL OFFICE OF THE COMMUNIST PARTY OF CHINA
CENTRAL SECURITY BUREAU OF THE COMMUNIST PARTY OF CHINA	PARENTORGANIZATION	JOINT STAFF DEPARTMENT OF THE CENTRAL MILITARY COMMISSION
CENTRE FOR ARAB GENOMIC STUDIES	PARENTORGANIZATION	SHEIKH HAMDAN BIN RASHID AL MAKTOUM AWARD FOR MEDICAL SCIENCES
INDEPENDENT INVESTIGATIONS GROUP	PARENTORGANIZATION	CENTER FOR INQUIRY WEST
HINARI	PARENTORGANIZATION	WORLD HEALTH ORGANIZATION
GENE SISKEL FILM CENTER	PARENTORGANIZATION	SCHOOL OF THE ART INSTITUTE OF CHICAGO
GAMBLING COMMISSION	PARENTORGANIZATION	DEPARTMENT FOR CULTURE, MEDIA AND SPORT
IT@SCHOOL PROJECT	PARENTORGANIZATION	DEPARTMENT OF GENERAL AND HIGHER EDUCATION
COAL AUTHORITY	PARENTORGANIZATION	DEPARTMENT OF ENERGY AND CLIMATE CHANGE
TRANS-EUROPEAN DIVISION OF SEVENTH-DAY ADVENTISTS	PARENTORGANIZATION	GENERAL CONFERENCE OF SEVENTH-DAY ADVENTISTS
YALE SUSTAINABLE FOOD PROJECT	PARENTORGANIZATION	YALE UNIVERSITY
CHINESE CHESS ASSOCIATION	PARENTORGANIZATION	ZHONGGUO QIYUAN
GENERAL UNION OF PALESTINIAN WOMEN	PARENTORGANIZATION	PALESTINE LIBERATION ORGANIZATION
GERMAN AGENCY FOR QUALITY IN MEDICINE	PARENTORGANIZATION	GERMAN MEDICAL ASSOCIATION & NAT. ASS. FOR STATUTORY HEALTH INSURANCE PHYSICIANS
CYCLE ACTION AUCKLAND	PARENTORGANIZATION	CYCLING ADVOCATES' NETWORK
UNIVERSITY COLLEGE OPERA	PARENTORGANIZATION	UNIVERSITY COLLEGE LONDON UNION
PENNIES FOR PEACE	PARENTORGANIZATION	CENTRAL ASIA INSTITUTE
INTERNATIONAL SWAMINARAYAN SATSANG ORGANISATION	PARENTORGANIZATION	NARNARAYAN DEV GADI
ISSO SEVA	PARENTORGANIZATION	ISSO
INTERNATIONAL ASSOCIATION OF GEOMAGNETISM AND AERONOMY	PARENTORGANIZATION	INTERNATIONAL UNION OF GEODESY AND GEOPHYSICS
BASEBALL FEDERATION OF ASIA	PARENTORGANIZATION	INTERNATIONAL BASEBALL FEDERATION
AFRICAN BASEBALL & SOFTBALL ASSOCIATION	PARENTORGANIZATION	INTERNATIONAL BASEBALL FEDERATION
NARNARAYAN DEV YUVAK MANDAL	PARENTORGANIZATION	NARNARAYAN DEV GADI
ILLINOIS LEGISLATIVE BLACK CAUCUS	PARENTORGANIZATION	NATIONAL BLACK CAUCUS OF STATE LEGISLATORS
MATHS, STATS & OR NETWORK	PARENTORGANIZATION	HIGHER EDUCATION ACADEMY
BERLIN-BRANDENBURG ACADEMY OF SCIENCES AND HUMANITIES	PARENTORGANIZATION	GERMAN ACADEMY OF SCIENCES LEOPOLDINA
SWISS RED CROSS	PARENTORGANIZATION	INTERNATIONAL FEDERATION OF RED CROSS AND RED CRESCENT SOCIETIES
LEADERSHIP FOUNDATION FOR HIGHER EDUCATION	PARENTORGANIZATION	UNIVERSITIES UK, GUILDHE
JOHANNITER-UNFALL-HILFE	PARENTORGANIZATION	ORDER OF SAINT JOHN
UK COMMISSION FOR EMPLOYMENT AND SKILLS	PARENTORGANIZATION	DEPARTMENT FOR BUSINESS, INNOVATION AND SKILLS
UK COMMISSION FOR EMPLOYMENT AND SKILLS	PARENTORGANIZATION	DEPARTMENT FOR WORK AND PENSIONS
UK COMMISSION FOR EMPLOYMENT AND SKILLS	PARENTORGANIZATION	DEPARTMENT FOR EDUCATION
UK COMMISSION FOR EMPLOYMENT AND SKILLS	PARENTORGANIZATION	DEPARTMENT FOR EMPLOYMENT AND LEARNING
MIDLAND EXAMINING GROUP	PARENTORGANIZATION	UCLES
COMITé INTERNATIONAL DE ROLLER IN-LINE HOCKEY	PARENTORGANIZATION	FéDéRATION INTERNATIONALE DE ROLLER SPORTS
MEXICAN INSTITUTE OF PETROLEUM	PARENTORGANIZATION	SECRETARIAT OF ENERGY
SAARLAND FOOTBALL ASSOCIATION	PARENTORGANIZATION	GERMAN FOOTBALL ASSOCIATION
INTERNATIONAL UNION OF IMMUNOLOGICAL SOCIETIES	PARENTORGANIZATION	INTERNATIONAL COUNCIL FOR SCIENCE
PAULIST NATIONAL CATHOLIC EVANGELIZATION ASSOCIATION	PARENTORGANIZATION	PAULIST FATHERS
CUSTODY OF THE HOLY LAND	PARENTORGANIZATION	ORDER OF FRIARS MINOR
INTERNATIONAL ASSOCIATION OF HYDROLOGICAL SCIENCES	PARENTORGANIZATION	INTERNATIONAL UNION OF GEODESY AND GEOPHYSICS
PRESBYTERY OF NEW BRUNSWICK	PARENTORGANIZATION	SYNOD OF THE NORTHEAST
BUREAUCRASH	PARENTORGANIZATION	COMPETITIVE ENTERPRISE INSTITUTE
UPPSALA CONFLICT DATA PROGRAM	PARENTORGANIZATION	DEPARTMENT OF PEACE AND CONFLICT RESEARCH, AT UPPSALA UNIVERSITY
PROJECT LINGUA	PARENTORGANIZATION	GLOBAL VOICES ONLINE
SCIENTIFIC COMMITTEE ON PROBLEMS OF THE ENVIRONMENT	PARENTORGANIZATION	INTERNATIONAL COUNCIL FOR SCIENCE
ACADEMIA COLOMBIANA DE LA LENGUA	PARENTORGANIZATION	REAL ACADEMIA ESPAñOLA
COMMUNITY LIVING ONTARIO	PARENTORGANIZATION	CANADIAN ASSOCIATION FOR COMMUNITY LIVING
RICHMOND BOYS CHOIR	PARENTORGANIZATION	THEATRE IV AND BOYS & GIRLS CLUBS OF AMERICA
MAX PLANCK INSTITUTE OF PSYCHIATRY	PARENTORGANIZATION	MAX PLANCK SOCIETY
OSINFORM INFORMATION AGENCY	PARENTORGANIZATION	SOUTH OSSETIAN TELEVISION AND RADIO BROADCASTING COMPANY \
MISSION SCIENCE DIVISION	PARENTORGANIZATION	EUROPEAN SPACE AGENCY
IDSC	PARENTORGANIZATION	
ZAMBOANGA DEL SUR – PAGADIAN F.A.	PARENTORGANIZATION	PHILIPPINE FOOTBALL FEDERATION
DAVAO F.A.	PARENTORGANIZATION	PHILIPPINE FOOTBALL FEDERATION
FEDERATED F.A. OF MASBATE	PARENTORGANIZATION	PHILIPPINE FOOTBALL FEDERATION
CEBU F.A.	PARENTORGANIZATION	PHILIPPINE FOOTBALL FEDERATION
QUEZON F.A.	PARENTORGANIZATION	PHILIPPINE FOOTBALL FEDERATION
UNIVERSITY OF WINDSOR STUDENTS' ALLIANCE	PARENTORGANIZATION	UNIVERSITY OF WINDSOR
BRITISH OCEANOGRAPHIC DATA CENTRE	PARENTORGANIZATION	NATURAL ENVIRONMENT RESEARCH COUNCIL
ALLIANCE FOR OPEN SOCIETY INTERNATIONAL	PARENTORGANIZATION	OPEN SOCIETY FOUNDATIONS
STUDENT ADVISORY COUNCIL	PARENTORGANIZATION	GEORGIA BOARD OF REGENTS
CROATIAN BISHOPS' CONFERENCE	PARENTORGANIZATION	HOLY SEE
CANADIAN FEDERATION OF UNIVERSITY WOMEN	PARENTORGANIZATION	INTERNATIONAL FEDERATION OF UNIVERSITY WOMEN
MORAL WELFARE WORKERS' ASSOCIATION	PARENTORGANIZATION	STANDING CONFERENCE OF ORGANISATIONS OF SOCIAL WORKERS
WASHINGTON STATE GUARD	PARENTORGANIZATION	WASHINGTON MILITARY DEPARTMENT
UNICEF	PARENTORGANIZATION	UNITED NATIONS ECONOMIC AND SOCIAL COUNCIL
NORTHUMBRIA UNIVERSITY PRESS	PARENTORGANIZATION	NORTHUMBRIA UNIVERSITY
DEPARTMENT OF PLANT SCIENCES, UNIVERSITY OF OXFORD	PARENTORGANIZATION	UNIVERSITY OF OXFORD
WILTSHIRE LIBRARY AND INFORMATION SERVICE	PARENTORGANIZATION	WILTSHIRE COUNCIL
FéDéRATION DES ASSOCIATIONS éTUDIANTES DU CAMPUS DE L'UNIVERSITé DE MONTRéAL	PARENTORGANIZATION	UNIVERSITé DE MONTRéAL
CANADIAN SOCIETY FOR THE STUDY OF RHETORIC	PARENTORGANIZATION	INTERNATIONAL SOCIETY FOR THE HISTORY OF RHETORIC
COUNCIL OF OSTEOPATHIC STUDENT GOVERNMENT PRESIDENTS	PARENTORGANIZATION	AMERICAN ASSOCIATION OF COLLEGES OF OSTEOPATHIC MEDICINE
MANITOBA BAR ASSOCIATION	PARENTORGANIZATION	CANADIAN BAR ASSOCIATION
BT RESEARCH	PARENTORGANIZATION	BT GROUP
NORWEGIAN CENTRE FOR VIOLENCE AND TRAUMATIC STRESS STUDIES	PARENTORGANIZATION	UNIVERSITY OF OSLO
OFFICE OF THE PRESIDENT-ELECT	PARENTORGANIZATION	GENERAL SERVICES ADMINISTRATION
EUROPEAN COUNCIL OF RELIGIOUS LEADERS	PARENTORGANIZATION	RELIGIONS FOR PEACE
NORWEGIAN SOCIAL RESEARCH	PARENTORGANIZATION	OSLO AND AKERSHUS UNIVERSITY COLLEGE
COALITION FOR NETWORKED INFORMATION	PARENTORGANIZATION	ASSOCIATION OF RESEARCH LIBRARIES
COALITION FOR NETWORKED INFORMATION	PARENTORGANIZATION	EDUCAUSE
RAMAKRISHNA-VIVEKANANDA CENTER	PARENTORGANIZATION	RAMAKRISHNA MISSION
UNIVERSITY OF GLASGOW SCHOOL OF LAW	PARENTORGANIZATION	UNIVERSITY OF GLASGOW
BEDFORDSHIRE AND LUTON ARCHIVES AND RECORDS SERVICE	PARENTORGANIZATION	BEDFORD BOROUGH COUNCILCENTRAL BEDFORDSHIRE COUNCILLUTON BOROUGH COUNCIL
FRONT YARDS IN BLOOM	PARENTORGANIZATION	EHS, CITY OF EDMONTON
LEFT WING SECTION OF THE SOCIALIST PARTY	PARENTORGANIZATION	SOCIALIST PARTY OF AMERICA
FERA SCIENCE	PARENTORGANIZATION	CAPITA
FERA SCIENCE	PARENTORGANIZATION	DEPARTMENT FOR ENVIRONMENT, FOOD AND RURAL AFFAIRS
YOUNG GREENS OF GREECE	PARENTORGANIZATION	FEDERATION OF YOUNG EUROPEAN GREENS
PARTNERSHIPS IN ENVIRONMENTAL MANAGEMENT FOR THE SEAS OF EAST ASIA	PARENTORGANIZATION	UNDP
PARTNERSHIPS IN ENVIRONMENTAL MANAGEMENT FOR THE SEAS OF EAST ASIA	PARENTORGANIZATION	UNOPS
UNITED ISRAEL APPEAL	PARENTORGANIZATION	JEWISH FEDERATIONS OF NORTH AMERICA
VENEZUELA INFORMATION OFFICE	PARENTORGANIZATION	EMBASSY OF VENEZUELA, WASHINGTON, D.C.
UNITED NATIONS MINE ACTION SERVICE	PARENTORGANIZATION	UNITED NATIONS
GERMAN SKI ASSOCIATION	PARENTORGANIZATION	INTERNATIONAL SKI FEDERATION
ARPA-E	PARENTORGANIZATION	UNITED STATES DEPARTMENT OF ENERGY
GLASGOW UNIVERSITY CONSERVATIVE ASSOCIATION	PARENTORGANIZATION	UNIVERSITY OF GLASGOW
CINCY BLUES FEST	PARENTORGANIZATION	CINCYBLUES.ORG
MAX PLANCK INSTITUTE FOR BIOLOGY OF AGEING	PARENTORGANIZATION	MAX PLANCK SOCIETY
INTERNATIONAL ASSOCIATION OF CRYOSPHERIC SCIENCES	PARENTORGANIZATION	INTERNATIONAL UNION OF GEODESY AND GEOPHYSICS
PATRIARCHIAL PARISHES IN CANADA	PARENTORGANIZATION	MOSCOW PATRIARCHATE
ECOLOGICAL SANITATION RESEARCH PROGRAMME	PARENTORGANIZATION	STOCKHOLM ENVIRONMENT INSTITUTE
CENSUS OF DIVERSITY OF ABYSSAL MARINE LIFE	PARENTORGANIZATION	CENSUS OF MARINE LIFE
CENSUS OF ANTARCTIC MARINE LIFE	PARENTORGANIZATION	CENSUS OF MARINE LIFE
CENSUS OF CORAL REEFS	PARENTORGANIZATION	CENSUS OF MARINE LIFE
CENSUS OF MARINE ZOOPLANKTON	PARENTORGANIZATION	CENSUS OF MARINE LIFE
SOUTHERN ASIA-PACIFIC DIVISION OF SEVENTH-DAY ADVENTISTS	PARENTORGANIZATION	GENERAL CONFERENCE OF SEVENTH-DAY ADVENTISTS
BRITISH COLUMBIA SOCCER ASSOCIATION	PARENTORGANIZATION	CANADIAN SOCCER ASSOCIATION
INTERNATIONAL CENTER FOR THE HISTORY OF ELECTRONIC GAMES	PARENTORGANIZATION	THE STRONG
UNITED NATIONS REDD PROGRAMME	PARENTORGANIZATION	FOOD AND AGRICULTURE ORGANIZATION
UNITED NATIONS REDD PROGRAMME	PARENTORGANIZATION	UNITED NATIONS DEVELOPMENT PROGRAMME
UNITED NATIONS REDD PROGRAMME	PARENTORGANIZATION	UNITED NATIONS ENVIRONMENT PROGRAMME
WASHINGTON FEDERATION OF INDEPENDENT SCHOOLS	PARENTORGANIZATION	COUNCIL OF AMERICAN PRIVATE EDUCATION
IRISH UNIVERSITIES FOOTBALL UNION	PARENTORGANIZATION	FOOTBALL ASSOCIATION OF IRELAND
EAST MIDLANDS DEVELOPMENT AGENCY	PARENTORGANIZATION	DEPARTMENT FOR BUSINESS, INNOVATION AND SKILLS
HIGHWAYS ENGLAND TRAFFIC OFFICER SERVICE	PARENTORGANIZATION	HIGHWAYS ENGLAND
CONSERVATOIRE DE MUSIQUE DU QUéBEC à MONTRéAL	PARENTORGANIZATION	CONSERVATOIRE DE MUSIQUE ET D'ART DRAMATIQUE DU QUéBEC
NATIONAL INSTITUTE FOR BIOLOGICAL STANDARDS AND CONTROL	PARENTORGANIZATION	MEDICINES AND HEALTHCARE PRODUCTS REGULATORY AGENCY
INTERNATIONAL BRAIN RESEARCH ORGANIZATION	PARENTORGANIZATION	INTERNATIONAL COUNCIL FOR SCIENCE
INTERNATIONAL COMMITTEE OF ARCHITECTURAL CRITICS	PARENTORGANIZATION	INTERNATIONAL UNION OF ARCHITECTS
IEEE TECHNOLOGY AND ENGINEERING MANAGEMENT SOCIETY	PARENTORGANIZATION	INSTITUTE OF ELECTRICAL AND ELECTRONIC ENGINEERS
INTERNATIONAL NUCLEAR LIBRARY NETWORK	PARENTORGANIZATION	IAEA
CONGREGATION OF JESUS	PARENTORGANIZATION	ROMAN CATHOLIC CHURCH
CENTER FOR THE STUDY OF SOUTHERN CULTURE	PARENTORGANIZATION	UNIVERSITY OF MISSISSIPPI
GOVERNMENT FINANCE OFFICERS ASSOCIATION OF TEXAS	PARENTORGANIZATION	GOVERNMENT FINANCE OFFICERS ASSOCIATION
YOUNG MUSLIM ADVISORY GROUP	PARENTORGANIZATION	COMMUNITIES AND LOCAL GOVERNMENT
SOUTH AMERICAN DIVISION OF SEVENTH-DAY ADVENTISTS	PARENTORGANIZATION	GENERAL CONFERENCE OF SEVENTH-DAY ADVENTISTS
WEST-CENTRAL AFRICA DIVISION OF SEVENTH-DAY ADVENTISTS	PARENTORGANIZATION	GENERAL CONFERENCE OF SEVENTH-DAY ADVENTISTS
PROJECT ADVANCE	PARENTORGANIZATION	SYRACUSE UNIVERSITY
BBC MOTION GALLERY	PARENTORGANIZATION	BBC WORLDWIDE
PROJECT C.U.R.E.	PARENTORGANIZATION	BENEVOLENT HEALTHCARE FOUNDATION
CENTER FOR STUDIES AND RESEARCH IN AERONAUTICAL MEDICINE	PARENTORGANIZATION	ITALIAN AIR FORCE
SPACE INNOVATION AND GROWTH TEAM	PARENTORGANIZATION	DEPARTMENT FOR BUSINESS, INNOVATION AND SKILLS
INSTITUTE OF GENOMICS AND INTEGRATIVE BIOLOGY	PARENTORGANIZATION	COUNCIL OF SCIENTIFIC AND INDUSTRIAL RESEARCH
NATIONAL NUCLEAR ENERGY COMMISSION	PARENTORGANIZATION	MINISTRY OF SCIENCE AND TECHNOLOGY
DESIGN FACTORY	PARENTORGANIZATION	AALTO UNIVERSITY
HELLENIC CIVIL AVIATION AUTHORITY	PARENTORGANIZATION	MINISTRY OF INFRASTRUCTURE, TRANSPORT AND NETWORKS
IGNATIAN CENTER FOR JESUIT EDUCATION	PARENTORGANIZATION	SANTA CLARA UNIVERSITY
ARCHAEOLOGY DATA SERVICE	PARENTORGANIZATION	UNIVERSITY OF YORK
KONINKLIJKE NEDERLANDSE BASEBALL EN SOFTBALL BOND	PARENTORGANIZATION	CONFEDERATION OF EUROPEAN BASEBALL
LUXEMBOURG RED CROSS	PARENTORGANIZATION	INTERNATIONAL FEDERATION OF RED CROSS AND RED CRESCENT SOCIETIES
CENTRAL COMMITTEE OF GERMAN CATHOLICS	PARENTORGANIZATION	CATHOLIC CHURCH
CHINESE NUCLEAR SOCIETY	PARENTORGANIZATION	CHINA ASSOCIATION FOR SCIENCE AND TECHNOLOGY
GLOBAL GAME JAM	PARENTORGANIZATION	GLOBAL GAME JAM, INC.
PAKISTAN YOUTH HOSTELS ASSOCIATION	PARENTORGANIZATION	HOSTELLING INTERNATIONAL
WORLD BANK'S INSPECTION PANEL	PARENTORGANIZATION	INTERNATIONAL DEVELOPMENT ASSOCIATION
WORLD BANK'S INSPECTION PANEL	PARENTORGANIZATION	IBRD
UNIVERSITY WOMEN'S CLUB OF TORONTO	PARENTORGANIZATION	CANADIAN FEDERATION OF UNIVERSITY WOMEN
EUROPEAN RACQUETBALL FEDERATION	PARENTORGANIZATION	INTERNATIONAL RACQUETBALL FEDERATION
HERITAGE TRUST FOR THE NORTH WEST	PARENTORGANIZATION	ENGLISH HERITAGE
UNIVERSITY OF BRISTOL SOCIETY OF CHANGE RINGERS	PARENTORGANIZATION	UNIVERSITY OF BRISTOL UNION
ASOM SENA	PARENTORGANIZATION	ALL ASSAM STUDENTS UNION
ORDNANCE SURVEY INTERNATIONAL	PARENTORGANIZATION	ORDNANCE SURVEY
PLATFORM2	PARENTORGANIZATION	CHRISTIAN AID
PLATFORM2	PARENTORGANIZATION	BUNAC
PEOPLE'S CONSULTATIVE GROUP	PARENTORGANIZATION	ULFA
AAA NORTHERN NEW ENGLAND	PARENTORGANIZATION	AMERICAN AUTOMOBILE ASSOCIATION
SANJUKTA MUKTI FOUJ	PARENTORGANIZATION	ULFA
BANK HALL ACTION GROUP	PARENTORGANIZATION	HERITAGE TRUST FOR THE NORTH WEST
PORT AUTHORITY OF JAMAICA	PARENTORGANIZATION	MINISTRY OF TRANSPORT AND WORKS, JAMAICA
CENTRO DE ESTUDIOS CONSERVACIONISTAS	PARENTORGANIZATION	FACULTAD DE CIENCIAS QUíMICAS Y FARMACIA, USAC
INTERNATIONAL SOCIETY FOR PHOTOGRAMMETRY AND REMOTE SENSING	PARENTORGANIZATION	INTERNATIONAL COUNCIL FOR SCIENCE
MUNSTER FOOTBALL ASSOCIATION	PARENTORGANIZATION	FOOTBALL ASSOCIATION OF IRELAND
DOCTORS OF BC	PARENTORGANIZATION	CANADIAN MEDICAL ASSOCIATION
FILM MUSIC GUILD	PARENTORGANIZATION	BIOLA UNIVERSITY
SOUTHEAST ASIAN REGIONAL CENTER FOR GRADUATE STUDY AND RESEARCH IN AGRICULTURE	PARENTORGANIZATION	WWW.SEAMEO.ORG
THE LAW SOCIETY, UNIVERSITY COLLEGE CORK	PARENTORGANIZATION	UNIVERSITY COLLEGE CORK
SPOKES CANTERBURY	PARENTORGANIZATION	CYCLING ADVOCATES' NETWORK
OLYMPIC BROADCASTING SERVICES	PARENTORGANIZATION	INTERNATIONAL OLYMPIC COMMITTEE
CENTER FOR BUSINESS AND ECONOMIC RESEARCH	PARENTORGANIZATION	BALL STATE UNIVERSITY
OREGON HIGH DESERT GROTTO	PARENTORGANIZATION	NATIONAL SPELEOLOGICAL SOCIETY
CHINESE BASKETBALL ASSOCIATION	PARENTORGANIZATION	STATE GENERAL ADMINISTRATION OF SPORTS
FOUNDATION FOR PEOPLE WITH LEARNING DISABILITIES	PARENTORGANIZATION	MENTAL HEALTH FOUNDATION
UNITED KINGDOM ACCREDITATION SERVICE	PARENTORGANIZATION	DEPARTMENT FOR BUSINESS, INNOVATION AND SKILLS
CANADIAN WELDING BUREAU	PARENTORGANIZATION	CWB GROUP - INDUSTRY SERVICES
ALLIANCE RAIL HOLDINGS	PARENTORGANIZATION	ARRIVA UK TRAINS
PRAIRIE METEORITE NETWORK	PARENTORGANIZATION	SMITHSONIAN ASTROPHYSICAL OBSERVATORY
ASIA-OCEANIA FEDERATION OF ORGANIZATIONS FOR MEDICAL PHYSICS	PARENTORGANIZATION	INTERNATIONAL ORGANIZATION FOR MEDICAL PHYSICS
CIVIL RIGHTS LITIGATION CLEARINGHOUSE	PARENTORGANIZATION	UNIVERSITY OF MICHIGAN LAW SCHOOL
INTERNATIONAL UNION FOR PHYSICAL AND ENGINEERING SCIENCES IN MEDICINE	PARENTORGANIZATION	INTERNATIONAL COUNCIL FOR SCIENCE
COLLEGE OF RADIOLOGY, ACADEMY OF MEDICINE MALAYSIA	PARENTORGANIZATION	ACADEMY OF MEDICINE OF MALAYSIA
IAR GRADUATE CONFERENCE	PARENTORGANIZATION	UNIVERSITY OF BRITISH COLUMBIA
BIBLE SOCIETY OF INDIA ANDHRA PRADESH AUXILIARY	PARENTORGANIZATION	BIBLE SOCIETY OF INDIA
FUNCTIONAL FOOD CENTRE AT OXFORD BROOKES UNIVERSITY	PARENTORGANIZATION	OXFORD BROOKES UNIVERSITY
NATIONAL NEIGHBORHOOD WATCH PROGRAM	PARENTORGANIZATION	NATIONAL SHERIFFS' ASSOCIATION
NATIONAL ENERGY COMMISSION	PARENTORGANIZATION	STATE COUNCIL OF THE PEOPLE'S REPUBLIC OF CHINA
MILITANT FACTION	PARENTORGANIZATION	SOCIALIST PARTY OF AMERICA
EUROPEAN NETWORK OF DEMOCRATIC YOUNG LEFT	PARENTORGANIZATION	PARTY OF THE EUROPEAN LEFT
OLD GUARD FACTION	PARENTORGANIZATION	SOCIALIST PARTY OF AMERICA
SMITH SCHOOL OF ENTERPRISE AND THE ENVIRONMENT	PARENTORGANIZATION	UNIVERSITY OF OXFORD
BIRMINGHAM CORPORATION WATER DEPARTMENT	PARENTORGANIZATION	BIRMINGHAM CITY COUNCIL
GOLF ASSOCIATION OF PHILADELPHIA	PARENTORGANIZATION	UNITED STATES GOLF ASSOCIATION
LEINSTER FOOTBALL ASSOCIATION	PARENTORGANIZATION	FOOTBALL ASSOCIATION OF IRELAND
BADGER BOYS STATE	PARENTORGANIZATION	AMERICAN LEGION
KILGORE COLLEGE RANGERETTES	PARENTORGANIZATION	KILGORE COLLEGE
MAX PLANCK INSTITUTE FOR COMPARATIVE PUBLIC LAW AND INTERNATIONAL LAW	PARENTORGANIZATION	MAX PLANCK SOCIETY
CONSERVATOIRE DE MUSIQUE DU QUéBEC à QUéBEC	PARENTORGANIZATION	CONSERVATOIRE DE MUSIQUE ET D'ART DRAMATIQUE DU QUéBEC
CONSERVATOIRE DE MUSIQUE DU QUéBEC à TROIS-RIVIèRES	PARENTORGANIZATION	CONSERVATOIRE DE MUSIQUE ET D'ART DRAMATIQUE DU QUéBEC
UK SPACE AGENCY	PARENTORGANIZATION	DEPARTMENT FOR BUSINESS, INNOVATION AND SKILLS
CYCLING ENGLAND	PARENTORGANIZATION	DEPARTMENT FOR TRANSPORT
POLICE COMPLAINTS COMMISSIONER FOR SCOTLAND	PARENTORGANIZATION	SCOTTISH GOVERNMENT
DISCIPLESHIP MINISTRIES	PARENTORGANIZATION	UNITED METHODIST CHURCH
INDIANA HIGH SCHOOL ATHLETIC ASSOCIATION	PARENTORGANIZATION	NATIONAL FEDERATION OF STATE HIGH SCHOOL ASSOCIATIONS
VIRTUAL USA	PARENTORGANIZATION	UNITED STATES DEPARTMENT OF HOMELAND SECURITY
JOHN S. KNIGHT JOURNALISM FELLOWSHIPS AT STANFORD	PARENTORGANIZATION	STANFORD UNIVERSITY
ARIZONA SOUTHERN BAPTIST CONVENTION	PARENTORGANIZATION	SOUTHERN BAPTIST CONVENTION
CENTER FOR INFRASTRUCTURE ASSURANCE AND SECURITY	PARENTORGANIZATION	THE UNIVERSITY OF TEXAS AT SAN ANTONIO
TÜBİTAK SPACE TECHNOLOGIES RESEARCH INSTITUTE	PARENTORGANIZATION	SCIENTIFIC AND TECHNOLOGICAL RESEARCH COUNCIL OF TURKEY
EUROPEAN FIREBALL NETWORK	PARENTORGANIZATION	THE GERMAN AEROSPACE CENTER  AND THE INSTITUTE OF PLANETARY RESEARCH IN PRAGUE .
KOREAN E-SPORTS ASSOCIATION	PARENTORGANIZATION	MINISTRY OF CULTURE, SPORTS AND TOURISM
INSTITUTE FOR SPECTROSCOPY RUSSIAN ACADEMY OF SCIENCES	PARENTORGANIZATION	RUSSIAN ACADEMY OF SCIENCES
CHILDREN'S AIR AMBULANCE	PARENTORGANIZATION	AIR AMBULANCE SERVICE
CENTRE FOR CELLULAR AND MOLECULAR PLATFORMS	PARENTORGANIZATION	DEPARTMENT OF BIOTECHNOLOGY
CENTRE FOR CELLULAR AND MOLECULAR PLATFORMS	PARENTORGANIZATION	INDIA
DIVISION OF SIGNAL TRANSDUCTION THERAPY	PARENTORGANIZATION	UNIVERSITY OF DUNDEE
HAPKIDOWON	PARENTORGANIZATION	KOREAN MARTIAL ARTS
INTERNATIONAL SOCIETY FOR ECOLOGICAL ECONOMICS	PARENTORGANIZATION	INTERNATIONAL SOCIAL SCIENCE COUNCIL
ATLANTIC JEWISH COUNCIL	PARENTORGANIZATION	CENTRE FOR ISRAEL AND JEWISH AFFAIRS
ATLANTIC JEWISH COUNCIL	PARENTORGANIZATION	CANADIAN JEWISH CONGRESS
DIVISION OF INTERNATIONAL LABOR COMPARISONS	PARENTORGANIZATION	BUREAU OF LABOR STATISTICS
THINK TANKS AND CIVIL SOCIETIES PROGRAM	PARENTORGANIZATION	THE LAUDER INSTITUTE, THE UNIVERSITY OF PENNSYLVANIA
HEALTHLINKBC	PARENTORGANIZATION	MINISTRY OF HEALTH
COLONIAL LEAGUE	PARENTORGANIZATION	PENNSYLVANIA INTERSCHOLASTIC ATHLETIC ASSOCIATION
PACIFIC SOUTHWEST CHAPTER OF THE NATIONAL TELEVISION ACADEMY	PARENTORGANIZATION	NATIONAL ACADEMY OF TELEVISION ARTS AND SCIENCES
CYPRUS SAFER INTERNET HOTLINE	PARENTORGANIZATION	CYPRUS NEUROSCIENCE AND TECHNOLOGY INSTITUTE
CYPRUS SAFER INTERNET HELPLINE	PARENTORGANIZATION	CYPRUS NEUROSCIENCE AND TECHNOLOGY INSTITUTE
ISRAEL PHILHARMONIC ORCHESTRA FOUNDATION	PARENTORGANIZATION	ISRAEL PHILHARMONIC ORCHESTRA
ILMIN INTERNATIONAL RELATIONS INSTITUTE	PARENTORGANIZATION	KOREA UNIVERSITY
CHINESE ARCTIC AND ANTARCTIC ADMINISTRATION	PARENTORGANIZATION	STATE OCEANIC ADMINISTRATION
OFFICE OF INSPECTOR GENERAL, U.S. AGENCY FOR INTERNATIONAL DEVELOPMENT	PARENTORGANIZATION	UNITED STATES AGENCY FOR INTERNATIONAL DEVELOPMENT
INDEX: DESIGN TO IMPROVE LIFE	PARENTORGANIZATION	DANISH DESIGN CENTRE
INTERNATIONAL HUMAN DIMENSIONS PROGRAMME	PARENTORGANIZATION	INTERNATIONAL SOCIAL SCIENCE COUNCIL
MARINE CONSERVATION SOCIETY SOUTH EAST GROUP	PARENTORGANIZATION	MARINE CONSERVATION SOCIETY
OXFORD POVERTY AND HUMAN DEVELOPMENT INITIATIVE	PARENTORGANIZATION	OXFORD DEPARTMENT OF INTERNATIONAL DEVELOPMENT
ARAB LEAGUE EDUCATIONAL, CULTURAL AND SCIENTIFIC ORGANIZATION	PARENTORGANIZATION	ARAB LEAGUE
HELLENIC RED CROSS	PARENTORGANIZATION	INTERNATIONAL FEDERATION OF RED CROSS AND RED CRESCENT SOCIETIES
INTERNATIONAL COMMISSION ON THE HISTORY OF GEOLOGICAL SCIENCES	PARENTORGANIZATION	INTERNATIONAL UNION OF GEOLOGICAL SCIENCES
MICROSOFT INNOVATION CENTER	PARENTORGANIZATION	MICROSOFT
YOUNG PEOPLE'S LEARNING AGENCY	PARENTORGANIZATION	DEPARTMENT FOR EDUCATION
NORTH KOREA INTERNATIONAL DOCUMENTATION PROJECT	PARENTORGANIZATION	WOODROW WILSON INTERNATIONAL CENTER FOR SCHOLARS
THE OWYHEE AVALANCHE	PARENTORGANIZATION	OWYHEE PUBLISHING
NORTH CAROLINA SCIENCE FESTIVAL	PARENTORGANIZATION	MOREHEAD PLANETARIUM AND SCIENCE CENTER, UNIVERSITY OF NORTH CAROLINA AT CHAPEL HILL
NATIONAL INSTITUTE ON MINORITY HEALTH AND HEALTH DISPARITIES	PARENTORGANIZATION	NATIONAL INSTITUTES OF HEALTH
SIR RONALD ROSS INSTITUTE OF PARASITOLOGY	PARENTORGANIZATION	OSMANIA UNIVERSITY
ABU DHABI AUTHORITY FOR CULTURE & HERITAGE	PARENTORGANIZATION	ABU DHABI CULTURAL FOUNDATION
WILDLIFE RESERVES SINGAPORE	PARENTORGANIZATION	TEMASEK HOLDINGS
ASSURED FOOD STANDARDS	PARENTORGANIZATION	NATIONAL FARMERS UNION OF ENGLAND AND WALES
PORTA CARIBE	PARENTORGANIZATION	PUERTO RICO TOURISM COMPANY
NATIONAL ACADEMY FOR PRISONS ADMINISTRATION	PARENTORGANIZATION	MINISTRY OF INTERIOR
OXFORD MARTIN SCHOOL	PARENTORGANIZATION	UNIVERSITY OF OXFORD
ASIA-PACIFIC RUGBY LEAGUE CONFEDERATION	PARENTORGANIZATION	RLIF
CATHOLIC BISHOPS' CONFERENCE OF NIGERIA	PARENTORGANIZATION	CATHOLIC CHURCH
SMART ALLIANCE	PARENTORGANIZATION	ASEAN
UPPER MIDWEST PREPAREDNESS AND EMERGENCY RESPONSE LEARNING CENTER	PARENTORGANIZATION	UNIVERSITY OF IOWA COLLEGE OF PUBLIC HEALTH
MARITIME SAFETY AND RESCUE SOCIETY	PARENTORGANIZATION	MINISTERIO DE FOMENTO
MARITIME SAFETY AND RESCUE SOCIETY	PARENTORGANIZATION	DIRECCIóN GENERAL DE LA MARINA MERCANTE
BRITISH ASSOCIATION OF ORAL AND MAXILLOFACIAL SURGEONS	PARENTORGANIZATION	ROYAL COLLEGE OF SURGEONS OF ENGLAND
INTERNATIONAL CONSORTIUM OF INVESTIGATIVE JOURNALISTS	PARENTORGANIZATION	CENTER FOR PUBLIC INTEGRITY
SOCIETY OF BRITISH NEUROLOGICAL SURGEONS	PARENTORGANIZATION	ROYAL COLLEGE OF SURGEONS OF ENGLAND
INTERNATIONAL COUNCIL FOR TRADITIONAL MUSIC	PARENTORGANIZATION	UNESCO
INTERNATIONAL UNION OF THEORETICAL AND APPLIED MECHANICS	PARENTORGANIZATION	INTERNATIONAL COUNCIL FOR SCIENCE
IRAN CIVIL AVIATION ORGANIZATION	PARENTORGANIZATION	*IRANIAN AIRPORTS HOLDING COMPANY\N*
IRAN CIVIL AVIATION ORGANIZATION	PARENTORGANIZATION	MINISTRY OF ROADS AND TRANSPORTATION
YOUTH AGAINST THE EU	PARENTORGANIZATION	NEI TIL EU
KOREA BASKETBALL ASSOCIATION	PARENTORGANIZATION	KOREAN OLYMPIC COMMITTEE
NATIONAL CENTER FOR ADVANCING TRANSLATIONAL SCIENCES	PARENTORGANIZATION	NATIONAL INSTITUTES OF HEALTH
FRIENDS OF FIVE CREEKS	PARENTORGANIZATION	BERKELEY PARTNERS FOR PARKS
PRIATELIA ZEME – SPZ	PARENTORGANIZATION	FRIENDS OF THE EARTH INTERNATIONAL
CONSERVATIVE CAMPAIGN HEADQUARTERS	PARENTORGANIZATION	CONSERVATIVE PARTY
NATIONAL INSTITUTE FOR SPACE RESEARCH	PARENTORGANIZATION	MINISTRY OF SCIENCE AND TECHNOLOGY
THE 2.0 ADOPTION COUNCIL	PARENTORGANIZATION	WWW.DACHISGROUP.COM
NEW MEXICO ASSOCIATION OF STUDENT COUNCILS	PARENTORGANIZATION	NEW MEXICO ASSOCIATION OF SECONDARY PRINCIPALS
NEW MEXICO ASSOCIATION OF STUDENT COUNCILS	PARENTORGANIZATION	NEW MEXICO ACTIVITIES ASSOCIATION
EASTERN SUDAN STATES COORDINATING COUNCIL	PARENTORGANIZATION	GOVERNMENT OF SUDAN
4-H SHOOTING SPORTS PROGRAMS	PARENTORGANIZATION	UNITED STATES DEPARTMENT OF AGRICULTURE
MISSOURI BOYS STATE	PARENTORGANIZATION	AMERICAN LEGION
INSTITUTE OF SWIMMING	PARENTORGANIZATION	AMATEUR SWIMMING ASSOCIATION
LILLIAN BOOTH ACTORS HOME	PARENTORGANIZATION	ACTORS FUND
PEN CENTER USA	PARENTORGANIZATION	INTERNATIONAL PEN
THE CYPRUS INSTITUTE OF NEUROLOGY AND GENETICS	PARENTORGANIZATION	THE CYPRUS FOUNDATION FOR MUSCULAR DYSTROPHY RESEARCH
WISCONSIN SENATE, DISTRICT 25	PARENTORGANIZATION	WISCONSIN LEGISLATURE
YALE WORLD FELLOWS	PARENTORGANIZATION	YALE UNIVERSITY
WISCONSIN SENATE, DISTRICT 29	PARENTORGANIZATION	WISCONSIN LEGISLATURE
GA²LEN	PARENTORGANIZATION	EUROPEAN UNION
WISCONSIN SENATE, DISTRICT 1	PARENTORGANIZATION	WISCONSIN LEGISLATURE
WISCONSIN SENATE, DISTRICT 2	PARENTORGANIZATION	WISCONSIN LEGISLATURE
WISCONSIN SENATE, DISTRICT 3	PARENTORGANIZATION	WISCONSIN LEGISLATURE
WISCONSIN SENATE, DISTRICT 4	PARENTORGANIZATION	WISCONSIN LEGISLATURE
WISCONSIN SENATE, DISTRICT 5	PARENTORGANIZATION	WISCONSIN LEGISLATURE
WISCONSIN SENATE, DISTRICT 6	PARENTORGANIZATION	WISCONSIN LEGISLATURE
WISCONSIN SENATE, DISTRICT 7	PARENTORGANIZATION	WISCONSIN LEGISLATURE
WISCONSIN SENATE, DISTRICT 8	PARENTORGANIZATION	WISCONSIN LEGISLATURE
WISCONSIN SENATE, DISTRICT 9	PARENTORGANIZATION	WISCONSIN LEGISLATURE
WISCONSIN SENATE, DISTRICT 10	PARENTORGANIZATION	WISCONSIN LEGISLATURE
WISCONSIN SENATE, DISTRICT 11	PARENTORGANIZATION	WISCONSIN LEGISLATURE
WISCONSIN SENATE, DISTRICT 12	PARENTORGANIZATION	WISCONSIN LEGISLATURE
WISCONSIN SENATE, DISTRICT 31	PARENTORGANIZATION	WISCONSIN LEGISLATURE
SPECTRUM CENTER	PARENTORGANIZATION	UNIVERSITY OF MICHIGAN
IRRIGATED RICE RESEARCH CONSORTIUM	PARENTORGANIZATION	INTERNATIONAL RICE RESEARCH INSTITUTE
INTERNATIONAL UNION OF PSYCHOLOGICAL SCIENCE	PARENTORGANIZATION	INTERNATIONAL COUNCIL FOR SCIENCE
WOLVERHAMPTON HOMES	PARENTORGANIZATION	WOLVERHAMPTON CITY COUNCIL
NIPPON BASS CLUB	PARENTORGANIZATION	JAPAN BASS PRO ASSOCIATION
RIDEAU RIVER RESIDENCE ASSOCIATION	PARENTORGANIZATION	CARLETON UNIVERSITY
OPEN VIRTUALIZATION ALLIANCE	PARENTORGANIZATION	LINUX FOUNDATION
LEADING GROUP FOR FINANCIAL AND ECONOMIC AFFAIRS	PARENTORGANIZATION	CENTRAL COMMITTEE OF THE COMMUNIST PARTY OF CHINA
NATIONAL DEFENSE MOBILIZATION COMMISSION	PARENTORGANIZATION	STATE COUNCIL OF THE PEOPLE'S REPUBLIC OF CHINA
NATIONAL DEFENSE MOBILIZATION COMMISSION	PARENTORGANIZATION	CENTRAL MILITARY COMMISSION
CENTRAL INSTITUTIONAL ORGANIZATION COMMISSION	PARENTORGANIZATION	CENTRAL COMMITTEE OF THE COMMUNIST PARTY OF CHINA
GENERAL OFFICE OF THE COMMUNIST PARTY OF CHINA	PARENTORGANIZATION	CENTRAL COMMITTEE OF THE COMMUNIST PARTY OF CHINA
INTERNATIONAL LIAISON DEPARTMENT OF THE COMMUNIST PARTY OF CHINA	PARENTORGANIZATION	CENTRAL COMMITTEE OF THE COMMUNIST PARTY OF CHINA
AKHIL BHARATIYA ITIHAS SANKALAN YOJANA	PARENTORGANIZATION	RASHTRIYA SWAYAMSEVAK SANGH
YOUNG PEOPLE'S FRONT FOR DEMOCRACY AND JUSTICE	PARENTORGANIZATION	PEOPLE'S FRONT FOR DEMOCRACY AND JUSTICE
ENERGY SECTOR MANAGEMENT ASSISTANCE PROGRAM	PARENTORGANIZATION	THE WORLD BANK
INTERNATIONAL ETHICS STANDARDS BOARD FOR ACCOUNTANTS	PARENTORGANIZATION	INTERNATIONAL FEDERATION OF ACCOUNTANTS
HARVARD INSTITUTE FOR INTERNATIONAL DEVELOPMENT	PARENTORGANIZATION	HARVARD UNIVERSITY
GAA HANDBALL	PARENTORGANIZATION	THE GAELIC ATHLETIC ASSOCIATION
NATIONAL ARCHIVES	PARENTORGANIZATION	MINISTRY OF PRESIDENTIAL AFFAIRS
MRC HUMAN NUTRITION RESEARCH	PARENTORGANIZATION	MEDICAL RESEARCH COUNCIL
WISCONSIN SENATE, DISTRICT 13	PARENTORGANIZATION	WISCONSIN LEGISLATURE
YOUTH PARLIAMENT	PARENTORGANIZATION	HELLENIC PARLIAMENT
CENTRAL LEADING GROUP FOR TAIWAN AFFAIRS	PARENTORGANIZATION	CENTRAL COMMITTEE OF THE COMMUNIST PARTY OF CHINA
CHINESE ACADEMY OF FISHERY SCIENCES	PARENTORGANIZATION	MINISTRY OF AGRICULTURE OF THE PEOPLE'S REPUBLIC OF CHINA
BAVARIAN FOOTBALL ASSOCIATION	PARENTORGANIZATION	GERMAN FOOTBALL ASSOCIATION
HESSIAN FOOTBALL ASSOCIATION	PARENTORGANIZATION	GERMAN FOOTBALL ASSOCIATION
BADEN FOOTBALL ASSOCIATION	PARENTORGANIZATION	GERMAN FOOTBALL ASSOCIATION
TONAWANDA ENGINE	PARENTORGANIZATION	GENERAL MOTORS
ENGINEERS WITHOUT BORDERS – LEBANON	PARENTORGANIZATION	EWB-INTERNATIONAL.ORG
WALTHAM CENTRE FOR PET NUTRITION	PARENTORGANIZATION	MARS-PETCARE.ASPX
E-SKILLS UK	PARENTORGANIZATION	UK COMMISSION FOR EMPLOYMENT AND SKILLS
CANADIAN LABOUR DEFENCE LEAGUE	PARENTORGANIZATION	INTERNATIONAL LABOR DEFENSE
AFL EUROPE	PARENTORGANIZATION	AUSTRALIAN FOOTBALL LEAGUE
SYRIAN REVOLUTION GENERAL COMMISSION	PARENTORGANIZATION	SYRIAN OPPOSITION
MINNESOTA SENATE, DISTRICT 60	PARENTORGANIZATION	MINNESOTA LEGISLATURE
GIOVENTù ITALIANA DEL LITTORIO	PARENTORGANIZATION	NATIONAL FASCIST PARTY
SPIRIT OF LONDON AWARDS	PARENTORGANIZATION	DAMILOLA TAYLOR TRUST
INTERNATIONAL UNION OF HISTORY AND PHILOSOPHY OF SCIENCE	PARENTORGANIZATION	INTERNATIONAL COUNCIL FOR SCIENCE
INTERNATIONAL UNION OF SPELEOLOGY	PARENTORGANIZATION	INTERNATIONAL COUNCIL FOR SCIENCE
CENTRO CULTURAL DE PONCE CARMEN SOLá DE PEREIRA	PARENTORGANIZATION	INSTITUTE OF PUERTO RICAN CULTURE
AMERICAN HOTEL & LODGING EDUCATIONAL INSTITUTE	PARENTORGANIZATION	AMERICAN HOTEL AND LODGING ASSOCIATION
CHINESE BADMINTON ASSOCIATION	PARENTORGANIZATION	STATE GENERAL ADMINISTRATION OF SPORTS
CULHAM CENTRE FOR FUSION ENERGY	PARENTORGANIZATION	UNITED KINGDOM ATOMIC ENERGY AUTHORITY
ROYAL ACADEMY OF PERFORMING ARTS	PARENTORGANIZATION	MINISTRY OF HOME AND CULTURAL AFFAIRS
MANUFACTURING ADVISORY SERVICE	PARENTORGANIZATION	DEPARTMENT FOR BUSINESS, INNOVATION AND SKILLS
RECONCILIATION OF EUROPEAN HISTORIES GROUP	PARENTORGANIZATION	EUROPEAN PARLIAMENT
DEEP BAY MARINE FIELD STATION	PARENTORGANIZATION	CENTRE FOR SHELLFISH RESEARCH, VANCOUVER ISLAND UNIVERSITY
BSAC LONDON BRANCH	PARENTORGANIZATION	BRITISH SUB-AQUA CLUB
GLOBAL FORUM ON TRANSPARENCY AND EXCHANGE OF INFORMATION FOR TAX PURPOSES	PARENTORGANIZATION	OECD
CIGI CAMPUS	PARENTORGANIZATION	CENTRE FOR INTERNATIONAL GOVERNANCE INNOVATION
AL SHAQAB	PARENTORGANIZATION	QATAR FOUNDATION
FEMINISM AND LEGAL THEORY PROJECT	PARENTORGANIZATION	UNIVERSITY OF WISCONSIN LAW SCHOOL
FEMINISM AND LEGAL THEORY PROJECT	PARENTORGANIZATION	COLUMBIA LAW SCHOOL
FEMINISM AND LEGAL THEORY PROJECT	PARENTORGANIZATION	CORNELL LAW SCHOOL
FEMINISM AND LEGAL THEORY PROJECT	PARENTORGANIZATION	EMORY UNIVERSITY SCHOOL OF LAW
NATIONAL BOARD OF REVENUE	PARENTORGANIZATION	INTERNAL RESOURCES DIVISION, MINISTRY OF FINANCE
MRC CANCER UNIT	PARENTORGANIZATION	UNIVERSITY OF CAMBRIDGE AND MEDICAL RESEARCH COUNCIL
NATIONAL APPRENTICESHIP SERVICE	PARENTORGANIZATION	SKILLS FUNDING AGENCY
PAN-AFRICAN UNIVERSITY	PARENTORGANIZATION	AFRICAN UNION
WüRTTEMBERG FOOTBALL ASSOCIATION	PARENTORGANIZATION	GERMAN FOOTBALL ASSOCIATION
SOUTH BADEN FOOTBALL ASSOCIATION	PARENTORGANIZATION	GERMAN FOOTBALL ASSOCIATION
WELLCOME TRUST CENTRE FOR HUMAN GENETICS	PARENTORGANIZATION	UNIVERSITY OF OXFORD
WELLCOME TRUST CENTRE FOR HUMAN GENETICS	PARENTORGANIZATION	WELLCOME TRUST
LOCAL COORDINATION COMMITTEES OF SYRIA	PARENTORGANIZATION	SYRIAN OPPOSITION
SAN DIEGO FIGURE SKATING CLUB	PARENTORGANIZATION	WWW.USFSA.ORG
MACARTHUR ASTRONOMY FORUM	PARENTORGANIZATION	MACARTHUR ASTRONOMICAL SOCIETY
ÓGRA CHORCAí	PARENTORGANIZATION	NATIONAL YOUTH COUNCIL OF IRELAND
ENABLE IRELAND	PARENTORGANIZATION	HEALTH SERVICE EXECUTIVE
ENABLE IRELAND	PARENTORGANIZATION	NATIONAL YOUTH COUNCIL OF IRELAND
INDIAN ANTHROPOLOGICAL SOCIETY	PARENTORGANIZATION	INTERNATIONAL COUNCIL FOR SCIENCE
TURKISH ACADEMIC NETWORK AND INFORMATION CENTER	PARENTORGANIZATION	SCIENTIFIC AND TECHNOLOGICAL RESEARCH COUNCIL OF TURKEY
YOUTH ADVISORY COMMITTEE OF CUYAHOGA COUNTY	PARENTORGANIZATION	4
STUDENT GOVERNMENT IN THE PHILIPPINES	PARENTORGANIZATION	DEPARTMENT OF EDUCATION - OFFICE OF THE UNDERSECRETARY FOR REGIONAL OPERATIONS
ORGANIZATION OF AMERICAN STATES SECRETARIAT FOR POLITICAL AFFAIRS	PARENTORGANIZATION	ORGANIZATION OF AMERICAN STATES GENERAL SECRETARIAT
WISCONSIN SENATE, DISTRICT 14	PARENTORGANIZATION	WISCONSIN LEGISLATURE
WISCONSIN SENATE, DISTRICT 15	PARENTORGANIZATION	WISCONSIN LEGISLATURE
WISCONSIN SENATE, DISTRICT 16	PARENTORGANIZATION	WISCONSIN LEGISLATURE
WISCONSIN SENATE, DISTRICT 17	PARENTORGANIZATION	WISCONSIN LEGISLATURE
WISCONSIN SENATE, DISTRICT 18	PARENTORGANIZATION	WISCONSIN LEGISLATURE
WISCONSIN SENATE, DISTRICT 19	PARENTORGANIZATION	WISCONSIN LEGISLATURE
WISCONSIN SENATE, DISTRICT 20	PARENTORGANIZATION	WISCONSIN LEGISLATURE
WISCONSIN SENATE, DISTRICT 21	PARENTORGANIZATION	WISCONSIN LEGISLATURE
WISCONSIN SENATE, DISTRICT 22	PARENTORGANIZATION	WISCONSIN LEGISLATURE
WISCONSIN SENATE, DISTRICT 23	PARENTORGANIZATION	WISCONSIN LEGISLATURE
WISCONSIN SENATE, DISTRICT 24	PARENTORGANIZATION	WISCONSIN LEGISLATURE
ST JOHN AMBULANCE AUSTRALIA CADETS	PARENTORGANIZATION	ST JOHN AMBULANCE AUSTRALIA
OREGON STATE UNIVERSITY MARS ROVER	PARENTORGANIZATION	OREGON STATE UNIVERSITY ROBOTICS CLUB
WISCONSIN SENATE, DISTRICT 26	PARENTORGANIZATION	WISCONSIN LEGISLATURE
WISCONSIN SENATE, DISTRICT 27	PARENTORGANIZATION	WISCONSIN LEGISLATURE
WISCONSIN SENATE, DISTRICT 28	PARENTORGANIZATION	WISCONSIN LEGISLATURE
ATLAS BENEFITING THON	PARENTORGANIZATION	PANHELLENIC DANCE MARATHON
COLUMBIA LAW SCHOOL CENTER FOR JAPANESE LEGAL STUDIES	PARENTORGANIZATION	COLUMBIA LAW SCHOOL
WISCONSIN SENATE, DISTRICT 30	PARENTORGANIZATION	WISCONSIN LEGISLATURE
WISCONSIN SENATE, DISTRICT 32	PARENTORGANIZATION	WISCONSIN LEGISLATURE
WISCONSIN SENATE, DISTRICT 33	PARENTORGANIZATION	WISCONSIN LEGISLATURE
NIRMAN	PARENTORGANIZATION	SEARCH
NIRMAN	PARENTORGANIZATION	MKCL
BIRMINGHAM MUSEUMS TRUST	PARENTORGANIZATION	BIRMINGHAM CITY COUNCIL
4T – VIETNAM YOUTH EDUCATION SUPPORT CENTER	PARENTORGANIZATION	VIETNAM ASSOCIATION FOR PROMOTING EDUCATION
MINNESOTA HOUSE OF REPRESENTATIVES, DISTRICT 61A	PARENTORGANIZATION	MINNESOTA LEGISLATURE
GEORGIA STATE SENATE DISTRICT 42	PARENTORGANIZATION	GEORGIA GENERAL ASSEMBLY
JOULE CENTRE	PARENTORGANIZATION	NORTHWEST REGIONAL DEVELOPMENT AGENCY
ARTHUR C. CLARKE INSTITUTE FOR MODERN TECHNOLOGIES	PARENTORGANIZATION	MINISTRY OF TECHNOLOGY AND RESEARCH
VIVEKANANDA INTERNATIONAL FOUNDATION	PARENTORGANIZATION	VIVEKANANDA KENDRA
COALITION OF SECULAR AND DEMOCRATIC SYRIANS	PARENTORGANIZATION	SYRIAN OPPOSITION
INSTITUTE FOR BUSINESS IN THE GLOBAL CONTEXT	PARENTORGANIZATION	THE FLETCHER SCHOOL OF LAW AND DIPLOMACY
INSTITUTE FOR BUSINESS IN THE GLOBAL CONTEXT	PARENTORGANIZATION	TUFTS UNIVERSITY
MINNESOTA SPORTS FACILITIES AUTHORITY	PARENTORGANIZATION	STATE OF MINNESOTA
EAST SUSSEX YOUTH CABINET	PARENTORGANIZATION	UK YOUTH PARLIAMENT
FEDERAL EXECUTIVE	PARENTORGANIZATION	LIBERAL DEMOCRATS
NATIONAL CENTRE FOR ATMOSPHERIC SCIENCE	PARENTORGANIZATION	NATURAL ENVIRONMENT RESEARCH COUNCIL
NATIONAL CENTRE FOR EARTH OBSERVATION	PARENTORGANIZATION	NATURAL ENVIRONMENT RESEARCH COUNCIL
SANAEM	PARENTORGANIZATION	TAEK
ÇNAEM	PARENTORGANIZATION	TAEK
ANAEM	PARENTORGANIZATION	TAEK
TELEKOM INNOVATION LABORATORIES	PARENTORGANIZATION	DEUTSCHE TELEKOM
TELEKOM INNOVATION LABORATORIES	PARENTORGANIZATION	TECHNISCHE UNIVERSITäT BERLIN
SPORT NORTHERN IRELAND	PARENTORGANIZATION	DEPARTMENT FOR COMMUNITIES
ICE CHIPS	PARENTORGANIZATION	THE SKATING CLUB OF BOSTON
INTERNATIONAL STATE CRIME INITIATIVE	PARENTORGANIZATION	HARVARD UNIVERSITY
INTERNATIONAL STATE CRIME INITIATIVE	PARENTORGANIZATION	UNIVERSITY OF HULL
INTERNATIONAL STATE CRIME INITIATIVE	PARENTORGANIZATION	UNIVERSITY OF ULSTER
PROJECT FOR AWESOME	PARENTORGANIZATION	
WISCONSIN ASSEMBLY, DISTRICT 1	PARENTORGANIZATION	WISCONSIN LEGISLATURE
SUPREME COUNCIL OF THE SYRIAN REVOLUTION	PARENTORGANIZATION	SYRIAN OPPOSITION
PREVENTION OF BLINDNESS TRUST	PARENTORGANIZATION	PAKISTAN ISLAMIC MEDICAL ASSOCIATION
DIRECTORATE OF ARMY RESEARCH AND ANALYSIS	PARENTORGANIZATION	AUSTRALIAN ARMY
ACHUCARRO BASQUE CENTER FOR NEUROSCIENCE	PARENTORGANIZATION	BASQUE GOVERNMENT
ACHUCARRO BASQUE CENTER FOR NEUROSCIENCE	PARENTORGANIZATION	IKERBASQUE
ACHUCARRO BASQUE CENTER FOR NEUROSCIENCE	PARENTORGANIZATION	EHU
EUROPEAN SQUASH FEDERATION	PARENTORGANIZATION	WORLD SQUASH FEDERATION
SQUASH FEDERATION OF AFRICA	PARENTORGANIZATION	WORLD SQUASH FEDERATION
FEDERATION OF PANAMERICA	PARENTORGANIZATION	WORLD SQUASH FEDERATION
NATIONAL POISONS INFORMATION SERVICE	PARENTORGANIZATION	PUBLIC HEALTH ENGLAND
SCOTTISH POLICE AUTHORITY	PARENTORGANIZATION	SCOTTISH GOVERNMENT
INTERNATIONAL TROPICAL FRUITS NETWORK	PARENTORGANIZATION	FOOD AND AGRICULTURE ORGANIZATION
GEEKS WITHOUT BOUNDS	PARENTORGANIZATION	THE SCHOOL FACTORY
NORTHERN GERMAN FOOTBALL ASSOCIATION	PARENTORGANIZATION	GERMAN FOOTBALL ASSOCIATION
WESTERN GERMAN FOOTBALL ASSOCIATION	PARENTORGANIZATION	GERMAN FOOTBALL ASSOCIATION
THE HERITAGE FOUNDATION'S ASIAN STUDIES CENTER	PARENTORGANIZATION	THE HERITAGE FOUNDATION
ARCHITECH	PARENTORGANIZATION	DEPARTMENT OF ARCHITECTURE, UNIVERSITI TEKNOLOGI MALAYSIA
SCOTTISH SCIENCE ADVISORY COUNCIL	PARENTORGANIZATION	SCOTTISH GOVERNMENT
EGYPTIAN PHARMACEUTICAL STUDENTS' FEDERATION	PARENTORGANIZATION	IPSF
CENTRAL PUBLIC SECURITY COMPREHENSIVE MANAGEMENT COMMISSION	PARENTORGANIZATION	CENTRAL COMMITTEE OF THE COMMUNIST PARTY OF CHINA
SAN JOSE BIOCENTER	PARENTORGANIZATION	SAN JOSE REDEVELOPMENT AGENCY
ASTANA ECONOMIC FORUM	PARENTORGANIZATION	* EURASIAN ECONOMIC CLUB OF SCIENTISTS ASSOCIATION,\N*
ASTANA ECONOMIC FORUM	PARENTORGANIZATION	GOVERNMENT OF KAZAKHSTAN
BARZA RADIO COMMUNITY	PARENTORGANIZATION	FARM RADIO INTERNATIONAL
AIDA HELLAS	PARENTORGANIZATION	AIDA INTERNATIONAL
DALLE MOLLE INSTITUTE FOR SEMANTIC AND COGNITIVE STUDIES	PARENTORGANIZATION	FONDATION DALLE MOLLE
THE NATIONAL VOLLEYBALL FEDERATION OF INDONESIA	PARENTORGANIZATION	NATIONAL SPORTS COMMITTEE OF INDONESIA
SUSTAINABLE ARCHAEOLOGY	PARENTORGANIZATION	UNIVERSITY OF WESTERN ONTARIO AND MCMASTER UNIVERSITY
GLOBAL ALLIANCE FOR CLEAN COOKSTOVES	PARENTORGANIZATION	UNITED NATIONS FOUNDATION
NORWEGIAN FILM INSTITUTE	PARENTORGANIZATION	MINISTRY OF CULTURE
KNIGHT-WALLACE FELLOWSHIP	PARENTORGANIZATION	UNIVERSITY OF MICHIGAN
OXFORD VACCINE GROUP	PARENTORGANIZATION	UNIVERSITY OF OXFORD
GIBRALTAR CAVING GROUP	PARENTORGANIZATION	GIBRALTAR ORNITHOLOGICAL AND NATURAL HISTORY SOCIETY
NATIONAL COALITION FOR SYRIAN REVOLUTIONARY AND OPPOSITION FORCES	PARENTORGANIZATION	SYRIAN OPPOSITION
CENTRE FOR THE STUDY OF EXISTENTIAL RISK	PARENTORGANIZATION	UNIVERSITY OF CAMBRIDGE
NEPAL ACADEMY	PARENTORGANIZATION	MINISTRY OF CULTURE, TOURISM AND CIVIL AVIATION
NEPAL ACADEMY	PARENTORGANIZATION	NEPAL GOVERNMENT
NORDIC GAME JAM	PARENTORGANIZATION	INTERNATIONAL GAME DEVELOPERS ASSOCIATION DENMARK
PUERTO RICO COALITION FOR EQUITY AND EDUCATIONAL QUALITY	PARENTORGANIZATION	SAPIENTIS
INTERNATIONAL WITTGENSTEIN SYMPOSIUM	PARENTORGANIZATION	AUSTRIAN LUDWIG WITTGENSTEIN SOCIETY
PLASTIC DISCLOSURE PROJECT	PARENTORGANIZATION	OCEAN RECOVERY ALLIANCE
HK-SF OCEAN FILM FESTIVAL	PARENTORGANIZATION	OCEAN RECOVERY ALLIANCE
PLASTICITY FORUM	PARENTORGANIZATION	OCEAN RECOVERY ALLIANCE
OCEANIC BIG 5	PARENTORGANIZATION	OCEAN RECOVERY ALLIANCE
ASSOCIATION OF SURFING PROFESSIONALS EUROPE	PARENTORGANIZATION	WORLD SURF LEAGUE
GOA UNIVERSITY LIBRARY	PARENTORGANIZATION	GOA UNIVERSITY
YMCA SCUBA PROGRAM	PARENTORGANIZATION	YMCA
KOMSOMOL OF UKRAINE	PARENTORGANIZATION	COMMUNIST PARTY OF UKRAINE
TURKISH SPACE SYSTEMS, INTEGRATION AND TEST CENTER	PARENTORGANIZATION	TURKISH AEROSPACE INDUSTRIES
2X2 PROJECT	PARENTORGANIZATION	DEPARTMENT OF EPIDEMIOLOGY AT THE MAILMAN SCHOOL OF PUBLIC HEALTH
BLUE HEART CAMPAIGN	PARENTORGANIZATION	UNITED NATIONS OFFICE ON DRUGS AND CRIME
GLORY FALL	PARENTORGANIZATION	PLACE OF REFUGE
EFFICIENCY AND REFORM GROUP	PARENTORGANIZATION	CABINET OFFICE
KOCHPAC	PARENTORGANIZATION	KOCH INDUSTRIES
THE ARTS & SCIENCE UNDERGRADUATE SOCIETY OF QUEEN'S UNIVERSITY	PARENTORGANIZATION	QUEEN'S UNIVERSITY
ASIAN LEADERSHIP CONFERENCE	PARENTORGANIZATION	THE CHOSUN ILBO
PETROGRAD MILITARY REVOLUTIONARY COMMITTEE	PARENTORGANIZATION	PETROGRAD SOVIET
PIONEERS IN ENGINEERING	PARENTORGANIZATION	TAU BETA PI
COMMISSION ON ISOTOPIC ABUNDANCES AND ATOMIC WEIGHTS	PARENTORGANIZATION	IUPAC
PTV ACADEMY	PARENTORGANIZATION	PAKISTAN TELEVISION CORPORATION
FEDERAL MARITIME AND HYDROGRAPHIC AGENCY OF GERMANY	PARENTORGANIZATION	FEDERAL MINISTRY OF TRANSPORT AND DIGITAL INFRASTRUCTURE
TÜBİTAK DEFENSE INDUSTRIES RESEARCH AND DEVELOPMENT INSTITUTE	PARENTORGANIZATION	SCIENTIFIC AND TECHNOLOGICAL RESEARCH COUNCIL OF TURKEY
TÜBİTAK MARMARA RESEARCH CENTER	PARENTORGANIZATION	SCIENTIFIC AND TECHNOLOGICAL RESEARCH COUNCIL OF TURKEY
TÜBİTAK INFORMATICS AND INFORMATION SECURITY RESEARCH CENTER	PARENTORGANIZATION	SCIENTIFIC AND TECHNOLOGICAL RESEARCH COUNCIL OF TURKEY
YOUTH UNLIMITED	PARENTORGANIZATION	DYNAMIC YOUTH MINISTRIES
NATO STANDARDIZATION OFFICE	PARENTORGANIZATION	NATO
REVIVING BASEBALL IN INNER CITIES	PARENTORGANIZATION	MAJOR LEAGUE BASEBALL
STARTX	PARENTORGANIZATION	STANFORD UNIVERSITY
PRESBYTERY OF PHILADELPHIA	PARENTORGANIZATION	SYNOD OF THE TRINITY
PRESBYTERY OF NEW YORK	PARENTORGANIZATION	SYNOD OF PHILADELPHIA
WIXOM PERFORMANCE BUILD CENTER	PARENTORGANIZATION	GENERAL MOTORS
HUNGARIAN TESTING BOARD	PARENTORGANIZATION	ISTQB
KERALA NADVATHUL MUJAHIDEEN	PARENTORGANIZATION	KERALA JAMIYYATHUL ULAMA
LIRYC	PARENTORGANIZATION	UNIVERSITY OF BORDEAUX
DYNAMIC SPORTS SHOOTING NORWAY	PARENTORGANIZATION	INTERNATIONAL PRACTICAL SHOOTING CONFEDERATION
INNOVATIONS FOR SUCCESSFUL SOCIETIES	PARENTORGANIZATION	PRINCETON UNIVERSITY
ORGANIZATION OF AMERICAN STATES SECRETARIAT FOR MULTIDIMENSIONAL SECURITY	PARENTORGANIZATION	ORGANIZATION OF AMERICAN STATES
ASSOCIATION OF SURFING PROFESSIONALS AUSTRALASIA	PARENTORGANIZATION	WORLD SURF LEAGUE
JESUIT EUROPEAN SOCIAL CENTRE	PARENTORGANIZATION	SOCIETY OF JESUS
CRITICAL COMMONS	PARENTORGANIZATION	USC SCHOOL OF CINEMATIC ARTS
GENERAL DEBATE OF THE SIXTY-EIGHTH SESSION OF THE UNITED NATIONS GENERAL ASSEMBLY	PARENTORGANIZATION	UNITED NATIONS
KRANTIKARI ADIVASI MAHILA SANGATHAN	PARENTORGANIZATION	COMMUNIST PARTY OF INDIA
ECOJESUIT	PARENTORGANIZATION	JESUIT EUROPEAN SOCIAL CENTRE
THE CLERGY PROJECT	PARENTORGANIZATION	FREEDOM FROM RELIGION FOUNDATION
THE CLERGY PROJECT	PARENTORGANIZATION	RICHARD DAWKINS FOUNDATION FOR REASON AND SCIENCE
MUNICIPAL TECHNICAL ADVISORY SERVICE	PARENTORGANIZATION	UNIVERSITY OF TENNESSEE SYSTEM
HOUSE OCTOBER SURPRISE TASK FORCE	PARENTORGANIZATION	COMMITTEE ON FOREIGN AFFAIRS OF THE UNITED STATES HOUSE OF REPRESENTATIVES
NRENUM.NET	PARENTORGANIZATION	TERENA
CONGRESSIONAL COMMITTEES INVESTIGATING THE IRAN–CONTRA AFFAIR	PARENTORGANIZATION	UNITED STATES HOUSE OF REPRESENTATIVES
CONGRESSIONAL COMMITTEES INVESTIGATING THE IRAN–CONTRA AFFAIR	PARENTORGANIZATION	UNITED STATES SENATE
HEALTH AND CARE RESEARCH WALES	PARENTORGANIZATION	WELSH GOVERNMENT
NASU INSTITUTE FOR ECONOMICS AND FORECASTING	PARENTORGANIZATION	NATIONAL ACADEMY OF SCIENCES OF UKRAINE
VULNERABILITY AND THE HUMAN CONDITION INITIATIVE	PARENTORGANIZATION	EMORY UNIVERSITY SCHOOL OF LAW
NORTH WESTERN KARNATAKA ROAD TRANSPORT CORPORATION	PARENTORGANIZATION	KARNATAKA STATE ROAD TRANSPORT CORPORATION
ALL-UNION SCIENTIFIC AND RESEARCH, PLANNING AND DESIGN TECHNOLOGICAL INSTITUTE ON ELECTRIC LOCOMOTIVES BUILDING	PARENTORGANIZATION	TRANSMASHHOLDING
LEWISHAM AND GREENWICH NHS TRUST	PARENTORGANIZATION	NATIONAL HEALTH SERVICE
MENSHEVIKS	PARENTORGANIZATION	RUSSIAN SOCIAL-DEMOCRATIC LABOUR PARTY
CENTER FOR JEWISH-CHRISTIAN UNDERSTANDING AND COOPERATION	PARENTORGANIZATION	
WHITE CLIFFS COUNTRYSIDE PARTNERSHIP	PARENTORGANIZATION	DOVER DISTRICT COUNCIL
DUNDEE ENGINE PLANT	PARENTORGANIZATION	CHRYSLER GROUP LLC
NEPAL ELECTRICITY AUTHORITY	PARENTORGANIZATION	MINISTRY OF ENERGY, GOVERNMENT OF NEPAL
COSTA RICAN DIRECTORATE OF GEOLOGY AND MINES	PARENTORGANIZATION	MINISTRY OF ENVIRONMENT, ENERGY AND TELECOMMUNICATIONS
FEDERAçãO DAS INDúSTRIAS DO ESTADO DE SãO PAULO	PARENTORGANIZATION	CONFEDERAçãO NACIONAL DA INDúSTRIA
DRIVER AND VEHICLE STANDARDS AGENCY	PARENTORGANIZATION	DEPARTMENT FOR TRANSPORT
WORLD INNOVATION SUMMIT FOR HEALTH	PARENTORGANIZATION	WWW.QF.ORG.QA
NETWORK STARTUP RESOURCE CENTER	PARENTORGANIZATION	UNIVERSITY OF OREGON
MICROSOFT DIGITAL CRIMES UNIT	PARENTORGANIZATION	MICROSOFT
EUROPEAN YOUNG CHEMISTS' NETWORK	PARENTORGANIZATION	EUROPEAN ASSOCIATION FOR CHEMICAL AND MOLECULAR SCIENCES
CONSERVATION CANINES	PARENTORGANIZATION	UNIVERSITY OF WASHINGTON
NATIONAL CENTRE OF RESEARCH IN SOCIAL AND CULTURAL ANTHROPOLOGY	PARENTORGANIZATION	MINISTRY OF HIGHER EDUCATION AND SCIENTIFIC RESEARCH
LEGION OF BOOM	PARENTORGANIZATION	SEATTLE SEAHAWKS
DHAKA UNIVERSITY FILM SOCIETY	PARENTORGANIZATION	DHAKA UNIVERSITY CENTRAL STUDENTS' UNION
CHEONGSHIM INTERNATIONAL ACADEMY MODEL UNITED NATIONS	PARENTORGANIZATION	CHEONGSHIM INTERNATIONAL ACADEMY
OPEN AUTOMOTIVE ALLIANCE	PARENTORGANIZATION	GOOGLE INC.
CENTRAL LEADING GROUP FOR COMPREHENSIVELY DEEPENING REFORMS	PARENTORGANIZATION	CENTRAL COMMITTEE OF THE COMMUNIST PARTY OF CHINA
ILLINOIS INNOCENCE PROJECT	PARENTORGANIZATION	INNOCENCE PROJECT
CONSERVATIVES ABROAD	PARENTORGANIZATION	CONSERVATIVE PARTY
NIAGARA FOUNDATION	PARENTORGANIZATION	ALLIANCE FOR SHARED VALUES
CENTRE FOR FINANCE AND DEVELOPMENT	PARENTORGANIZATION	GRADUATE INSTITUTE OF INTERNATIONAL AND DEVELOPMENT STUDIES
COUNCIL ON EMERGING MARKET ENTERPRISES	PARENTORGANIZATION	INSTITUTE FOR BUSINESS IN THE GLOBAL CONTEXT
COUNCIL ON EMERGING MARKET ENTERPRISES	PARENTORGANIZATION	THE FLETCHER SCHOOL OF LAW AND DIPLOMACY
YOUNG MUSLIM ORGANISATION	PARENTORGANIZATION	ISLAMIC FORUM OF EUROPE
INTERNATIONAL SECURITY STUDIES PROGRAM	PARENTORGANIZATION	THE FLETCHER SCHOOL OF LAW AND DIPLOMACY
INTERNATIONAL SECURITY STUDIES PROGRAM	PARENTORGANIZATION	TUFTS UNIVERSITY
BOWLING GREEN STATE UNIVERSITY DEPARTMENT OF POPULAR CULTURE	PARENTORGANIZATION	BOWLING GREEN STATE UNIVERSITY
CENTRE JUSTICE ET FOI	PARENTORGANIZATION	SOCIETY OF JESUS
AMI INSURANCE	PARENTORGANIZATION	IAG NEW ZEALAND LIMITED
INSTITUTE FOR STEM CELL BIOLOGY AND REGENERATIVE MEDICINE	PARENTORGANIZATION	DEPARTMENT OF BIOTECHNOLOGY
INSTITUTE FOR STEM CELL BIOLOGY AND REGENERATIVE MEDICINE	PARENTORGANIZATION	INDIA
SOUTH ASIA COLLECTION AT THE UNIVERSITY OF PENNSYLVANIA LIBRARIES	PARENTORGANIZATION	UNIVERSITY OF PENNSYLVANIA
MILKEN EDUCATOR AWARD	PARENTORGANIZATION	MILKEN FAMILY FOUNDATION
MUGGLE QUIDDITCH NEDERLAND	PARENTORGANIZATION	INTERNATIONAL QUIDDITCH ASSOCIATION
YOUNG FABIANS FINANCE NETWORK	PARENTORGANIZATION	YOUNG FABIANS
INDIAN GRASSLAND AND FODDER RESEARCH INSTITUTE	PARENTORGANIZATION	INDIAN COUNCIL OF GRASSLAN AND FOODER RESEARCH
WISCONSIN ASSEMBLY DISTRICT 58	PARENTORGANIZATION	WISCONSIN LEGISLATURE
INTERNATIONAL ELECTROTECHNICAL VOCABULARY	PARENTORGANIZATION	INTERNATIONAL ELECTROTECHNICAL COMMISSION
CIF LOS ANGELES CITY SECTION	PARENTORGANIZATION	CALIFORNIA INTERSCHOLASTIC FEDERATION
RENEWABLE ENERGY PROGRAMME	PARENTORGANIZATION	NIGERIAN MINISTRY OF THE ENVIRONMENT
JAPANESE BLIND GOLF ASSOCIATION	PARENTORGANIZATION	INTERNATIONAL BLIND GOLF ASSOCIATION
SECTION 3	PARENTORGANIZATION	NYSPHSAA
SURAKSHA CLINIC	PARENTORGANIZATION	NATIONAL AIDS CONTROL ORGANISATION
SURAKSHA CLINIC	PARENTORGANIZATION	MINISTRY OF HEALTH AND FAMILY WELFARE
NETHERLANDS INSTITUTE FOR NEUROSCIENCE	PARENTORGANIZATION	KNAW
IRAN AIRPORTS COMPANY	PARENTORGANIZATION	MINISTRY OF ROADS AND URBAN DEVELOPMENT
ASSOCIATION OF EUROPEAN OPERATIONAL RESEARCH SOCIETIES	PARENTORGANIZATION	INTERNATIONAL FEDERATION OF OPERATIONAL RESEARCH SOCIETIES
GOOD SAM CLUB	PARENTORGANIZATION	GOOD SAM ENTERPRISES
RAISING FOR EFFECTIVE GIVING	PARENTORGANIZATION	
AUSTRALIA BIOINFORMATICS RESOURCE	PARENTORGANIZATION	EUROPEAN MOLECULAR BIOLOGY LABORATORY
PREGINET	PARENTORGANIZATION	ADVANCED SCIENCE AND TECHNOLOGY INSTITUTE, DEPARTMENT OF SCIENCE AND TECHNOLOGY
HEFORSHE	PARENTORGANIZATION	UN WOMEN
GENERAL DEBATE OF THE SIXTY-NINTH SESSION OF THE UNITED NATIONS GENERAL ASSEMBLY	PARENTORGANIZATION	UNITED NATIONS
MISS DIVA	PARENTORGANIZATION	FEMINA MISS INDIA AND
MISS DIVA	PARENTORGANIZATION	THE TIMES GROUP
VIRGINIA SCIENCE FESTIVAL	PARENTORGANIZATION	VIRGINIA TECH
VIRGINIA SCIENCE FESTIVAL	PARENTORGANIZATION	SCIENCE MUSEUM OF WESTERN NORTH CAROLINA
BELGIAN QUIDDITCH FEDERATION	PARENTORGANIZATION	INTERNATIONAL QUIDDITCH ASSOCIATION
CHETNA NATYA MANCH	PARENTORGANIZATION	COMMUNIST PARTY OF INDIA
ROTE LISTE	PARENTORGANIZATION	GESELLSCHAFT ZUR ERHALTUNG ALTER UND GEFäHRDETER HAUSTIERRASSEN
AUSTRALIAN QUIDDITCH ASSOCIATION	PARENTORGANIZATION	INTERNATIONAL QUIDDITCH ASSOCIATION
LET'S ENCRYPT	PARENTORGANIZATION	INTERNET SECURITY RESEARCH GROUP
UNITS OF BATTLE HUGO CHáVEZ	PARENTORGANIZATION	PSUV
EUROPEAN MINIFOOTBALL FEDERATION	PARENTORGANIZATION	WORLD MINIFOOTBALL FEDERATION
ECMA-407	PARENTORGANIZATION	ECMA INTERNATIONAL
ITALIAN OPERATIONS RESEARCH SOCIETY	PARENTORGANIZATION	ASSOCIATION OF EUROPEAN OPERATIONAL RESEARCH SOCIETIES
ITALIAN OPERATIONS RESEARCH SOCIETY	PARENTORGANIZATION	INTERNATIONAL FEDERATION OF OPERATIONAL RESEARCH SOCIETIES
HUNGARIAN OPERATIONS RESEARCH SOCIETY	PARENTORGANIZATION	ASSOCIATION OF EUROPEAN OPERATIONAL RESEARCH SOCIETIES
HUNGARIAN OPERATIONS RESEARCH SOCIETY	PARENTORGANIZATION	INTERNATIONAL FEDERATION OF OPERATIONAL RESEARCH SOCIETIES
INDIAN SOCIETY FOR PARASITOLOGY	PARENTORGANIZATION	CENTRAL DRUG RESEARCH INSTITUTE
CAMLA	PARENTORGANIZATION	CAMBRIDGE ENGLISH LANGUAGE ASSESSMENT AND THE UNIVERSITY OF MICHIGAN
MEDIA INSTITUTE OF SOUTHERN AFRICA	PARENTORGANIZATION	MEDIA INSTITUTE FOR SOUTHERN AFRICA
CENTRAL LEADING GROUP FOR INTERNET SECURITY AND INFORMATIZATION	PARENTORGANIZATION	CENTRAL COMMITTEE OF THE COMMUNIST PARTY OF CHINA
CENTRAL LEADING GROUP FOR MILITARY REFORM	PARENTORGANIZATION	CENTRAL MILITARY COMMISSION OF THE COMMUNIST PARTY OF CHINA
LITHUANIAN HELSINKI GROUP	PARENTORGANIZATION	HELSINKI COMMITTEE FOR HUMAN RIGHTS
CENTRAL LEADING GROUP FOR INSPECTION WORK	PARENTORGANIZATION	CENTRAL COMMITTEE OF THE COMMUNIST PARTY OF CHINA
CENTRAL LEADING GROUP FOR INSPECTION WORK	PARENTORGANIZATION	CENTRAL COMMISSION FOR DISCIPLINE INSPECTION
ISO TC 279	PARENTORGANIZATION	INTERNATIONAL ORGANIZATION FOR STANDARDIZATION
HISTORY AND PUBLIC POLICY PROGRAM	PARENTORGANIZATION	WOODROW WILSON INTERNATIONAL CENTER FOR SCHOLARS
FINNISH OPERATIONS RESEARCH SOCIETY	PARENTORGANIZATION	ASSOCIATION OF EUROPEAN OPERATIONAL RESEARCH SOCIETIES
FINNISH OPERATIONS RESEARCH SOCIETY	PARENTORGANIZATION	INTERNATIONAL FEDERATION OF OPERATIONAL RESEARCH SOCIETIES
YOUNG FABIANS HEALTH NETWORK	PARENTORGANIZATION	YOUNG FABIANS
CROATIAN OPERATIONAL RESEARCH SOCIETY	PARENTORGANIZATION	ASSOCIATION OF EUROPEAN OPERATIONAL RESEARCH SOCIETIES
CROATIAN OPERATIONAL RESEARCH SOCIETY	PARENTORGANIZATION	INTERNATIONAL FEDERATION OF OPERATIONAL RESEARCH SOCIETIES
RENEWABLEUK CYMRU	PARENTORGANIZATION	RENEWABLEUK
INDUSTRIAL INTERNET CONSORTIUM	PARENTORGANIZATION	OBJECT MANAGEMENT GROUP
HET DENKGELAG	PARENTORGANIZATION	SKEPP
WORLD BANK	PARENTORGANIZATION	WORLD BANK GROUP
DUBAI CHESS AND CULTURE CLUB	PARENTORGANIZATION	DUBAI SPORTS COUNCIL
VERMONT ORGANIZATION OF KOHA AUTOMATED LIBRARIES	PARENTORGANIZATION	GREEN MOUNTAIN LIBRARY CONSORTIUM
SCIENCE AND TECHNOLOGY POLICY INSTITUTE	PARENTORGANIZATION	INSTITUTE FOR DEFENSE ANALYSES
BIOSCIENTIFICA	PARENTORGANIZATION	SOCIETY FOR ENDOCRINOLOGY
BAGAMOYO ARTS AND CULTURAL INSTITUTE	PARENTORGANIZATION	MINISTRY OF INFORMATION, YOUTH, CULTURE AND SPORTS
SONS OF THE AMERICAN LEGION	PARENTORGANIZATION	AMERICAN LEGION
AMERICAN CENTER OF ORIENTAL RESEARCH	PARENTORGANIZATION	COUNCIL OF AMERICAN OVERSEAS RESEARCH CENTERS
SOUTHWEST GERMAN FOOTBALL ASSOCIATION	PARENTORGANIZATION	GERMAN FOOTBALL ASSOCIATION
RHINELAND FOOTBALL ASSOCIATION	PARENTORGANIZATION	GERMAN FOOTBALL ASSOCIATION
SOUTHERN GERMAN FOOTBALL ASSOCIATION	PARENTORGANIZATION	GERMAN FOOTBALL ASSOCIATION
SOUTHWESTERN REGIONAL FOOTBALL ASSOCIATION	PARENTORGANIZATION	GERMAN FOOTBALL ASSOCIATION
NORTHEASTERN GERMAN FOOTBALL ASSOCIATION	PARENTORGANIZATION	GERMAN FOOTBALL ASSOCIATION
BREMEN FOOTBALL ASSOCIATION	PARENTORGANIZATION	GERMAN FOOTBALL ASSOCIATION
HAMBURG FOOTBALL ASSOCIATION	PARENTORGANIZATION	GERMAN FOOTBALL ASSOCIATION
LOWER SAXONY FOOTBALL ASSOCIATION	PARENTORGANIZATION	GERMAN FOOTBALL ASSOCIATION
SCHLESWIG-HOLSTEIN FOOTBALL ASSOCIATION	PARENTORGANIZATION	GERMAN FOOTBALL ASSOCIATION
KOTAK LIFE INSURANCE	PARENTORGANIZATION	KOTAK MAHINDRA BANK AND OLD MUTUAL
EUREKAHEDGE	PARENTORGANIZATION	MIZUHO BANK
NEXUS FOR EXOPLANET SYSTEM SCIENCE	PARENTORGANIZATION	NASA
DET FRIVILLIGE SKYTTERVESEN	PARENTORGANIZATION	STORTING
NORGES SKYTTERFORBUND	PARENTORGANIZATION	INTERNATIONAL SHOOTING SPORT FEDERATION
COMMISSION ON FOOD SAFETY	PARENTORGANIZATION	STATE COUNCIL OF THE PEOPLE'S REPUBLIC OF CHINA
INTERNATIONAL UNION OF PHYSIOLOGICAL SCIENCES	PARENTORGANIZATION	INTERNATIONAL COUNCIL FOR SCIENCE
VIRTUAL PLANETARY LABORATORY	PARENTORGANIZATION	NASA
WEST ASIA BASKETBALL ASSOCIATION	PARENTORGANIZATION	FIBA ASIA
WEST ASIAN TENNIS FEDERATION	PARENTORGANIZATION	ASIAN TENNIS FEDERATION
FOUNDATION OF SAARC WRITERS AND LITERATURE	PARENTORGANIZATION	SAARC
GERMAN OPERATIONS RESEARCH SOCIETY	PARENTORGANIZATION	ASSOCIATION OF EUROPEAN OPERATIONAL RESEARCH SOCIETIES
GERMAN OPERATIONS RESEARCH SOCIETY	PARENTORGANIZATION	INTERNATIONAL FEDERATION OF OPERATIONAL RESEARCH SOCIETIES
WORLD VIDEO GAME HALL OF FAME	PARENTORGANIZATION	THE STRONG
THE FARES CENTER FOR EASTERN MEDITERRANEAN STUDIES	PARENTORGANIZATION	THE FLETCHER SCHOOL OF LAW AND DIPLOMACY
THE FARES CENTER FOR EASTERN MEDITERRANEAN STUDIES	PARENTORGANIZATION	TUFTS UNIVERSITY
SCIENCE CITY CHENNAI	PARENTORGANIZATION	DEPARTMENT OF HIGHER EDUCATION
SECRETARIAT FOR COMMUNICATIONS	PARENTORGANIZATION	ROMAN CURIA
MAX PLANCK INSTITUTE FOR COMPARATIVE AND INTERNATIONAL PRIVATE LAW	PARENTORGANIZATION	MAX PLANCK SOCIETY
MAX PLANCK INSTITUTE FOR METEOROLOGY	PARENTORGANIZATION	MAX PLANCK SOCIETY
DAVAO DEL NORTE F.A.	PARENTORGANIZATION	PHILIPPINE FOOTBALL FEDERATION
LEYTE F.A.	PARENTORGANIZATION	PHILIPPINE FOOTBALL FEDERATION
CYBERSPACE ADMINISTRATION OF CHINA	PARENTORGANIZATION	CENTRAL LEADING GROUP FOR INTERNET SECURITY AND INFORMATIZATION
CENTER FOR INTERNATIONAL ENVIRONMENT AND RESOURCE POLICY	PARENTORGANIZATION	THE FLETCHER SCHOOL OF LAW AND DIPLOMACY
CENTER FOR INTERNATIONAL ENVIRONMENT AND RESOURCE POLICY	PARENTORGANIZATION	TUFTS UNIVERSITY
WOMEN UNDER SIEGE PROJECT	PARENTORGANIZATION	WOMEN'S MEDIA CENTER
ASIA REGIONAL ORGANIC STANDARD	PARENTORGANIZATION	FOOD AND AGRICULTURE ORGANIZATION OF THE UNITED NATIONS
ASIA REGIONAL ORGANIC STANDARD	PARENTORGANIZATION	INTERNATIONAL FEDERATION OF ORGANIC AGRICULTURE MOVEMENTS
ASIA REGIONAL ORGANIC STANDARD	PARENTORGANIZATION	UNITED NATIONS CONFERENCE ON TRADE AND DEVELOPMENT
ADUR AND WORTHING COUNCILS	PARENTORGANIZATION	*
ADUR AND WORTHING COUNCILS	PARENTORGANIZATION	ADUR DISTRICT COUNCIL
ADUR AND WORTHING COUNCILS	PARENTORGANIZATION	WORTHING BOROUGH COUNCIL
SRI LANKA SOFTWARE TESTING BOARD	PARENTORGANIZATION	INTERNATIONAL SOFTWARE TESTING QUALIFICATIONS BOARD
ORAL HISTORY OF AMERICAN MUSIC	PARENTORGANIZATION	YALE UNIVERSITY LIBRARY
SOHO 3Q	PARENTORGANIZATION	SOHO CHINA
WORKING COMMISSION TO INVESTIGATE THE USE OF PSYCHIATRY FOR POLITICAL PURPOSES	PARENTORGANIZATION	MOSCOW HELSINKI GROUP
NORTH EASTERN KARNATAKA ROAD TRANSPORT CORPORATION	PARENTORGANIZATION	KARNATAKA STATE ROAD TRANSPORT CORPORATION
LOWER RHINE FOOTBALL ASSOCIATION	PARENTORGANIZATION	GERMAN FOOTBALL ASSOCIATION
EAST AFRICA CHRISTIAN ALLIANCE	PARENTORGANIZATION	INTERNATIONAL COUNCIL OF CHRISTIAN CHURCHES
MIDDLE RHINE FOOTBALL ASSOCIATION	PARENTORGANIZATION	GERMAN FOOTBALL ASSOCIATION
WESTPHALIAN FOOTBALL AND ATHLETICS ASSOCIATION	PARENTORGANIZATION	GERMAN FOOTBALL ASSOCIATION
FEDERATION OF EUROPEAN NUTRITION SOCIETIES	PARENTORGANIZATION	INTERNATIONAL UNION OF NUTRITIONAL SCIENCES
EMERGENCY AEROMEDICAL SERVICE	PARENTORGANIZATION	AIR CORPS
EMERGENCY AEROMEDICAL SERVICE	PARENTORGANIZATION	NATIONAL AMBULANCE SERVICE
GENERAL DEBATE OF THE SEVENTIETH SESSION OF THE UNITED NATIONS GENERAL ASSEMBLY	PARENTORGANIZATION	UNITED NATIONS
BERLIN FOOTBALL ASSOCIATION	PARENTORGANIZATION	GERMAN FOOTBALL ASSOCIATION
BRANDENBURG STATE FOOTBALL ASSOCIATION	PARENTORGANIZATION	GERMAN FOOTBALL ASSOCIATION
MECKLENBURG-VORPOMMERN STATE FOOTBALL ASSOCIATION	PARENTORGANIZATION	GERMAN FOOTBALL ASSOCIATION
SAXONY FOOTBALL ASSOCIATION	PARENTORGANIZATION	GERMAN FOOTBALL ASSOCIATION
SAXONY-ANHALT FOOTBALL ASSOCIATION	PARENTORGANIZATION	GERMAN FOOTBALL ASSOCIATION
THURINGIAN FOOTBALL ASSOCIATION	PARENTORGANIZATION	GERMAN FOOTBALL ASSOCIATION
WIKITOLEARN	PARENTORGANIZATION	KDE
BERKELEY INSTITUTE FOR DATA SCIENCE	PARENTORGANIZATION	UNIVERSITY OF CALIFORNIA, BERKELEY
SALZBURG FOOTBALL ASSOCIATION	PARENTORGANIZATION	AUSTRIAN FOOTBALL ASSOCIATION
VIENNA FOOTBALL ASSOCIATION	PARENTORGANIZATION	AUSTRIAN FOOTBALL ASSOCIATION
TIROL FOOTBALL ASSOCIATION	PARENTORGANIZATION	AUSTRIAN FOOTBALL ASSOCIATION
STYRIA FOOTBALL ASSOCIATION	PARENTORGANIZATION	AUSTRIAN FOOTBALL ASSOCIATION
UPPER AUSTRIAN FOOTBALL ASSOCIATION	PARENTORGANIZATION	AUSTRIAN FOOTBALL ASSOCIATION
DESTINATION KOHLER	PARENTORGANIZATION	KOHLER COMPANY
NIPPON TAIKO FOUNDATION	PARENTORGANIZATION	AGENCY FOR CULTURAL AFFAIRS
INSTITUTE FOR SOCIAL ANTHROPOLOGY	PARENTORGANIZATION	AUSTRIAN ACADEMY OF SCIENCES
BURGENLAND FOOTBALL ASSOCIATION	PARENTORGANIZATION	AUSTRIAN FOOTBALL ASSOCIATION
LOWER AUSTRIAN FOOTBALL ASSOCIATION	PARENTORGANIZATION	AUSTRIAN FOOTBALL ASSOCIATION
VORARLBERG FOOTBALL ASSOCIATION	PARENTORGANIZATION	AUSTRIAN FOOTBALL ASSOCIATION
CENTRAL POLICY RESEARCH OFFICE	PARENTORGANIZATION	CENTRAL COMMITTEE OF THE COMMUNIST PARTY OF CHINA
I. I. SCHMALHAUSEN INSTITUTE OF ZOOLOGY	PARENTORGANIZATION	NATIONAL ACADEMY OF SCIENCES OF UKRAINE
SCION DTU	PARENTORGANIZATION	TECHNICAL UNIVERSITY OF DENMARK
EUROPEAN CHAPTER ON COMBINATORIAL OPTIMIZATION	PARENTORGANIZATION	ASSOCIATION OF EUROPEAN OPERATIONAL RESEARCH SOCIETIES
SWEDISH DYNAMIC SPORTS SHOOTING ASSOCIATION	PARENTORGANIZATION	INTERNATIONAL PRACTICAL SHOOTING CONFEDERATION
FEDERATION OF GERMAN MARKSMEN	PARENTORGANIZATION	INTERNATIONAL PRACTICAL SHOOTING CONFEDERATION
FEDERATION OF GERMAN MARKSMEN	PARENTORGANIZATION	INTERNATIONAL METALLIC SILHOUETTE SHOOTING UNION
FEDERATION OF GERMAN MARKSMEN	PARENTORGANIZATION	FIELD TARGET
DANISH SPORT SHOOTING ASSOCIATION	PARENTORGANIZATION	INTERNATIONAL PRACTICAL SHOOTING CONFEDERATION
DANISH SPORT SHOOTING ASSOCIATION	PARENTORGANIZATION	PRECISION PISTOL COMPETITION
DANISH SPORT SHOOTING ASSOCIATION	PARENTORGANIZATION	INTERNATIONAL METALLIC SILHOUETTE SHOOTING UNION
THAILAND PRACTICAL SHOOTING ASSOCIATION	PARENTORGANIZATION	INTERNATIONAL PRACTICAL SHOOTING CONFEDERATION
FINNISH SHOOTING SPORT FEDERATION	PARENTORGANIZATION	INTERNATIONAL PRACTICAL SHOOTING CONFEDERATION
FINNISH SHOOTING SPORT FEDERATION	PARENTORGANIZATION	INTERNATIONAL SHOOTING SPORT FEDERATION
FINNISH SHOOTING SPORT FEDERATION	PARENTORGANIZATION	INTERNATIONAL METALLIC SILHOUETTE SHOOTING UNION
FINNISH SHOOTING SPORT FEDERATION	PARENTORGANIZATION	WORLD BENCH REST SHOOTING FEDERATION
SOUTH AFRICAN PRACTICAL SHOOTING ASSOCIATION	PARENTORGANIZATION	INTERNATIONAL PRACTICAL SHOOTING CONFEDERATION
UNITED KINGDOM PRACTICAL SHOOTING ASSOCIATION	PARENTORGANIZATION	INTERNATIONAL PRACTICAL SHOOTING CONFEDERATION
PRACTICAL SHOOTING ASSOCIATION OF THE CZECH REPUBLIC	PARENTORGANIZATION	INTERNATIONAL PRACTICAL SHOOTING CONFEDERATION
SLOVAKIAN ASSOCIATION FOR DYNAMIC SHOOTING	PARENTORGANIZATION	INTERNATIONAL PRACTICAL SHOOTING CONFEDERATION
SERBIAN ASSOCIATION FOR PRACTICAL SHOOTING	PARENTORGANIZATION	INTERNATIONAL PRACTICAL SHOOTING CONFEDERATION
RUSSIAN FEDERATION OF PRACTICAL SHOOTING	PARENTORGANIZATION	INTERNATIONAL PRACTICAL SHOOTING CONFEDERATION
DYNAMIC SHOOTING ASSOCIATION SINGAPORE	PARENTORGANIZATION	INTERNATIONAL PRACTICAL SHOOTING CONFEDERATION
PDP NATIONAL WORKING COMMITTEE	PARENTORGANIZATION	PEOPLE'S DEMOCRATIC PARTY
DEPARTMENT OF PSYCHOLOGY, UNIVERSITY OF OSLO	PARENTORGANIZATION	UNIVERSITY OF OSLO
UNIVERSITY OF OSLO FACULTY OF MEDICINE	PARENTORGANIZATION	UNIVERSITY OF OSLO
NEPAL VOLLEYBALL ASSOCIATION	PARENTORGANIZATION	NATIONAL SPORTS COUNCIL
NAMIBIAN PRACTICAL SHOOTING ASSOCIATION	PARENTORGANIZATION	INTERNATIONAL PRACTICAL SHOOTING CONFEDERATION
ZIMBABWE PISTOL AND SMALLBORE ASSOCIATION	PARENTORGANIZATION	INTERNATIONAL PRACTICAL SHOOTING CONFEDERATION
PRECISION SHOOTING CLUB ANDORRA	PARENTORGANIZATION	INTERNATIONAL PRACTICAL SHOOTING CONFEDERATION
CENTRE FOR INTERNATIONAL CLIMATE AND ENVIRONMENTAL RESEARCH	PARENTORGANIZATION	UNIVERSITY OF OSLO
NORTHERN IRELAND PRACTICAL SHOOTING CONFEDERATION	PARENTORGANIZATION	INTERNATIONAL PRACTICAL SHOOTING CONFEDERATION
CHANNEL ISLANDS PRACTICAL SHOOTING ASSOCIATION	PARENTORGANIZATION	INTERNATIONAL PRACTICAL SHOOTING CONFEDERATION
GUAM NATIONAL SHOOTING SPORTS FEDERATION	PARENTORGANIZATION	INTERNATIONAL SHOOTING SPORT FEDERATION
GUAM SHOOTING SPORTS FEDERATION	PARENTORGANIZATION	INTERNATIONAL PRACTICAL SHOOTING CONFEDERATION
PHILIPPINE PRACTICAL SHOOTING ASSOCIATION	PARENTORGANIZATION	INTERNATIONAL PRACTICAL SHOOTING CONFEDERATION
BULGARIAN DYNAMIC SHOOTING FEDERATION	PARENTORGANIZATION	INTERNATIONAL PRACTICAL SHOOTING CONFEDERATION
ISLE OF MAN TARGET SHOOTING FEDERATION	PARENTORGANIZATION	INTERNATIONAL PRACTICAL SHOOTING CONFEDERATION
ISLE OF MAN TARGET SHOOTING FEDERATION	PARENTORGANIZATION	INTERNATIONAL SHOOTING SPORT FEDERATION
HONG KONG PRACTICAL SHOOTING ASSOCIATION	PARENTORGANIZATION	INTERNATIONAL PRACTICAL SHOOTING CONFEDERATION
IPSC JAPAN	PARENTORGANIZATION	INTERNATIONAL PRACTICAL SHOOTING CONFEDERATION
IPSC AUSTRALIA	PARENTORGANIZATION	INTERNATIONAL PRACTICAL SHOOTING CONFEDERATION
CHINA PRACTICAL SHOOTING ASSOCIATION	PARENTORGANIZATION	INTERNATIONAL PRACTICAL SHOOTING CONFEDERATION
GALWAY FOOTBALL ASSOCIATION	PARENTORGANIZATION	CONNACHT FOOTBALL ASSOCIATION
CHAJ	PARENTORGANIZATION	NEDERLANDS ISRAëLITISCHE GEMEENTE DEN HAAG
NEDERLANDS ISRAëLITISCHE GEMEENTE DEN HAAG	PARENTORGANIZATION	NEDERLANDS ISRAëLITISCH KERKGENOOTSCHAP
IPSC CANADA	PARENTORGANIZATION	INTERNATIONAL PRACTICAL SHOOTING CONFEDERATION
SWISS DYNAMIC SHOOTING FEDERATION	PARENTORGANIZATION	INTERNATIONAL PRACTICAL SHOOTING CONFEDERATION
PRACTICAL SHOOTING FEDERATION OF ARGENTINA	PARENTORGANIZATION	INTERNATIONAL PRACTICAL SHOOTING CONFEDERATION
IPSC BARBADOS	PARENTORGANIZATION	INTERNATIONAL PRACTICAL SHOOTING CONFEDERATION
ARUBA PRACTICAL SHOOTERS CLUB	PARENTORGANIZATION	INTERNATIONAL PRACTICAL SHOOTING CONFEDERATION
VEROLOG	PARENTORGANIZATION	ASSOCIATION OF EUROPEAN OPERATIONAL RESEARCH SOCIETIES
SCIENTOLOGY IN NORWAY	PARENTORGANIZATION	CHURCH OF SCIENTOLOGY INTERNATIONAL
PDP GOVERNORS FORUM	PARENTORGANIZATION	PEOPLE'S DEMOCRATIC PARTY
SLOVENIAN ASSOCIATION FOR PRACTICAL SHOOTING	PARENTORGANIZATION	INTERNATIONAL PRACTICAL SHOOTING CONFEDERATION
ROYAL SPANISH OLYMPIC SHOOTING FEDERATION	PARENTORGANIZATION	INTERNATIONAL PRACTICAL SHOOTING CONFEDERATION
ROYAL SPANISH OLYMPIC SHOOTING FEDERATION	PARENTORGANIZATION	INTERNATIONAL SHOOTING SPORT FEDERATION
TURKEY PRACTICAL SHOOTING ASSOCIATION	PARENTORGANIZATION	INTERNATIONAL PRACTICAL SHOOTING CONFEDERATION
MONACO SHOOTING FEDERATION	PARENTORGANIZATION	INTERNATIONAL PRACTICAL SHOOTING CONFEDERATION
MONACO SHOOTING FEDERATION	PARENTORGANIZATION	INTERNATIONAL SHOOTING SPORT FEDERATION
MONACO SHOOTING FEDERATION	PARENTORGANIZATION	FéDéRATION INTERNATIONALE DE TIR AUX ARMES SPORTIVES DE CHASSE
UKRAINIAN PRACTICAL SHOOTING ASSOCIATION	PARENTORGANIZATION	INTERNATIONAL PRACTICAL SHOOTING CONFEDERATION
NETHERLANDS PRACTICAL SHOOTING ASSOCIATION	PARENTORGANIZATION	INTERNATIONAL PRACTICAL SHOOTING CONFEDERATION
POLISH SPORT SHOOTING FEDERATION	PARENTORGANIZATION	INTERNATIONAL PRACTICAL SHOOTING CONFEDERATION
POLISH SPORT SHOOTING FEDERATION	PARENTORGANIZATION	INTERNATIONAL SHOOTING SPORT FEDERATION
PORTUGUESE SHOOTING FEDERATION	PARENTORGANIZATION	INTERNATIONAL PRACTICAL SHOOTING CONFEDERATION
PORTUGUESE SHOOTING FEDERATION	PARENTORGANIZATION	INTERNATIONAL SHOOTING SPORT FEDERATION
ROMANIAN DYNAMIC SHOOTING ASSOCIATION	PARENTORGANIZATION	INTERNATIONAL PRACTICAL SHOOTING CONFEDERATION
MONTENEGRIN PRACTICAL SHOOTING ASSOCIATION	PARENTORGANIZATION	INTERNATIONAL PRACTICAL SHOOTING CONFEDERATION
IPSC MOLDOVA	PARENTORGANIZATION	INTERNATIONAL PRACTICAL SHOOTING CONFEDERATION
RACE	PARENTORGANIZATION	UKAEA
ITALIAN DYNAMIC SHOOTING FEDERATION	PARENTORGANIZATION	INTERNATIONAL PRACTICAL SHOOTING CONFEDERATION
IPSC KAZAKHSTAN	PARENTORGANIZATION	INTERNATIONAL PRACTICAL SHOOTING CONFEDERATION
LITHUANIA PRACTICAL SHOOTING SPORT FEDERATION	PARENTORGANIZATION	INTERNATIONAL PRACTICAL SHOOTING CONFEDERATION
ASSOCIATION OF MALTESE ARMS COLLECTORS AND SHOOTERS	PARENTORGANIZATION	FEDERATION OF EUROPEAN SOCIETIES OF ARMS COLLECTORS
ASSOCIATION OF MALTESE ARMS COLLECTORS AND SHOOTERS	PARENTORGANIZATION	WORLD FIELD TARGET FEDERATION
ASSOCIATION OF MALTESE ARMS COLLECTORS AND SHOOTERS	PARENTORGANIZATION	INTERNATIONAL PRACTICAL SHOOTING CONFEDERATION
ASSOCIATION OF MALTESE ARMS COLLECTORS AND SHOOTERS	PARENTORGANIZATION	WORLD CROSSBOW SHOOTING ASSOCIATION
ASSOCIATION OF MALTESE ARMS COLLECTORS AND SHOOTERS	PARENTORGANIZATION	INTERNATIONAL METALLIC SILHOUETTE SHOOTING UNION
ISRAEL SHOOTING FEDERATION	PARENTORGANIZATION	INTERNATIONAL PRACTICAL SHOOTING CONFEDERATION
ISRAEL SHOOTING FEDERATION	PARENTORGANIZATION	INTERNATIONAL SHOOTING SPORT FEDERATION
BELGIAN PARCOURS SHOOTING ASSOCIATION	PARENTORGANIZATION	INTERNATIONAL PRACTICAL SHOOTING CONFEDERATION
BELARUSIAN FEDERATION OF PRACTICAL SHOOTING	PARENTORGANIZATION	INTERNATIONAL PRACTICAL SHOOTING CONFEDERATION
AUSTRIAN ASSOCIATION FOR PRACTICAL SHOOTING	PARENTORGANIZATION	INTERNATIONAL PRACTICAL SHOOTING CONFEDERATION
IPSC ARMENIA	PARENTORGANIZATION	INTERNATIONAL PRACTICAL SHOOTING CONFEDERATION
INTERNATIONAL RANGE OFFICERS ASSOCIATION	PARENTORGANIZATION	INTERNATIONAL PRACTICAL SHOOTING CONFEDERATION
MIT GLOBAL STARTUP WORKSHOP	PARENTORGANIZATION	MASSACHUSETTS INSTITUTE OF TECHNOLOGY
SOCIéTé FRANçAISE DE RECHERCHE OPéRATIONNELLE ET AIDE à LA DéCISION	PARENTORGANIZATION	ASSOCIATION OF EUROPEAN OPERATIONAL RESEARCH SOCIETIES
SOCIéTé FRANçAISE DE RECHERCHE OPéRATIONNELLE ET AIDE à LA DéCISION	PARENTORGANIZATION	INTERNATIONAL FEDERATION OF OPERATIONAL RESEARCH SOCIETIES
ALLIANCE FRANçAISE DE TORONTO	PARENTORGANIZATION	FONDATION ALLIANCE FRANçAISE
CENTRE ON CONFLICT, DEVELOPMENT AND PEACEBUILDING	PARENTORGANIZATION	GRADUATE INSTITUTE OF INTERNATIONAL AND DEVELOPMENT STUDIES
SINO-AMERICAN YOUTH AMBASSADORS	PARENTORGANIZATION	AMESON EDUCATION AND CULTURAL EXCHANGE FOUNDATION
AMESON YEAR IN CHINA	PARENTORGANIZATION	AMESON EDUCATION AND CULTURAL EXCHANGE FOUNDATION
KRIPKE CENTER	PARENTORGANIZATION	CREIGHTON UNIVERSITY
KRIPKE CENTER	PARENTORGANIZATION	OMAHA
KRIPKE CENTER	PARENTORGANIZATION	NEBRASKA
CENTER FOR URBAN RESEARCH AND LEARNING	PARENTORGANIZATION	LOYOLA UNIVERSITY CHICAGO
AFRICAN STORYBOOK	PARENTORGANIZATION	
COUNTIES MANUKAU DISTRICT HEALTH BOARD	PARENTORGANIZATION	MINISTRY OF HEALTH
INSTITUTE OF GLOBAL CONCERN	PARENTORGANIZATION	SOPHIA UNIVERSITY, TOKYO
DEPARTMENT OF SOCIOLOGY AND HUMAN GEOGRAPHY, UNIVERSITY OF OSLO	PARENTORGANIZATION	UNIVERSITY OF OSLO
CENTER FOR EDUCATION POLICY ANALYSIS	PARENTORGANIZATION	STANFORD UNIVERSITY
NEW DEMOCRATIC YOUTH OF ALBERTA	PARENTORGANIZATION	ALBERTA NDP
CONNACHT FOOTBALL ASSOCIATION	PARENTORGANIZATION	FOOTBALL ASSOCIATION OF IRELAND
CENTER FOR SOCIAL JUSTICE RESEARCH, TEACHING, & SERVICE	PARENTORGANIZATION	GEORGETOWN UNIVERSITY
SOUTH CAROLINA SCIENCE OLYMPIAD	PARENTORGANIZATION	SCIENCE OLYMPIAD
KERALA JAMI'YATHU AHLUSUNNA AL SALAFIYYA	PARENTORGANIZATION	KERALA JAMIYYATHUL ULAMA
PLANNED PRESIDENTIAL TRANSITION OF DONALD TRUMP	PARENTORGANIZATION	DONALD TRUMP PRESIDENTIAL CAMPAIGN, 2016
ULTRAHACK	PARENTORGANIZATION	
ULTRAHACK	PARENTORGANIZATION	
ULTRAHACK	PARENTORGANIZATION	
ULTRAHACK	PARENTORGANIZATION	EN
CATHOLIC BISHOPS' CONFERENCE OF JAPAN	PARENTORGANIZATION	CATHOLIC CHURCH
FRANCISCANS OF LIFE	PARENTORGANIZATION	CATHOLIC CHURCH
ALDERNEY BIRD OBSERVATORY	PARENTORGANIZATION	ALDERNEY WILDLIFE TRUST
AFRICAN GOVERNANCE ARCHITECTURE	PARENTORGANIZATION	AFRICAN UNION
IOWA SENATE, DISTRICT 28	PARENTORGANIZATION	IOWA GENERAL ASSEMBLY
IOWA SENATE, DISTRICT 1	PARENTORGANIZATION	IOWA GENERAL ASSEMBLY
ORDER OF FRIARS MINOR	PARENTORGANIZATION	CATHOLIC CHURCH
AGROPHYSICAL RESEARCH INSTITUTE	PARENTORGANIZATION	RUSSIAN ACADEMY OF AGRICULTURAL SCIENCES, RUSSIAN ACADEMY OF SCIENCES
BELGIAN SOCIETY FOR OPERATIONS RESEARCH	PARENTORGANIZATION	ASSOCIATION OF EUROPEAN OPERATIONAL RESEARCH SOCIETIES
BELGIAN SOCIETY FOR OPERATIONS RESEARCH	PARENTORGANIZATION	INTERNATIONAL FEDERATION OF OPERATIONAL RESEARCH SOCIETIES
BOHDAN DOBRZAńSKI INSTITUTE OF AGROPHYSICS	PARENTORGANIZATION	POLISH ACADEMY OF SCIENCES
SWEDISH RED CROSS	PARENTORGANIZATION	INTERNATIONAL FEDERATION OF RED CROSS AND RED CRESCENT SOCIETIES
WASHINGTON STATE GOLF ASSOCIATION	PARENTORGANIZATION	UNITED STATES GOLF ASSOCIATION
NO FLY ZONE	PARENTORGANIZATION	DENVER BRONCOS
FRENCH SHOOTING FEDERATION	PARENTORGANIZATION	INTERNATIONAL PRACTICAL SHOOTING CONFEDERATION
FRENCH SHOOTING FEDERATION	PARENTORGANIZATION	INTERNATIONAL SHOOTING SPORT FEDERATION
CENTER ON JUVENILE AND CRIMINAL JUSTICE	PARENTORGANIZATION	NATIONAL CENTER ON INSTITUTIONS AND ALTERNATIVES
@HOME	PARENTORGANIZATION	NILKAMAL PLASTICS
AUSTRIAN SOCIETY OF OPERATIONS RESEARCH	PARENTORGANIZATION	ASSOCIATION OF EUROPEAN OPERATIONAL RESEARCH SOCIETIES
AUSTRIAN SOCIETY OF OPERATIONS RESEARCH	PARENTORGANIZATION	INTERNATIONAL FEDERATION OF OPERATIONAL RESEARCH SOCIETIES
IOWA SENATE, DISTRICT 4	PARENTORGANIZATION	IOWA GENERAL ASSEMBLY
IOWA SENATE, DISTRICT 3	PARENTORGANIZATION	IOWA GENERAL ASSEMBLY
IOWA SENATE, DISTRICT 2	PARENTORGANIZATION	IOWA GENERAL ASSEMBLY
IOWA SENATE, DISTRICT 6	PARENTORGANIZATION	IOWA GENERAL ASSEMBLY
IOWA SENATE, DISTRICT 5	PARENTORGANIZATION	IOWA GENERAL ASSEMBLY
IOWA SENATE, DISTRICT 7	PARENTORGANIZATION	IOWA GENERAL ASSEMBLY
IOWA SENATE, DISTRICT 8	PARENTORGANIZATION	IOWA GENERAL ASSEMBLY
LANCASTER ARTS AT LANCASTER UNIVERSITY	PARENTORGANIZATION	LANCASTER UNIVERSITY
IOWA SENATE, DISTRICT 9	PARENTORGANIZATION	IOWA GENERAL ASSEMBLY
IOWA SENATE, DISTRICT 10	PARENTORGANIZATION	IOWA GENERAL ASSEMBLY
IOWA SENATE, DISTRICT 11	PARENTORGANIZATION	IOWA GENERAL ASSEMBLY
IOWA SENATE, DISTRICT 12	PARENTORGANIZATION	IOWA GENERAL ASSEMBLY
IOWA SENATE, DISTRICT 13	PARENTORGANIZATION	IOWA GENERAL ASSEMBLY
IOWA SENATE, DISTRICT 14	PARENTORGANIZATION	IOWA GENERAL ASSEMBLY
IOWA SENATE, DISTRICT 15	PARENTORGANIZATION	IOWA GENERAL ASSEMBLY
IOWA SENATE, DISTRICT 16	PARENTORGANIZATION	IOWA GENERAL ASSEMBLY
IOWA SENATE, DISTRICT 17	PARENTORGANIZATION	IOWA GENERAL ASSEMBLY
IOWA SENATE, DISTRICT 19	PARENTORGANIZATION	IOWA GENERAL ASSEMBLY
IOWA SENATE, DISTRICT 18	PARENTORGANIZATION	IOWA GENERAL ASSEMBLY
IOWA SENATE, DISTRICT 20	PARENTORGANIZATION	IOWA GENERAL ASSEMBLY
AMALTHEA	PARENTORGANIZATION	IIT GANDHINAGAR
IOWA SENATE, DISTRICT 21	PARENTORGANIZATION	IOWA GENERAL ASSEMBLY
IOWA SENATE, DISTRICT 23	PARENTORGANIZATION	IOWA GENERAL ASSEMBLY
IOWA SENATE, DISTRICT 22	PARENTORGANIZATION	IOWA GENERAL ASSEMBLY
IOWA SENATE, DISTRICT 24	PARENTORGANIZATION	IOWA GENERAL ASSEMBLY
IOWA SENATE, DISTRICT 25	PARENTORGANIZATION	IOWA GENERAL ASSEMBLY
IOWA SENATE, DISTRICT 27	PARENTORGANIZATION	IOWA GENERAL ASSEMBLY
IOWA SENATE, DISTRICT 26	PARENTORGANIZATION	IOWA GENERAL ASSEMBLY
IOWA SENATE, DISTRICT 30	PARENTORGANIZATION	IOWA GENERAL ASSEMBLY
IOWA SENATE, DISTRICT 29	PARENTORGANIZATION	IOWA GENERAL ASSEMBLY
IOWA SENATE, DISTRICT 31	PARENTORGANIZATION	IOWA GENERAL ASSEMBLY
IOWA SENATE, DISTRICT 32	PARENTORGANIZATION	IOWA GENERAL ASSEMBLY
IOWA SENATE, DISTRICT 33	PARENTORGANIZATION	IOWA GENERAL ASSEMBLY
IOWA SENATE, DISTRICT 34	PARENTORGANIZATION	IOWA GENERAL ASSEMBLY
IOWA SENATE, DISTRICT 35	PARENTORGANIZATION	IOWA GENERAL ASSEMBLY
IOWA SENATE, DISTRICT 36	PARENTORGANIZATION	IOWA GENERAL ASSEMBLY
IOWA SENATE, DISTRICT 37	PARENTORGANIZATION	IOWA GENERAL ASSEMBLY
IOWA SENATE, DISTRICT 38	PARENTORGANIZATION	IOWA GENERAL ASSEMBLY
IOWA SENATE, DISTRICT 39	PARENTORGANIZATION	IOWA GENERAL ASSEMBLY
IOWA SENATE, DISTRICT 40	PARENTORGANIZATION	IOWA GENERAL ASSEMBLY
IOWA SENATE, DISTRICT 41	PARENTORGANIZATION	IOWA GENERAL ASSEMBLY
IOWA SENATE, DISTRICT 42	PARENTORGANIZATION	IOWA GENERAL ASSEMBLY
IOWA SENATE, DISTRICT 43	PARENTORGANIZATION	IOWA GENERAL ASSEMBLY
IOWA SENATE, DISTRICT 44	PARENTORGANIZATION	IOWA GENERAL ASSEMBLY
IOWA SENATE, DISTRICT 45	PARENTORGANIZATION	IOWA GENERAL ASSEMBLY
IOWA SENATE, DISTRICT 46	PARENTORGANIZATION	IOWA GENERAL ASSEMBLY
IOWA SENATE, DISTRICT 47	PARENTORGANIZATION	IOWA GENERAL ASSEMBLY
IOWA SENATE, DISTRICT 48	PARENTORGANIZATION	IOWA GENERAL ASSEMBLY
IOWA SENATE, DISTRICT 49	PARENTORGANIZATION	IOWA GENERAL ASSEMBLY
IOWA SENATE, DISTRICT 50	PARENTORGANIZATION	IOWA GENERAL ASSEMBLY
OPERATIONS RESEARCH SOCIETY OF SOUTH AFRICA	PARENTORGANIZATION	ASSOCIATION OF EUROPEAN OPERATIONAL RESEARCH SOCIETIES
BOLIVIAN PRACTICAL SHOOTING FEDERATION	PARENTORGANIZATION	INTERNATIONAL PRACTICAL SHOOTING CONFEDERATION
BRAZILIAN CONFEDERATION OF PRACTICAL SHOOTING	PARENTORGANIZATION	INTERNATIONAL PRACTICAL SHOOTING CONFEDERATION
IPSC CHILE	PARENTORGANIZATION	INTERNATIONAL PRACTICAL SHOOTING CONFEDERATION
GUYANA SPORT SHOOTING FEDERATION	PARENTORGANIZATION	INTERNATIONAL PRACTICAL SHOOTING CONFEDERATION
GUYANA SPORT SHOOTING FEDERATION	PARENTORGANIZATION	STEEL CHALLENGE
GUYANA SPORT SHOOTING FEDERATION	PARENTORGANIZATION	WORLD ARCHERY FEDERATION
GUYANA SPORT SHOOTING FEDERATION	PARENTORGANIZATION	AMATEUR TRAPSHOOTING ASSOCIATION
PARAGUAY PRACTICAL SHOOTING ASSOCIATION	PARENTORGANIZATION	INTERNATIONAL PRACTICAL SHOOTING CONFEDERATION
IPSC PERU	PARENTORGANIZATION	INTERNATIONAL PRACTICAL SHOOTING CONFEDERATION
IPSC SURINAME	PARENTORGANIZATION	INTERNATIONAL PRACTICAL SHOOTING CONFEDERATION
IPSC URUGUAY	PARENTORGANIZATION	INTERNATIONAL PRACTICAL SHOOTING CONFEDERATION
IPSC CAYMAN ISLANDS	PARENTORGANIZATION	INTERNATIONAL PRACTICAL SHOOTING CONFEDERATION
PRACTICAL SHOOTING ASSOCIATION OF COSTA RICA	PARENTORGANIZATION	INTERNATIONAL PRACTICAL SHOOTING CONFEDERATION
COLOMBIAN ASSOCIATION OF PRACTICAL SHOOTING	PARENTORGANIZATION	INTERNATIONAL PRACTICAL SHOOTING CONFEDERATION
IPSC ECUADOR	PARENTORGANIZATION	INTERNATIONAL PRACTICAL SHOOTING CONFEDERATION
CURAçAO PRACTICAL SHOOTERS CLUB	PARENTORGANIZATION	INTERNATIONAL PRACTICAL SHOOTING CONFEDERATION
EL SALVADOR PRACTICAL SHOOTING ASSOCIATION	PARENTORGANIZATION	INTERNATIONAL PRACTICAL SHOOTING CONFEDERATION
IPSC GUATEMALA	PARENTORGANIZATION	INTERNATIONAL PRACTICAL SHOOTING CONFEDERATION
HONDURAN ASSOCIATION PRACTICAL SHOOTING	PARENTORGANIZATION	INTERNATIONAL PRACTICAL SHOOTING CONFEDERATION
PRACTICAL SHOOTING FEDERATION OF VENEZUELA	PARENTORGANIZATION	INTERNATIONAL PRACTICAL SHOOTING CONFEDERATION
TRINIDAD RIFLE ASSOCIATION	PARENTORGANIZATION	INTERNATIONAL PRACTICAL SHOOTING CONFEDERATION
TRINIDAD RIFLE ASSOCIATION	PARENTORGANIZATION	INTERNATIONAL SHOOTING SPORT FEDERATION
SAINT LUCIA SHOOTING ASSOCIATION	PARENTORGANIZATION	INTERNATIONAL PRACTICAL SHOOTING CONFEDERATION
PUERTO RICO PRACTICAL SHOOTING ASSOCIATION	PARENTORGANIZATION	INTERNATIONAL PRACTICAL SHOOTING CONFEDERATION
IPSC NICARAGUA	PARENTORGANIZATION	INTERNATIONAL PRACTICAL SHOOTING CONFEDERATION
PRACTICAL SHOOTING ASSOCIATION OF PANAMA	PARENTORGANIZATION	INTERNATIONAL PRACTICAL SHOOTING CONFEDERATION
JAMAICA RIFLE ASSOCIATION	PARENTORGANIZATION	INTERNATIONAL PRACTICAL SHOOTING CONFEDERATION
JAMAICA RIFLE ASSOCIATION	PARENTORGANIZATION	INTERNATIONAL SHOOTING SPORT FEDERATION
JAMAICA RIFLE ASSOCIATION	PARENTORGANIZATION	WORLD ARCHERY FEDERATION
IPSC BOSNIA HERZEGOVINA	PARENTORGANIZATION	INTERNATIONAL PRACTICAL SHOOTING CONFEDERATION
CROATIAN PRACTICAL SHOOTING ASSOCIATION	PARENTORGANIZATION	INTERNATIONAL PRACTICAL SHOOTING CONFEDERATION
IPSC CYPRUS	PARENTORGANIZATION	INTERNATIONAL PRACTICAL SHOOTING CONFEDERATION
HELLENIC SHOOTING FEDERATION	PARENTORGANIZATION	INTERNATIONAL PRACTICAL SHOOTING CONFEDERATION
GIBRALTAR PISTOL ASSOCIATION	PARENTORGANIZATION	INTERNATIONAL PRACTICAL SHOOTING CONFEDERATION
ESTONIAN PRACTICAL SHOOTING ASSOCIATION	PARENTORGANIZATION	INTERNATIONAL PRACTICAL SHOOTING CONFEDERATION
IPSC HUNGARY	PARENTORGANIZATION	INTERNATIONAL PRACTICAL SHOOTING CONFEDERATION
IRISH TARGET SPORTS	PARENTORGANIZATION	INTERNATIONAL PRACTICAL SHOOTING CONFEDERATION
IPSC KYRGYZSTAN	PARENTORGANIZATION	INTERNATIONAL PRACTICAL SHOOTING CONFEDERATION
IPSC LATVIA	PARENTORGANIZATION	INTERNATIONAL PRACTICAL SHOOTING CONFEDERATION
IPSC CAMBODIA	PARENTORGANIZATION	INTERNATIONAL PRACTICAL SHOOTING CONFEDERATION
IPSC INDONESIA	PARENTORGANIZATION	INTERNATIONAL PRACTICAL SHOOTING CONFEDERATION
IPSC KUWAIT	PARENTORGANIZATION	INTERNATIONAL PRACTICAL SHOOTING CONFEDERATION
IPSC LAOS	PARENTORGANIZATION	INTERNATIONAL PRACTICAL SHOOTING CONFEDERATION
IPSC MACAU ASSOCIATION	PARENTORGANIZATION	INTERNATIONAL PRACTICAL SHOOTING CONFEDERATION
IPSC TAIWAN	PARENTORGANIZATION	INTERNATIONAL PRACTICAL SHOOTING CONFEDERATION
IPSC SRI LANKA	PARENTORGANIZATION	INTERNATIONAL PRACTICAL SHOOTING CONFEDERATION
PAPUA NEW GUINEA PRACTICAL SHOOTING ASSOCIATION	PARENTORGANIZATION	INTERNATIONAL PRACTICAL SHOOTING CONFEDERATION
MONGOLIAN SHOOTING ASSOCIATION	PARENTORGANIZATION	INTERNATIONAL PRACTICAL SHOOTING CONFEDERATION
IPSC MALAYSIA	PARENTORGANIZATION	INTERNATIONAL PRACTICAL SHOOTING CONFEDERATION
CALINAN FOOTBALL CLUB	PARENTORGANIZATION	DAVAO F.A.
SPANISH STATISTICS AND OPERATIONS RESEARCH SOCIETY	PARENTORGANIZATION	ASSOCIATION OF EUROPEAN OPERATIONAL RESEARCH SOCIETIES
SPANISH STATISTICS AND OPERATIONS RESEARCH SOCIETY	PARENTORGANIZATION	INTERNATIONAL FEDERATION OF OPERATIONAL RESEARCH SOCIETIES
DOMINICAN REPUBLIC SHOOTING FEDERATION	PARENTORGANIZATION	INTERNATIONAL SHOOTING SPORT FEDERATION
EURO WORKING GROUP ON LOCATIONAL ANALYSIS	PARENTORGANIZATION	ASSOCIATION OF EUROPEAN OPERATIONAL RESEARCH SOCIETIES
PONTIFICAL COUNCIL FOR DIALOGUE WITH NON-BELIEVERS	PARENTORGANIZATION	ROMAN CURIA
GENERAL DEBATE OF THE SEVENTY-FIRST SESSION OF THE UNITED NATIONS GENERAL ASSEMBLY	PARENTORGANIZATION	UNITED NATIONS
EUROPT, CONTINUOUS OPTIMIZATION WORKING GROUP OF EURO	PARENTORGANIZATION	ASSOCIATION OF EUROPEAN OPERATIONAL RESEARCH SOCIETIES
NATIONAL CLARION CYCLING CLUB 1895	PARENTORGANIZATION	NATIONAL CLARION CYCLING CLUB
PUNJAB POLICE COLLEGE SIHALA	PARENTORGANIZATION	GOVERNMENT OF PAKISTAN
ROBIN HOOD ENERGY	PARENTORGANIZATION	NOTTINGHAM CITY COUNCIL
CHEMICAL INSTITUTE OF SARRIá	PARENTORGANIZATION	RAMON LLULL UNIVERSITY
