Grant Park (Chicago)	picture	Buckingham Fountain
Fort Ticonderoga	picture	Ticonderoga (hamlet), New York
Eureka, Utah  Eureka Historic District   1	picture	Eureka (word)
Mount Vernon	picture	Mount Vernon, Virginia
The Clouds	picture	Socrates
...And Justice for All (album)	picture	Metallica
Proof (play)	picture	Mathematical proof
Carnegie Hall	picture	Carnegie Hall, Inc.
Washington National Cathedral	picture	George Washington
England, Half-English	picture	England
Robert F. Kennedy Bridge	picture	Hell Gate
Lambeth Bridge	picture	River Thames
Drum Barracks	picture	Wilmington, Los Angeles
Southwark Bridge	picture	River Thames
Southwark Bridge	picture	London
Waterloo Bridge	picture	River Thames
Westminster Bridge	picture	River Thames
Hungerford Bridge and Golden Jubilee Bridges	picture	River Thames
Hungerford Bridge and Golden Jubilee Bridges	picture	London
Grosvenor Bridge	picture	River Thames
Grosvenor Bridge	picture	London
Hearts of Oak (album)	picture	Ted Leo
National Building Museum	picture	National Law Enforcement Officers Memorial
The Mousetrap	picture	St Martin's Theatre
Sino-Korean Friendship Bridge	picture	Dandong
Wadsworth Atheneum	picture	Hartford, Connecticut
Old North Church	picture	North End, Boston
Royal Mausoleum of Hawaii	picture	Honolulu
Electra (Sophocles)	picture	Electra
Kykuit	picture	Tarrytown, New York
Uncle Vanya	picture	Astrov
First Baptist Church in America	picture	Providence, Rhode Island
Consolidated Mine	picture	Underground mining (hard rock)#Block Caving
Cobi Jones	picture	Ruud Gullit
Tri-Rail and Metrorail Transfer Station	picture	Tri-Rail
Rock Against Bush, Vol. 1	picture	Rock Against Bush
Rock Against Bush, Vol. 2	picture	Rock Against Bush
Arena (An Absurd Notion)	picture	Arena (Duran Duran album)
Arena (An Absurd Notion)	picture	Duran Duran
Brunswick Street, Melbourne	picture	Fitzroy, Victoria
Denis Irwin	picture	The Cliff (training ground)
Trinity Church (Boston)	picture	Trinity Church
Standedge Tunnels	picture	Marsden, West Yorkshire
Lovell House	picture	Los Angeles
Rose Bowl (stadium)  Rose Bowl, The   1	picture	Rose Bowl Game
Roger Miret and The Disasters (album)	picture	Roger Miret
1984 (Roger Miret and The Disasters album)	picture	Roger Miret
Rock Creek and Potomac Parkway	picture	Rock Creek Park
Tarcisio Burgnich	picture	René Houseman
Tell Balgeary, Balgury Is Dead	picture	Ted Leo
Boston Athenæum	picture	Boston
Fire and Water (Ecoutez Vos Murs)	picture	Dave Greenfield
Mighty ReArranger	picture	Robert Plant
Oxted railway station	picture	Southern (train operating company)
Oxted railway station	picture	Connex South Central
Treble in Trouble	picture	Ted Leo
Mashmakhan/The Family	picture	Mashmakhan
The Elms (Newport, Rhode Island)	picture	Newport, Rhode Island
Swing Bridge, River Tyne	picture	High Level Bridge
Hollywood/Vine (Los Angeles Metro station)	picture	Hollywood
Litchfield Law School	picture	Litchfield (borough), Connecticut
CSN (album)	picture	David Crosby
Chicken tikka	picture	Chicken Tikka:[[File:Chk Tikka.jpg
Brown Hotel (Louisville, Kentucky)	picture	Louisville, Kentucky
McDonald and Giles	picture	Ian McDonald (musician)
Arrowhead (Herman Melville House)	picture	Pittsfield, Massachusetts
Difford & Tilbrook (album)	picture	Chris Difford
Ptah, the El Daoud	picture	Ptah
Former Chicago Historical Society Building	picture	Chicago History Museum
Marble House	picture	Newport, Rhode Island
Kitchener railway station	picture	Kitchener, Ontario
Rock the House (album)	picture	DJ Jazzy Jeff
Sunnyside (Tarrytown, New York)	picture	Tarrytown, New York
Peter Tufts House	picture	Medford, Massachusetts
Grandfather's House	picture	Medford, Massachusetts
Philipsburg Manor House	picture	Philipsburg Manor
Philipsburg Manor House	picture	Sleepy Hollow, New York
Rügen Bridge	picture	Stralsund
Rügen Bridge	picture	Germany
Tej leo(?), Rx / pharmacists	picture	Ted Leo
Murray Baker Bridge	picture	Peoria, Illinois
Unfabulous and More	picture	Unfabulous
Buffalo City Hall	picture	Buffalo, New York
Leach Highway	picture	Myaree, Western Australia
Yousuf Al-Thunayan	picture	Youssef Al-Thunayan celebration 2.jpn
Prospect Park (SEPTA station)	picture	Amtrak
Allen University    1	picture	Chappelle Administration Building
Luís Pereira	picture	1974 FIFA World Cup
Amesbury Friends Meeting House	picture	Amesbury, Massachusetts
Undercurrent (Bill Evans and Jim Hall album)	picture	Bill Evans
Bittersweet (album)	picture	Blu Cantrell
Ashburnham Center Historic District	picture	Ashburnham, Massachusetts
Kiev Passenger Railway Station	picture	Kiev
Capitol Theatre, Melbourne	picture	Swanston Street, Melbourne
Morristown (NJT station)	picture	Morristown, New Jersey
Memphis & Arkansas Bridge	picture	Memphis, Tennessee
Central Railroad of New Jersey Terminal	picture	Liberty State Park
General Belgrano Bridge	picture	Corrientes
Weather and Forecasting	picture	Weather forecasting
Viking (album)	picture	Lars Frederiksen
Lars Frederiksen and the Bastards (album)	picture	Lars Frederiksen
Nehemiah Royce House	picture	Wallingford, Connecticut
Hammersmith Odeon London '75	picture	Hammersmith Apollo
Camelback Bridge	picture	Normal, Illinois
Eleanor Schonell Bridge	picture	Brisbane
Napalm Death/S.O.B. split 7"	picture	Napalm Death
Namkeen  amkeen   1	picture	List of Indian snacks
Allen County Museum  acDonell House   1	picture	Lima
His Majesty's Theatre, Perth	picture	His Majesty's Theatre
Phoenicia Railroad Station	picture	Phoenicia, New York
Phoenicia Railroad Station	picture	New York
Randolph Hotel (Des Moines, Iowa)	picture	Des Moines, Iowa
Traffic Bridge (Saskatoon)	picture	Nutana, Saskatoon
Elephant Micah, Your Dreams Are Feeding Back	picture	Elephant Micah
20 år med oss – Vem é dé du vill ha	picture	Kikki Danielsson
20 år med oss – Vem é dé du vill ha	picture	Elisabeth Andreassen
Emily Dickinson Museum	picture	Amherst, Massachusetts
Webb Horton House	picture	Orange County Community College
Webb Horton House	picture	Middletown, Orange County, New York
Mariusz Jop	picture	Oleg Kuzmin
28 (album)	picture	Aoki Takamasa
In Colour	picture	The Concretes
A Certain Smile, a Certain Sadness	picture	A Certain Smile (song)
Prospect Hall (Frederick, Maryland)	picture	Frederick
Fleetwood Mac in Chicago/Blues Jam in Chicago, Vols. 1–2	picture	Fleetwood Mac
Princess Theatre, Melbourne	picture	Melbourne
Charles River Reservation	picture	Boston
Blair High School (Blair, Nebraska)	picture	Blair, Nebraska
Chatham (NJT station)	picture	Chatham, New Jersey
Madison (NJT station)	picture	Madison, New Jersey
Pearl River (Metro-North station)	picture	Pearl River, New York
Nanuet (Metro-North station)	picture	Nanuet, New York
8th Street (HBLR station)	picture	Bayonne, New Jersey
Middletown – Town of Wallkill (Metro-North station)	picture	Middletown, Orange County, New York
Fort Churchill and Sand Springs Toll Road	picture	Fort Churchill State Historic Park#Fort Churchill
Villa Zorayda	picture	St. Augustine, Florida
Harry Potter and the Goblet of Fire (soundtrack)	picture	Harry Potter (character)
Julie Doiron and the Wooden Stars	picture	Julie Doiron
Boothe Memorial Park and Museum	picture	Stratford, Connecticut
The Tin Angel	picture	Odetta
Logan Road, Brisbane	picture	Greenslopes, Queensland
Child of Glass (album)	picture	Blutengel
Valses venezolanos (album)	picture	Aldemaro Romero
Kyoto Gardens of Honolulu Memorial Park	picture	Honolulu
Kossoff, Kirke, Tetsu and Rabbit	picture	Simon Kirke
Kossoff, Kirke, Tetsu and Rabbit	picture	Tetsu Yamauchi
Centre Bridge–Stockton Bridge	picture	Centre Bridge, Pennsylvania
Lyric Theatre (Stuart, Florida)	picture	Stuart, Florida
Grey Towers Castle	picture	Arcadia University
Bobbie Gentry and Glen Campbell	picture	Bobbie Gentry
Brickell Mausoleum	picture	Miami
Under Construction, Part II	picture	Under Construction
Lynchburg-Kemper Street Station (Virginia)	picture	Lynchburg, Virginia
The Bluetones (album)	picture	My Neighbour's House
Roger McGuinn & Band	picture	Roger McGuinn
Michael Leary	picture	Grimsby Town F.C.
Taman Paramount LRT station	picture	Petaling Jaya
Sentul Timur LRT station	picture	Sentul
Chillout Sessions  9   1	picture	Chillout Sessions
Chillout Sessions  XIII   1	picture	Chillout Sessions XIII
Mory's	picture	New Haven, Connecticut
St. Paul's Mission	picture	Franklin D. Roosevelt Lake
Bayley House	picture	Newton, Massachusetts
Paul Bunyan and Babe the Blue Ox	picture	Paul Bunyan
The Poacher Diaries	picture	Converge (band)
Dutch Reformed Church (Newburgh, New York)	picture	Dutch Reformed Church
Shibaraku	picture	Japan
In Concert (America album)	picture	America (band)
4,000 Weeks' Holiday	picture	Ian Dury
Hawkwind, Friends and Relations	picture	Hawkwind
Hawkwind, Friends and Relations  Hawkwind, Friends & Relations: Twice Upon a Time   1	picture	Hawkwind
Hawkwind, Friends and Relations  Hawkwind, Friends & Relations Vol. 3   1	picture	Hawkwind
Hawkwind, Friends and Relations  The Best of Hawkwind, Friends and Relations   1	picture	Hawkwind
Hawkwind, Friends and Relations  Hawkwind, Friends & Relations: The Rarities   1	picture	Hawkwind
Hawkwind, Friends and Relations  Hawkwind, Friends & Relations, Vol. 6: Cosmic Trav  1	picture	Hawkwind
Living with the Living	picture	Ted Leo
Daniel Waring House	picture	Montgomery (village), New York
Army Medical Museum and Library	picture	National Museum of Health and Medicine
Episcopal Burying Ground and Chapel (Lexington, Kentucky)	picture	Chapel
Christmas in My Heart	picture	Christmas music
Ward Hall (Georgetown, Kentucky)	picture	Georgetown, Kentucky
Together Again (George Jones and Tammy Wynette album)	picture	George Jones
Put Yourself in My Shoes	picture	Clint Black
Nothin' but the Taillights	picture	Clint Black
Greatest Hits (Clint Black album)	picture	Clint Black
Greatest Hits II (Clint Black album)	picture	Clint Black
Spend My Time	picture	Clint Black
Drinkin' Songs and Other Logic	picture	Clint Black
Nick Lowe and His Cowboy Outfit (album)	picture	Nick Lowe
Family Values Tour 2006 CD	picture	Family Values Tour
Polo Independent Order of Odd Fellows Lodge No. 197	picture	Polo, Illinois
Chana School	picture	Oregon, Illinois
Soldier's Monument (Byron, Illinois)	picture	Byron, Illinois
John Coltrane and Johnny Hartman	picture	John Coltrane
The Love Songs (Clint Black album)	picture	Clint Black
Pont-Saint-Martin (bridge)	picture	Aosta Valley
Roman Bridge (Vaison-la-Romaine)	picture	Vaison-la-Romaine
Indiana Jones and the Last Crusade (soundtrack)	picture	Indiana Jones
Firefly and Live!	picture	Firefly (TNT album)
Lyle Lovett and His Large Band	picture	Lyle Lovett
Joanna Newsom and the Ys Street Band	picture	Joanna Newsom
Prince (Amtrak station)	picture	Prince, West Virginia
Portland Transportation Center	picture	Amtrak
Sonoma Developmental Center	picture	Eldridge, California
Institut Kultury (Minsk Metro)	picture	Minsk Metro
Alice Cooper and Friends	picture	Alice Cooper
Governor John Langdon House	picture	Portsmouth, New Hampshire
Cathedral of the Most Blessed Sacrament	picture	Detroit
The Motorcycle Diaries (soundtrack)	picture	The Motorcycle Diaries (film)
Jaren Station	picture	Gran
Jaren Station	picture	Norway
Alconétar Bridge	picture	Province of Cáceres
Gainesville, Texas (Amtrak station)	picture	Gainesville, Texas
Guitar for Jodi	picture	Ted Leo
Mo' Living	picture	Ted Leo
La Grange (Amtrak station)	picture	La Grange, Illinois
Hutchinson (Amtrak station)	picture	Hutchinson, Kansas
Lamar (Amtrak station)	picture	Lamar, Colorado
La Junta (Amtrak station)	picture	La Junta, Colorado
McCook (Amtrak station)	picture	McCook, Nebraska
Nilai Komuter station	picture	Nilai
Monstereo Delicio	picture	Monstereo.jpg
North Side Historic District (Peoria, Illinois)	picture	Peoria, Illinois
Rock Island Depot and Freight House	picture	Peoria, Illinois
All Angels (album)	picture	All Angels
Burl Ives and the Korean Orphan Choir Sing of Faith and Joy	picture	Burl Ives
Untold Passion	picture	Neal Schon
Here to Stay (Schon & Hammer album)	picture	Neal Schon
Alvin Lee and Company	picture	Alvin Lee
Cincinnati, Richmond, & Muncie Depot	picture	Muncie, Indiana
Ruben Mendoza	picture	1956 Summer Olympics
Ajiyoshi Station (Meitetsu)	picture	Ajiyoshi Station (Jōhoku Line)
Smith's Castle	picture	Wickford, Rhode Island
Deuce (play)	picture	Angela Lansbury
Union Street-Academy Hill Historic District	picture	Montgomery (village), New York
Georgetown-Silver Plume Historic District	picture	Georgetown Loop
The Balsams Grand Resort Hotel	picture	Dixville Notch, New Hampshire
Flashback (Joan Jett album)	picture	Joan Jett
Evil Stig	picture	Joan Jett
Gauler Twin Houses	picture	Chicago
Moffat Library	picture	Washingtonville, New York
Stepping Stones (home)	picture	Katonah, New York
Viva la Bands, Volume 2	picture	Viva la Bands
One with Everything: Styx and the Contemporary Youth Orchestra	picture	Styx (band)
St. Pius X Catholic Church (Cincinnati, Ohio)	picture	Cincinnati
Historic Track	picture	Goshen (village), New York
Buffalo and Erie County Historical Society	picture	Buffalo, New York
Carlos Santana and Wayne Shorter – Live at the Montreux Jazz Festival 1988	picture	Carlos Santana
Old Town Cemetery (Newburgh, New York)	picture	Newburgh (city), New York
Hurley Historic District	picture	Hurley, New York
U.S. Post Office (Rhinebeck, New York)	picture	Rhinebeck (village), New York
U.S. Post Office (Rhinebeck, New York)	picture	New York
United States Post Office (Hyde Park, New York)	picture	Hyde Park, New York
United States Post Office (Hyde Park, New York)	picture	New York
Lower Main Street Historic District (Beacon, New York)	picture	Beacon, New York
Akira Toriyama: The World	picture	Akira Toriyama
Van Alen House	picture	Kinderhook (town), New York
St. Thomas Episcopal Church (New Windsor, New York)	picture	New Windsor, New York
California Avenue (Caltrain station)	picture	California
United States Post Office (Newburgh, New York)	picture	Newburgh (city), New York
United States Post Office (Newburgh, New York)	picture	New York
Montgomery-Grand-Liberty Streets Historic District	picture	Newburgh (city), New York
Canfield Casino and Congress Park	picture	Saratoga Springs, New York
A Couple More Years	picture	Ronnie Drew
Steepletop	picture	Austerlitz, New York
Harmony Mills	picture	Cohoes, New York
King of the World	picture	Sheila
New York State Armory (Newburgh)	picture	Newburgh (city), New York
Cobblestone Historic District	picture	Childs, New York
Paramount Theatre (Middletown, New York)	picture	Middletown, Orange County, New York
Lemuel Haynes House	picture	Granville, New York
Hyde Hall Bridge	picture	Hyde Hall
Jay Bridge	picture	Jay, New York
William Henry Seward Memorial	picture	Florida, Orange County, New York
B. B. King in London	picture	B.B. King
Carl Dale	picture	Carldale.JPG
Christmas in Brobdingnag, Vol 1	picture	Christmas music
Locust Grove (Samuel F. B. Morse House)	picture	Poughkeepsie, New York
Moses Fowler House	picture	Lafayette, Indiana
Caravan and the New Symphonia	picture	Caravan (band)
Bobby Bland and B. B. King Together Again...Live	picture	Bobby Bland
Buddy & Julie Miller	picture	Buddy Miller
Litchfield Historic District	picture	Litchfield (borough), Connecticut
Terwilliger House (Shawangunk, New York)	picture	Shawangunk, New York
Oakland Memorial Chapel	picture	Alcorn State University
Bill Haley and His Comets (1960 album)	picture	Bill Haley
Cragsmoor Historic District	picture	Cragsmoor, New York
Cragsmoor Historic District	picture	New York
Cliveden (Benjamin Chew House)	picture	Philadelphia
MacPheadris-Warner House	picture	Portsmouth, New Hampshire
Moss Ledge	picture	Upper Saranac Lake
Prospect Point Camp	picture	Upper Saranac Lake
Saturn V Dynamic Test Stand	picture	Saturn V Dynamic Test Vehicle
Wyck House	picture	Philadelphia
Dig, Lazarus, Dig!!!	picture	Lazarus
Christmas with You	picture	Clint Black
Looking for Christmas	picture	Clint Black
Strawbs in Concert	picture	Strawbs
New York State Armory (Poughkeepsie)	picture	Poughkeepsie, New York
United States Post Office (Poughkeepsie, New York)	picture	Poughkeepsie, New York
United States Post Office (Poughkeepsie, New York)	picture	New York
Henry Delamater House	picture	Rhinebeck (village), New York
Hyde Park Firehouse	picture	New York
Hyde Park Railroad Station	picture	New York
Warner Valley Ranger Station	picture	Lassen Volcanic National Park
San Juan Bautista Plaza	picture	Mission San Juan Bautista
Minami-za	picture	Kyoto
Christ Church (Stevensville, Maryland)	picture	Stevensville, Maryland
Yes, Friends and Relatives	picture	Yes (band)
Grand Army of the Republic Hall (Rockland, Massachusetts)	picture	Grand Army of the Republic Hall
Jazz in Paris: Nuages	picture	Jazz
Lockport (Metra)	picture	Lockport, Illinois
St. John's Episcopal Church (Highgate Falls, Vermont)	picture	St. John's Episcopal Church
Grahamsville Historic District	picture	Grahamsville, New York
Grahamsville Historic District	picture	New York
15 Years Deep	picture	Mac Dre
Kijik Archeological District	picture	Lake Clark (Alaska)
East End Historic District (Newburgh, New York)	picture	Newburgh (city), New York
Kingscote (mansion)	picture	Newport, Rhode Island
Guthrie Historic District	picture	Carnegie Library (Guthrie, Oklahoma)
Academy Street Historic District (Poughkeepsie, New York)	picture	Poughkeepsie, New York
Carroll Avenue	picture	Los Angeles
Doru Buican	picture	Http://www.google.pt/imgres?q=doru+buican+mihai&hl=pt-PT&gbv=2&tbm=isch&tbnid=a8eB5b LOIRsbM:&imgrefurl=http://www.csu-vointa-sibiu.ro/Jucatori.aspx&docid=ymlCWgisOL65IM&w=150&h=200&ei=Ua0qTvWRENCa-wbp6In4Bg&zoom=1&iact=hc&vpx=483&vpy=262&dur=1502&hovh=160&hovw=120&tx=109&ty=61&page=1&tbnh=137&tbnw=114&start=0&ndsp=29&ved=1t:429,r:9,s:0&biw=1429&bih=749
B1159 road	picture	Paston, Norfolk
Alexander Classical School	picture	Alexander (village), New York
Calypso in Brass	picture	Calypso music
Edward King House	picture	Newport, Rhode Island
Central Railroad of New Jersey Freight Station	picture	Scranton, Pennsylvania
Finch Building (Scranton, Pennsylvania)	picture	Scranton, Pennsylvania
Hugh R. Thomas Bridge	picture	Tuscaloosa, Alabama
Mauch Chunk Switchback Railway	picture	Jim Thorpe, Pennsylvania
Woodville (Heidelberg, Pennsylvania)	picture	Heidelberg, Pennsylvania
Selkirk Light	picture	Lake Ontario
Main Street Historic District (Stone Ridge, New York)	picture	Stone Ridge, New York
Battle of Rhode Island Site	picture	Portsmouth, Rhode Island
High Falls Historic District	picture	High Falls, New York
Bellevue Avenue Historic District	picture	Newport, Rhode Island
Bethabara Historic District	picture	Bethabara Moravian Church
Cray House (Stevensville, Maryland)	picture	Stevensville, Maryland
A Thurber Carnival	picture	Peggy Cass
A Thurber Carnival	picture	James Thurber
Off White	picture	James Chance
Delaware College of Art and Design  Delmarva Power & Light Building   1	picture	Pepco Holdings
Pont del Diable	picture	Martorell
Pont del Diable	picture	Catalonia
Main Street Historic District (Danbury, Connecticut)	picture	Danbury, Connecticut
Dunning House	picture	Wawayanda, New York
St. James' Parish (Lothian, Maryland)	picture	Lothian, Maryland
Lincoln Hall, Berea College	picture	Berea College
Lincoln Hall, Berea College	picture	Berea College
Cook Landing Site (Waimea, Hawai'i)	picture	Waimea, Kauai County, Hawaii
Cook Landing Site (Waimea, Hawai'i)	picture	Kauai
First Church of Christ, Unitarian	picture	Lancaster, Massachusetts
Farmer's and Manufacturer's Bank	picture	Poughkeepsie, New York
Church Building	picture	Poughkeepsie, New York
U.S. Post Office and Courthouse (Columbus, Georgia)	picture	Columbus, Georgia
Fannin County Courthouse (Georgia)	picture	Blue Ridge, Georgia
Main Mall Row	picture	Poughkeepsie, New York
Hasbrouck House (Poughkeepsie, New York)	picture	Poughkeepsie, New York
Peekskill Downtown Historic District	picture	Peekskill, New York
Feltville Historic District	picture	Watchung Reservation
Wanton-Lyman-Hazard House	picture	Newport, Rhode Island
Waterford Historic District (Waterford, Virginia)	picture	Waterford, Virginia
Newport Historic District (Rhode Island)	picture	Newport, Rhode Island
Governor Stephen Hopkins House	picture	Providence, Rhode Island
Breed Street Shul	picture	Boyle Heights, Los Angeles
Ocean Drive Historic District	picture	Newport, Rhode Island
Fountain Hall	picture	Clark Atlanta University
College Hill Historic District (Providence, Rhode Island)	picture	Providence, Rhode Island
Joseph Reynolds House	picture	Bristol, Rhode Island
Corliss-Carrington House	picture	Providence, Rhode Island
Orton Plantation	picture	Brunswick County, North Carolina
Pike-Pawnee Village Site	picture	Guide Rock, Nebraska
Fulton County Courthouse (Ohio)	picture	Wauseon, Ohio
McLellan-Sweat Mansion	picture	Portland, Maine
W.E.B. Du Bois Boyhood Homesite	picture	Great Barrington, Massachusetts
Chicago, Rock Island and Pacific Railroad Depot (Marseilles, Illinois)	picture	Marseilles, Illinois
Nathan and Mary (Polly) Johnson properties	picture	New Bedford, Massachusetts
Rotch-Jones-Duff House and Garden Museum	picture	New Bedford, Massachusetts
The Locusts	picture	New Paltz, New York
New Bedford Historic District	picture	New Bedford, Massachusetts
Horace Silver and the Jazz Messengers	picture	Horace Silver
United States Post Office (Suffern, New York)	picture	Suffern, New York
United States Post Office (Suffern, New York)	picture	New York
Albert Ayler in Greenwich Village	picture	Albert Ayler
William Saunders House	picture	Mary Prentiss Inn
Elsa, l'essentiel 1986–1993	picture	Elsa (album)
Goodrich Memorial Library	picture	Newport (city), Vermont
John C. Fremont Branch Library, Los Angeles	picture	Los Angeles
Kathryn (skipjack)	picture	Chesapeake Bay
Octagon House (Danbury, Connecticut)	picture	Danbury, Connecticut
Widehall	picture	Chestertown, Maryland
United States Post Office (Dobbs Ferry, New York)	picture	Dobbs Ferry, New York
United States Post Office (Dobbs Ferry, New York)	picture	New York
Estherwood (Dobbs Ferry, New York)	picture	Dobbs Ferry, New York
Estabrook Octagon House	picture	Hoosick Falls, New York
White Sands V-2 Launching Site	picture	White Sands Missile Range
Dubois-Sarles Octagon	picture	Marlboro, New York
The Glebe (Arlington, Virginia)	picture	The Glebe
Colfax County Courthouse (Springer, New Mexico)	picture	Springer, New Mexico
Falcon Tabernacle	picture	Falcon, North Carolina
Sourdough Lodge	picture	Richardson Highway
Main Street Historic District (Roslyn, New York)	picture	Roslyn, New York
St. Mary's Catholic Church (Indianapolis, Indiana)	picture	Indianapolis
Eugene W. Britt House	picture	West Adams, Los Angeles
Bethlehem Lutheran Church (Round Top, Texas)	picture	Round Top, Texas
Linthicum (Baltimore Light Rail station)	picture	Baltimore Light Rail
John and Priscilla Alden Family Sites	picture	Duxbury, Massachusetts
Forrest-Marbury House	picture	Ukrainian Embassy, Washington, D.C.
George I. Briggs House	picture	Bourne, Massachusetts
Old Third District Courthouse	picture	New Bedford, Massachusetts
H.H. Richardson Historic District of North Easton	picture	Oakes Ames Memorial Hall
Cinnamon Bay Plantation	picture	Saint John, U.S. Virgin Islands
Cannonball House (Saint Michaels, Maryland)	picture	Saint Michaels, Maryland
Mary Point Estate	picture	Saint John, U.S. Virgin Islands
Woodlawn Farm (Slate Hill, New York)	picture	Slate Hill, New York
The Birches (Garrison, New York)	picture	Garrison, New York
Everything That Happens Will Happen Today	picture	David Byrne
Ralphs Grocery Store	picture	Ralphs
First United Presbyterian Church (Auburn, Nebraska)	picture	Auburn, Nebraska
Hunnewell Estates Historic District	picture	Wellesley, Massachusetts
Hawkins House (Scott County, Kentucky)	picture	Scott County, Kentucky
Venice of America House	picture	Venice, Los Angeles
Warren Wilson Beach House	picture	Venice, Los Angeles
Federal Reserve Bank of San Francisco, Los Angeles Branch	picture	Federal Reserve Bank of San Francisco
Arlington Mills Historic District	picture	Lawrence, Massachusetts
Giddings Hall, Georgetown College	picture	Georgetown College (Kentucky)
Reed Memorial Library	picture	Carmel Hamlet, New York
South Green Historic District (Ipswich, Massachusetts)	picture	John Whipple House
Lincoln Center Historic District	picture	Lincoln, Massachusetts
Georgetown College Historic Buildings (Scott County, Kentucky)	picture	Giddings Hall, Georgetown College
Georgetown College Historic Buildings (Scott County, Kentucky)	picture	Georgetown College (Kentucky)
Shaw Bridge	picture	Claverack-Red Mills, New York
Vallejo Estate	picture	Sonoma, California
Banning House	picture	Wilmington, Los Angeles
J. C. Penney Building (Newberg, Oregon)	picture	Newberg, Oregon
Ramin Nasibov	picture	İmage:nasibov.JPG
Joel Turner and the Modern Day Poets with the Beatbox Alliance	picture	Joel Turner (musician)
Mill Street-North Clover Street Historic District	picture	Poughkeepsie, New York
Lone Oaks	picture	Roanoke, Virginia
Rosendale Library	picture	Rosendale Village, New York
Snyder Estate Natural Cement Historic District	picture	Rosendale, New York
Bill Frisell, Ron Carter, Paul Motian	picture	Bill Frisell
Bill Frisell, Ron Carter, Paul Motian	picture	Ron Carter
Olmstead Street Historic District	picture	Cohoes, New York
William J. Dickey House	picture	Cohoes, New York
J. Leonard Lackman House	picture	Cohoes, New York
Trinity Cathedral (Omaha, Nebraska)	picture	Omaha, Nebraska
Red Hill Fire Observation Station	picture	Denning, New York
Hustis House	picture	Nelsonville, New York
Stockade Historic District	picture	Schenectady, New York
House at 3 Crown Street	picture	Nelsonville, New York
Deep Purple in Rock	picture	Deep Purple
Glen Campbell in Concert with the South Dakota Symphony	picture	Glen Campbell
Wynkoop House	picture	Saugerties (town), New York
Bain Commercial Building	picture	Wappingers Falls, New York
Garfield Place Historic District	picture	Poughkeepsie, New York
Church Street Row	picture	Poughkeepsie, New York
Scribner House (Cornwall, New York)	picture	Cornwall, New York
Main Street Historic District (New Hamburg, New York)	picture	New Hamburg, New York
Mojo Nixon and Skid Roper (album)	picture	Mojo Nixon
Stone Street Historic District (New Hamburg, New York)	picture	New Hamburg, New York
Abraham Brower House	picture	New Hamburg, New York
Adolph Brower House	picture	New Hamburg, New York
Chelsea Grammar School	picture	Chelsea, Dutchess County, New York
United States Post Office (Delmar, New York)	picture	Delmar, New York
United States Post Office (Delmar, New York)	picture	New York
The Very Thought of You (Emilie-Claire Barlow album)	picture	Emilie-Claire Barlow
Elks Lodge (Lima, Ohio)	picture	Elks (disambiguation)
National State Bank Building	picture	Troy, New York
Pont sur la Laye	picture	Mane, Alpes-de-Haute-Provence
Pont sur la Laye	picture	Alpes-de-Haute-Provence
Norman Blake and Red Rector	picture	Norman Blake (American musician)
Incanto	picture	Andrea Bocelli
Sivtsev Vrazhek Lane	picture	Moscow
Bethesda Meeting House	picture	Bethesda, Maryland
Bethesda Theatre	picture	Bethesda, Maryland
Ilium Building	picture	Troy, New York
Pont d'Aël	picture	Aosta Valley
Rhinestone Cowboy Live, on the Air & in the Studio	picture	Glen Campbell Live (1981 album)
Jean-Louis Akpa Akpro	picture	Grimsby Town F.C.
Hank Mobley and his All Stars	picture	Hank Mobley
Linden Grove (Frederick, Maryland)	picture	Frederick, Maryland
Rose Hill Manor	picture	Frederick, Maryland
Keedy House	picture	Boonsboro, Maryland
Hagerstown Charity School	picture	Hagerstown, Maryland
Auburn House (Towson, Maryland)	picture	Towson, Maryland
Morgan House (Bloomington, Indiana)	picture	Bloomington, Indiana
Bagarmossen metro station	picture	Bagarmossen
Maple Lawn	picture	Balmville, New York
Milton Railroad Station	picture	New York
United States Post Office and Court House (Huntington, West Virginia)	picture	Huntington, West Virginia
Walter Hand House	picture	Cornwall, New York
Well Kept Secrets	picture	Lisa Moscatiello
What Happens After Love	picture	Lisa Moscatiello
Village of Monroe Historic District	picture	Monroe (village), New York
Checkerboard Inn	picture	Monroe (town), New York
Rushmore Memorial Library	picture	Highland Mills, New York
Rita Lee (Rita Lee album)	picture	Rita Lee
Hobcaw Barony	picture	Bernard Baruch
Kemer Bridge	picture	Lycia
McCoy Tyner and the Latin All-Stars	picture	McCoy Tyner
Masten-Quinn House	picture	Wurtsboro, New York
Sloat House	picture	Sloatsburg, New York
Pont Flavien	picture	Bouches-du-Rhône
Dill Farm	picture	Shawangunk, New York
Brykill Farms	picture	Gardiner, New York
U.S. Post Office (Northport, New York)	picture	Northport, New York
Enfield Shaker Museum	picture	Enfield, New Hampshire
Old Southeast Church (Brewster, New York)	picture	Southeast, New York
Tabor-Wing House	picture	Dover Plains, New York
Clinton Avenue Historic District (Albany, New York)	picture	Albany, New York
Allison Ranger Station	picture	Oregon
Nadim Barghouthi	picture	Arabic language
Woodman Institute Museum	picture	Dover, New Hampshire
Said Al-Sobakhi	picture	Arabic language
Medway (Mount Holly, South Carolina)	picture	U.S. Route 52#South Carolina
Portsmouth Athenæum	picture	Portsmouth, New Hampshire
Wilkes County Courthouse (Georgia)	picture	Washington, Georgia
Silver Lake Dam	picture	Woodridge, New York
William Montgomery House (Lancaster, Pennsylvania)	picture	Lancaster, Pennsylvania
Rivoli Theatre (South Fallsburg, New York)	picture	South Fallsburg, New York
House at 249 Main Street	picture	Nelsonville, New York
Montrest	picture	Nelsonville, New York
In Jesus	picture	Phatfish
Fair Lawn (Cold Spring, New York)	picture	Cold Spring, New York
DeRham Farm	picture	Garrison, New York
Wilson House (Garrison, New York)	picture	Garrison, New York
Mandeville House	picture	Garrison, New York
Glenfields (Philipstown, New York)	picture	Garrison, New York
Walker House (Garrison, New York)	picture	Garrison, New York
Normandy Grange	picture	Garrison, New York
Indian Brook Road Historic District	picture	Garrison, New York
Union Street Historic District (Poughkeepsie, New York)	picture	Poughkeepsie, New York
Karamagara Bridge	picture	Cappadocia
Vassar Institute	picture	Poughkeepsie, New York
San Carlos Borromeo Church	picture	Puerto Rico
Strawberry Chapel and Childsbury Town Site	picture	Cooper River (South Carolina)
Building at 73 Mansion Street	picture	Poughkeepsie, New York
Ponte Salario	picture	Giovanni Battista Piranesi
Balding Avenue Historic District	picture	Poughkeepsie, New York
Niagara Engine House	picture	Poughkeepsie, New York
Ponte Molino (Padua)	picture	Padua
Siouxland Veterans Memorial Bridge	picture	South Sioux City, Nebraska
Italian Center	picture	Poughkeepsie, New York
Isaac Roosevelt House	picture	Hyde Park, New York
Roosevelt Point Cottage and Boathouse	picture	Hyde Park, New York
Bergh-Stoutenburgh House	picture	Hyde Park, New York
Main Street-Albertson Street-Park Place Historic District	picture	Hyde Park, New York
Wales House (Hyde Park, New York)	picture	Hyde Park, New York
Envy / Jesu	picture	Envy (band)
Schenectady City Hall	picture	Schenectady, New York
Schenectady City Hall	picture	New York
Vanderbilt Lane Historic District	picture	Hyde Park, New York
Keeseville Historic District	picture	Keeseville, New York
John Hendricks House and Dutch Barn	picture	Staatsburg, New York
Benner House	picture	Rhinebeck (village), New York
West Point Rice Mill	picture	Ashley River (South Carolina)
The Maples (Rhinebeck, New York)	picture	Rhinebeck (village), New York
Neher-Elseffer House	picture	Rhinebeck (town), New York
Imiola Church	picture	Waimea, Hawaii County, Hawaii
Cootie Williams and His Orchestra 1941–1944	picture	Cootie Williams
Village Diner	picture	Red Hook (village), New York
Elmendorph Inn	picture	Red Hook (village), New York
Greenway Plantation	picture	Greenway, Charles City County, Virginia
Warren County Courthouse (Indiana)	picture	Warren County, Indiana
Stone Jug	picture	Clermont, New York
Clarkson Chapel	picture	Clermont, New York
Coons House	picture	Clermont, New York
U.S. Post Office (Hudson, New York)	picture	Hudson, New York
U.S. Post Office (Hudson, New York)	picture	New York
Hudson Historic District (New York)	picture	Hudson, New York
Houses at 37-47 North Fifth Street	picture	Hudson, New York
Rossman-Prospect Avenue Historic District	picture	Hudson, New York
Kinderhook Village District	picture	Kinderhook (village), New York
Archie Shepp and the Full Moon Ensemble	picture	Archie Shepp
Lace House (Canaan, New York)	picture	Canaan, New York
Pastures Historic District	picture	Albany, New York
The Beatles in Mono	picture	The Beatles
White-Pool House	picture	Odessa, Texas
Mansion Historic District	picture	Albany, New York
Downtown Cody Historic District	picture	Irma Hotel
Bridgewater Historic District (Bridgewater, Pennsylvania)	picture	Bridgewater, Pennsylvania
Gerard Crane House	picture	Somers, New York
Mount Zion Methodist Church (Somers, New York)	picture	Somers, New York
Bridge L-158	picture	Golden's Bridge, New York
Zagreb Main Station	picture	Zagreb
Bud Powell in Paris	picture	Bud Powell
A Provincial Lady	picture	Constantin Stanislavski
Jazz in the Space Age	picture	Jazz
The Mistress of the Inn	picture	Constantin Stanislavski
Enough Stupidity in Every Wise Man	picture	Constantin Stanislavski
Enough Stupidity in Every Wise Man	picture	Vasili Kachalov
Johnny Burnette and the Rock 'n Roll Trio	picture	Johnny Burnette
Kingston City Hall (New York)	picture	Kingston, New York
Kingston City Hall (New York)	picture	New York
Boice House	picture	Kingston, New York
Chichester House (Kingston, New York)	picture	Kingston, New York
William V. N. Barlow House	picture	Albion (village), New York
Jackson Blood Cobblestone House	picture	Lyndonville, New York
John Shelp Cobblestone House	picture	Shelby, New York
Skinner-Tinkham House	picture	Barre Center, New York
House at 184 Albany Avenue	picture	Kingston, New York
U.S. Post Office (Albion, New York)	picture	Albion (village), New York
U.S. Post Office (Albion, New York)	picture	New York
U.S. Post Office (Medina, New York)	picture	Medina, New York
U.S. Post Office (Medina, New York)	picture	New York
House at 313 Albany Avenue	picture	Kingston, New York
House at 322 Albany Avenue	picture	Kingston, New York
Tousley-Church House	picture	Albion (village), New York
Servoss House	picture	Medina, New York
Little Rock U.S. Post Office and Courthouse	picture	Courthouse
Little Rock U.S. Post Office and Courthouse	picture	Little Rock, Arkansas
James A. Walsh United States Courthouse	picture	Tucson, Arizona
House at 356 Albany Avenue	picture	Kingston, New York
Jacob Weinberger United States Courthouse	picture	San Diego
William R. Cotter Federal Building	picture	Hartford, Connecticut
Cobblestone Inn	picture	Oak Orchard, New York
Woodruff House (Cornwall, New York)	picture	Cornwall, New York
Orleans County Courthouse Historic District	picture	Albion (village), New York
United States Post Office and Federal Building (Wichita, Kansas)	picture	Wichita, Kansas
Edward T. Gignoux United States Courthouse	picture	Portland, Maine
Gene Snyder United States Courthouse	picture	Louisville, Kentucky
Federal Building (Port Huron, Michigan)	picture	Port Huron, Michigan
Grand Island United States Post Office and Courthouse	picture	Grand Island, Nebraska
United States Post Office (Missoula, Montana)	picture	Courthouse
Robert C. McEwen United States Custom House	picture	Ogdensburg, New York
United States Customhouse (Portland, Oregon)	picture	Portland, Oregon
United States Post Office, Courthouse, and Federal Office Building (Oklahoma City, Oklahoma)	picture	Courthouse
United States Post Office, Courthouse, and Federal Office Building (Oklahoma City, Oklahoma)	picture	Oklahoma City
Hipolito F. Garcia Federal Building and United States Courthouse	picture	San Antonio
Laredo United States Post Office, Court House and Custom House	picture	Courthouse
Laredo United States Post Office, Court House and Custom House	picture	Laredo, Texas
United States Customhouse (Houston)	picture	Houston
Federal Building (Milwaukee, Wisconsin)	picture	Milwaukee
Le Roy House and Union Free School	picture	Le Roy (village), New York
Marion Steam Shovel (Le Roy, New York)	picture	Le Roy (town), New York
Gifford-Walker Farm	picture	North Bergen, New York
Mount Pleasant (Indian Falls, New York)	picture	Indian Falls, New York
Lake Street Historic District (Bergen, New York)	picture	Bergen (village), New York
Stafford Village Four Corners Historic District	picture	Stafford, New York
United States Post Office (Nyack, New York)	picture	Nyack, New York
United States Post Office (Nyack, New York)	picture	New York
Waterbury (Metro-North station)	picture	Waterbury, Connecticut
United States Post Office (Haverstraw, New York)	picture	Haverstraw (village), New York
United States Post Office (Haverstraw, New York)	picture	New York
The Homestead (Haverstraw, New York)	picture	Haverstraw (village), New York
William H. Rose House	picture	Stony Point, New York
Woodlawn (Garrison, New York)	picture	Garrison, New York
United States Post Office (Peekskill, New York)	picture	Peekskill, New York
United States Post Office (Peekskill, New York)	picture	New York
Nelson Avenue-Fort Hill Historic District	picture	Peekskill, New York
Foster Building	picture	Schenectady, New York
U.S. Post Office (Schenectady, New York)	picture	Schenectady, New York
U.S. Post Office (Schenectady, New York)	picture	New York
General Electric Realty Plot	picture	Schenectady, New York
Union Street Historic District (Schenectady, New York)	picture	Schenectady, New York
The Maltings Theatre & Cinema	picture	Berwick-upon-Tweed
Elston Hall	picture	Schenectady, New York
United States Post Office (Scotia, New York)	picture	Scotia, New York
United States Post Office (Scotia, New York)	picture	New York
Abraham Glen House	picture	Scotia, New York
Verbeck House	picture	Ballston Spa, New York
U.S. Post Office (Ballston Spa, New York)	picture	Ballston Spa, New York
U.S. Post Office (Ballston Spa, New York)	picture	New York
Brookside Museum	picture	Ballston Spa, New York
Bradley Wood	picture	Grimsby Town F.C.
Stone Bridge and the Oregon Central Military Wagon Road	picture	Lake County, Oregon
Stone Bridge and the Oregon Central Military Wagon Road	picture	Oregon
Odd Fellows Block (Grand Forks, North Dakota)	picture	Grand Forks, North Dakota
East Side Historic District (Saratoga Springs, New York)	picture	Saratoga Springs, New York
Sonny Rollins and the Big Brass	picture	Sonny Rollins
West Side Historic District (Saratoga Springs, New York)	picture	Saratoga Springs, New York
Sonny Rollins and the Contemporary Leaders	picture	Sonny Rollins
Joseph Bell DeRemer House	picture	Grand Forks, North Dakota
U.S. Post Office (Saratoga Springs, New York)	picture	Saratoga Springs, New York
U.S. Post Office (Saratoga Springs, New York)	picture	New York
Thelonious Monk and Sonny Rollins	picture	Thelonious Monk
Justin Hayward and Friends Sing the Moody Blues Classic Hits	picture	Justin Hayward
Old Warren County Courthouse Complex	picture	Lake George (village), New York
United States Post Office (Lake George, New York)	picture	Lake George (village), New York
United States Post Office (Lake George, New York)	picture	New York
Columbiana County Courthouse	picture	Ohio
Elisha Straight House	picture	Hartford, New York
United States Post Office (Granville, New York)	picture	Granville (village), New York
United States Post Office (Granville, New York)	picture	New York
Salem Historic District (New York)	picture	Salem (village), New York
Cannonball Adderley and the Poll Winners	picture	Cannonball Adderley
Cambridge Historic District (Cambridge, New York)	picture	Cambridge (village), New York
U.S. Post Office (Hoosick Falls, New York)	picture	Hoosick Falls, New York
U.S. Post Office (Hoosick Falls, New York)	picture	New York
Bridge in Newport Borough	picture	Bridge
Main Street Historic District (Addison, New York)	picture	Addison (village), New York
Mountain View House	picture	Whitefield, New Hampshire
Houses at 208-218 East 78th Street	picture	New York City
Nine Partners Meeting House and Cemetery	picture	Millbrook, New York
Gula Matari	picture	Quincygula.jpg
Seneca County Courthouse Complex at Ovid	picture	Ovid (village), New York
Schuyler County Courthouse Complex	picture	Watkins Glen, New York
Heisey House	picture	Lock Haven, Pennsylvania
Delaware and Hudson Canal Company Office	picture	Lackawaxen Township, Pike County, Pennsylvania
Union Free School (New Hamburg, New York)	picture	New Hamburg, New York
Cornelius Carman House	picture	Chelsea, Dutchess County, New York
Carmine Liberta Bridge	picture	New Paltz (village), New York
Melville railway station	picture	Melville, Saskatchewan
St. Patrick's Catholic Church (Glynwood, Ohio)	picture	Glynwood, Ohio
Memorial Park Site	picture	Lock Haven, Pennsylvania
Kirkland Hotel	picture	Kingston, New York
Kingston Stockade District	picture	Kingston, New York
Bing Crosby: The Voice of Christmas	picture	Bing Crosby
The Brutalist Bricks	picture	Ted Leo
Cortland County Courthouse	picture	Cortland, New York
United States Post Office (Homer, New York)	picture	Homer (village), New York
William Kenyon House	picture	Kingston, New York
Tobias Van Steenburgh House	picture	Kingston, New York
James and Mary Forsyth House	picture	Kingston, New York
Oswego County Courthouse	picture	Oswego, New York
Hillsborough Historic District	picture	Heartsease (Hillsborough, North Carolina)
John Smith House (Kingston, New York)	picture	Kingston, New York
George J. Smith House	picture	Kingston, New York
Jacob Ten Broeck Stone House	picture	Kingston, New York
Pak Chol-Jin	picture	Archivo:FIFA World Cup 2010 Portugal North Korea4.jpg
Cornelius H. Evans House	picture	Hudson, New York
First Columbia County Courthouse	picture	Claverack-Red Mills, New York
Arapsu Bridge	picture	Antalya
Stephen Hogeboom House	picture	Claverack-Red Mills, New York
Eurymedon Bridge (Selge)	picture	Selge, Pisidia
Cornelius S. Muller House	picture	Claverack-Red Mills, New York
Trinity Episcopal Church (Claverack, New York)	picture	Claverack-Red Mills, New York
Laura Branigan in Concert	picture	Laura Branigan (video)
Jazz in the Garden	picture	Jazz
George Felpel House	picture	Claverack-Red Mills, New York
Harmon Miller House	picture	Claverack-Red Mills, New York
Emmanuel Baptist Church (Alexandria, Louisiana)	picture	Alexandria, Louisiana
Jacob P. Mesick House	picture	Claverack-Red Mills, New York
Michigan Bell and Western Electric Warehouse	picture	Michigan Bell
Van Rensselaer Lower Manor House	picture	Claverack-Red Mills, New York
Stephen Miller House	picture	Claverack-Red Mills, New York
Robber's Bridge	picture	Exmoor
Wanakena Presbyterian Church	picture	Wanakena, New York
Dr. Abram Jordan House	picture	Claverack-Red Mills, New York
Stephen Storm House	picture	Claverack-Red Mills, New York
Guyue Bridge	picture	Song Dynasty
Dr. A. H. Allen Cottage	picture	Saranac Lake, New York
Ames Cottage	picture	Saranac Lake, New York
Baird Cottage	picture	Saranac Lake, New York
Colbath Cottage	picture	Saranac Lake, New York
Drury Cottage	picture	Saranac Lake, New York
Ellenberger Cottage	picture	Saranac Lake, New York
E. L. Gray House	picture	Saranac Lake, New York
Hathaway Cottage	picture	Saranac Lake, New York
Beekman Meeting House and Friends' Cemetery	picture	LaGrange, New York
Russia Corners Historic District	picture	Russia, New York
U.S. Post Office (Cooperstown, New York)	picture	Post office
U.S. Post Office (Cooperstown, New York)	picture	Cooperstown, New York
Department Store Historic District	picture	Cheney Building
Charles Lloyd in Europe	picture	Charles Lloyd (jazz musician)
Emile Brunel Studio and Sculpture Garden	picture	Boiceville, New York
Marina Theatre	picture	Lowestoft
Marina Theatre	picture	Suffolk
Morton Memorial Library (Pine Hill, New York)	picture	Pine Hill, New York
Elm Street Stone Arch Bridge	picture	Pine Hill, New York
St. Anthony's Catholic Church (Padua, Ohio)	picture	Padua, Ohio
Galli-Curci Theatre	picture	Margaretville, New York
Goldfield Hotel	picture	Goldfield, Nevada
District 10 School	picture	Middletown, Delaware County, New York
Frank Sinatra's Greatest Hits, Vol. 2	picture	Frank Sinatra's Greatest Hits
Skene Memorial Library	picture	Fleischmanns, New York
Live & More (Marcus Miller album)	picture	Marcus Miller
Tiller Ranger Station	picture	Oregon
Mill Street Stone Arch Bridge	picture	Pine Hill, New York
District School No. 14	picture	Pine Hill, New York
Landing Masonry Bridge	picture	Lake Hopatcong (NJT station)
Ulster House Hotel	picture	Pine Hill, New York
Bevier House	picture	Gardiner, New York
Lock Tender's House and Canal Store Ruin	picture	High Falls, New York
Jules Wijdenbosch Bridge	picture	Paramaribo
William Lawrence House (Bellefontaine, Ohio)	picture	Bellefontaine, Ohio
Smith-Rourke House	picture	East Patchogue, New York
St. Patrick's Catholic Church (St. Patrick, Ohio)	picture	St. Patrick, Ohio
Prime House	picture	Huntington, New York
Joseph Wood House	picture	Sayville, New York
St. John's Catholic Church (Delphos, Ohio)	picture	Delphos, Ohio
Holy Rosary Catholic Church (St. Marys, Ohio)	picture	St. Marys, Ohio
St. Joseph's Catholic Church (Wapakoneta, Ohio)	picture	Wapakoneta, Ohio
Southern New England Telephone Company Administration Building	picture	New Haven, Connecticut
St. Joseph's Catholic Church (Springfield, Ohio)	picture	Springfield, Ohio
Third Presbyterian Church (Springfield, Ohio)	picture	Springfield, Ohio
St. Paul's Episcopal Church (Cleveland, Ohio)	picture	Cleveland
Frank A. Palen House	picture	Kingston, New York
J. Dupuy Stone House	picture	Kerhonkson, New York
Ephriam DuPuy Stone House	picture	Kerhonkson, New York
East 80th Street Houses	picture	New York City
C. K. Schoonmaker Stone House	picture	Kerhonkson, New York
Dirck Westbrook Stone House	picture	Kerhonkson, New York
Jacob Hoornbeck Stone House	picture	Kerhonkson, New York
Hornbeck Stone House	picture	Kerhonkson, New York
Krom Stone House at 45 Upper Whitfield Road	picture	Kerhonkson, New York
Terwilliger-Smith Farm	picture	Kerhonkson, New York
Trapps Mountain Hamlet Historic District	picture	Gardiner, New York
Mary Willis Library	picture	Washington, Georgia
Building at 136-138 Collins Street	picture	Hartford, Connecticut
Building at 136-138 Collins Street	picture	Connecticut
William L. Linke House	picture	Hartford, Connecticut
William L. Linke House	picture	Connecticut
Building at 142 Collins Street	picture	Hartford, Connecticut
Building at 142 Collins Street	picture	Connecticut
Perkins-Clark House	picture	Hartford, Connecticut
Newington Junction Railroad Depot	picture	Newington, Connecticut
Main Street Historic District (Damariscotta, Maine)	picture	Damariscotta, Maine
Timothy Goodman House	picture	West Hartford, Connecticut
Daniel Hosmer House	picture	West Hartford, Connecticut
Union Block (Lima, Ohio)	picture	Lima, Ohio
Sarah Whitman Hooker House	picture	West Hartford, Connecticut
The Spanish House	picture	West Hartford, Connecticut
Whitman House	picture	West Hartford, Connecticut
James Butler House	picture	West Hartford, Connecticut
Samuel Farnsworth House	picture	West Hartford, Connecticut
House at 847 Main Street, North	picture	West Hartford, Connecticut
Whiting Homestead	picture	West Hartford, Connecticut
Rosaly-Batiz House	picture	Primero (Ponce)
Rosaly-Batiz House	picture	Ponce, Puerto Rico
Sears, Roebuck and Company Department Store (Miami, Florida)	picture	Sears
Bykenhulle	picture	Hopewell Junction, New York
Newcomb-Brown Estate	picture	Pleasant Valley (town), New York
Ohio Theatre (Lima, Ohio)	picture	Lima, Ohio
John Wells, Jr. House	picture	West Hartford, Connecticut
Gen. Martin Kellogg House	picture	Newington, Connecticut
Mount St. Joseph Academy (West Hartford, Connecticut)	picture	West Hartford, Connecticut
Lynfeld	picture	Washington, New York
Thorne Memorial School	picture	Millbrook, New York
MTV Unplugged (Diego Torres album)	picture	MTV Unplugged
New Mill and Depot Building, Hawthorne Woolen Mill	picture	Greenwich, Connecticut
Indian Rock Schoolhouse	picture	Amenia (CDP), New York
Gardiner Railroad Station	picture	Gardiner, Maine
Lewis Mumford House	picture	Amenia (town), New York
Barr Hotel	picture	Lima, Ohio
Piano in the Background	picture	Piano
Piano in the Foreground	picture	Piano
Font-Ubides House	picture	Ponce, Puerto Rico
Coleman Station Historic District	picture	New York
Fan of a Fan	picture	Chris Brown (American entertainer)
Yorktown Heights Railroad Station	picture	New York
Contoocook Railroad Bridge	picture	Contoocook, New Hampshire
U.S. Post Office (Spring Valley, New York)	picture	Spring Valley, New York
U.S. Post Office (Spring Valley, New York)	picture	New York
U.S. Post Office (Pearl River, New York)	picture	Pearl River, New York
U.S. Post Office (Pearl River, New York)	picture	New York
Hiddenhurst	picture	Millerton, New York
George Shearing and the Montgomery Brothers	picture	George Shearing
Oliver Barrett House	picture	Millerton, New York
Oppenheimer House	picture	Ponce, Puerto Rico
H. R. Stevens House	picture	New City, New York
Thomas N. Wheeler Farm	picture	Millerton, New York
Ezra Clark House	picture	Millerton, New York
Michael Salyer Stone House	picture	Orangetown, New York
Jacob P. Perry House	picture	Pearl River, New York
Edward Salyer House	picture	Pearl River, New York
North Main Street School	picture	Spring Valley, New York
Highland Falls Village Hall	picture	Highland Falls, New York
Highland Falls Village Hall	picture	New York
House at 365 Main Street	picture	Highland Falls, New York
House at 20 Center Street	picture	Highland Falls, New York
Static Migration	picture	Tribes of Neurot
Joe Henderson in Japan	picture	Joe Henderson
Salazar-Candal House	picture	Ponce, Puerto Rico
Residencia Subirá	picture	Segundo (Ponce)
Residencia Subirá	picture	Ponce, Puerto Rico
Butterfield Cobblestone House	picture	Clarendon, New York
New Preston Hill Historic District	picture	New Preston, Connecticut
Double-Span Metal Pratt Truss Bridge	picture	Keeseville, New York
Strode Theatre	picture	Street, Somerset
Anahí (album)	picture	Anahí
Smith Tavern	picture	Armonk, New York
Hubbard Hall (Elizabethtown, New York)	picture	Elizabethtown, New York
Clayton H. Delano House	picture	Ticonderoga, New York
Clark House (Ticonderoga, New York)	picture	Ticonderoga, New York
Community Building (Ticonderoga, New York)	picture	Ticonderoga (hamlet), New York
Liberty Monument	picture	Ticonderoga, New York
Keene Valley Library	picture	Keene, New York
Jean Lee and the Yellow Dog	picture	Jean Lee (murderer)
William E. Ward House	picture	Rye Brook, New York
United States Post Office (Lake Placid, New York)	picture	Lake Placid, New York
Bogie Cottage	picture	Saranac Lake, New York
Coulter Cottage	picture	Saranac Lake, New York
Fallon Cottage Annex	picture	Saranac Lake, New York
Hill Cottage (Saranac Lake, New York)	picture	Saranac Lake, New York
Kennedy Cottage (Saranac Lake, New York)	picture	Saranac Lake, New York
Peyton Clark Cottage	picture	Saranac Lake, New York
Denny Cottage	picture	Saranac Lake, New York
Lane Cottage (Saranac Lake, New York)	picture	Saranac Lake, New York
Dr. Henry Leetch House	picture	Saranac Lake, New York
Lent Cottage	picture	Saranac Lake, New York
Marquay Cottage	picture	Saranac Lake, New York
Marvin Cottage	picture	Saranac Lake, New York
Partridge Cottage	picture	Saranac Lake, New York
Pittenger Cottage	picture	Saranac Lake, New York
Stuckman Cottage	picture	Saranac Lake, New York
Barngalow	picture	Saranac Lake, New York
Distin Cottage	picture	Saranac Lake, New York
Feisthamel-Edelberg Cottage	picture	Saranac Lake, New York
Hillside Lodge	picture	Saranac Lake, New York
Hooey Cottage	picture	Saranac Lake, New York
Hopkins Cottage	picture	Saranac Lake, New York
Jennings Cottage	picture	Saranac Lake, New York
Johnson Cottage	picture	Saranac Lake, New York
Larom-Welles Cottage	picture	Saranac Lake, New York
Leis Cottage	picture	Saranac Lake, New York
Magill Cottage	picture	Saranac Lake, New York
McBean Cottage	picture	Saranac Lake, New York
Morgan Cottage	picture	Saranac Lake, New York
Radwell Cottage	picture	Saranac Lake, New York
Ryan Cottage	picture	Saranac Lake, New York
Sarbanes Cottage	picture	Saranac Lake, New York
Schrader-Griswold Cottage	picture	Saranac Lake, New York
Seeley Cottage	picture	Saranac Lake, New York
Sloan Cottage	picture	Saranac Lake, New York
Smith Cottage	picture	Saranac Lake, New York
Stonaker Cottage	picture	Saranac Lake, New York
Freer Cottage	picture	Saranac Lake, New York
The Homestead (Saranac Lake, New York)	picture	Saranac Lake, New York
Larom Cottage	picture	Saranac Lake, New York
Musselman Cottage	picture	Saranac Lake, New York
Pomeroy Cottage	picture	Saranac Lake, New York
Orin Savage Cottage	picture	Saranac Lake, New York
Wilson Cottage	picture	Saranac Lake, New York
Witherspoon Cottage	picture	Saranac Lake, New York
Leis Block	picture	Saranac Lake, New York
James Cant Ranch Historic District	picture	Grant County, Oregon
Saugatuck River Railroad Bridge	picture	Saugatuck River Bridge
Charles Ives House	picture	Danbury, Connecticut
Beer's Bridge	picture	Keene, New York
Ranney Bridge	picture	Keene, New York
Essex County Fairgrounds	picture	Westport, New York
Hand-Hale Historic District	picture	Elizabethtown, New York
Lake George Avenue Historic District	picture	Ticonderoga, New York
Syamsul Chaerudin	picture	Berkas:Syamsul-chaerudin.gif
P Ranch	picture	Frenchglen, Oregon
Putnam County Courthouse (Ohio)	picture	Ottawa, Ohio
Henderson Street	picture	Leith
Eleutherna Bridge	picture	Crete
Paul Smith's Electric Light and Power and Railroad Company Complex	picture	Saranac Lake, New York
Berkeley Square Historic District (Saranac Lake, New York)	picture	Saranac Lake, New York
Cottage Row Historic District	picture	Saranac Lake, New York
Camp Intermission	picture	Saranac Lake, New York
God Willin' & the Creek Don't Rise	picture	Ray LaMontagne
Little Crystal Creek Bridge	picture	Crystal Creek
Legg House (Bloomington, Indiana)	picture	Bloomington, Indiana
United States Post Office (Hempstead, New York)	picture	Hempstead (village), New York
Double-O Ranch Historic District	picture	Harney County, Oregon
Christmas in Harmony	picture	Christmas
U.S. Customhouse (Old Customhouse) and Post Office	picture	Wiscasset, Maine
Fall City Masonic Hall	picture	Fall City, Washington
Cummings Shoe Factory	picture	South Berwick, Maine
Mary R. Hurd House	picture	North Berwick, Maine
Polka! All Night Long	picture	Jimmy Sturr
Living on Polka Time	picture	Jimmy Sturr
Let's Kiss: 25th Anniversary Album	picture	Brave Combo
Top of the World (Jimmy Sturr album)	picture	Jimmy Sturr
When It's Polka Time at Your House	picture	Jimmy Sturr
Henry Mancini: Pink Guitar	picture	Henry Mancini
Just Chillin'	picture	Norman Brown (guitarist)
Inside (David Sanborn album)	picture	David Sanborn
75 (album)	picture	Joe Zawinul
Rangeley Public Library	picture	Rangeley, Maine
Keith Potger and the New Seekers	picture	Keith Potger
Pauline Felix House	picture	Long Beach, New York
House at 226 West Penn Street	picture	Long Beach, New York
Samuel Vaisberg House	picture	Long Beach, New York
Willet Titus House	picture	Roslyn, New York
Danzón (Dance On)	picture	Arturo Sandoval
Portraits of Cuba	picture	Paquito D'Rivera
Land of the Sun (album)	picture	Charlie Haden
Nocturne (Charlie Haden album)	picture	Charlie Haden
Live at the Village Vanguard (Chucho Valdés album)	picture	Chucho Valdés
Listen Here! (album)	picture	Eddie Palmieri
Song for Chico	picture	Arturo O'Farrill
Hicks Lumber Company Store	picture	Roslyn, New York
Cliff Hanger (album)	picture	Jimmy Cliff
Hall of Fame: A Tribute to Bob Marley's 50th Anniversary	picture	Bunny Wailer
Crucial! Roots Classics	picture	Bunny Wailer
Ploshchad Lenina (Minsk Metro)	picture	Minsk Metro
Nemiga (Minsk Metro)	picture	Minsk Metro
Frunzenskaya (Minsk Metro)	picture	Minsk Metro
Molodyozhnaya (Minsk Metro)	picture	Minsk Metro
Runaway (Bill Champlin album)	picture	Bill Champlin
Montgomery Park (Portland, Oregon)	picture	Montgomery Ward
Let It Be Me: Mathis in Nashville	picture	Johnny Mathis
Patrick Henry Hotel	picture	Roanoke, Virginia
Edi Hafid	picture	Berkas:Edi Hafid.jpg
Rachmat Afandi	picture	Berkas:Rahmat affandi.jpeg
Dadang Sudrajat	picture	Berkas:Dadang sudrajat.jpg
Waterbury Municipal Center Complex	picture	Waterbury, Connecticut
Immaculate Conception Catholic Church (Celina, Ohio)	picture	Celina, Ohio
Live at Carnegie Hall: The 50th Anniversary Concert	picture	Patti Page
David L. Shirk Ranch	picture	Lake County, Oregon
Timeless Love	picture	Smokey Robinson
Aaron Copland House	picture	Cortlandt Manor, New York
Prayer for Compassion	picture	David Darling (musician)
Brandreth Pill Factory	picture	Ossining (village), New York
Bella (album)	picture	Teddy Thompson
Lake Placid Station	picture	Lake Placid, New York
Mundo (album)	picture	Rubén Blades
Elton Hotel	picture	Waterbury, Connecticut
Full Circle: Carnegie Hall 2000	picture	Ravi Shankar
Nascimento (album)	picture	Milton Nascimento
Santiago (album)	picture	The Chieftains
Harry & Lena	picture	Harry Belafonte
Livro	picture	Caetano Veloso
Booker Little and Friend	picture	Booker Little
Keokuk County Courthouse	picture	Keokuk County, Iowa
Bob, Peter, Bunny & Rita	picture	Bob Marley
Marion County Courthouse (Iowa)	picture	Marion County, Iowa
John Kendrick House	picture	Waterbury, Connecticut
La Fave Block	picture	Aspen, Colorado
Cornershop and the Double 'O' Groove Of	picture	Cornershop
Count Basie and the Kansas City 7	picture	Count Basie
Bank Street Historic District (Waterbury, Connecticut)	picture	Waterbury, Connecticut
Students' Hall	picture	Barnard College
Wheeler Opera House	picture	Aspen, Colorado
Brand Building	picture	Aspen, Colorado
Collins Block	picture	Aspen, Colorado
Jo & Friends	picture	Jo Stafford
Pervomaiskaya (Minsk Metro)	picture	Minsk Metro
Patizanskaya (Minsk Metro)	picture	Minsk Metro
Mogilevskaya (Minsk Metro)	picture	Minsk Metro
Pushkinskaya (Minsk Metro)	picture	Minsk Metro
Kuntsevshchina (Minsk Metro)	picture	Minsk Metro
House at 36 Forest Street	picture	Hartford, Connecticut
Live at Benaroya Hall with the Seattle Symphony	picture	Brandi Carlile
Dixon–Markle House	picture	Aspen, Colorado
Ski Lift No. 1	picture	Aspen, Colorado
Sarah Vaughan in Hi-Fi	picture	Sarah Vaughan
Charles Mingus and Friends in Concert	picture	Charles Mingus
Heryford Brothers Building	picture	Lakeview, Oregon
Riede's City Bakery	picture	Aspen, Colorado
Live at the 2008 New Orleans Jazz & Heritage Festival	picture	BeauSoleil
Miss Willie's House	picture	Talladega, Alabama
Miss Willie's House	picture	Alabama
Eagle Hotel (Waterford, Pennsylvania)	picture	Waterford, Pennsylvania
Gainesville Historic District	picture	Aduston Hall
Fayetteville Historic Square	picture	Fayetteville, Arkansas
Roscoe Mitchell and the Sound and Space Ensembles	picture	Roscoe Mitchell
St. Paul's Episcopal Church (Hicksville, Ohio)	picture	Hicksville, Ohio
Death By Stereo (album)	picture	Umdbs600.jpg
Pioneer Park (Aspen, Colorado)	picture	Aspen, Colorado
Wheeler–Stallard House	picture	Aspen, Colorado
Ritzville Carnegie Library	picture	Ritzville, Washington
