JOHN WOO	PINYINCHINESENAME	Wú Yǔ SēN
JET LI	PINYINCHINESENAME	Lǐ LIáNJIé
BRUCE LEE	PINYINCHINESENAME	Lǐ XIǎOLóNG
ZHANG ZIYI	PINYINCHINESENAME	ZHāNG ZǐYí
CHOW YUN-FAT	PINYINCHINESENAME	ZHōU RùNFā
SAMMO HUNG	PINYINCHINESENAME	HóNG JīNBǎO
ROMAN TAM	PINYINCHINESENAME	LUó WéN
MICHELLE YEOH	PINYINCHINESENAME	YáNG ZǐQIóNG
MAGGIE CHEUNG	PINYINCHINESENAME	ZHāNG MàNYù
GONG LI	PINYINCHINESENAME	GǒNG Lì
LESLIE CHEUNG	PINYINCHINESENAME	ZHāNG GUóRóNG
BRANDON LEE	PINYINCHINESENAME	Lǐ GUóHáO
TONY LEUNG CHIU-WAI	PINYINCHINESENAME	LIáNG CHáOWěI
LEON LAI	PINYINCHINESENAME	Lí MíNG
SAMMI CHENG	PINYINCHINESENAME	ZHèNG XIùWéN
FAYE WONG	PINYINCHINESENAME	WáNG FēI
COCO LEE	PINYINCHINESENAME	Lǐ WéN
GE YOU	PINYINCHINESENAME	Gě YōU
ANDY LAU	PINYINCHINESENAME	LIú DéHUá
JOSEPH KOO	PINYINCHINESENAME	GU4 JIA1 HUI1
JOAN CHEN	PINYINCHINESENAME	CHéN CHōNG
FANN WONG	PINYINCHINESENAME	FàN WéNFāNG
CHANG CHEN	PINYINCHINESENAME	ZHāNG ZHèN
CUI JIAN	PINYINCHINESENAME	CUī JIàN
CHRISTOPHER DOYLE	PINYINCHINESENAME	Dù KěFēNG
CHEN KAIGE	PINYINCHINESENAME	CHéN KǎIGē
MICHAEL HUI	PINYINCHINESENAME	Xǔ GUàNWéN
BETTY LOH TI	PINYINCHINESENAME	Lè Dì
STANLEY KWAN	PINYINCHINESENAME	GUāN JǐNPéNG
SALLY YEH	PINYINCHINESENAME	Yè QIàNWéN
TERESA TENG	PINYINCHINESENAME	DèNG LìJūN
JACKY CHEUNG	PINYINCHINESENAME	ZHāNG XUéYǒU
PRISCILLA CHAN	PINYINCHINESENAME	CHéN HUìXIáN
WILLIAM HUNG	PINYINCHINESENAME	KǒNG QìNGXIáNG
JING TIAN	PINYINCHINESENAME	JǐNG TIáN
A-MEI	PINYINCHINESENAME	ZHāNG HUìMèI
JOSIE HO	PINYINCHINESENAME	Hé CHāOYí
KING HU	PINYINCHINESENAME	Hú JīNQUáN
BAI LING	PINYINCHINESENAME	BáI LíNG
STEPHEN CHOW	PINYINCHINESENAME	ZHōU XīNGCHí
JAY CHOU	PINYINCHINESENAME	ZHōU JIéLúN
YUEN BIAO	PINYINCHINESENAME	YUáN BIāO
JOEY YUNG	PINYINCHINESENAME	RóNG Zǔ'éR
TERESA CHEUNG	PINYINCHINESENAME	ZHANG1 DE2 LAN2
DOU WEI	PINYINCHINESENAME	DòU WéI
NICHOLAS TSE	PINYINCHINESENAME	XIè TíNGFēNG
JUNO MAK	PINYINCHINESENAME	MAI4 JUN4 LONG2
JERRY YAN	PINYINCHINESENAME	YáN CHéNGXù
KEN CHU	PINYINCHINESENAME	ZHū XIàOTIāN
GIGI LEUNG	PINYINCHINESENAME	LIáNG YǒNG Qí
VANNESS WU	PINYINCHINESENAME	Wú JIàNHáO
KELLY CHEN	PINYINCHINESENAME	CHEN HUILIN
DEEP NG	PINYINCHINESENAME	WU2 HAO4 KANG1
EVONNE HSU	PINYINCHINESENAME	Xǔ HUìXīN
STEPHANIE CHENG	PINYINCHINESENAME	ZHèNG RóNG
SAMUEL HUI	PINYINCHINESENAME	Xǔ GUàNJIé
TAKESHI KANESHIRO	PINYINCHINESENAME	JīNCHéNG Wǔ
MACHI	PINYINCHINESENAME	MáJí
SHU QI	PINYINCHINESENAME	SHū Qí
CHEN DAOMING	PINYINCHINESENAME	CHéN DàOMíNG
MAGGIE LAU	PINYINCHINESENAME	LIú SīHUì
STEFANIE SUN	PINYINCHINESENAME	SūN YàNZī
JIANG WEN	PINYINCHINESENAME	JIāNG WéN
CARINA LAU	PINYINCHINESENAME	LIú JIāLíNG
DANNY CHAN	PINYINCHINESENAME	CHéN BǎIQIáNG
ALEC SU	PINYINCHINESENAME	Sū YǒUPéNG
AARON KWOK	PINYINCHINESENAME	GUō FùCHéNG
HACKEN LEE	PINYINCHINESENAME	Lǐ KèQíN
EASON CHAN	PINYINCHINESENAME	CHéN YìXùN
JAYCEE CHAN	PINYINCHINESENAME	FáNG ZǔMíNG
ANGIE CHEONG	PINYINCHINESENAME	ZHāNG HUìYí
DAO LANG	PINYINCHINESENAME	DāO LáNG
JAMES WONG	PINYINCHINESENAME	HUáNG ZHāN
VANGIE TANG	PINYINCHINESENAME	DENG4 YING3 ZHI1
LIZA WANG	PINYINCHINESENAME	WāNG MíNGQUáN
YUEN WAH	PINYINCHINESENAME	YUáN HUá
CYNDI WANG	PINYINCHINESENAME	WáNG XīNLíNG
MA SANLI	PINYINCHINESENAME	Mǎ SāNLì
ANDY HUI	PINYINCHINESENAME	Xǔ ZHì'āN
JOEY WONG	PINYINCHINESENAME	WáNG ZǔXIáN
F.I.R.	PINYINCHINESENAME	FēIéR YUèTUáN
Y2J	PINYINCHINESENAME	SHéN Mù Yǔ TóNG
FELIX WONG	PINYINCHINESENAME	HUáNG RìHUá
YUEN WOO-PING	PINYINCHINESENAME	YUáN HéPíNG
ALAN TAM	PINYINCHINESENAME	TáN YǒNGLíN
ADAM CHENG	PINYINCHINESENAME	ZHèNG SHàOQIū
WONG KA KUI	PINYINCHINESENAME	HUáNG JIāJū
WONG KA KEUNG	PINYINCHINESENAME	HUANG2 JIA1 QIANG2
RUBY LIN	PINYINCHINESENAME	LíN XīNRú
PAUL WONG	PINYINCHINESENAME	HUáNG GUàNZHōNG
YIP SAI WING	PINYINCHINESENAME	Yè SHìRóNG
TONY LEUNG KA-FAI	PINYINCHINESENAME	LIáNG JIāHUī
KIT CHAN	PINYINCHINESENAME	CHéN JIéYí
ANITA YUEN	PINYINCHINESENAME	YUáN YǒNGYí
RICHARD LAM	PINYINCHINESENAME	LíN ZHèNQIáNG
PAULA TSUI	PINYINCHINESENAME	XU2 XIAO3 FENG4
SEAN LAU	PINYINCHINESENAME	LíU QīNGYúN
FRANCIS NG	PINYINCHINESENAME	Wú ZHèNYǔ
DAVID TAO	PINYINCHINESENAME	TáO ZHé
SIMON YAM	PINYINCHINESENAME	RéN DáHUá
DEANIE IP	PINYINCHINESENAME	Yè DéXIáN
ISABELLA LEONG	PINYINCHINESENAME	LIáNG LUòSHī
SELINA JEN	PINYINCHINESENAME	RéN JIāXUāN
ZHOU XUAN	PINYINCHINESENAME	ZHōU XUáN
NANCY SIT	PINYINCHINESENAME	XUē JIāYàN
HOU HSIAO-HSIEN	PINYINCHINESENAME	HóU XIàOXIáN
BRUCE LI	PINYINCHINESENAME	Lí XIǎOLóNG
RICKY HUI	PINYINCHINESENAME	Xǔ GUàNYīNG
YUAN MUZHI	PINYINCHINESENAME	YUáN MùZHī
SUSANNE HOU	PINYINCHINESENAME	HóU YǐJIā
TI LUNG	PINYINCHINESENAME	Dí LóNG
JOSEPHINE SIAO	PINYINCHINESENAME	XIāO FāNGFāNG
IDY CHAN	PINYINCHINESENAME	CHéN YùLIáN
BRIGITTE LIN	PINYINCHINESENAME	LíN QīNGXIá
EKIN CHENG	PINYINCHINESENAME	ZHèNG YīJIàN
PATTY HOU	PINYINCHINESENAME	HóU PèICéN
LIU YE	PINYINCHINESENAME	LíU Yè
WING	PINYINCHINESENAME	ZēNG YǒNGHáN
JIA ZHANGKE	PINYINCHINESENAME	JIǎ ZHāNGKē
KENIX KWOK	PINYINCHINESENAME	GUō KěYíNG
KAREN MOK	PINYINCHINESENAME	Mò WéNWèI
RAYMOND TO	PINYINCHINESENAME	Dù GUóWēI
FELICIA CHIN	PINYINCHINESENAME	CHéN FèNGLíNG
CHRISTY CHUNG	PINYINCHINESENAME	ZHōNG LìTí
FENG FENG	PINYINCHINESENAME	FéNG FēNG
SUN DAOLIN	PINYINCHINESENAME	SūN DàOLíN
MICHELLE CHONG	PINYINCHINESENAME	ZHUāNG MǐXUě
WU TIANMING	PINYINCHINESENAME	Wú TIāNMíNG
TIAN ZHUANGZHUANG	PINYINCHINESENAME	TIáN ZHUàNGZHUàNG
ZHAO WEI	PINYINCHINESENAME	ZHàO WēI
BENNY CHAN	PINYINCHINESENAME	CHéN MùSHèNG
ANTHONY WONG	PINYINCHINESENAME	HUáNG YàOMíNG
JADE KWAN	PINYINCHINESENAME	GUAN1 XIN1 YAN2
SHANNON LEE	PINYINCHINESENAME	Lǐ XIāNGNíNG
SILVER ASH	PINYINCHINESENAME	YíNSè HUīCHéN
RAINIE YANG	PINYINCHINESENAME	YáNG CHéNGLíN
LIU KAI-CHI	PINYINCHINESENAME	LIàO QǐZHì
WONG JING	PINYINCHINESENAME	WáNG JīNG
JEANETTE AW	PINYINCHINESENAME	ŌU XUāN
CHANG FEI	PINYINCHINESENAME	ZHāNG FēI
ERIC MOO	PINYINCHINESENAME	Wū QǐXIáN
VALERIE CHOW	PINYINCHINESENAME	ZHōU JIāLíNG
WILBER PAN	PINYINCHINESENAME	PāN WěIBó
SHAWN YUE	PINYINCHINESENAME	Yú WéNLè
KENNETH TSANG	PINYINCHINESENAME	ZēNG JIāNG
FISH LEONG	PINYINCHINESENAME	LIáNG JìNGRú
ERIC TSANG	PINYINCHINESENAME	ZēNG ZHìWěI
RAYMOND CHOW	PINYINCHINESENAME	ZōU WéNHUáI
ROGER KWOK	PINYINCHINESENAME	GUō JǐNáN
ALEXANDER FU SHENG	PINYINCHINESENAME	Fù SHēNG
RACE WONG	PINYINCHINESENAME	HUANG2 WAN3 LING2
LAM BUN	PINYINCHINESENAME	LíN BīN
ADIA CHAN	PINYINCHINESENAME	CHéN SōNGLíNG
ASHIN	PINYINCHINESENAME	CHéN XìNHóNG
JESSICA HSUAN	PINYINCHINESENAME	XUāN XUāN
LOUIS KOO	PINYINCHINESENAME	Gǔ TIāNLè
ADA CHOI	PINYINCHINESENAME	CàI SHàOFēN
YOSHIKO YAMAGUCHI	PINYINCHINESENAME	Lǐ XIāNGLáN
SHIRLEY KWAN	PINYINCHINESENAME	GUāN SHúYí
FRANKIE KAO	PINYINCHINESENAME	GāO LíNGFēNG
AMY YIP	PINYINCHINESENAME	Yè ZǐMèI
NA YING	PINYINCHINESENAME	Nà YīNG
LIU XIAO LING TONG	PINYINCHINESENAME	LìU XIǎO LíNG TóNG
AT17	PINYINCHINESENAME	YAN4 SHI2 FEN1 TIAN1
KENNY BEE	PINYINCHINESENAME	ZHōNG ZHèNTāO
JORDAN CHAN	PINYINCHINESENAME	CHéN XIǎOCHūN
WAKIN CHAU	PINYINCHINESENAME	ZHōU HUáJIàN
MAGGIE SHIU	PINYINCHINESENAME	SHàO MěIQí
CHIN KA-LOK	PINYINCHINESENAME	QIAN JIALE
FEI YU-CHING	PINYINCHINESENAME	FèI YùQīNG
WU MA	PINYINCHINESENAME	Wǔ Mǎ
LAM CHING-YING	PINYINCHINESENAME	LíN ZHèNGYĩNG
GORDON LIU	PINYINCHINESENAME	LIú JIāHUī
LIU YIFEI	PINYINCHINESENAME	LíU YìFēI
WEI WEI	PINYINCHINESENAME	WéI WéI
VIVIAN WU	PINYINCHINESENAME	Wū JūNMéI
TAT MING PAIR	PINYINCHINESENAME	DA2 MING2 YI1 PAI4
ENDY CHOW	PINYINCHINESENAME	ZHOU1 GUO2 XIAN2
JULIAN CHEUNG	PINYINCHINESENAME	ZHāNG ZHìLíN
GEORGE LAM	PINYINCHINESENAME	LíN ZǐXIáNG
ALEX FONG	PINYINCHINESENAME	FāNG LìSHēN
CHAPMAN TO	PINYINCHINESENAME	Dù WéNZé
JIM CHIM	PINYINCHINESENAME	ZHāN RUìWéN
PETER PAU	PINYINCHINESENAME	BāO Dé Xī
BARBARA YUNG	PINYINCHINESENAME	WēNG MěILíNG
ADRIAN PANG	PINYINCHINESENAME	PéNG YàOSHùN
ROY CHEUNG	PINYINCHINESENAME	ZHāNG YàOYáNG
GALLEN LO	PINYINCHINESENAME	LUó JIāLIáNG
SANDY LAM	PINYINCHINESENAME	LíN YìLIáN
KELLY POON	PINYINCHINESENAME	PāN JīALì
CHINGMY YAU	PINYINCHINESENAME	QIū SHūZHēN
MELISSA NG	PINYINCHINESENAME	Wú MěIHéNG
CHARMAINE SHEH	PINYINCHINESENAME	SHé SHīMàN
LIU XIAOQING	PINYINCHINESENAME	LíU XIǎOQìNG
ATHENA CHU	PINYINCHINESENAME	ZHū YīN
PATRICK TAM	PINYINCHINESENAME	TáN YIǎOWéN
DANIEL WU	PINYINCHINESENAME	Wú YàNZǔ
LANDY WEN	PINYINCHINESENAME	WēN LáN
MAGGIE CHEUNG HO-YEE	PINYINCHINESENAME	ZHāNG KěYí
DANNY CHAN KWOK-KWAN	PINYINCHINESENAME	CHéN GUóKūN
JOYCE CHENG	PINYINCHINESENAME	ZHèNG XīNYí
SUNNY CHAN	PINYINCHINESENAME	CHéN JǐNHóNG
JJ LIN	PINYINCHINESENAME	LíN JùNJIé
ZHANG YUAN	PINYINCHINESENAME	ZHāNG YUáN
KWONG WA	PINYINCHINESENAME	JIāNG HUá
ANNIE YI	PINYINCHINESENAME	Yī NéNGJìNG
HE PING	PINYINCHINESENAME	Hé PíNG
LI YUCHUN	PINYINCHINESENAME	Lǐ YǔCHūN
BOBO CHAN	PINYINCHINESENAME	CHEN2 WEN2 YUAN2
PATRICK TSE	PINYINCHINESENAME	XIè XIáN
FU BIAO	PINYINCHINESENAME	Fù BIāO
JANE ZHANG	PINYINCHINESENAME	ZHāNG LIàNGYǐNG
CHIU CHI-LING	PINYINCHINESENAME	ZHàO ZHìLíNG
KENNETH CHAN KAI-TAI	PINYINCHINESENAME	CHéN QǐTàI
DICKY CHEUNG	PINYINCHINESENAME	ZHāNG WèIJIàN
STEVEN CHEUNG	PINYINCHINESENAME	ZHāNG ZHìHéNG
CHEN HAO	PINYINCHINESENAME	CHéN HǎO
SHIRLEY YEUNG	PINYINCHINESENAME	YáNG SīQí
LAU KAR-LEUNG	PINYINCHINESENAME	LIú JIāLIáNG
KENNY KWAN	PINYINCHINESENAME	GUāN ZHìBīN
FRANCES YIP	PINYINCHINESENAME	Yè LìYí
ZHOU XIAOWEN	PINYINCHINESENAME	ZHōU XIǎOWéN
GIGI LAI	PINYINCHINESENAME	Lí Zī
XIE SHAOGUANG	PINYINCHINESENAME	XIè SHáOGUāNG
TAY PING HUI	PINYINCHINESENAME	ZHèNG BīNHUī
XIE JIN	PINYINCHINESENAME	XIè JìN
WANG XIAOSHUAI	PINYINCHINESENAME	WáNG XIăOSHUàI
STEPHY TANG	PINYINCHINESENAME	DèNG LìXīN
THERESA FU	PINYINCHINESENAME	Fù YǐNG
KARY NG	PINYINCHINESENAME	WU2 YU3 FEI1
MIKI YEUNG	PINYINCHINESENAME	YANG2 AI4 JIN3
DENISE HO	PINYINCHINESENAME	Hé YùNSHī
LO LIEH	PINYINCHINESENAME	LUó LIè
KELVIN TAN	PINYINCHINESENAME	CHéN WěILIáN
MANDY CHO	PINYINCHINESENAME	CáO MǐNLì
NING JING	PINYINCHINESENAME	NíNG JìNG
IVY LEE	PINYINCHINESENAME	Lǐ JǐNMéI
LI NANXING	PINYINCHINESENAME	Lǐ NáNXīNG
ANDREW SEOW	PINYINCHINESENAME	XIāO YǐMíNG
CHRISTOPHER LEE	PINYINCHINESENAME	Lǐ MíNGSHùN
JIMMY WANG YU	PINYINCHINESENAME	WáNG Yǔ
NIKI CHOW	PINYINCHINESENAME	ZHōU Lì Qí
TSAI CHIN	PINYINCHINESENAME	ZHōU CǎIQíN
BOSCO WONG	PINYINCHINESENAME	HUáNG ZōNGZé
JIMMY LIN	PINYINCHINESENAME	LíN ZHìYǐNG
KELLYJACKIE	PINYINCHINESENAME	CHEN2 XIAO3 QI2
ELLA KOON	PINYINCHINESENAME	GUāN ĒNNà
MOSES CHAN	PINYINCHINESENAME	CHéN HáO
DICK LEE	PINYINCHINESENAME	Lǐ DíWéN
KATE TSUI	PINYINCHINESENAME	Xú ZǐSHāN
ANGELICA LEE	PINYINCHINESENAME	Lǐ XīNJIé
TAVIA YEUNG	PINYINCHINESENAME	YáNG Yí
BACK DORM BOYS	PINYINCHINESENAME	HòUSHè NáNSHēNG
CHET LAM	PINYINCHINESENAME	LíN YīFēNG
ELLEN JOYCE LOO	PINYINCHINESENAME	Lú KǎITóNG
OCEAN OU	PINYINCHINESENAME	ŌU Dé YáNG
EMAN LAM	PINYINCHINESENAME	LIN2 ER4 WEN4
JENNY TSENG	PINYINCHINESENAME	ZHēN Nī
DERIC WAN	PINYINCHINESENAME	WēN ZHàO LúN
JACKIE CHAN STUNT TEAM	PINYINCHINESENAME	CHéNG JIā BāN
STANLEY HUANG	PINYINCHINESENAME	HUáNG LìXíNG
JANICE VIDAL	PINYINCHINESENAME	WèI LáN
CARMAN LEE	PINYINCHINESENAME	Lǐ RUòTóNG
JEFF CHANG	PINYINCHINESENAME	ZHāNG XìN ZHé
DEREK YEE	PINYINCHINESENAME	ĚR DōNGSHēNG
YVONNE YUNG	PINYINCHINESENAME	WēNG HóNG
NORA MIAO	PINYINCHINESENAME	MIáO KěXIù
HUANG BIREN	PINYINCHINESENAME	HUáNG BìRéN
MARK LEE	PINYINCHINESENAME	Lǐ GUóHUáNG
MICHAEL WONG	PINYINCHINESENAME	WáNG GUāNGLIáNG
JUSTIN LIN	PINYINCHINESENAME	LíN YìBīN
MAYDAY	PINYINCHINESENAME	Wǔ YUè TIāN
CHEW CHOR MENG	PINYINCHINESENAME	ZHōU CHūMíNG
QI YUWU	PINYINCHINESENAME	Qī YùWǔ
JAN LAMB	PINYINCHINESENAME	LíN HăIFēNG
TANYA CHUA	PINYINCHINESENAME	CàI JIàNYǎ
NG MAN-TAT	PINYINCHINESENAME	Wú MèNGDá
IVY LING PO	PINYINCHINESENAME	LíNG Bō
FIONA SIT	PINYINCHINESENAME	XUE1 KAI3 QI2
MARK LUI	PINYINCHINESENAME	LéI SòNG Dé
AILEEN TAN	PINYINCHINESENAME	CHéN LìZHēN
XIANG YUN	PINYINCHINESENAME	XIàNG YúN
XIANG YUN	PINYINCHINESENAME	WADE-GILES: HSIANG4 YüN2
RICHIE JEN	PINYINCHINESENAME	RéN XIáNQí
DADAWA	PINYINCHINESENAME	ZHU1 ZHE2 QIN2
EDWARD YANG	PINYINCHINESENAME	YáNG DéCHāNG
FENG GONG	PINYINCHINESENAME	FéNG GǒNG
GRASSHOPPER	PINYINCHINESENAME	CǎO MěNG
LI XUEJIAN	PINYINCHINESENAME	Lí XUěJIàN
DIANA PANG	PINYINCHINESENAME	PéNG DāN
CHEN BOLIN	PINYINCHINESENAME	CHéN BóLíN
ROSAMUND KWAN	PINYINCHINESENAME	GUāN ZHīLíN
RON NG	PINYINCHINESENAME	Wú ZHUōXī
FAITH YANG	PINYINCHINESENAME	YáNG NǎIWéN
WU BAI	PINYINCHINESENAME	Wǔ BǎI
KENJI WU	PINYINCHINESENAME	Wú KèQúN
RAY LUI	PINYINCHINESENAME	Lǚ LIáNGWěI
SHARON AU	PINYINCHINESENAME	ŌU JīNGXIāN
HEBE TIEN	PINYINCHINESENAME	TIáN FùZHēN
BERNICE LIU	PINYINCHINESENAME	LIàO Bì'éR
FAN BINGBING	PINYINCHINESENAME	FàN BīNGBīNG
IVANA WONG	PINYINCHINESENAME	WANG2 WAN3 ZHI1
COLLIN CHOU	PINYINCHINESENAME	ZōU ZHàOLóNG
LI XIAOLU	PINYINCHINESENAME	Lǐ XIǎOLù
PANG BROTHERS	PINYINCHINESENAME	PéNG Fā
PANG BROTHERS	PINYINCHINESENAME	PéNG SHùN
KELLY LIN	PINYINCHINESENAME	LíN XīLěI
SHIH KIEN	PINYINCHINESENAME	SHí JIāN
BOBBY AU-YEUNG	PINYINCHINESENAME	ŌUYáNG ZHèNHUá
XIA YU	PINYINCHINESENAME	XIà Yǔ
LEE HOI-CHUEN	PINYINCHINESENAME	Lǐ HǎIQUáN
ADAM CHEN	PINYINCHINESENAME	ZHāN JīNQUáN
SAMMY LEUNG	PINYINCHINESENAME	SEN1 MEI3
JOSHUA ANG	PINYINCHINESENAME	HóNG CìJIàN
DASMOND KOH	PINYINCHINESENAME	Xǔ ZHèNRóNG
FEI MU	PINYINCHINESENAME	FèI Mù
CAI CHUSHENG	PINYINCHINESENAME	CàI CHǔSHēNG
MANDY CHIANG	PINYINCHINESENAME	JIANG3 YA3 WEN2
LISA LU	PINYINCHINESENAME	Lú YàN
MYOLIE WU	PINYINCHINESENAME	Hú XìNG'éR
RUI EN	PINYINCHINESENAME	RUì'EN
PENNY TAI	PINYINCHINESENAME	DáI PEìNī
ELLA CHEN	PINYINCHINESENAME	CHéN JIāHUà
FLORA CHAN	PINYINCHINESENAME	CHEN2 HUI4 SHAN1
CHEN HONG	PINYINCHINESENAME	CHéN HóNG
CHENG PEI-PEI	PINYINCHINESENAME	ZHèNG PèIPèI
ANGELA MAO	PINYINCHINESENAME	MáO YīNG
KWAN TAK-HING	PINYINCHINESENAME	GUāN DéXīNG
BIBI ZHOU	PINYINCHINESENAME	ZHōU BǐCHàNG
CHEN HANWEI	PINYINCHINESENAME	CHéN HàN WěI
WU YONGGANG	PINYINCHINESENAME	Wú YǒNGGāNG
YUEN SIU-TIEN	PINYINCHINESENAME	YUáN XIǎOTIáN
SANDRA NG	PINYINCHINESENAME	WU2 JUN1 RU2
SAM LEE	PINYINCHINESENAME	Lǐ CàNCHēN
CHEN XIUHUAN	PINYINCHINESENAME	CHéN XIùHUáN
REBECCA CHAN	PINYINCHINESENAME	CHéN XìU ZHū
LOUISE LEE	PINYINCHINESENAME	Lǐ SīQí
YAN YAN MAK	PINYINCHINESENAME	MàI WăNXīN
JOANNE PEH	PINYINCHINESENAME	BáI WēIXìU
NAN QUAN MAMA	PINYINCHINESENAME	NáN QUáN MāMā
CHARMAINE LI	PINYINCHINESENAME	LI SIXIN
LI BINGBING	PINYINCHINESENAME	Lǐ BīNGBīNG
TANK	PINYINCHINESENAME	Lǚ JIàNZHōNG
SAMMUL CHAN	PINYINCHINESENAME	CHéN JIàNFēNG
SONIJA KWOK	PINYINCHINESENAME	GUō XIàNNī
SHARON CHAN	PINYINCHINESENAME	CHéN MǐNZHī
VINCY CHAN	PINYINCHINESENAME	YǒNG'éR
LEILA TONG	PINYINCHINESENAME	TANG2 NING2
DON LI	PINYINCHINESENAME	LI3 YI4 LANG3
CHERRIE YING	PINYINCHINESENAME	YìNG CǎIéR
HUANG XIAOMING	PINYINCHINESENAME	HUáNG XIǎOMíNG
LINDA CHUNG	PINYINCHINESENAME	ZHōNG JIāXīN
BLACKIE CHEN	PINYINCHINESENAME	CHéN JIàNZHōU
BENNY YAU	PINYINCHINESENAME	QIū SUìHéNG
JOE CHEN	PINYINCHINESENAME	CHEN QIAO EN
ANGELA CHANG	PINYINCHINESENAME	ZHāNG SHàOHáN
LIU TAO	PINYINCHINESENAME	LíU TāO
JIANG QINQIN	PINYINCHINESENAME	JIǎNG QíNQíN
ERIC WAN	PINYINCHINESENAME	YǐN TIāNZHàO
SHAWN LEE	PINYINCHINESENAME	LI CHUàNGRUì
SHEREN TANG	PINYINCHINESENAME	DèNG CUìWéN
STEVEN MA	PINYINCHINESENAME	Mǎ JùNWěI
KEVIN CHENG	PINYINCHINESENAME	ZHèNG JIāYǐNG
KAIRA GONG	PINYINCHINESENAME	GǒNG SHī JIā
CONNIE CHAN	PINYINCHINESENAME	CHéN BǎOZHū
CHYI CHIN	PINYINCHINESENAME	Qí QíN
FREYA LIM	PINYINCHINESENAME	LIN FAN
TRACY IP	PINYINCHINESENAME	Yè CUìCUì
SHOW LUO	PINYINCHINESENAME	LUó ZHìXIáNG
SYLVIA CHANG	PINYINCHINESENAME	ZHāNG1 ÀI4 JIā1
TIFFANY LAM	PINYINCHINESENAME	LíN MǐNì
DAVE WANG	PINYINCHINESENAME	WANG2 JIE2
KEN LO	PINYINCHINESENAME	Lú HUìGUāNG
FALA CHEN	PINYINCHINESENAME	CHéN FǎLā
GLORIA YIP	PINYINCHINESENAME	YE YUN-YI
WU JING	PINYINCHINESENAME	Wú JīNG
LEANNE LI	PINYINCHINESENAME	LI3 YA4 NAN2
ZHANG YANG	PINYINCHINESENAME	ZHāNG YáNG
MAVIS HEE	PINYINCHINESENAME	Xǔ MěIJìNG
ALAN KO	PINYINCHINESENAME	Kē YǒULúN
CHARLIE YOUNG	PINYINCHINESENAME	YáNG CàI Nī
NICHOLAS TEO	PINYINCHINESENAME	ZHāNG DòNGLIáNG
NICKY WU	PINYINCHINESENAME	Wú QíLóNG
LEON JAY WILLIAMS	PINYINCHINESENAME	Lì WēI LIáN
ELLEN CHAN	PINYINCHINESENAME	CHéN Yǎ LúN
ANG CHING HUI	PINYINCHINESENAME	WēNG QìNHUì
MARIA CORDERO	PINYINCHINESENAME	Mǎ LìYà
JOE CHENG	PINYINCHINESENAME	ZHèNG YUáNCHàNG
KANG KANG	PINYINCHINESENAME	KāNG JìNRóNG
AH NIU	PINYINCHINESENAME	ā NIú
ZHOU XUN	PINYINCHINESENAME	ZHōU XùN
WILLIAM CHAN	PINYINCHINESENAME	CHéN WěITíNG
CHELSIA CHAN	PINYINCHINESENAME	CHEN2 QIU1 XIA2
YANG MI	PINYINCHINESENAME	YáNG Mì
APPLE HONG	PINYINCHINESENAME	HóNG YǐXīN
WILSON YIP	PINYINCHINESENAME	Yé WěIXìN
JERRYC	PINYINCHINESENAME	ZHāNG YìFāN
HAN GENG	PINYINCHINESENAME	HáN GēNG
WAI KA-FAI	PINYINCHINESENAME	WEI2 JIā1 HUī4
ALEX FONG	PINYINCHINESENAME	FāNG ZHōNGXìN
CYNTHIA KOH	PINYINCHINESENAME	Xǔ MěIZHēN
NATALIS CHAN	PINYINCHINESENAME	CHéN BáI XIáNG
NATALIE WONG	PINYINCHINESENAME	HUáNG JìYíNG
YLK ORGANIZATION	PINYINCHINESENAME	YU2 LI4 JI1 GOU4
MICHELLE YE	PINYINCHINESENAME	Yè XUáN
ANGIE CHIU	PINYINCHINESENAME	ZHàO YǎZHī
XU JINGLEI	PINYINCHINESENAME	Xú JìNGLěI
BOWIE LAM	PINYINCHINESENAME	LíN BǎOYí
VALEN HSU	PINYINCHINESENAME	Xǔ RúYúN
ELAINE NG YI-LEI	PINYINCHINESENAME	Wú QǐLì
CARRIE LAM	PINYINCHINESENAME	LíN Lì
QUEENIE CHU	PINYINCHINESENAME	ZHū HUì MǐN
KARA HUI	PINYINCHINESENAME	HUì YīNG HóNG
WINSTON CHAO	PINYINCHINESENAME	ZHàO WéNXUāN
HU JUN	PINYINCHINESENAME	Hú JūN
SELENA LI	PINYINCHINESENAME	Lǐ SHīHUà
SHARON LUK	PINYINCHINESENAME	LU4 SHI1 YUN4
CHERIE CHUNG	PINYINCHINESENAME	ZHōNG CHU HóNG
TSAI CHIN	PINYINCHINESENAME	CàI QíN
ANGELA TONG	PINYINCHINESENAME	TANG1 YING2 YING2
LAWRENCE AH MON	PINYINCHINESENAME	LIú\TGUó CHāNG
JANET CHOW	PINYINCHINESENAME	ZHōU JIāWèI
LI JINHUI	PINYINCHINESENAME	Lí JǐNHUī
BOWIE TSANG	PINYINCHINESENAME	ZēNG BǎOYí
ZHENG JUNLI	PINYINCHINESENAME	ZHèNG JūNLǐ
TATS LAU	PINYINCHINESENAME	LIú YǐDá
ARIEL LIN	PINYINCHINESENAME	LíN YīCHéN
ZHAO DAN	PINYINCHINESENAME	ZHàO DāN
SOO KUI JIEN	PINYINCHINESENAME	Sū GUìJIàN
CHEN KUN	PINYINCHINESENAME	CHéN KūN
EMME WONG	PINYINCHINESENAME	HUáNG Yī WéN
REN YEXIANG	PINYINCHINESENAME	RéN YěXIāNG
LEUNG SIU-LUNG	PINYINCHINESENAME	LIáNG XIǎOLóNG
TERESA CARPIO	PINYINCHINESENAME	Dù LìSHā
ZHANG LIYIN	PINYINCHINESENAME	ZHāNG LìYǐN
CANDY LO	PINYINCHINESENAME	Lú QIǎO YīN
HAWICK LAU	PINYINCHINESENAME	LIú KǎIWēI
BRUCE LE	PINYINCHINESENAME	Lú XIǎOLóNG
HARLEM YU	PINYINCHINESENAME	Yú CHéNGQìNG
RONALD CHENG	PINYINCHINESENAME	ZHèNG ZHōNGJī
PHILIP KWOK	PINYINCHINESENAME	GUō ZHUī
MICHAEL KWAN	PINYINCHINESENAME	GUAN1 ZHENG4 JIE2
ADY AN	PINYINCHINESENAME	ĀN YǐXUāN
VIVIEN YEO	PINYINCHINESENAME	YáNG XìUHùI
TEDDY ROBIN	PINYINCHINESENAME	TAI4 DI2 LUO2 BIN1
EDISON CHEN	PINYINCHINESENAME	CHéN GUāNXī
ANNE HEUNG	PINYINCHINESENAME	XIàNG HǎILáN
NINA LI	PINYINCHINESENAME	Lì ZHì
FRANçOISE YIP	PINYINCHINESENAME	Yè FāNGHUá
FRANKIE LAM	PINYINCHINESENAME	LIN WEN LONG
YOYO MUNG	PINYINCHINESENAME	MéNG JIā HUì
STEPHEN CHAN CHI-WAN	PINYINCHINESENAME	CHéN ZHìYúN
DAVID CHIANG	PINYINCHINESENAME	JIāNG DàWèI
CHANG CHEN-YUE	PINYINCHINESENAME	ZHāNG ZHèNYùE
YU JIM-YUEN	PINYINCHINESENAME	Yú ZHāNYUáN
HUANG SHENGYI	PINYINCHINESENAME	HUáNG SHèNGYī
SAM CHAN	PINYINCHINESENAME	CHEN YUCEN
RICHARD LOW	PINYINCHINESENAME	LIú QIāNYì
MARGARET LEE	PINYINCHINESENAME	Lǐ MěILíNG
BENNY CHAN	PINYINCHINESENAME	CHéN HàOMíN
GUO DEGANG	PINYINCHINESENAME	GUō DéGāNG
CHARLES YING	PINYINCHINESENAME	YING4 CHANG1 YOU4
PIERRE PNG	PINYINCHINESENAME	FāNG ZHǎNFā
RUNME SHAW	PINYINCHINESENAME	SHàO RéNMéI
LU YI	PINYINCHINESENAME	Lù Yì
MIKE HE	PINYINCHINESENAME	Hè JūNXIáNG
LIU HUAN	PINYINCHINESENAME	LIú HUāN
POWER STATION	PINYINCHINESENAME	DòNGLì HUǒCHē
LIN XI	PINYINCHINESENAME	LIN2 XI1
ELVIN NG	PINYINCHINESENAME	HUáNG JùNXíONG
HU GE	PINYINCHINESENAME	Hú Gē
WINNIE LAU	PINYINCHINESENAME	LIU2 XIAO3 HUI4
TERENCE CAO	PINYINCHINESENAME	CáO GUóHUī
BABY ZHANG	PINYINCHINESENAME	ZHāNG HáNYùN
TERESA MO	PINYINCHINESENAME	MáO SHùNJūN
SHEILA CHAN	PINYINCHINESENAME	CHéN SHūLáN
KANG CHENG XI	PINYINCHINESENAME	JIāNG CHéNGXǐ
ALIEN SUN	PINYINCHINESENAME	SūN JIāJūN
MA JI	PINYINCHINESENAME	Mǎ Jì
ALEX TO	PINYINCHINESENAME	DU4 DE2 WEI3
ALAN TERN	PINYINCHINESENAME	TáNG YùSHū
ZHANG FENGYI	PINYINCHINESENAME	ZHāNG FēNGYì
LO TA-YU	PINYINCHINESENAME	LUó DàYòU
FAHRENHEIT	PINYINCHINESENAME	FēILúNHǎI
CHIN TSI-ANG	PINYINCHINESENAME	QIáN SìYīNG
BLACKIE KO	PINYINCHINESENAME	Kē SHòU LIáNG
LOUISA SO	PINYINCHINESENAME	Sū YùHUā
TERENCE YIN	PINYINCHINESENAME	YIN ZIWEI
VICTOR WONG	PINYINCHINESENAME	HUáNG PǐNGUàN
KHALIL FONG	PINYINCHINESENAME	FāNG DàTóNG
POWER CHAN	PINYINCHINESENAME	CHéN GUóBǎNG
MATTHEW KO	PINYINCHINESENAME	GāO JūNXIáN
THE WYNNERS	PINYINCHINESENAME	WēN Nā
WILFRED LAU	PINYINCHINESENAME	LIU2 HAO4 LONG2
SUN FEIFEI	PINYINCHINESENAME	SūN FēIFēI
ALLAN WU	PINYINCHINESENAME	Wú ZHèNTIāN
HSIAO HO	PINYINCHINESENAME	HSIAO HOU
WU CHUN	PINYINCHINESENAME	Wú ZūN
RAYSON TAN	PINYINCHINESENAME	CHéN TàIMíNG
AARON YAN	PINYINCHINESENAME	YáN YǎLúN
SARAH SONG	PINYINCHINESENAME	SòNG XīNíAN
JADE SEAH	PINYINCHINESENAME	XIè MěIYù
BEATRICE HSU	PINYINCHINESENAME	Xǔ WěILúN
SHAWN TNG	PINYINCHINESENAME	TáNG ZHìWéI
JIRO WANG	PINYINCHINESENAME	WāNG DōNGCHéNG
GU CHANGWEI	PINYINCHINESENAME	Gù CHáNGWèI
CALVIN CHEN	PINYINCHINESENAME	CHéN YìRú
YAO LEE	PINYINCHINESENAME	YáO Lì
NATALIE TONG	PINYINCHINESENAME	TáNG SHī YǒNG
YAM KIM-FAI	PINYINCHINESENAME	RéN JIàNHUī
BAK SHEUT-SIN	PINYINCHINESENAME	BáI XUěXIāN
ANTHONY LUN	PINYINCHINESENAME	LúN YôNG LIàNG
WEI ZI	PINYINCHINESENAME	WēI Zǐ
ZHANG YAODONG	PINYINCHINESENAME	ZHāNG YàODòNG
GARY CHAW	PINYINCHINESENAME	CáO Gé
LOU YE	PINYINCHINESENAME	LóU Yè
LAU DAN	PINYINCHINESENAME	LIú DāN
JOEY MENG	PINYINCHINESENAME	WàN QǐWéN
SODAGREEN	PINYINCHINESENAME	SūDǎ Lǜ
EVAN YO	PINYINCHINESENAME	CàI MíNYòU
BECKY LEE	PINYINCHINESENAME	Lǐ BìQí
CHAN SING	PINYINCHINESENAME	CHéN XīNG
CHANG YU-SHENG	PINYINCHINESENAME	ZHāNG YǔSHēNG
PHIL CHANG	PINYINCHINESENAME	ZHANG1 YU3
GAO YUANYUAN	PINYINCHINESENAME	GāO YUáNYUáN
HE MEITIAN	PINYINCHINESENAME	Hé MěITIáN
CINDY AU	PINYINCHINESENAME	ŌU QIàNYí
NGO KA-NIN	PINYINCHINESENAME	ÁO JIāNIáN
SHARLA CHEUNG	PINYINCHINESENAME	ZHāNG MǐN
TIMI ZHUO	PINYINCHINESENAME	ZHUó YīTíNG
VICTOR HUANG	PINYINCHINESENAME	HUáNG WéIDé
ETHAN JUAN	PINYINCHINESENAME	RUǎN JīNGTIāN
SUN YU	PINYINCHINESENAME	SūN Yú
KELVIN KWAN	PINYINCHINESENAME	GUāN CHǔYàO
ROMAN AND THE FOUR STEPS	PINYINCHINESENAME	LUó WéN Sǐ Bú Hé CHāNG TUáN
LOTUS	PINYINCHINESENAME	LIAN2 HUA1 LUO4 DUI4
DAREN TAN	PINYINCHINESENAME	CHéN SHìWéI -> CHéN XUāN Yù
LAM CHI-CHUNG	PINYINCHINESENAME	LíN ZǐCōNG
DANSON TANG	PINYINCHINESENAME	TáNG YǔZHé
RICHARD NG	PINYINCHINESENAME	Wú YàOHàN
YOU YONG	PINYINCHINESENAME	YóU YǒNG
KENNETH MA	PINYINCHINESENAME	Mǎ GUóMíNG
JOE MA	PINYINCHINESENAME	Mǎ DéZHōNG
MICHAEL MIU	PINYINCHINESENAME	MIáO QIáOWěI
BAI GUANG	PINYINCHINESENAME	BáI GUāNG
BAI HONG	PINYINCHINESENAME	BAI2 HONG2
GONG QIUXIA	PINYINCHINESENAME	GONG1 QIU1 XIA2
ELSA LIN	PINYINCHINESENAME	LíN YùTíNG
WU YINGYIN	PINYINCHINESENAME	WU2 YING1 YIN1
LI YANG	PINYINCHINESENAME	Lǐ YáNG
WALLACE HUO	PINYINCHINESENAME	HUò JIàNHUá
YING LIANG	PINYINCHINESENAME	YīNG LIàNG
ANNIE WU	PINYINCHINESENAME	Wú CHéNJūN
KYM NG	PINYINCHINESENAME	ZHōNG QíN
CHARLES HEUNG	PINYINCHINESENAME	XIANG4 HUA2 QIANG2
BRYAN LEUNG	PINYINCHINESENAME	LIáNG JIāRēN
TIFFANY CHEN	PINYINCHINESENAME	CHéN2 MíNG4 YīN1
STANLEY FUNG	PINYINCHINESENAME	FéNG CUìFāN
PHILIP CHAN	PINYINCHINESENAME	CHéN XīNJIàN
KATHY CHOW	PINYINCHINESENAME	ZHōU HǎIMèI
BERG NG	PINYINCHINESENAME	Wú TíNGYé
GORDON LAM	PINYINCHINESENAME	LíN JIāDòNG
WANG QUAN'AN	PINYINCHINESENAME	WáNG QUáN'āN
VINCENT FANG	PINYINCHINESENAME	FāNG WéNSHāN
CHEN XIAOXU	PINYINCHINESENAME	CHéN XIǎOXù
HENRY THIA	PINYINCHINESENAME	CHéNG XùHUī
SHERMAN CHUNG	PINYINCHINESENAME	ZHōNG SHūMàN
SUSANNA KWAN	PINYINCHINESENAME	GUAN1 JU2 YING1
CHARLIE CHIN	PINYINCHINESENAME	QíN XIANGLíN
JASMINE	PINYINCHINESENAME	TíNG ZHú
HA YU	PINYINCHINESENAME	XIà Yǔ
ALAN TANG	PINYINCHINESENAME	DèNG GUāNGRóNG
JACK NEO	PINYINCHINESENAME	LIáNG ZHìQIáNG
WANG LEEHOM	PINYINCHINESENAME	WáNG LìHóNG
WINNIE HSIN	PINYINCHINESENAME	XīN XIǎOQí
HOU YAOWEN	PINYINCHINESENAME	HóU YàOWéN
TIFFANY TANG	PINYINCHINESENAME	TáNG YāN
DENNIS LAW	PINYINCHINESENAME	LUO2 SHOU3 YAO4
MAX MOK	PINYINCHINESENAME	Mò XIǎO CóNG
MICHELLE YIM	PINYINCHINESENAME	Mǐ XUě
FOUR GOLDEN FLOWERS	PINYINCHINESENAME	Sì DUǒ JīN HUā
ANGELA AU	PINYINCHINESENAME	ŌU WéNSHī
SANDRA LANG	PINYINCHINESENAME	XIāNDùLā
THE CHOPSTICKS	PINYINCHINESENAME	KUAI4 ZI3 ZI3 MEI4 HUA1
JOE JUNIOR	PINYINCHINESENAME	ZU3 ZUN1 NI2 YA4
WONG LI-LIN	PINYINCHINESENAME	HUáNG LìLíNG
JIA HONGSHENG	PINYINCHINESENAME	JIǎ HóNGSHēNG
DESERTS CHANG	PINYINCHINESENAME	ZHāNG XUáN
YAU NAI-HOI	PINYINCHINESENAME	YóU NǎI HǎI
ROY CHIU	PINYINCHINESENAME	QIū Zé
Lü YUE	PINYINCHINESENAME	Lǚ YUè
FANFAN	PINYINCHINESENAME	FàN WěIQí
LIU WAI-HUNG	PINYINCHINESENAME	LIàO WěIXIóNG
NAMEWEE	PINYINCHINESENAME	HUANG MINGZHI
MICHAEL & VICTOR	PINYINCHINESENAME	WúYìN LIáNGPǐN
WANG BAOQIANG	PINYINCHINESENAME	WáNG BǎOQIáNG
IX SHEN	PINYINCHINESENAME	SHěN QīNGSHàN
LAI LOK-YI	PINYINCHINESENAME	Lí NùOYì
ANGELA PAN	PINYINCHINESENAME	PāN YíNGZǐ
IAN GOUW	PINYINCHINESENAME	Wú JĭNGTāO
KEN HUNG	PINYINCHINESENAME	HóNG ZHUóLì
ANDY ON	PINYINCHINESENAME	ĀN ZHìJIé
RENE LIU	PINYINCHINESENAME	LIú RUòYīNG
AU KIN-YEE	PINYINCHINESENAME	ŌU JIàN ÉR
LAW WING-CHEUNG	PINYINCHINESENAME	LUó2 YǒNG3 CHāNG1
BENJAMIN YUEN	PINYINCHINESENAME	YUáN WěI HáO
NG SEE-YUEN	PINYINCHINESENAME	Wú SīYUǎN
JAMES TIEN	PINYINCHINESENAME	TIáN JùN
CHAN KWONG-WING	PINYINCHINESENAME	CHéN GUāNGRóNG
TANG GUOQIANG	PINYINCHINESENAME	TáNG GUóQIáNG
ZHAO TAO	PINYINCHINESENAME	ZHàO TāO
CHYI YU	PINYINCHINESENAME	Qí Yù
FRANKIE CHAN	PINYINCHINESENAME	CHéN XūNQí
YAO WENLONG	PINYINCHINESENAME	YáO WéNLóNG
REGINA KENT	PINYINCHINESENAME	JǐAN HùIZHéN
MANFRED WONG	PINYINCHINESENAME	WéN JùN
HEY GIRL	PINYINCHINESENAME	HēI GIRL
MICHAEL TSE	PINYINCHINESENAME	XIè TIáNHUá
LI YU	PINYINCHINESENAME	Lǐ Yù
WANG BING	PINYINCHINESENAME	WáNG BīNG
HOU YONG	PINYINCHINESENAME	HóU YǒNG
RAY CHANG	PINYINCHINESENAME	ZHāNG RUìJIā
JOSEPH CHANG	PINYINCHINESENAME	ZHāNG XIàOQUáN
AN YOUQI	PINYINCHINESENAME	ĀN YòUQí
JACKLYN WU	PINYINCHINESENAME	Wú QIàNLIáN
AMGUULAN	PINYINCHINESENAME	Ā Mù LóNG
JIMMY HEUNG	PINYINCHINESENAME	XIàNG HUáSHèNG
DAMIAN LAU	PINYINCHINESENAME	LIú SōNGRéN
GENIE CHUO	PINYINCHINESENAME	ZHUó WéNXUāN
PU CUNXIN	PINYINCHINESENAME	Pǔ CúNXīN
JIANG WU	PINYINCHINESENAME	JIāNG Wǔ
SHIN	PINYINCHINESENAME	XìN YUèTUáN
NICK CHEUNG	PINYINCHINESENAME	ZHāNG JIāHUī
KIRK WONG	PINYINCHINESENAME	WáNG Yǔ
CHOR YUEN	PINYINCHINESENAME	CHǔ YUáN
SZETO KAM-YUEN	PINYINCHINESENAME	SīTú JǐNYUáN
ALICE AU	PINYINCHINESENAME	ŌU YàNQīNG
ALICE TZENG	PINYINCHINESENAME	ZēNG KǎIXUáN
GORDON CHAN	PINYINCHINESENAME	CHéN JIāSHàNG
MICHELLE GOH	PINYINCHINESENAME	Wú Yí HUì
EILEEN YEOW	PINYINCHINESENAME	YáO YíNGYíNG
HSIEH HO-HSIEN	PINYINCHINESENAME	XIè HéXIáN
CHEN YUNSHANG	PINYINCHINESENAME	CHéN YúNSHANG
ASKA YANG	PINYINCHINESENAME	YáNG ZōNG WěI
DONG JIE	PINYINCHINESENAME	DǒNG JIé
SUN LI	PINYINCHINESENAME	SūN Lì
JONATHAN LEE	PINYINCHINESENAME	Lǐ ZōNGSHèNG
YVONNE LIM	PINYINCHINESENAME	LíN XIāNGPíNG
DA MOUTH	PINYINCHINESENAME	Dà ZUǐ Bā
HUANG WENYONG	PINYINCHINESENAME	HUáNG WéNYǒNG
TOBY LEUNG	PINYINCHINESENAME	LIANG2 JING4 QI2
DIAO YINAN	PINYINCHINESENAME	DIāO YìNáN
CAI SHANGJUN	PINYINCHINESENAME	CàI SHàNGJūN
ANGUS TUNG	PINYINCHINESENAME	TóNG ĀNGé
LIU FENDOU	PINYINCHINESENAME	LíU FèN DǒU
DEE HSU	PINYINCHINESENAME	Xú XīDì
WAISE LEE	PINYINCHINESENAME	Lǐ ZǐXIóNG
JEFFREY LAU	PINYINCHINESENAME	LIú ZHèNWěI
SARAH CHEN	PINYINCHINESENAME	CHéN SHūHUà
BRYAN WONG	PINYINCHINESENAME	WáNG LùJIāNG
RAYMOND WONG HO-YIN	PINYINCHINESENAME	HUáNG HàORáN
ALBERT AU	PINYINCHINESENAME	Oū RUì QIáNG
KINGONE WANG	PINYINCHINESENAME	WáNG CHUáN Yī
JOHN CHONG	PINYINCHINESENAME	ZHUāNG CHéNG
PATRICK YAU	PINYINCHINESENAME	YóU2 DA2 ZHI4
WONG TIN-LAM	PINYINCHINESENAME	WáNG2 TIāN1 LíN2
ZHANG GUOLI	PINYINCHINESENAME	ZHāNG GUóLì
ZHANG JINGCHU	PINYINCHINESENAME	ZHāNG JìNGCHū
CHEN LIPING	PINYINCHINESENAME	CHéN LìPíNG
CLAIRE YIU	PINYINCHINESENAME	YáO JIāNī
MARTIN CHAPPELL	PINYINCHINESENAME	ZHUō1 BǎO3 Yí2
CHEN SHIANG-CHYI	PINYINCHINESENAME	CHéN XIāNG Qí
JIMMY NAH	PINYINCHINESENAME	LáN QīNXǐ
KU FENG	PINYINCHINESENAME	Gǔ FēNG
WANG GUANGLI	PINYINCHINESENAME	WáNG GUāNGLì
LU XUECHANG	PINYINCHINESENAME	Lù XUéCHáNG
HE SAIFEI	PINYINCHINESENAME	Hé SàIFēI
LOWELL LO	PINYINCHINESENAME	Lú GUàNTíNG
JIANG YING	PINYINCHINESENAME	JIǎNG YīNG
SOFTHARD	PINYINCHINESENAME	RUAN3 YING4 TIAN1 SHI1
PAKHO CHAU	PINYINCHINESENAME	ZHōU BǎIHáO
ELAINE YIU	PINYINCHINESENAME	YáO ZǐLíNG
CHEN SHUCHENG	PINYINCHINESENAME	CHéN SHùCHéNG
JADE LEUNG	PINYINCHINESENAME	CHēNG LIáNG
MARIA YI	PINYINCHINESENAME	Yī Yī
ZHAO XIAODING	PINYINCHINESENAME	ZHàO XIǎODīNG
WANG CHAO	PINYINCHINESENAME	WáNG CHāO
WANG YAN	PINYINCHINESENAME	WáNG YàN
AMBER KUO	PINYINCHINESENAME	GUō CǎIJIé
YONFAN	PINYINCHINESENAME	YáNG FáN
JOLENE CHIN	PINYINCHINESENAME	CHéN YǐNG WéN
DANTE LAM	PINYINCHINESENAME	LíN CHāOXIáN
SIQIN GAOWA	PINYINCHINESENAME	SīQíN GāOWá
MATT CHOW	PINYINCHINESENAME	ZōU1 KǎI3 GUāNG1
PANG HO-CHEUNG	PINYINCHINESENAME	PéNG HàOXIáNG
JAM HSIAO	PINYINCHINESENAME	XIāO JìNGTéNG
YU LIK-WAI	PINYINCHINESENAME	Yú LìWéI
CHUNG KING-FAI	PINYINCHINESENAME	ZHONG1 JING3 HUI1
TSUI SIU-MING	PINYINCHINESENAME	Xú2 XIǎO3 MíNG2
YANG SHU	PINYINCHINESENAME	YáNG SHù
WU DI	PINYINCHINESENAME	Wū Dí
WANG YU	PINYINCHINESENAME	WáNG Yù
WANG YUQING	PINYINCHINESENAME	WáNG YùQīNG
ZHENG GEPING	PINYINCHINESENAME	ZHèNG GèPíNG
KATHY YUEN	PINYINCHINESENAME	TANG YI
TIGER HU	PINYINCHINESENAME	Hú YANBīN
JACOB CHEUNG	PINYINCHINESENAME	ZHANG ZHI LIANG
WAYNE LAI	PINYINCHINESENAME	Lí YàOXIáNG
BIANCA BAI	PINYINCHINESENAME	BáI XīNHUì
YOGA LIN	PINYINCHINESENAME	LíN YòUJIā
CHU YEN-PING	PINYINCHINESENAME	ZHū YáNPíNG
NING YING	PINYINCHINESENAME	NíNG YíNG
SUN HONGLEI	PINYINCHINESENAME	SūN HóNGLéI
JASON HSU	PINYINCHINESENAME	Xǔ MèNGZHE
KENT CHENG	PINYINCHINESENAME	ZHèNG ZéSHì
FLORENCE KWOK	PINYINCHINESENAME	GUō SHǎOYúN
MA LIWEN	PINYINCHINESENAME	Mǎ LìWéN
SA DINGDING	PINYINCHINESENAME	Sà DǐNGDǐNG
PACE WU	PINYINCHINESENAME	Wú PèICí
LILY LI	PINYINCHINESENAME	Lǐ LìLì
JOHN SHUM	PINYINCHINESENAME	CéN JIàNXūN
HAN SANPING	PINYINCHINESENAME	HáN SāNPíNG
SU RUI	PINYINCHINESENAME	Sū RUì
PAI PING-PING	PINYINCHINESENAME	BáI BīNGBīNG
HUO JIANQI	PINYINCHINESENAME	HùO JIàNQǐ
ZHANG YIBAI	PINYINCHINESENAME	ZHāNG YīBáI
PRISCELIA CHAN	PINYINCHINESENAME	ZēNG SHīMéI
LUNG FONG	PINYINCHINESENAME	LóNG FāNG
NING HAO	PINYINCHINESENAME	NìNG HàO
NAT HO	PINYINCHINESENAME	Hè TIāN Cì
HONG HUIFANG	PINYINCHINESENAME	HóNG HUìFāNG
BARRY WONG	PINYINCHINESENAME	HUáNG BǐNG YàO
JULIAN HEE	PINYINCHINESENAME	Xǔ LìHUá
LI WENHAI	PINYINCHINESENAME	Lǐ WéNHǎI
DONG YONG	PINYINCHINESENAME	DǒNG YǒNG
WONG CHO-LAM	PINYINCHINESENAME	WáNG ZǔLáN
XU JIAO	PINYINCHINESENAME	Xú JIāO
ALAN DAWA DOLMA	PINYINCHINESENAME	ĀLáN DáWǎZHUóMǎ
CHEN TIANWEN	PINYINCHINESENAME	CHéN TIāNWéN
HUANG YILIANG	PINYINCHINESENAME	HUáNG YìLIáNG
LI SHING-CHEONG	PINYINCHINESENAME	Lǐ CHéNGCHāNG
MARCUS CHIN	PINYINCHINESENAME	CHéN JIàNBīN
JOANNA WANG	PINYINCHINESENAME	WáNG RUòLíN
CHOI KWOK-WAI	PINYINCHINESENAME	CàI GUóWēI
LINA NG	PINYINCHINESENAME	HUáNG SùFāNG
JACK WU	PINYINCHINESENAME	Hú NUòYáN
STEFAN WONG	PINYINCHINESENAME	HUáNG CHáNGXīNG
VINCENT KOK	PINYINCHINESENAME	Gǔ DéZHāO
HSU WEI-NING	PINYINCHINESENAME	Xǔ WěINìNG
ZHANG JIZHONG	PINYINCHINESENAME	ZHāNG JìZHōNG
ERIC KOT	PINYINCHINESENAME	Gé MǐNHUī
JOHN CHENG	PINYINCHINESENAME	ZHōNG YàO NáN
TSAI YI-CHEN	PINYINCHINESENAME	CAI YIZHEN
WU YIGONG	PINYINCHINESENAME	Wú YíGōNG
MICHAEL CHOW	PINYINCHINESENAME	ZHōU WéNJIàN
DANIEL CHAN	PINYINCHINESENAME	CHéN XIǎODōNG
JUTOUPI	PINYINCHINESENAME	ZHū YUēXìN
DOMINIC LAM	PINYINCHINESENAME	LíN JIāHUá
CASS PHANG	PINYINCHINESENAME	PéNG LíNG
GRACE CHANG	PINYINCHINESENAME	Gě LáN
CLAIRE KUO	PINYINCHINESENAME	GUō JìNG
ZHOU MI	PINYINCHINESENAME	ZHōU Mì
XIE FEI	PINYINCHINESENAME	XIè FēI
HUANG JIANXIN	PINYINCHINESENAME	HUáNG JIàNXīN
WANG GANG	PINYINCHINESENAME	WáNG GāNG
NG CHIN HAN	PINYINCHINESENAME	HUáNG JīNGHàN
SHANG WENJIE	PINYINCHINESENAME	SHàNG WéNJIé
MING DAO	PINYINCHINESENAME	MíNG DàO
CHRISTINE NG	PINYINCHINESENAME	Wú YǒNG WēI
EDELWEISS CHEUNG	PINYINCHINESENAME	ZHANG1 SHU1 YA3
YAN SHUNKAI	PINYINCHINESENAME	YáN\TSHùNKāI
SIRE MA	PINYINCHINESENAME	Mǎ SàI
YAMMIE LAM	PINYINCHINESENAME	LáN JíEYīNG
CANDY CHU	PINYINCHINESENAME	ZHU WAN YI
LIU WEN ZHENG	PINYINCHINESENAME	LIú WēNZHèNG
YANG PEIYI	PINYINCHINESENAME	YáNG PèIYí
CAO FANG	PINYINCHINESENAME	CáO FāNG
GEORGE HU	PINYINCHINESENAME	Hú YǔWēI
STEPHEN AU	PINYINCHINESENAME	ŌU JǐNTáNG
PAULINE CHAN BO-LIN	PINYINCHINESENAME	CHéN BǎOLIáN
CHEUNG TAT-MING	PINYINCHINESENAME	ZHāNG DáMíNG
PETER HO	PINYINCHINESENAME	Hé RùNDōNG
PATRICIA MOK	PINYINCHINESENAME	Mò XIáO LíNG
NANCY WU	PINYINCHINESENAME	Hú DìNGXīN
CHENG GWAN-MIN	PINYINCHINESENAME	ZHèNG JūN MIàN
VINCENT ZHAO	PINYINCHINESENAME	ZHàO WéNZHUó
YUAN QUAN	PINYINCHINESENAME	YUáN QUáN
HE JIANJUN	PINYINCHINESENAME	Hé JIàNJūN
PAIGE CHUA	PINYINCHINESENAME	CàI QíHUì
PATRICK KONG	PINYINCHINESENAME	Yè NIàNCHēN
SUN NAN	PINYINCHINESENAME	SūN NáN
SHAUN CHEN	PINYINCHINESENAME	CHéN HóNGYǔ
JING BORAN	PINYINCHINESENAME	JǐNG BóRáN
NICOLE LAI	PINYINCHINESENAME	Lí JIāYì
MA TIANYU	PINYINCHINESENAME	MA TIāNYǔ
BOWIE WU	PINYINCHINESENAME	Hù FēNG
LIU HAO	PINYINCHINESENAME	LíU HàO
ALEX MAN	PINYINCHINESENAME	WàN ZìLIáNG
KARL DOMINIK	PINYINCHINESENAME	KǎIěR
LAU KAR-WING	PINYINCHINESENAME	LIú JIāRONG
CHARLENE TSE	PINYINCHINESENAME	XIè NíNG
CHEN YING-GIT	PINYINCHINESENAME	CHéN YíNGJIé
SONG ZUDE	PINYINCHINESENAME	SòNG ZǔDé
EDMUND CHEN	PINYINCHINESENAME	CHéN ZHīCáI
CUTIE MUI	PINYINCHINESENAME	MéI XIǎOHUì
WALLIS PANG	PINYINCHINESENAME	PANG CHI CHING
ZHU HOUREN	PINYINCHINESENAME	ZHū HòURèN
GILBERT LAM	PINYINCHINESENAME	LíN WéI CHéN
KIKI SHEUNG	PINYINCHINESENAME	SHāNG TIāN'é
CHEN GUOHUA	PINYINCHINESENAME	CHéN GúOHúA
ONG AI LENG	PINYINCHINESENAME	WáNG ÀILíNG
ROSANNE WONG	PINYINCHINESENAME	HUANG2 WAN3 JUN1
PRUDENCE LIEW	PINYINCHINESENAME	LIú MěIJūN
LEE HEUNG-KAM	PINYINCHINESENAME	Lǐ XIāNGQíN
WAN YEUNG-MING	PINYINCHINESENAME	YǐN YáNGMíNG
A-ONE	PINYINCHINESENAME	A-ONE ZU3 HE2
SIU YAM-YAM	PINYINCHINESENAME	SHàO YīNYīN
WILLIAM SO	PINYINCHINESENAME	SU1 YONG3 KANG1
KIMBERLEY CHEN	PINYINCHINESENAME	CHéN FāNGYǔ
HUANG YI	PINYINCHINESENAME	HUáNG Yì
HE JIE	PINYINCHINESENAME	Hé JIé
KEITH CHAN SIU-KEI	PINYINCHINESENAME	CHéNSHàOQí
JANE HUANG	PINYINCHINESENAME	HUANG MEI ZHEN
SHENG ZHIMIN	PINYINCHINESENAME	SHèNG ZHìMíN
CAO BAOPING	PINYINCHINESENAME	CáO BǎOPíNG
ZHAO FEI	PINYINCHINESENAME	ZHàO FēI
GUI GUI	PINYINCHINESENAME	GUI GUI
TOP COMBINE	PINYINCHINESENAME	ZHì SHàNG Lì Hé
ROY CHIAO	PINYINCHINESENAME	QIáO HóNG
FIONA XIE	PINYINCHINESENAME	XIè WǎNYù
TERENCE SIUFAY	PINYINCHINESENAME	XU ZHI YONG
MONA FONG	PINYINCHINESENAME	FāNG YìHUá
SUSAN WONG	PINYINCHINESENAME	HUáNG CUì SHāN
WU ZINIU	PINYINCHINESENAME	Wú ZìNIú
HUANG BO	PINYINCHINESENAME	HUáNG Bó
LU CHUAN	PINYINCHINESENAME	Lù CHUāN
EDWARD OU	PINYINCHINESENAME	ōU DìNG XīNG
CHEN CHUSHENG	PINYINCHINESENAME	CHéN CHǔSHēNG
WILLIE CHAN	PINYINCHINESENAME	CHéN2 Zì4 QIANG2
LO MANG	PINYINCHINESENAME	LUO2 MANG3
GUO TAO	PINYINCHINESENAME	GUō TāO
LIU BINGJIAN	PINYINCHINESENAME	LíU BīNGJIàN
TSUI PING	PINYINCHINESENAME	CUī PíNG
YOYO CHEN	PINYINCHINESENAME	CHéN Zì YáO
YU QUAN	PINYINCHINESENAME	Yǔ QUáN
GUAN HU	PINYINCHINESENAME	GUǎN Hǔ
SUKI CHUI	PINYINCHINESENAME	Xú SHúMǐN
VIVIAN LAI	PINYINCHINESENAME	LàI YíLíNG
ZHANG JIANYA	PINYINCHINESENAME	ZHāNG JIàNYà
TANG PIK-WAN	PINYINCHINESENAME	TENG-BI-YUN
HE QUN	PINYINCHINESENAME	Hé QúN
XIA GANG	PINYINCHINESENAME	XIà GāNG
ELLIOT NGOK	PINYINCHINESENAME	YUè HUá
LIU MIAOMIAO	PINYINCHINESENAME	LíU MIáOMIáO
BARON CHEN	PINYINCHINESENAME	CHéNCHùHé
SUPERBAND	PINYINCHINESENAME	ZONG4 GUAN1 XIAN4
FAMA	PINYINCHINESENAME	NONG2 FU1
SUN MA SZE TSANG	PINYINCHINESENAME	XīN Mǎ SHī ZēNG
LOONG KIN SANG	PINYINCHINESENAME	LóNG JIàNSHēNG
VIN CHOI	PINYINCHINESENAME	CàI Qí JùN
TING-TING HU	PINYINCHINESENAME	Hú TíNGTíNG
YAN NI	PINYINCHINESENAME	YáN Ní
DEAN SHEK	PINYINCHINESENAME	SHí TIāN
PATRICK TANG	PINYINCHINESENAME	DèNG JIàNHóNG
CHAN HUNG-LIT	PINYINCHINESENAME	CHéN HóNG LIé
ROBERT LEE	PINYINCHINESENAME	Lǐ ZHèNHUī
LAWRENCE CHENG	PINYINCHINESENAME	ZHéNG DáNRúI
CHIN SIU-HO	PINYINCHINESENAME	QIáN XIAóHAó
LOUIS FAN	PINYINCHINESENAME	FáN SHàOHUáNG
CHIEH YUAN	PINYINCHINESENAME	JIé YUáN
ZHANG JUNZHAO	PINYINCHINESENAME	ZHāNG JūNZHāO
PAW HEE-CHING	PINYINCHINESENAME	BAò QǐJìNG
MEI TING	PINYINCHINESENAME	MéI TíNG
JOAN LIN	PINYINCHINESENAME	LíN FèNGJIāO
WANG ZI	PINYINCHINESENAME	WáNG Zǐ
ADELE WONG	PINYINCHINESENAME	WáNG HUìSHāN
MEIMEI KUO	PINYINCHINESENAME	GUō JIéQǐ
CANDY CHEN	PINYINCHINESENAME	CHEN SI-YA
MARK KWOK	PINYINCHINESENAME	GUó YIǎO MíNG
EDDIE CHOW	PINYINCHINESENAME	ZHOU JUN WEI
CAROL CHENG	PINYINCHINESENAME	ZHèNG YùLíNG
HSIAO HUANG-CHI	PINYINCHINESENAME	XIāO HUáNG Qí
TIMMY HUNG	PINYINCHINESENAME	HóNG TIáN MíNG
WANG LUOYONG	PINYINCHINESENAME	WáNG LUóYóNG
KRISTY YANG	PINYINCHINESENAME	YáNG GōNGRú
CHOC7	PINYINCHINESENAME	CHAO KE QI
XIAO XUN	PINYINCHINESENAME	HUANG JING YI
JIAN YI	PINYINCHINESENAME	JIǎN Yì
HUNG YAN-YAN	PINYINCHINESENAME	XIóNG XīNXīN
WONG JINGLUN	PINYINCHINESENAME	HUáNG JìNGLúN
FAN WEI	PINYINCHINESENAME	FàN WěI
DYLAN KUO	PINYINCHINESENAME	GUō PǐNCHāO
HUO SIYAN	PINYINCHINESENAME	HUò SīYàN
HU MEI	PINYINCHINESENAME	Hú MéI
ALIEN HUANG	PINYINCHINESENAME	HUáNG HóNG SHēNG
CELEST CHONG	PINYINCHINESENAME	ZHāNG YùHUá
ZHANG YUQI	PINYINCHINESENAME	ZHāNG YǔQǐ
CHEN SICHENG	PINYINCHINESENAME	CHéN SīCHéNG
CROWD LU	PINYINCHINESENAME	LúGUǎNGZHòNG
JOHNSON LEE	PINYINCHINESENAME	Lǐ SīJIé
TONY LIU	PINYINCHINESENAME	LíU YóNG
CHENG BUGAO	PINYINCHINESENAME	CHéNG BùGāO
EDWIN SIU	PINYINCHINESENAME	XIāO ZHèNGNáN
KONG LIN	PINYINCHINESENAME	KǒNG LíN
SHUI HUA	PINYINCHINESENAME	SHǔI HUà
SHI HUI	PINYINCHINESENAME	SHí HūI
UNICORN CHAN	PINYINCHINESENAME	XIǎO QíLúN
PAUL WEI PING-AO	PINYINCHINESENAME	WèI PíNG-àO
TIEN FENG	PINYINCHINESENAME	TIáN FēNG
MARS	PINYINCHINESENAME	HUò XīNG
ELLESMERE CHOI	PINYINCHINESENAME	CàI Zǐ JIàN
LEE KWAN	PINYINCHINESENAME	Lǐ KūN
MICHELLE WAI	PINYINCHINESENAME	WEI SHI YA
CAROLE LIN	PINYINCHINESENAME	LíN XIǎOPèI
EELYN KOK	PINYINCHINESENAME	GUō HUìWéN
MARK CHENG	PINYINCHINESENAME	ZHèNG HàONáN
CHRISSIE CHAU	PINYINCHINESENAME	ZHōU XIùNà
JANINE CHANG	PINYINCHINESENAME	ZHāNG JūNNíNG
SHI DONGSHAN	PINYINCHINESENAME	SHǐ DōNGSHāN
LOUIS YUEN	PINYINCHINESENAME	RUǎN ZHàOXIáNG
DEXTER YOUNG	PINYINCHINESENAME	YáNG TIāNJīNG
LI LINGYU	PINYINCHINESENAME	Lǐ LíNGYù
LENE LAI	PINYINCHINESENAME	LAI LIN EN
JANICE MAN	PINYINCHINESENAME	WéN YǒNGSHāN
LI XIAORAN	PINYINCHINESENAME	Lǐ XIáORǎN
ZHANG GUOQIANG	PINYINCHINESENAME	ZHANG GUOQIANG
HSIAO HUNG-JEN	PINYINCHINESENAME	XIāO HóNG RéN
VICTORIA SONG	PINYINCHINESENAME	SòNG QIàN
NG HUI	PINYINCHINESENAME	HUáNG HUì
CARRIE NG	PINYINCHINESENAME	Wú JIāLǐ
JOHNNY NGAN	PINYINCHINESENAME	YáN GUó LIáNG
LI JING	PINYINCHINESENAME	Lì JìNG
PAN LINGLING	PINYINCHINESENAME	PāN LíNGLíNG
VAN FAN	PINYINCHINESENAME	FàN YìCHéN
HAO LEI	PINYINCHINESENAME	HǎO LěI
LIU XIJUN	PINYINCHINESENAME	LíU XīJūN
LILJAY	PINYINCHINESENAME	XIǎO JIé
BOBBY CHEN	PINYINCHINESENAME	CHéN SHēNG
YANG LEI	PINYINCHINESENAME	YáNG LěI
OWODOG	PINYINCHINESENAME	ÁO QUǎN
CHEN KUO-FU	PINYINCHINESENAME	CHéN GUóFù
YI JET QI	PINYINCHINESENAME	YI1 JIE2 QI2
LYDIA SHUM	PINYINCHINESENAME	SHěN DIàNXIá
KRISTAL TIN	PINYINCHINESENAME	TIáN RUǐ Nī
XIAOSHENYANG	PINYINCHINESENAME	XIǎOSHěNYáNG
GILL MOHINDEPAUL SINGH	PINYINCHINESENAME	QIáO BǎOBǎO
MICHELLE SARAM	PINYINCHINESENAME	ZHèNG XUě'éR
ELANNE KONG	PINYINCHINESENAME	JIāNG RUòLíN
VIC CHOU	PINYINCHINESENAME	ZHōU YùMíN
RUCO CHAN	PINYINCHINESENAME	CHéN ZHǎNPéNG
CHEN LIN	PINYINCHINESENAME	CHéN LíN
NANA LEE	PINYINCHINESENAME	LI QIAN NA
VINCENT WONG	PINYINCHINESENAME	WáNG HàOXìN
CHIANG SHENG	PINYINCHINESENAME	JIANG1 SHENG1
MARY HON	PINYINCHINESENAME	HáN MǎLì
EVERGREEN MAK CHEUNG-CHING	PINYINCHINESENAME	MàI CHáNGQīNG
LIU PEIQI	PINYINCHINESENAME	LIú PèI Qí
ZHANG TIELIN	PINYINCHINESENAME	ZHāNG TIěLíN
LIN MEIJIAO	PINYINCHINESENAME	LíN MéIJIāO
DERRICK HOH	PINYINCHINESENAME	Hé WéI JIàN
MARY JEAN REIMER	PINYINCHINESENAME	WēNG JìNGJīNG
HE ZHUOYAN	PINYINCHINESENAME	Hé ZHUóYáN
REEN YU	PINYINCHINESENAME	Yù HóNGYUāN
ANGELABABY	PINYINCHINESENAME	YáNG YǐNG
CHEN BAOGUO	PINYINCHINESENAME	CHéN BǎOGUó
WAYNE CHUA	PINYINCHINESENAME	CàI PèIXUáN
JING CHANG	PINYINCHINESENAME	ZHāNG YúNJīNG
YANG LINA	PINYINCHINESENAME	YáNG LìNà
ALFRED HSING	PINYINCHINESENAME	XíNG SīJIé
TINA LEUNG	PINYINCHINESENAME	Dí Nà
LI LILI	PINYINCHINESENAME	Lí LìLì
LIN YU-CHUN	PINYINCHINESENAME	LíN YùQúN
RON HEUNG	PINYINCHINESENAME	XIāNG ZǐJùN
OSMAN HUNG	PINYINCHINESENAME	HóNG ZHìJIé
QIN HAO	PINYINCHINESENAME	QíN HàO
HIM LAW	PINYINCHINESENAME	LUó ZHòNGQIāN
MARK CHAO	PINYINCHINESENAME	ZHAO YòUTíNG
COOL SILLY	PINYINCHINESENAME	SHǎ Kù
MANDY WONG	PINYINCHINESENAME	HUáNG ZHìWéN
ZHU YUCHEN	PINYINCHINESENAME	ZHū YǔCHéN
HOU YONG	PINYINCHINESENAME	HóU YǒNG
TONG DAWEI	PINYINCHINESENAME	TóNG DàWéI
LYNDEL SOON	PINYINCHINESENAME	SOON GAIK SIM
YU CHENGHUI	PINYINCHINESENAME	Yú CHéNGHUì
ELVIS TSUI	PINYINCHINESENAME	Xú JǐNJIāNG
YU RONGGUANG	PINYINCHINESENAME	Yú RóNGGUāNG
DU CHUN	PINYINCHINESENAME	Dù CHúN
JESS SUM	PINYINCHINESENAME	SHěN ZHUōYíNG
THOMAS HO	PINYINCHINESENAME	Hé ZHàOHóNG
WEI WEI	PINYINCHINESENAME	WéI WěI
FENG SHAOFENG	PINYINCHINESENAME	FéNG SHàOFēNG
KENNY HO	PINYINCHINESENAME	Hé JIāJìN
AARIF RAHMAN	PINYINCHINESENAME	Lǐ ZHìTíNG
SERENA FANG	PINYINCHINESENAME	FáNG SīYú
QUAN YI FONG	PINYINCHINESENAME	QUáN YíFèNG
ANDREA CHEN	PINYINCHINESENAME	CHéN KUāNGYí
JAMES LYE	PINYINCHINESENAME	LàI XìNGXIáNG
WANG CHONG	PINYINCHINESENAME	WáNG CHōNG
CHEN ZEYU	PINYINCHINESENAME	CHéN ZéYǔ
MEILIN GRAY	PINYINCHINESENAME	MEI LIN
TERRI KWAN	PINYINCHINESENAME	GUAN YING
JUJU CHAN	PINYINCHINESENAME	CHéN YùYúN
MAY LO	PINYINCHINESENAME	LUó MěIWéI
JOEL CHAN	PINYINCHINESENAME	CHéN SHāNCōNG
KINGDOM YUEN	PINYINCHINESENAME	YUāN QIóNGDāN
LUO JIN	PINYINCHINESENAME	LUó JìN
KEITH CHAN FAI-YOUNG	PINYINCHINESENAME	CHéN HUī YáNG
RUSSELL CHEUNG	PINYINCHINESENAME	ZHāNG ZHìXUāN
HU DIE	PINYINCHINESENAME	Hú DIé
LIU SHISHI	PINYINCHINESENAME	LíU SHīSHī
HENRY O	PINYINCHINESENAME	ŌU HēNGLì
MIMI LO	PINYINCHINESENAME	LUó MǐNZHUāNG
CRUZ TENG	PINYINCHINESENAME	DīNG ZHìYǒNG
FIONA FUNG	PINYINCHINESENAME	FéNG XīYú
ERIC LI	PINYINCHINESENAME	LI TIAN XIANG
CINDY YEN	PINYINCHINESENAME	YUáN YǒNGLíN
TONG BING YU	PINYINCHINESENAME	TóNG BīNGYù
LORI CHOW	PINYINCHINESENAME	ZHōU MěIXīN
CHUI TIEN-YOU	PINYINCHINESENAME	Xú TIāNYòU
YANG PEI-AN	PINYINCHINESENAME	YANG PEI-AN
CARY KWOK	PINYINCHINESENAME	GUō SHàO HéNG
QIN YI	PINYINCHINESENAME	QíN Yí
BILLY CHUNG	PINYINCHINESENAME	ZHōNG SHǎO XIóNG
LI XIAOYUN	PINYINCHINESENAME	Lǐ XIāOYúN
WU XIUBO	PINYINCHINESENAME	Wú XIù Bō
WANG FENG	PINYINCHINESENAME	WāNG FēNG
RUBY WONG	PINYINCHINESENAME	HUáNG ZHUóLíNG
ANTHONY NEELY	PINYINCHINESENAME	Ní ĀNDōNG
ZENG HUIFEN	PINYINCHINESENAME	ZēNG HUìFēN
CHANG FENG	PINYINCHINESENAME	CHáNG FēNG
EMILY CHU	PINYINCHINESENAME	ZHū BǎO Yì
BII	PINYINCHINESENAME	Bì SHūJìN
ASHTON CHEN	PINYINCHINESENAME	SHī XIǎOLóNG
MICKEY HE	PINYINCHINESENAME	Hé SHèNGMíNG
YEN-J	PINYINCHINESENAME	YáN JUé
JESS LEE	PINYINCHINESENAME	Lǐ JIāWēI
NIE YUAN	PINYINCHINESENAME	NIè YUǎN
LEE TIM-SING	PINYINCHINESENAME	LI TIāNSHèNG
OCéANE ZHU	PINYINCHINESENAME	ZHū XUáN
TAO CHING-YING	PINYINCHINESENAME	TáO JīNGYíNG
SAMINGAD	PINYINCHINESENAME	Jì XIǎO-JūN
WALLACE CHUNG	PINYINCHINESENAME	ZHONG HàNLIáNG
ZHANG HANYU	PINYINCHINESENAME	ZHāNG HáNYú
WILLIAM CHAK	PINYINCHINESENAME	ZHáI WēILIáN
MIU ZHU	PINYINCHINESENAME	ZHū LìJìNG
JJ JIA	PINYINCHINESENAME	JIǎ XIǎOCHéN
GRACE WONG	PINYINCHINESENAME	WáNG JūNXīN
JAMES WEN	PINYINCHINESENAME	WēN SHēNGHáO
SANDRINE PINNA	PINYINCHINESENAME	ZHāNG RóNGRóNG
MEEIA FOO	PINYINCHINESENAME	Fú QIóNG-YīN
YAO CHEN	PINYINCHINESENAME	YáO CHéN
WU TSING-FONG	PINYINCHINESENAME	Wú QīNG FēNG
WILLIAM WEI	PINYINCHINESENAME	WéI Lǐ'āN
A-LIN	PINYINCHINESENAME	HUáNG LìLíNG
CHEUK WAN-CHI	PINYINCHINESENAME	ZHUó YùNZHī
BEN WONG	PINYINCHINESENAME	HUáNG ZHìXIáN
CHI KUAN-CHUN	PINYINCHINESENAME	Qī GUàNJūN
BATDORJ-IN BAASANJAB	PINYINCHINESENAME	BāSēNZHāBù
CANDY HSU	PINYINCHINESENAME	Xǔ YǎHáN
GOH ENG WAH	PINYINCHINESENAME	WU2 RONG2 HUA2
YUAN HONG	PINYINCHINESENAME	YUáN HóNG
HE JIONG	PINYINCHINESENAME	Hé JIǒNG
LIN GENGXIN	PINYINCHINESENAME	LíN GēNGXīN
REBECCA ZHU	PINYINCHINESENAME	ZHū CHéNLì
LI CHEN	PINYINCHINESENAME	LICHEN
LI SHAOHONG	PINYINCHINESENAME	Lǐ SHàOHóNG
SHU CHANG	PINYINCHINESENAME	SHū CHàNG
XIE NA	PINYINCHINESENAME	XIè Nà
LIU YUXIN	PINYINCHINESENAME	LíU YǔXīN
HANS ZHANG	PINYINCHINESENAME	ZHāNG HàN
LEE TENG	PINYINCHINESENAME	Lǐ TéNG
ZHENG SHUANG	PINYINCHINESENAME	ZHèNG SHUǎNG
ZHAO YIHUAN	PINYINCHINESENAME	ZHàO YìHUāN
ALYSSA CHIA	PINYINCHINESENAME	JIǎ JìNGWéN
HU XIA	PINYINCHINESENAME	HU XIA
IVY CHEN	PINYINCHINESENAME	CHéN YìHáN
EDDIE PENG	PINYINCHINESENAME	PéNGYúYàN
CUI PENG	PINYINCHINESENAME	CUī PéNG
NI NI	PINYINCHINESENAME	Ní Nī
DUAN LINXI	PINYINCHINESENAME	DUàN LíNXī
MIAO PU	PINYINCHINESENAME	MIáO Pǔ
MENG JIA	PINYINCHINESENAME	MèNG JIA
QI WEI	PINYINCHINESENAME	Qì Wēī
DONG ZHEN	PINYINCHINESENAME	DǒNG ZHēN
CHEN ZHIHUI	PINYINCHINESENAME	CHéN ZHīHUī
BAO GUO'AN	PINYINCHINESENAME	BàO GUó-āN
YAN YIKUAN	PINYINCHINESENAME	YáN YìKUāN
QIAO ZHENYU	PINYINCHINESENAME	QIáO ZHèNYǔ
WU YUE	PINYINCHINESENAME	Wú YUè
QIAN ZHIJUN	PINYINCHINESENAME	QIáN ZHìJūN
XUE ZHIQIAN	PINYINCHINESENAME	XUē ZHīQIāN
SAMMY SUM	PINYINCHINESENAME	SHéN ZHèNXUāN
DENNIS CHEW	PINYINCHINESENAME	ZHōU CHóNGQìNG
KATY KUNG	PINYINCHINESENAME	GōNG JIāXīN
JASON CHAN CHI-SAN	PINYINCHINESENAME	CHéN ZHìSHēN
MELVIN SIA	PINYINCHINESENAME	XIè JIāJIàN
KELLY CHEUNG	PINYINCHINESENAME	ZHāNG Xī WéN
ALFRED HUI	PINYINCHINESENAME	Xǔ TíNG KēNG
CANDY CHANG	PINYINCHINESENAME	ZHāNG HUìWéN
CHOW CHUNG	PINYINCHINESENAME	ZHōU CōNG
CILLA KUNG	PINYINCHINESENAME	Lè TóNG
DIANA SER	PINYINCHINESENAME	Xú XIùYíNG
KING KONG LAM	PINYINCHINESENAME	LíN JìNG GāNG
STANLEY CHEUNG	PINYINCHINESENAME	ZHāNG JǐNGCHúN
VINCENT NG	PINYINCHINESENAME	WēNG QīNGHǎI
ASTRID CHAN	PINYINCHINESENAME	CHéN ZHǐJīNG
LILY HO NGO YEE	PINYINCHINESENAME	Hé ÀO ER
GRISELDA YEUNG	PINYINCHINESENAME	YáNGZHUōNà
QIN LAN	PINYINCHINESENAME	QíN LáN
CASPER CHAN	PINYINCHINESENAME	CHéN Sī Qí
WANG YUMEI	PINYINCHINESENAME	WáNG Yù MéI
LILY LEUNG	PINYINCHINESENAME	LIáNG SHùN YàN
HUANG ZITAO	PINYINCHINESENAME	HUáNG ZǐTāO
LAY	PINYINCHINESENAME	ZHāNG YìXīNG
JIN CHAO-CHUN	PINYINCHINESENAME	JīN CHāO QúN
LAM TSZ-SIN	PINYINCHINESENAME	LíN Zǐ SHàN
MIMI CHU	PINYINCHINESENAME	ZHū MīMī
BRIAN TSE	PINYINCHINESENAME	XIè DōNGMǐN
HOU BAOLIN	PINYINCHINESENAME	HóU BǎOLíN
SIBELLE HU	PINYINCHINESENAME	Hú HUìZHōNG
LEANNE LIU	PINYINCHINESENAME	LIú XUěHUá
MA SU	PINYINCHINESENAME	Mǎ Sū
ALICE CHAN	PINYINCHINESENAME	CHéN WěI
XU HUANSHAN	PINYINCHINESENAME	Xǔ HUáNSHāN
DU ZHIGUO	PINYINCHINESENAME	Dù ZHìGUó
CHEN ZIHAN	PINYINCHINESENAME	CHéN ZǐHáN
LALA HSU	PINYINCHINESENAME	Xú JIāYíNG
CONNIE MAK KIT-MAN	PINYINCHINESENAME	MàI JIéWéN
KO CHEN-TUNG	PINYINCHINESENAME	Kē ZHèNDōNG
MAT YEUNG	PINYINCHINESENAME	YáNG MíNG
LI YUGANG	PINYINCHINESENAME	Lǐ YùGāNG
JIANG KUN	PINYINCHINESENAME	JIāNG KūN
GODFREY GAO	PINYINCHINESENAME	GāO YǐXIáNG
ROMEO TAN	PINYINCHINESENAME	CHéN LUóMìōU
ANDIE CHEN	PINYINCHINESENAME	CHéN BāNGJūN
TRACY LEE	PINYINCHINESENAME	Lǐ MěI LíNG
DAI XIANGYU	PINYINCHINESENAME	DàI XIàNGYǔ
KATE PANG	PINYINCHINESENAME	PáNG LéIXīN
YUAN SHUAI	PINYINCHINESENAME	YUáN SHUàI
DESMOND TAN	PINYINCHINESENAME	CHéN JIǒNGJIāNG
BEN YEO	PINYINCHINESENAME	YáNG ZHìLóNG
ZHANG ZHENHUAN	PINYINCHINESENAME	ZHāNG ZHèNHUáN
CHU KE-LIANG	PINYINCHINESENAME	ZHū GēLIàNG
OSCAR LEUNG	PINYINCHINESENAME	LíANG LìE WéI
DARRYL YONG	PINYINCHINESENAME	YáNG ZǐWéN
SORA MA	PINYINCHINESENAME	Mǎ YìXUāN
JEFF WANG	PINYINCHINESENAME	WáNG JIàNFù
ZEN CHONG	PINYINCHINESENAME	ZHāNG ZHèNGXIáNG
FAN HUNG-HSUAN	PINYINCHINESENAME	FàN HóNG XUāN
JERRY YEO	PINYINCHINESENAME	YáNG WěILIè
DARREN LIM	PINYINCHINESENAME	LíN MíNGLúN
NICK SHEN	PINYINCHINESENAME	SHěN WěIJùN
XU FAN	PINYINCHINESENAME	Xú FāN
CONSTANCE SONG	PINYINCHINESENAME	SòNG YíFēI
WILLIAM SAN	PINYINCHINESENAME	XīN WěI LIáN
WEE KHENG MING	PINYINCHINESENAME	HUáNG QǐMíNG
CAVIN SOH	PINYINCHINESENAME	Sū ZHīCHéNG
ZHANG LEI	PINYINCHINESENAME	ZHāNG LěI
MOO YAN YEE	PINYINCHINESENAME	Wū ĒNYí
TIFFANY LEONG	PINYINCHINESENAME	LIāNG LìFāNG
SHAO BING	PINYINCHINESENAME	SHàO BīNG
GARY YAP	PINYINCHINESENAME	Yè JùNCéN
ELIZA SAM	PINYINCHINESENAME	CéN LìXIāNG
YAN BINGLIANG	PINYINCHINESENAME	YáN BǐNGLIàNG
ZHOU YING	PINYINCHINESENAME	ZHōU YǐNG
GUO LIANG	PINYINCHINESENAME	GUō LIàNG
STELLA CHUNG	PINYINCHINESENAME	ZHōNG XIǎOYù
MICHELLE CHIA	PINYINCHINESENAME	XIè YùNYí
SAMUEL TAI	PINYINCHINESENAME	TáI ZHēNGXIāO
YANG LIBING	PINYINCHINESENAME	YáNG LìBīNG
FLORENCE TAN	PINYINCHINESENAME	CHéN XIùLì
THOMAS ONG	PINYINCHINESENAME	WáNG TIáNCáI
KERRY BERRY BROGAN	PINYINCHINESENAME	KǎIRUì
EVELYN TAN	PINYINCHINESENAME	CHéN YùYúN
AMY CHAN	PINYINCHINESENAME	CHéN XIùWéN
XU QING	PINYINCHINESENAME	Xǔ QíNG
PAMELYN CHEE	PINYINCHINESENAME	Qǐ FēI
WANTING QU	PINYINCHINESENAME	Qǔ WǎNTíNG
KWAN SHAN	PINYINCHINESENAME	GUāN SHāN
RENéE CHEN	PINYINCHINESENAME	CHéN JIāWéI
BETTY ZHOU	PINYINCHINESENAME	ZHōU LíNG'āN
ANGEL CHIANG	PINYINCHINESENAME	JIǎNG JIāMíN
VINCENT WAN	PINYINCHINESENAME	WEN JIA HENG
XU ZHENG	PINYINCHINESENAME	Xú ZHēNG
TAO HONG	PINYINCHINESENAME	TáO HóNG
TAO HONG	PINYINCHINESENAME	TáO HóNG
YISA YU	PINYINCHINESENAME	Yù KěWéI
DENNIS TO	PINYINCHINESENAME	Dù YǔHáNG
DANIEL LEE CHEE HUN	PINYINCHINESENAME	Lǐ JIéHàN
LANA LO	PINYINCHINESENAME	LUO LAN YA
LI SHUANGJIANG	PINYINCHINESENAME	Lǐ SHUāNGJIāNG
MENG GE	PINYINCHINESENAME	MèNG Gē
ANNIE LIU	PINYINCHINESENAME	LIú XīNYōU
THERESA LEE	PINYINCHINESENAME	Lǐ QǐHóNG
KEN CHANG	PINYINCHINESENAME	ZHāNG ZHìYáO
ANDREW LIN	PINYINCHINESENAME	LIáN KăI
SONG WENFEI	PINYINCHINESENAME	SONG WENFEI
WU MOCHOU	PINYINCHINESENAME	Wú MòCHóU
CHEN XIAO	PINYINCHINESENAME	CHéN XIǎO
BONNIE LOO	PINYINCHINESENAME	LUó MěIYí
LAN CHENG-LUNG	PINYINCHINESENAME	LáN ZHèNGLóNG
MAGGIE CHIANG	PINYINCHINESENAME	JIāNG MěIQí
JONATHAN CHIK	PINYINCHINESENAME	Qī QíYì
WYMAN WONG	PINYINCHINESENAME	HUANG2 WEI3 WEN2
CHAO CHUAN	PINYINCHINESENAME	ZHàO CHUáN
YANG KUN	PINYINCHINESENAME	YáNG KūN
GUAN ZHE	PINYINCHINESENAME	GUāN ZHé
IVY TAN	PINYINCHINESENAME	CHEN AI WEI
WANG LUODAN	PINYINCHINESENAME	WáNG LUòDāN
KENNETH CHUNG	PINYINCHINESENAME	ZHōNG KūNHUá
ED YEN	PINYINCHINESENAME	YAN ZI MAO
ESTHER ENG	PINYINCHINESENAME	WU JINXIA
MAO DI	PINYINCHINESENAME	MáO Dì
YANG LI-HUA	PINYINCHINESENAME	YáNG LìHUā
SAMUEL SO	PINYINCHINESENAME	Sū WéNXīNG
BUTTERFORD WONG	PINYINCHINESENAME	HUáNG HUáNGYóU FúTè
NICK CHOU	PINYINCHINESENAME	ZHōU TāNGHáO
ANN	PINYINCHINESENAME	BáI āN
HUANG YALI	PINYINCHINESENAME	HUáNG YǎLì
YU JUNJIAN	PINYINCHINESENAME	Yù JūNJIàN
ZENG YI	PINYINCHINESENAME	ZēNG Yì
YANGWEI LINGHUA	PINYINCHINESENAME	YáNGWEì LíNGHUā
PANG LONG	PINYINCHINESENAME	PáNG LóNG
LI GUYI	PINYINCHINESENAME	Lǐ GǔYī
JIN TIELIN	PINYINCHINESENAME	JīN TIĕLíN
ZU HAI	PINYINCHINESENAME	Zǔ HAǐ
YAN WEIWEN	PINYINCHINESENAME	YáN WEíWéN
ZHANG YE	PINYINCHINESENAME	ZHāNG Yě
CHANG SISI	PINYINCHINESENAME	CHáNG SīSī
TANG CAN	PINYINCHINESENAME	TāNG CàN
CHEN LILI	PINYINCHINESENAME	CHéN LìLì
Lü JIHONG	PINYINCHINESENAME	Lǚ JìHóNG
ANNIE CHEN	PINYINCHINESENAME	CHéN TíNG Nī
GRACE CHAN	PINYINCHINESENAME	CHéN KăILíN
MICHELLE CHEN	PINYINCHINESENAME	CHéN YáNXī
CRYSTAL ONG	PINYINCHINESENAME	WáNGXUěJīNG
ANGELINE KHOO	PINYINCHINESENAME	QIū YàN Nī
QUEENZ CHENG	PINYINCHINESENAME	ZHUāNG QúN SHī
CASS CHIN	PINYINCHINESENAME	CHéNJīNYàN
JAYDEN YUAN	PINYINCHINESENAME	YUáNXIǎOCHāO
PRISCILLA WONG	PINYINCHINESENAME	HUáNG CUì Rú
BILLY LAU	PINYINCHINESENAME	LóU NáNGUāNG
JEANNIE HSIEH	PINYINCHINESENAME	XIè JīNYàN
ZHU YUDONG	PINYINCHINESENAME	ZHū YùDōNG
ANGEL LAI WEI LI	PINYINCHINESENAME	LAI WEI LI
FAYE YU	PINYINCHINESENAME	Yú FēIHóNG
VINCENT CHIAO	PINYINCHINESENAME	JIāO ĒNJùN
DAISY WAITE	PINYINCHINESENAME	LIU DAIXI
LIN XIAWEI	PINYINCHINESENAME	LíN XìA WēI
ATHENA LEE YEN	PINYINCHINESENAME	Lĭ YāN
YAKO CHAN	PINYINCHINESENAME	CHAN CHI CHING
YAO YAO	PINYINCHINESENAME	GUO SHU YAO
CELINE MA	PINYINCHINESENAME	MǎTí Lù
LYAN CHENG	PINYINCHINESENAME	CHéNG Yǔ Xī
LEE E-JUN	PINYINCHINESENAME	Lǐ YìJūN
CHIANG SHU-NA	PINYINCHINESENAME	JIāNG SHūNà
CHRIS WANG	PINYINCHINESENAME	YOU SHENG
JULIE TAN	PINYINCHINESENAME	CHéN XīNQí
HUANG YING	PINYINCHINESENAME	HUáNG YīNG
MINI CHANG	PINYINCHINESENAME	CHANG HSIAO CHIEH /CHANG NING ER
DENG JIAJIA	PINYINCHINESENAME	DèNG JIāJIā
STEVEN MA	PINYINCHINESENAME	MA ZHEN YI
LARISA BAKUROVA	PINYINCHINESENAME	RUìSHā
PUFF KUO	PINYINCHINESENAME	GUō XUě Fú
MEGAN LAI	PINYINCHINESENAME	LàI YǎYáN
ZUO XIAOQING	PINYINCHINESENAME	ZUǒ XIǎOQīNG
JEANNIE CHAN	PINYINCHINESENAME	CHéN YíNG
ZHANG JIN	PINYINCHINESENAME	ZHāNG JìN
STEVE MA	PINYINCHINESENAME	Mǎ JǐNGTāO
HAN XUE	PINYINCHINESENAME	HAN XUE
SHARON KAO	PINYINCHINESENAME	GāO JìNG-RóNG
BETTY CHUNG	PINYINCHINESENAME	ZHōNG LíNGLíNG
JONATHAN WONG	PINYINCHINESENAME	WáNG Zǐ XUāN
SHANE POW	PINYINCHINESENAME	BāO XūNPíNG
FIGARO TSENG	PINYINCHINESENAME	CéNG SHăO ZōNG
JIANG DAWEI	PINYINCHINESENAME	JIǎNG DàWEí
CHIN HAN	PINYINCHINESENAME	JīN HàN
CHIN HAN	PINYINCHINESENAME	QíN HàN
JOYCE CHU	PINYINCHINESENAME	SìYèCǎO
TRACY CHU	PINYINCHINESENAME	ZHū QIāNXUě
XU BIN	PINYINCHINESENAME	Xú BīN
TONY HUNG	PINYINCHINESENAME	HONG WING SHING
JACQUELINE WONG	PINYINCHINESENAME	HUáNG XīN YǐNG
KIMBERLY CHIA	PINYINCHINESENAME	XIè JìNGYí
IAN FANG	PINYINCHINESENAME	FāNG WěIJIé
JIA JIA	PINYINCHINESENAME	JIā JIā
MARC MA	PINYINCHINESENAME	MA YUKE
HU QIAOHUA	PINYINCHINESENAME	Hú QIáOHUá
LEE SHIH SHIONG	PINYINCHINESENAME	Lǐ SīSōNG
LUHAN	PINYINCHINESENAME	Lù HáN
RICHARD JUAN	PINYINCHINESENAME	FàN HóNG ZHì
KRIS WU	PINYINCHINESENAME	Wú YìFáN
KANDY WONG	PINYINCHINESENAME	HUáNG SHāNYí
SEBASTIAN POON	PINYINCHINESENAME	PāN YúNFēNG
TIA LEE	PINYINCHINESENAME	LI YUFEN
JACKSON WANG	PINYINCHINESENAME	WáNG JIāěR
SUN YUE	PINYINCHINESENAME	SūN YUè
YANG YANG	PINYINCHINESENAME	YáNG YáNG
WAN JEN	PINYINCHINESENAME	WàN RéN
JACELYN TAY	PINYINCHINESENAME	ZHèNG XIùZHēN
LIM KAY TONG	PINYINCHINESENAME	LíN Qí-TáNG
JASPER LIU	PINYINCHINESENAME	LIU YI HAO
JIANG YIYAN	PINYINCHINESENAME	JIāNG YīYàN
FRED CHENG	PINYINCHINESENAME	ZHèNG JùNHóNG
FERLYN WONG	PINYINCHINESENAME	HUáNG JīNGLíNG
NATASHA LOW	PINYINCHINESENAME	LIú YíLíNG
ZHANG BICHEN	PINYINCHINESENAME	ZHāNG BìCHéN
XIDAN GIRL	PINYINCHINESENAME	RéN YUèLì
LI NA	PINYINCHINESENAME	Lǐ Nà
KENNY WONG	PINYINCHINESENAME	HUáNG DéBīN
A-SUN	PINYINCHINESENAME	Ā SāNG
A-FU	PINYINCHINESENAME	DèNG FúRú
ALFRED SIM	PINYINCHINESENAME	SHěN ZHìHáO
CHLOE WANG	PINYINCHINESENAME	WáNG LèYāN
ALOYSIUS PANG	PINYINCHINESENAME	FéNG WěIZHōNG
JOZEF WAITE	PINYINCHINESENAME	XI MENG ZI
CARRIE WONG	PINYINCHINESENAME	HUáNG SīTIáN
RED PEOPLE	PINYINCHINESENAME	HONG REN
SOMALINE ANG	PINYINCHINESENAME	HóNG LíNG
PONG NAN	PINYINCHINESENAME	LAN YIBANG
CHANG YI	PINYINCHINESENAME	ZHāNG Yì
MELODY TAN	PINYINCHINESENAME	CHéN YǒNGXīN
JEFFREY XU	PINYINCHINESENAME	Xú MíNGJIé
YAO BEINA	PINYINCHINESENAME	YáO BèINà
LAN YAN	PINYINCHINESENAME	LáN YàN
MATT WU	PINYINCHINESENAME	Wú ZHōNGTIāN
MARIANE CHAN	PINYINCHINESENAME	CHéN MIàOYīNG
SUN XING	PINYINCHINESENAME	SūN XīNG
CHRIS WU	PINYINCHINESENAME	Wú KāNGRéN
SISLEY CHOI	PINYINCHINESENAME	CàI SīBèI
QIN HAILU	PINYINCHINESENAME	QíN HǎILù
BRENDA WANG	PINYINCHINESENAME	WáNG SīYì
HENRY HUO	PINYINCHINESENAME	HENRY HUO
YA HUI	PINYINCHINESENAME	YǎHUì
HANNAH QUINLIVAN	PINYINCHINESENAME	KūN LíNG
SZE YU	PINYINCHINESENAME	SHī Yǔ
LIN TZAY-PEIR	PINYINCHINESENAME	LíN ZàIPéI
GüLNEZER BEXTIYAR	PINYINCHINESENAME	GǔLì NàZHā
LAI YING TONG	PINYINCHINESENAME	LàI YìINGTóNG
LIU HUA	PINYINCHINESENAME	LIǘ HUà
GREGORY WONG	PINYINCHINESENAME	WáNG ZōNGYáO
WANG SEN	PINYINCHINESENAME	WáNG SēN
JOLIN CHIEN	PINYINCHINESENAME	JIǎN HóNGLíN
LI YIFENG	PINYINCHINESENAME	Lǐ YìFēNG
TANG KEE-CHAN	PINYINCHINESENAME	DèNG Jì CHéN
KARSIN BAK	PINYINCHINESENAME	BáI JIā QIàN
SUSAN SU	PINYINCHINESENAME	Sū WéN
NYLON CHEN	PINYINCHINESENAME	CHéN NǎIRóNG
CHER NG	PINYINCHINESENAME	HUáNG ZǐRóNG
BAI FAN	PINYINCHINESENAME	BáI FáN
WANG LIKUN	PINYINCHINESENAME	WáNG LìKūN
MANDY WEI	PINYINCHINESENAME	WèI MàN
DUAN YIHONG	PINYINCHINESENAME	DUàN YìHóNG
LORENE REN	PINYINCHINESENAME	RèN RóNGXUāN
YAO YUANHAO	PINYINCHINESENAME	YáO YUáNHàO
XI MEIJUAN	PINYINCHINESENAME	Xī MěIJUāN
JONATHAN CHEUNG	PINYINCHINESENAME	CHEUNG WING HONG
FRANCIS LEE	PINYINCHINESENAME	LI3 ZHUO2 XIONG4
MAY CHAN	PINYINCHINESENAME	CHéN JIā JIā
ZHANG HUIWEN	PINYINCHINESENAME	ZHāNG HUìWéN
CARAT CHEUNG	PINYINCHINESENAME	ZHāNG MíNG Yǎ
LI RONGHAO	PINYINCHINESENAME	Lǐ RóNGHàO
CHANG TSAI-HSING	PINYINCHINESENAME	ZHANG ZAI XING
JAYLEY WOO	PINYINCHINESENAME	Hú JIāQí
LIANG JING	PINYINCHINESENAME	LIáNG JìNG
SHEN TENG	PINYINCHINESENAME	SHěN TéNG
ZHANG LEI	PINYINCHINESENAME	ZHāNG LěI
YAN SU	PINYINCHINESENAME	YáN Sù
ZHOU CHUCHU	PINYINCHINESENAME	ZHōU CHǔCHǔ
ZHOU XIAOYAN	PINYINCHINESENAME	ZHōU XIǎOYàN
LUDI LIN	PINYINCHINESENAME	LíN LùDí
YIN XIANGJIE	PINYINCHINESENAME	YǐN XIàNGJIé
SERAPH SUN	PINYINCHINESENAME	SūN XīNPèI
GUNTZEPAULA	PINYINCHINESENAME	QIANG JI PO LA
SARA CHANG	PINYINCHINESENAME	ZHàNG QIáNG
YOUYI	PINYINCHINESENAME	YǒUYì
CHANG HSIAO-YEN	PINYINCHINESENAME	ZHāNG XIǎOYàN
ROXANNE TONG	PINYINCHINESENAME	TāNG LUòWéN
RAM CHIANG	PINYINCHINESENAME	JIǎNG ZHì GUāNG
MAO NING	PINYINCHINESENAME	MáO NíNG
CHEN XUEDONG	PINYINCHINESENAME	CHéN XUéDōNG
BELINDA LEE	PINYINCHINESENAME	Lǐ XīNYù
SU MIAOLING	PINYINCHINESENAME	SU MIAOLING
SHEILA SIM	PINYINCHINESENAME	LíN CHéN
HUA CHENYU	PINYINCHINESENAME	HUàCHéN Yǔ
JEREMY CHAN	PINYINCHINESENAME	TIáN MíNGYàO
HAYLEY WOO	PINYINCHINESENAME	Hú JIāYì
HAN YING-CHIEH	PINYINCHINESENAME	HAN YING JIE
JOANNA DONG	PINYINCHINESENAME	DǒNG ZīYàN
HUANG SHUQIN	PINYINCHINESENAME	HUáNG SHǔQíN
YE JIANMING	PINYINCHINESENAME	YE JIAN MING
HUANG TSUNG HSING	PINYINCHINESENAME	HUANG ZHONG XING
LEAH DOU	PINYINCHINESENAME	DòU JìNGTóNG
WU JING	PINYINCHINESENAME	Wú JìNG
NICK TEO	PINYINCHINESENAME	ZHāNG JūNYù
SU YUNYING	PINYINCHINESENAME	Sū YùNYíNG
ZENG YANFEN	PINYINCHINESENAME	ZéNG YàNFēN
HUANG AN	PINYINCHINESENAME	HUáNG ĀN
JU JINGYI	PINYINCHINESENAME	Jū JìNGYī
LAM KWOK-HUNG	PINYINCHINESENAME	LíN GUóXIóNG
ALI LEE	PINYINCHINESENAME	Lǐ JIāXīN
ZHAO JIAMIN	PINYINCHINESENAME	ZHàO JIāMǐN
ZHU SHAOWEN	PINYINCHINESENAME	ZHū SHàOWéN
LI YITONG	PINYINCHINESENAME	Lǐ YìTóNG
QI QI	PINYINCHINESENAME	QíQí
YUEN SHUN-YI	PINYINCHINESENAME	YUáN XìN Yì
HUANG TINGTING	PINYINCHINESENAME	HUáNG TíNGTíNG
OMNIPOTENT YOUTH SOCIETY	PINYINCHINESENAME	WàN NéNG QīNG NIáN Lǚ DIàN
CHAN WUI-NGAI	PINYINCHINESENAME	CHEN HUI YI
FEI QINYUAN	PINYINCHINESENAME	FèI QìNYUáN
JAMES NG	PINYINCHINESENAME	Wú YèKūN
DOMINIC ZHAI	PINYINCHINESENAME	ZHáI SHì CHéNG
QIU XINYI	PINYINCHINESENAME	QIū XīNYí
TANG ANQI	PINYINCHINESENAME	TáNG ĀNQí
WANG QING	PINYINCHINESENAME	WáNG QīNG
XAVIER ONG	PINYINCHINESENAME	WáNG SHèNGYŭ
JIN YINJI	PINYINCHINESENAME	JīN YíNJī
DESMOND NG	PINYINCHINESENAME	HUáNG ZHèNLóNG
GUAN XIAOTONG	PINYINCHINESENAME	GUāN XIǎOTóNG
MA LI	PINYINCHINESENAME	Mǎ Lì
HUANG JINGYU	PINYINCHINESENAME	HUáNG JǐNGYú
XU WEIZHOU	PINYINCHINESENAME	Xǔ WèIZHōU
LI YOUBIN	PINYINCHINESENAME	Lǐ YòUBīN
NINE ONE ONE	PINYINCHINESENAME	JIǔ Yī Yī
YUAN YUAN	PINYINCHINESENAME	YUáN YUàN
FENG JIANYU	PINYINCHINESENAME	FéNG JIàNYǔ
LAW LOK-LAM	PINYINCHINESENAME	LUō Lè LíN
ZHANG YUGE	PINYINCHINESENAME	ZHāNG YǔGé
WU YUE	PINYINCHINESENAME	Wú YUè
MOON LAU	PINYINCHINESENAME	LIú PèI YUè
CHANG YUNG-HSIANG	PINYINCHINESENAME	ZHāNG YǒNGXIáNG
ZOIE TAM	PINYINCHINESENAME	TáN KǎI Qí
XU JIAQI	PINYINCHINESENAME	Xǔ JIāQí
TENG YU-KUN	PINYINCHINESENAME	DèNG YùKūN
HAI YAN	PINYINCHINESENAME	Sì HǎIYáN
ZHAO YUE	PINYINCHINESENAME	ZHàO YUē
RUBY YAP	PINYINCHINESENAME	Dī FēI
WANG QIANYUAN	PINYINCHINESENAME	WáNG QIāNYUáN
KARL TING	PINYINCHINESENAME	DīNGZI LǎNG
QIAO RENLIANG	PINYINCHINESENAME	QIáO RèNLIáNG
LI RUIJUN	PINYINCHINESENAME	Lǐ RUìJùN
HONG PEIYUN	PINYINCHINESENAME	HóNG PèIYúN
