FLIEGER	PREVLINK	LIED FüR EINEN FREUND
PUPPET ON A STRING	PREVLINK	A MAN WITHOUT LOVE
TEENAGE LIFE	PREVLINK	TOUCH MY FIRE
EIN BIßCHEN FRIEDEN	PREVLINK	JOHNNY BLUE
FåNGAD AV EN STORMVIND	PREVLINK	SOM EN VIND
DAG EFTER DAG	PREVLINK	FåNGAD I EN DRöM
REFRAIN	PREVLINK	DAS ALTE KARUSSELL
TU TE RECONNAîTRAS	PREVLINK	APRèS TOI
HALLELUJAH	PREVLINK	A-BA-NI-BI
LE PLUS BEAU JOUR DE MA VIE	PREVLINK	MESSIEURS LES NOYéS DE LA SEINE
MOJA šTIKLA	PREVLINK	VUKOVI UMIRU SAMI
HUILUMIES	PREVLINK	KATSON SINEEN TAIVAAN
IL EST Là	PREVLINK	LE TEMPS PERDU
SO GEHT DAS JEDE NACHT	PREVLINK	IM WARTESAAL ZUM GROßEN GLüCK
TELEFON, TELEFON	PREVLINK	SO GEHT DAS JEDE NACHT
HEUTE ABEND WOLLEN WIR TANZEN GEH'N	PREVLINK	FüR ZWEI GROSCHEN MUSIK
BONNE NUIT MA CHéRIE	PREVLINK	HEUTE ABEND WOLLEN WIR TANZEN GEH'N
EINMAL SEHEN WIR UNS WIEDER	PREVLINK	BONNE NUIT MA CHéRIE
ZWEI KLEINE ITALIENER	PREVLINK	EINMAL SEHEN WIR UNS WIEDER
MARCEL	PREVLINK	ZWEI KLEINE ITALIENER
PARADIES, WO BIST DU%3F	PREVLINK	MAN GEWöHNT SICH SO SCHNELL AN DAS SCHöNE
ANOUSCHKA	PREVLINK	DIE ZEIGER DER UHR
EIN HOCH DER LIEBE	PREVLINK	ANOUSCHKA
WUNDER GIBT ES IMMER WIEDER	PREVLINK	PRIMABALLERINA
DIESE WELT	PREVLINK	WUNDER GIBT ES IMMER WIEDER
DIE SOMMERMELODIE	PREVLINK	JUNGER TAG
JUNGER TAG	PREVLINK	NUR DIE LIEBE LäßT UNS LEBEN
NUR DIE LIEBE LäßT UNS LEBEN	PREVLINK	DIESE WELT
EIN LIED KANN EINE BRüCKE SEIN	PREVLINK	DIE SOMMERMELODIE
SING SANG SONG	PREVLINK	EIN LIED KANN EINE BRüCKE SEIN
TELEGRAM	PREVLINK	SING SANG SONG
RüCKSICHT	PREVLINK	EIN BIßCHEN FRIEDEN
AUFRECHT GEH'N	PREVLINK	RüCKSICHT
FüR ALLE	PREVLINK	AUFRECHT GEH'N
ÜBER DIE BRüCKE GEH'N	PREVLINK	FüR ALLE
LASS DIE SONNE IN DEIN HERZ	PREVLINK	ÜBER DIE BRüCKE GEH'N
FREI ZU LEBEN	PREVLINK	FLIEGER
TRäUME SIND FüR ALLE DA	PREVLINK	DIESER TRAUM DARF NIEMALS STERBEN
DIESER TRAUM DARF NIEMALS STERBEN	PREVLINK	FREI ZU LEBEN
VIEL ZU WEIT	PREVLINK	TRäUME SIND FüR ALLE DA
WIR GEBEN 'NE PARTY	PREVLINK	VIEL ZU WEIT
VERLIEBT IN DICH	PREVLINK	WIR GEBEN 'NE PARTY
LET'S GET HAPPY	PREVLINK	I CAN'T LIVE WITHOUT MUSIC
WER LIEBE LEBT	PREVLINK	WADDE HADDE DUDDE DA?
I CAN'T LIVE WITHOUT MUSIC	PREVLINK	WER LIEBE LEBT
CAN'T WAIT UNTIL TONIGHT	PREVLINK	LET'S GET HAPPY
REISE NACH JERUSALEM – KUDüS'E SEYAHAT	PREVLINK	GUILDO HAT EUCH LIEB!
RUN & HIDE	PREVLINK	CAN'T WAIT UNTIL TONIGHT
FOROGJ, VILáG!	PREVLINK	A HOLNAP MáR NEM LESZ SZOMORú
ELOISE	PREVLINK	I MORGON äR EN ANNAN DAG
CONGRATULATIONS	PREVLINK	IF I HAD YOUR LOVE
BOOGALOO	PREVLINK	E' DE' DET HäR DU KALLAR KäRLEK?
AMAMI SE VUOI	PREVLINK	APRITE LE FINESTRE
KäRLEKEN äR	PREVLINK	BARA HON äLSKAR MIG
BRA VIBRATIONER	PREVLINK	DIGGI-LOO DIGGI-LEY
STRAZDAS	PREVLINK	LOPšINė MYLIMAI
LES AMANTS DE MINUIT	PREVLINK	NE CROIS PAS
FRäMLING	PREVLINK	DAG EFTER DAG
OD NAS ZAVISI	PREVLINK	100
LIFE	PREVLINK	OD NAS ZAVISI
TAKE ME TO YOUR HEAVEN	PREVLINK	KäRLEKEN äR
LES JARDINS DE MONACO	PREVLINK	UNE PETITE FRANçAISE
NOTRE VIE C'EST LA MUSIQUE	PREVLINK	LES JARDINS DE MONACO
VOORGOED VOORBIJ	PREVLINK	DE VOGELS VAN HOLLAND
OPERA	PREVLINK	HANI?
VEN A BAILAR CONMIGO	PREVLINK	ALVEDANSEN
THEY CAN'T STOP THE SPRING	PREVLINK	EVERY SONG IS A CRY FOR LOVE
ZAUVIJEK MOJA	PREVLINK	LANE MOJE
VAMPIRES ARE ALIVE	PREVLINK	IF WE ALL GIVE A LITTLE
LAS VEGAS	PREVLINK	DET GöR ONT
I MORGON äR EN ANNAN DAG	PREVLINK	FåNGAD AV EN STORMVIND
EN DAG	PREVLINK	STAD I LJUS
SOM EN VIND	PREVLINK	EN DAG
FRAUEN REGIER'N DIE WELT	PREVLINK	NO NO NEVER
COME BACK	PREVLINK	NO DREAM IMPOSSIBLE
YORGUNUM ANLA	PREVLINK	DöN ARTıK
SEVGILIYE SON	PREVLINK	YORGUNUM ANLA
SAY WONDERFUL THINGS	PREVLINK	RING-A-DING GIRL
GIVE ME YOUR LOVE	PREVLINK	NEVER LET IT GO
LET ME LOVE YOU	PREVLINK	MOJOT SVET
QéLé, QéLé	PREVLINK	ANYTIME YOU NEED
HASTA LA VISTA	PREVLINK	WORK YOUR MAGIC
FOR REAL	PREVLINK	EVERYWAY THAT I CAN
LOVE GAMES	PREVLINK	I'M NEVER GIVING UP
GO	PREVLINK	ONLY THE LIGHT
KNOCK, KNOCK WHO'S THERE%3F	PREVLINK	BOOM BANG-A-BANG
GIVE A LITTLE LOVE BACK TO THE WORLD	PREVLINK	WHY DO I ALWAYS GET IT WRONG?
ONE STEP OUT OF TIME	PREVLINK	A MESSAGE TO YOUR HEART
BETTER THE DEVIL YOU KNOW	PREVLINK	ONE STEP OUT OF TIME
SE På MIG	PREVLINK	STJäRNORNA
DEN VILDA	PREVLINK	SE På MEJ
WHERE ARE YOU%3F	PREVLINK	LOVE SHINE A LIGHT
DINLE	PREVLINK	BEşINCI MEVSIM
NO DREAM IMPOSSIBLE	PREVLINK	DON'T PLAY THAT SONG AGAIN
LEYLAKLAR SOLDU KALBINDE	PREVLINK	SEVGILIYE SON
BARA HON äLSKAR MIG	PREVLINK	DEN VILDA
YAZ BITTI	PREVLINK	İKI DAKIKA
ESMER YARIM	PREVLINK	YAZ BITTI
DöN ARTıK	PREVLINK	UNUTAMAZSıN
UNUTAMAZSıN	PREVLINK	DINLE
LOVE CITY GROOVE	PREVLINK	LONELY SYMPHONY
PET'R OIL	PREVLINK	SEVINCE
MARY ANN	PREVLINK	THE BAD OLD DAYS
DöNME DOLAP	PREVLINK	PET'R OIL
SEVINCE	PREVLINK	SENINLE BIR DAKIKA
HANI%3F	PREVLINK	DöNME DOLAP
ROCK BOTTOM	PREVLINK	SAVE YOUR KISSES FOR ME
HALAY	PREVLINK	OPERA
HALLEY	PREVLINK	DIDAI DIDAI DAI
LONG LIVE LOVE	PREVLINK	POWER TO ALL OUR FRIENDS
APRIL, APRIL	PREVLINK	ALLA ANDRA FåR VARANN
SUFI	PREVLINK	ŞARKıM SEVGI ÜSTüNE
GöZLERININ HAPSINDEYIM	PREVLINK	BANA BANA
İKI DAKIKA	PREVLINK	GöZLERININ HAPSINDEYIM
BONJOUR, BONJOUR	PREVLINK	GUARDANDO IL SOLE
EN GåNG I STOCKHOLM	PREVLINK	SOL OCH VåR
ABSENT FRIEND	PREVLINK	EN GåNG I STOCKHOLM
SOM EN DRöM	PREVLINK	NYGAMMAL VALS
DET BöRJAR VERKA KäRLEK, BANNE MIG	PREVLINK	SOM EN DRöM
HABLEMOS DEL AMOR	PREVLINK	YO SOY AQUéL
SEV	PREVLINK	ESMER YARIM
I BELONG	PREVLINK	I LOVE THE LITTLE THINGS
ČAROBAN	PREVLINK	OVO JE BALKAN
BOOM BOOM	PREVLINK	APRICOT STONE
RISE UP	PREVLINK	ALCOHOL IS FREE
SILENT STORM	PREVLINK	I FEED YOU MY LOVE
DU äR INTE ENSAM	PREVLINK	DET äR DIT VI SKA
WARRIOR	PREVLINK	THREE MINUTES TO EARTH
HOPE NEVER DIES	PREVLINK	AVEN ROMALE
BULGARIA IN THE JUNIOR EUROVISION SONG CONTEST 2015	PREVLINK	PLANET OF THE CHILDREN
MACEDONIA IN THE JUNIOR EUROVISION SONG CONTEST 2015	PREVLINK	MACEDONIA IN THE JUNIOR EUROVISION SONG CONTEST 2013
BELARUS IN THE JUNIOR EUROVISION SONG CONTEST 2016	PREVLINK	BELARUS IN THE JUNIOR EUROVISION SONG CONTEST 2015#ARTIST AND SONG INFORMATION
