HM PRISON DARTMOOR	PRISONNAME	HMP DARTMOOR
HM PRISON MAZE	PRISONNAME	HER MAJESTY'S PRISON MAZE
DEVIL'S ISLAND	PRISONNAME	BAGNE DE CAYENNE
JOLIET CORRECTIONAL CENTER	PRISONNAME	JOLIET CORRECTIONAL CENTER
BEDFORD HILLS CORRECTIONAL FACILITY FOR WOMEN	PRISONNAME	BEDFORD HILLS CORRECTIONAL FACILITY FOR WOMEN
KINGSTON PENITENTIARY	PRISONNAME	KINGSTON PENITENTIARY
FOLSOM STATE PRISON	PRISONNAME	FOLSOM STATE PRISON
ATTICA CORRECTIONAL FACILITY	PRISONNAME	ATTICA CORRECTIONAL FACILITY
HM PRISON PENTONVILLE	PRISONNAME	HMP PENTONVILLE
PELICAN BAY STATE PRISON	PRISONNAME	PELICAN BAY STATE PRISON
HM PRISON HOLLOWAY	PRISONNAME	HMP HOLLOWAY
SING SING	PRISONNAME	SING SING CORRECTIONAL FACILITY
SAN QUENTIN STATE PRISON	PRISONNAME	SAN QUENTIN STATE PRISON
CALIFORNIA INSTITUTION FOR WOMEN	PRISONNAME	CALIFORNIA INSTITUTION FOR WOMEN
HM PRISON WANDSWORTH	PRISONNAME	HMP WANDSWORTH
FEDERAL CORRECTIONAL INSTITUTION, TERMINAL ISLAND	PRISONNAME	FEDERAL CORRECTIONAL INSTITUTION, TERMINAL ISLAND
UNITED STATES DISCIPLINARY BARRACKS	PRISONNAME	UNITED STATES DISCIPLINARY BARRACKS
HM PRISON WHITEMOOR	PRISONNAME	HMP WHITEMOOR
JOHN B. CONNALLY UNIT	PRISONNAME	JOHN B. CONNALLY UNIT
LIST OF SUBCAMPS OF MITTELBAU	PRISONNAME	KONZENTRATIONSLAGER MITTELBAU
NORTHERN NEW HAMPSHIRE CORRECTIONAL FACILITY	PRISONNAME	NORTHERN NEW HAMPSHIRE CORRECTIONAL FACILITY
LA SANTé PRISON	PRISONNAME	LA SANTé
ABU GHRAIB PRISON	PRISONNAME	BAGHDAD CENTRAL PRISON
CALIFORNIA MEN'S COLONY	PRISONNAME	CALIFORNIA MEN'S COLONY
CALIFORNIA STATE PRISON, CORCORAN	PRISONNAME	CALIFORNIA STATE PRISON, CORCORAN
ARIZONA STATE PRISON COMPLEX – LEWIS	PRISONNAME	ARIZONA STATE PRISON COMPLEX – LEWIS
ARIZONA STATE PRISON COMPLEX – FLORENCE	PRISONNAME	ARIZONA STATE PRISON COMPLEX – FLORENCE
ARIZONA STATE PRISON COMPLEX – PERRYVILLE	PRISONNAME	ARIZONA STATE PRISON COMPLEX – PERRYVILLE
ARIZONA STATE PRISON FLORENCE-WEST	PRISONNAME	ARIZONA STATE PRISON FLORENCE-WEST
ARIZONA STATE PRISON PHOENIX-WEST	PRISONNAME	ARIZONA STATE PRISON PHOENIX-WEST
ARIZONA STATE PRISON COMPLEX – PHOENIX	PRISONNAME	ARIZONA STATE PRISON COMPLEX – PHOENIX
ARIZONA STATE PRISON COMPLEX – YUMA	PRISONNAME	ARIZONA STATE PRISON COMPLEX – YUMA
ARIZONA STATE PRISON COMPLEX – EYMAN	PRISONNAME	ARIZONA STATE PRISON COMPLEX – EYMAN
ARIZONA STATE PRISON COMPLEX – DOUGLAS	PRISONNAME	ARIZONA STATE PRISON COMPLEX – DOUGLAS
ARIZONA STATE PRISON COMPLEX – SAFFORD	PRISONNAME	ARIZONA STATE PRISON COMPLEX – SAFFORD
ARIZONA STATE PRISON COMPLEX – WINSLOW	PRISONNAME	ARIZONA STATE PRISON COMPLEX – WINSLOW
MARANA COMMUNITY CORRECTIONAL TREATMENT FACILITY	PRISONNAME	MARANA COMMUNITY CORRECTIONAL TREATMENT FACILITY
ARIZONA STATE PRISON COMPLEX – TUCSON	PRISONNAME	ARIZONA STATE PRISON COMPLEX – TUCSON
MINNESOTA CORRECTIONAL FACILITY – OAK PARK HEIGHTS	PRISONNAME	MINNESOTA CORRECTIONAL FACILITY &NDASH; OAK PARK HEIGHTS
MINNESOTA CORRECTIONAL FACILITY – SHAKOPEE	PRISONNAME	MINNESOTA CORRECTIONAL FACILITY – SHAKOPEE
MINNESOTA CORRECTIONAL FACILITY – STILLWATER	PRISONNAME	MINNESOTA CORRECTIONAL FACILITY – STILLWATER
PLEASANT VALLEY STATE PRISON	PRISONNAME	PLEASANT VALLEY STATE PRISON
EAST JERSEY STATE PRISON	PRISONNAME	EAST JERSEY STATE PRISON
HM PRISON AYLESBURY	PRISONNAME	HMP AYLESBURY
HM PRISON LOW MOSS	PRISONNAME	HMP LOW MOSS
HM PRISON COOKHAM WOOD	PRISONNAME	HMP COOKHAM WOOD
IOWA CORRECTIONAL INSTITUTION FOR WOMEN	PRISONNAME	IOWA CORRECTIONAL INSTITUTION FOR WOMEN
UNITED STATES PENITENTIARY, LEAVENWORTH	PRISONNAME	UNITED STATES PENITENTIARY, LEAVENWORTH
FEDERAL PRISON CAMP, ALDERSON	PRISONNAME	FEDERAL PRISON CAMP, ALDERSON
HM PRISON KILMARNOCK	PRISONNAME	HMP KILMARNOCK
LANDSBERG PRISON	PRISONNAME	LANDSBERG PRISON
BUCKINGHAM CORRECTIONAL CENTER	PRISONNAME	BUCKINGHAM CORRECTIONAL CENTER
HM PRISON PENTRIDGE	PRISONNAME	HM PRISON PENTRIDGE
HOPKINS CORRECTIONAL CENTRE	PRISONNAME	HOPKINS CORRECTIONAL CENTRE
HM PRISON GEELONG	PRISONNAME	HM PRISON GEELONG
OLD MELBOURNE GAOL	PRISONNAME	OLD MELBOURNE GAOL
ARTHUR GORRIE CORRECTIONAL CENTRE	PRISONNAME	ARTHUR GORRIE CORRECTIONAL CENTRE
HM PRISON FAIRLEA	PRISONNAME	HM PRISON FAIRLEA
HM PRISON BEECHWORTH	PRISONNAME	HM PRISON BEECHWORTH
OLD CASTLEMAINE GAOL	PRISONNAME	OLD CASTLEMAINE GAOL
HM PRISON BARWON	PRISONNAME	BARWON PRISON
HM PRISON WON WRON	PRISONNAME	HM PRISON WON WRON
RISDON PRISON COMPLEX	PRISONNAME	RISDON PRISON COMPLEX
HM PRISON BENDIGO	PRISONNAME	HM PRISON BENDIGO
HM PRISON MORWELL RIVER	PRISONNAME	HM PRISON MORWELL RIVER
HM MELBOURNE ASSESSMENT PRISON	PRISONNAME	MELBOURNE ASSESSMENT PRISON
HM PRISON DHURRINGILE	PRISONNAME	HM PRISON DHURRINGILE
MELBOURNE YOUTH JUSTICE CENTRE	PRISONNAME	MELBOURNE YOUTH JUSTICE CENTRE
FLORIDA STATE PRISON	PRISONNAME	FLORIDA STATE PRISON
PORT AUGUSTA PRISON	PRISONNAME	PORT AUGUSTA PRISON
LONG BAY CORRECTIONAL CENTRE	PRISONNAME	HER MAJESTY'S AUSTRALIAN PRISON LONG BAY
EMU PLAINS CORRECTIONAL CENTRE	PRISONNAME	EMU PLAINS CORRECTIONAL CENTRE
DON DALE YOUTH DETENTION CENTRE	PRISONNAME	DON DALE YOUTH DETENTION CENTRE
WILDMAN RIVER WILDERNESS WORK CAMP	PRISONNAME	WILDMAN RIVER WILDERNESS WORK CAMP
HAYES PRISON FARM	PRISONNAME	HAYES PRISON FARM
MOUNT GAMBIER PRISON	PRISONNAME	MOUNT GAMBIER PRISON
VELLORE CENTRAL PRISON	PRISONNAME	ABHISHEK IN VELLORE JAIL FROM 1980 -TILL NOW
WOOROLOO PRISON FARM	PRISONNAME	WOOROLOO PRISON FARM
ACACIA PRISON	PRISONNAME	ACACIA PRISON
GRAFTON CORRECTIONAL CENTRE	PRISONNAME	GRAFTON CORRECTIONAL CENTRE
MOBILONG PRISON	PRISONNAME	MOBILONG PRISON
BROKEN HILL CORRECTIONAL CENTRE	PRISONNAME	BROKEN HILL CORRECTIONAL CENTRE
CASUARINA PRISON	PRISONNAME	CASUARINA PRISON
ALICE SPRINGS CORRECTIONAL CENTRE	PRISONNAME	ALICE SPRINGS CORRECTIONAL CENTRE
DARWIN CORRECTIONAL CENTRE	PRISONNAME	DARWIN CORRECTIONAL CENTRE
ALICE SPRINGS YOUTH DETENTION CENTRE	PRISONNAME	ALICE SPRINGS YOUTH DETENTION CENTRE
KIRKCONNELL CORRECTIONAL CENTRE	PRISONNAME	KIRKCONNELL CORRECTIONAL CENTRE
OBERON CORRECTIONAL CENTRE	PRISONNAME	OBERON CORRECTIONAL CENTRE
BELCONNEN REMAND CENTRE	PRISONNAME	BELCONNEN REMAND CENTRE
JUNEE CORRECTIONAL CENTRE	PRISONNAME	JUNEE CORRECTIONAL CENTRE
CADELL TRAINING CENTRE	PRISONNAME	CADELL TRAINING CENTRE
PORT LINCOLN PRISON	PRISONNAME	PORT LINCOLN PRISON
BOGGO ROAD GAOL	PRISONNAME	BOGGO ROAD GAOL
BORALLON CORRECTIONAL CENTRE	PRISONNAME	BORALLON TRAINING AND CORRECTIONAL CENTRE
PARKLEA CORRECTIONAL CENTRE	PRISONNAME	PARKLEA CORRECTIONAL CENTRE
GOULBURN CORRECTIONAL CENTRE	PRISONNAME	GOULBURN CORRECTIONAL CENTRE
HOBART RECEPTION CENTRE	PRISONNAME	HOBART RECEPTION CENTRE
MANNUS CORRECTIONAL CENTRE	PRISONNAME	MANNUS CORRECTIONAL CENTRE
LITHGOW CORRECTIONAL CENTRE	PRISONNAME	LITHGOW CORRECTIONAL CENTRE
KARNET PRISON FARM	PRISONNAME	KARNET PRISON
ST HELIERS CORRECTIONAL CENTRE	PRISONNAME	ST HELIERS CORRECTIONAL CENTRE
DARLINGHURST GAOL	PRISONNAME	DARLINGHURST GAOL
TAMWORTH CORRECTIONAL CENTRE	PRISONNAME	TAMWORTH CORRECTIONAL CENTRE
MARY HUTCHINSON WOMEN'S PRISON	PRISONNAME	MARY HUTCHINSON WOMEN'S PRISON
CAMPBELL STREET GAOL	PRISONNAME	H.M. GAOL HOBART
ADELAIDE GAOL	PRISONNAME	ADELAIDE GAOL
MACQUARIE HARBOUR PENAL STATION	PRISONNAME	MACQUARIE HARBOUR PENAL STATION
FEDERAL CORRECTIONAL INSTITUTION, FLORENCE	PRISONNAME	FEDERAL CORRECTIONAL INSTITUTION, FLORENCE
NOTTOWAY CORRECTIONAL CENTER	PRISONNAME	NOTTOWAY CORRECTIONAL CENTER
MOUNT OLIVE CORRECTIONAL COMPLEX	PRISONNAME	MOUNT OLIVE CORRECTIONAL COMPLEX
HUTTONSVILLE CORRECTIONAL CENTER	PRISONNAME	HUTTONSVILLE CORRECTIONAL CENTER
SULLIVAN CORRECTIONAL FACILITY	PRISONNAME	SULLIVAN CORRECTIONAL FACILITY
FULHAM CORRECTIONAL CENTRE	PRISONNAME	FULHAM CORRECTIONAL CENTRE
DAME PHYLLIS FROST CENTRE	PRISONNAME	DAME PHYLLIS FROST CENTRE
YATALA LABOUR PRISON	PRISONNAME	YATALA LABOUR PRISON
ARRENDALE STATE PRISON	PRISONNAME	ARRENDALE STATE PRISON
HM PRISON FELTHAM	PRISONNAME	HMP FELTHAM
ADX FLORENCE	PRISONNAME	U.S. PENITENTIARY, FLORENCE ADX
HM PRISON BELMARSH	PRISONNAME	HMP BELMARSH
PALEN CREEK CORRECTIONAL CENTRE	PRISONNAME	PALEN CREEK CORRECTIONAL CENTRE
NUMINBAH CORRECTIONAL CENTRE	PRISONNAME	NUMINBAH CORRECTIONAL CENTRE
SERKADJI PRISON	PRISONNAME	SERKADJI PRISON
SILVERWATER CORRECTIONAL COMPLEX	PRISONNAME	SILVERWATER CORRECTIONAL COMPLEX
HM PRISON BRONZEFIELD	PRISONNAME	HMP BRONZEFIELD
HM PRISON FOREST BANK	PRISONNAME	HM PRISON FOREST BANK
ARTHUR ROAD JAIL	PRISONNAME	ARTHUR ROAD JAIL
SASKATOON CORRECTIONAL CENTRE	PRISONNAME	SASKATOON CORRECTIONAL CENTRE
LEBANON CORRECTIONAL INSTITUTION	PRISONNAME	LEBANON CORRECTIONAL FACILITY
WARREN CORRECTIONAL INSTITUTION	PRISONNAME	WARREN CORRECTIONAL INSTITUTION
LA FORCE PRISON	PRISONNAME	LA FORCE PRISON
ADULT DIAGNOSTIC AND TREATMENT CENTER	PRISONNAME	ADULT DIAGNOSTIC AND TREATMENT CENTER
AHTANUM VIEW CORRECTIONS CENTER	PRISONNAME	AHTANUM VIEW CORRECTIONS CENTER
FANNIE BAY GAOL	PRISONNAME	FANNIE BAY GAOL
HM PRISON MANCHESTER	PRISONNAME	HMP MANCHESTER
HM PRISON PARC	PRISONNAME	HM PRISON PARC
FORT DENISON	PRISONNAME	PINCHGUT
BANDYUP WOMEN'S PRISON	PRISONNAME	BANDYUP WOMEN'S PRISON
PERTH IMMIGRATION DETENTION CENTRE	PRISONNAME	PERTH IMMIGRATION DETENTION CENTRE
HAKEA PRISON	PRISONNAME	HAKEA PRISON
BROOME REGIONAL PRISON	PRISONNAME	BROOME REGIONAL PRISON
ROEBOURNE REGIONAL PRISON	PRISONNAME	ROEBURNE REGIONAL PRISON
GREENOUGH REGIONAL PRISON	PRISONNAME	GREENOUGH REGIONAL PRISON
EASTERN GOLDFIELDS REGIONAL PRISON	PRISONNAME	EASTERN GOLDFIELDS REGIONAL PRISON
BUNBURY REGIONAL PRISON	PRISONNAME	BUNBURY REGIONAL PRISON
ALBANY REGIONAL PRISON	PRISONNAME	ALBANY REGIONAL PRISON
BORONIA PRE-RELEASE CENTRE FOR WOMEN	PRISONNAME	BORONIA PRE-RELEASE CENTRE FOR WOMEN
PARDELUP PRISON FARM	PRISONNAME	PARDELUP PRISON FARM
RANGEVIEW JUVENILE REMAND CENTRE	PRISONNAME	STATE YOUTH REMAND CENTRE - RANGEVIEW
FREMANTLE PRISON	PRISONNAME	FREMANTLE PRISON
BANKSIA HILL JUVENILE DETENTION CENTRE	PRISONNAME	BANKSIA HILL JUVENILE DETENTION CENTRE
PARRAMATTA CORRECTIONAL CENTRE	PRISONNAME	PARRAMATTA CORRECTIONAL CENTRE
IVANHOE	PRISONNAME	IVANHOE  CORRECTIONAL CENTRE
BATHURST CORRECTIONAL COMPLEX	PRISONNAME	BATHURST CORRECTIONAL CENTRE
CASCADES FEMALE FACTORY	PRISONNAME	CASCADES FEMALE FACTORY
DARLING DOWNS CORRECTIONAL CENTRE	PRISONNAME	DARLING DOWNS CORRECTIONAL CENTRE
WOLSTON CORRECTIONAL CENTRE	PRISONNAME	WOLSTON CORRECTIONAL CENTRE
LOTUS GLEN CORRECTIONAL CENTRE	PRISONNAME	LOTUS GLEN CORRECTIONAL CENTRE
LAUNCESTON RECEPTION CENTRE	PRISONNAME	LAUNCESTON RECEPTION CENTRE
TOWNSVILLE CORRECTIONAL CENTRE	PRISONNAME	TOWNSVILLE CORRECTIONAL COMPLEX
BRISBANE WOMEN'S CORRECTIONAL CENTRE	PRISONNAME	BRISBANE WOMEN'S CORRECTIONAL CENTRE
WOODFORD CORRECTIONAL CENTRE	PRISONNAME	WOODFORD CORRECTIONAL CENTRE
JOHN MORONY CORRECTIONAL COMPLEX	PRISONNAME	JOHN MORONY CORRECTIONAL COMPLEX
ADELAIDE WOMEN'S PRISON	PRISONNAME	ADELAIDE WOMEN'S PRISON
CESSNOCK CORRECTIONAL CENTRE	PRISONNAME	CESSNOCK CORRECTIONAL CENTRE
BREWARRINA	PRISONNAME	BREWARRINA  CENTRE
ADELAIDE REMAND CENTRE	PRISONNAME	ADELAIDE REMAND CENTRE
ADELAIDE PRE-RELEASE CENTRE	PRISONNAME	ADELAIDE PRE-RELEASE CENTRE
DILLWYNIA WOMEN'S CORRECTIONAL CENTRE	PRISONNAME	DILLWYNIA WOMEN'S CORRECTIONAL CENTRE
TARRAFAL CAMP	PRISONNAME	TARRAFAL CAMP
COOMA CORRECTIONAL CENTRE	PRISONNAME	COOMA CORRECTIONAL CENTRE
MAITLAND GAOL	PRISONNAME	MAITLAND GAOL
DON JAIL	PRISONNAME	DON JAIL
HM PRISON BIRMINGHAM	PRISONNAME	HM PRISON BIRMINGHAM
IOWA MEDICAL AND CLASSIFICATION CENTER	PRISONNAME	IOWA MEDICAL AND CLASSIFICATION CENTER
IOWA STATE PENITENTIARY	PRISONNAME	IOWA STATE PENITENTIARY
CLARINDA CORRECTIONAL FACILITY	PRISONNAME	CLARINDA CORRECTIONAL FACILITY
FORT DODGE CORRECTIONAL FACILITY	PRISONNAME	FORT DODGE CORRECTIONAL FACILITY
MOUNT PLEASANT CORRECTIONAL FACILITY	PRISONNAME	MOUNT PLEASANT CORRECTIONAL FACILITY
NEWTON CORRECTIONAL FACILITY	PRISONNAME	NEWTON CORRECTIONAL FACILITY
NORTH CENTRAL CORRECTIONAL FACILITY	PRISONNAME	NORTH CENTRAL CORRECTIONAL FACILITY
GLEN INNES CORRECTIONAL CENTRE	PRISONNAME	GLEN INNES CORRECTIONAL CENTRE
VIRGINIA CORRECTIONAL CENTER FOR WOMEN	PRISONNAME	VIRGINIA CORRECTIONAL CENTER FOR WOMEN
WASHINGTON STATE PENITENTIARY	PRISONNAME	WASHINGTON STATE PENITENTIARY
CLINTON CORRECTIONAL FACILITY	PRISONNAME	CLINTON CORRECTIONAL FACILITY
PUDU PRISON	PRISONNAME	PUDU PRISON
PUDU PRISON	PRISONNAME	PENJARA PUDU
LORAIN CORRECTIONAL INSTITUTION	PRISONNAME	LORAIN CORRECTIONAL INSTITUTION
FEDERAL CORRECTIONAL INSTITUTION, TEXARKANA	PRISONNAME	FEDERAL CORRECTIONAL INSTITUTION, TEXARKANA
BERRIMA CORRECTIONAL CENTRE	PRISONNAME	BERRIMA CORRECTIONAL CENTRE
TOOWOOMBA PRISON	PRISONNAME	TOOWOOMBA GAOL
MARYBOROUGH CORRECTIONAL CENTRE	PRISONNAME	MARYBOROUGH CORRECTIONAL CENTRE
NYANDI WOMEN'S PRISON	PRISONNAME	NYANDI WOMEN’S PRISON
MILLHAVEN INSTITUTION	PRISONNAME	MILLHAVEN INSTITUTION
SOUTHPORT CORRECTIONAL FACILITY	PRISONNAME	SOUTHPORT CORRECTIONAL FACILITY
PORT PHILLIP PRISON	PRISONNAME	PORT PHILLIP PRISON
CALIPATRIA STATE PRISON	PRISONNAME	CALIPATRIA STATE PRISON
PICKAWAY CORRECTIONAL INSTITUTION	PRISONNAME	PICKAWAY CORRECTIONAL INSTITUTION
HM PRISON LINDHOLME	PRISONNAME	HMP LINDHOLME
HIGH DESERT STATE PRISON	PRISONNAME	HIGH DESERT STATE PRISON
TIHAR JAIL	PRISONNAME	TIHAR PRISONS
J WARD	PRISONNAME	J WARD
ROCKHAMPTON CORRECTIONAL CENTRE	PRISONNAME	ROCKHAMPTON CORRECTIONAL CENTRE
HM PRISON STAFFORD	PRISONNAME	HMP STAFFORD
MOUNTJOY PRISON	PRISONNAME	MOUNTJOY PRISON
ST. BRIDES CORRECTIONAL CENTER	PRISONNAME	ST. BRIDES CORRECTIONAL CENTER
HM PRISON SHREWSBURY	PRISONNAME	HMP SHREWSBURY
OLYMPIC CORRECTIONS CENTER	PRISONNAME	OLYMPIC CORRECTIONS CENTER
NEUSE CORRECTIONAL INSTITUTION	PRISONNAME	NEUSE CORRECTIONAL INSTITUTION
NEW HAMPSHIRE STATE PRISON FOR MEN	PRISONNAME	NEW HAMPSHIRE STATE PRISON FOR MEN
NEW HAMPSHIRE STATE PRISON FOR WOMEN	PRISONNAME	NEW HAMPSHIRE STATE PRISON FOR WOMEN
TACONIC CORRECTIONAL FACILITY	PRISONNAME	TACONIC CORRECTIONAL FACILITY
FIVE POINTS CORRECTIONAL FACILITY	PRISONNAME	FIVE POINTS CORRECTIONAL FACILITY
ALBION CORRECTIONAL FACILITY	PRISONNAME	ALBION CORRECTIONAL FACILITY
WOODBOURNE CORRECTIONAL FACILITY	PRISONNAME	WOODBOURNE CORRECTIONAL FACILITY
DRAKENSTEIN CORRECTIONAL CENTRE	PRISONNAME	DRAKENSTEIN CORRECTIONAL CENTRE
AUBURN CORRECTIONAL FACILITY	PRISONNAME	AUBURN CORRECTIONAL FACILITY
HM PRISON THE VERNE	PRISONNAME	HMP THE VERNE
HM PRISON WEARE	PRISONNAME	HMP WEARE
HM PRISON WORMWOOD SCRUBS	PRISONNAME	HER MAJESTY'S PRISON WORMWOOD SCRUBS
HM PRISON BRINSFORD	PRISONNAME	HMP BRINSFORD
HM PRISON READING	PRISONNAME	HMP READING
SPECIAL ALTERNATIVE INCARCERATION FACILITY	PRISONNAME	SPECIAL ALTERNATIVE INCARCERATION FACILITY
JOHOR BAHRU PRISON	PRISONNAME	JOHOR BAHRU PRISON
JOHOR BAHRU PRISON	PRISONNAME	PENJARA JOHOR BAHRU
EL DORADO CORRECTIONAL FACILITY	PRISONNAME	EL DORADO CORRECTIONAL FACILITY
WARKWORTH INSTITUTION	PRISONNAME	WARKWORTH INSTITUTION
HM PRISON LEICESTER	PRISONNAME	HMP LEICESTER
MACLAREN YOUTH CORRECTIONAL FACILITY	PRISONNAME	MACLAREN YOUTH CORRECTIONAL FACILITY
FEDERAL CORRECTIONAL INSTITUTION, SEAGOVILLE	PRISONNAME	FEDERAL CORRECTIONAL INSTITUTION, SEAGOVILLE
TAZMAMART	PRISONNAME	TAZMAMART
DOWNSTATE CORRECTIONAL FACILITY	PRISONNAME	DOWNSTATE CORRECTIONAL FACILITY
BERRIMAH PRISON	PRISONNAME	BERRIMAH PRISON
FEDERAL MEDICAL CENTER, CARSWELL	PRISONNAME	FEDERAL MEDICAL CENTER, CARSWELL
ALTONA CORRECTIONAL FACILITY	PRISONNAME	ALTONA CORRECTIONAL FACILITY
COLLINS CORRECTIONAL FACILITY	PRISONNAME	COLLINS CORRECTIONAL FACILITY
WENDE CORRECTIONAL FACILITY	PRISONNAME	WENDE CORRECTIONAL FACILITY
EASTERN CORRECTIONAL FACILITY	PRISONNAME	EASTERN CORRECTIONAL FACILITY
ELMIRA CORRECTIONAL FACILITY	PRISONNAME	ELMIRA CORRECTIONAL FACILITY
LAKEVIEW SHOCK INCARCERATION CORRECTIONAL FACILITY	PRISONNAME	LAKEVIEW SHOCK INCARCERATION CORRECTIONAL FACILITY
METROPOLITAN REMAND CENTRE	PRISONNAME	METROPOLITAN REMAND CENTRE
WALLKILL CORRECTIONAL FACILITY	PRISONNAME	WALLKILL CORRECTIONAL FACILITY
WYOMING CORRECTIONAL FACILITY	PRISONNAME	WYOMING CORRECTIONAL FACILITY
REDGRANITE CORRECTIONAL INSTITUTION	PRISONNAME	REDGRANITE CORRECTIONAL INSTITUTION
TADMOR PRISON	PRISONNAME	TADMOR PRISON
HM PRISON PARKHURST	PRISONNAME	HMP PARKHURST
HM PRISON HIGH DOWN	PRISONNAME	HMP HIGH DOWN
COXSACKIE CORRECTIONAL FACILITY	PRISONNAME	COXSACKIE CORRECTIONAL FACILITY
MONTANA WOMEN'S PRISON	PRISONNAME	MONTANA WOMEN'S PRISON
HM PRISON DOWNVIEW	PRISONNAME	HMP DOWNVIEW
FRENCH M. ROBERTSON UNIT	PRISONNAME	FRENCH ROBERTSON UNIT
CHí HòA PRISON	PRISONNAME	CHí HòA PRISON
WINLATON YOUTH TRAINING CENTRE	PRISONNAME	WINLATON YOUTH TRAINING CENTRE
ACHERON BOYS HOME	PRISONNAME	ACHERON BOYS HOME
ALLAMBIE RECEPTION CENTRE	PRISONNAME	ALLAMBIE RECEPTION CENTRE
ASHENDENE BOYS HOME	PRISONNAME	ASHENDENE BOYS HOME
PIRRA HOMESTEAD	PRISONNAME	PIRRA HOMESTEAD
HM PRISON CASTLE HUNTLY	PRISONNAME	HMP CASTLE HUNTLY
GREEN HAVEN CORRECTIONAL FACILITY	PRISONNAME	GREEN HAVEN CORRECTIONAL FACILITY
FISHKILL CORRECTIONAL FACILITY	PRISONNAME	FISHKILL CORRECTIONAL FACILITY
CHUCKAWALLA VALLEY STATE PRISON	PRISONNAME	CHUCKAWALLA VALLEY STATE PRISON
BOONVILLE CORRECTIONAL CENTER	PRISONNAME	BOONVILLE CORRECTIONAL CENTER
WOMEN'S EASTERN RECEPTION, DIAGNOSTIC AND CORRECTIONAL CENTER	PRISONNAME	WOMEN'S EASTERN RECEPTION, DIAGNOSTIC AND CORRECTIONAL CENTER
MASSACHUSETTS CORRECTIONAL INSTITUTION – SHIRLEY	PRISONNAME	MCI - SHIRLEY
LåNGHOLMEN PRISON	PRISONNAME	LåNGHOLMEN PRISON
NEW JERSEY STATE PRISON	PRISONNAME	NEW JERSEY STATE PRISON
MARCY CORRECTIONAL FACILITY	PRISONNAME	MARCY CORRECTIONAL FACILITY
MID-STATE CORRECTIONAL FACILITY	PRISONNAME	MID-STATE CORRECTIONAL FACILITY
FEDERAL MEDICAL CENTER, ROCHESTER	PRISONNAME	FEDERAL MEDICAL CENTER, ROCHESTER
HM PRISON CRUMLIN ROAD	PRISONNAME	HER MAJESTY'S PRISON BELFAST
OHIO STATE PENITENTIARY	PRISONNAME	OHIO STATE PENITENTIARY
GREENSVILLE CORRECTIONAL CENTER	PRISONNAME	GREENSVILLE CORRECTIONAL CENTER
SOUZA-BARANOWSKI CORRECTIONAL CENTER	PRISONNAME	SOUZA BARANOWSKI CORRECTIONAL CENTER
JEFFERSON CITY CORRECTIONAL CENTER	PRISONNAME	JEFFERSON CITY CORRECTIONAL CENTER
REGIONAL RECEPTION CENTRE	PRISONNAME	REGIONAL RECEPTION CENTRE
REGIONAL RECEPTION CENTRE	PRISONNAME	SPECIAL HANDLING UNIT
HM PRISON BARLINNIE	PRISONNAME	HMP BARLINNIE
PORTLAOISE PRISON	PRISONNAME	PORTLAOISE PRISON
NORTH BRANCH CORRECTIONAL INSTITUTION	PRISONNAME	NORTH BRANCH CORRECTIONAL INSTITUTION
HM PRISON ACKLINGTON	PRISONNAME	HMP ACKLINGTON
HM PRISON DURHAM	PRISONNAME	HMP DURHAM
HM PRISON FRANKLAND	PRISONNAME	HMP FRANKLAND
HM PRISON LOW NEWTON	PRISONNAME	HMP & YOI LOW NEWTON
HM PRISON KIRKLEVINGTON GRANGE	PRISONNAME	HMP KIRKLEVINGTON GRANGE
CALIFORNIA MEDICAL FACILITY	PRISONNAME	CALIFORNIA MEDICAL FACILITY
STATE CORRECTIONAL INSTITUTION – GRATERFORD	PRISONNAME	STATE CORRECTIONAL INSTITUTION GRATERFORD
STANLEY PRISON	PRISONNAME	STANLEY PRISON
NORTH DAKOTA STATE PENITENTIARY	PRISONNAME	NORTH DAKOTA STATE PENITENTIARY
PUL-E-CHARKHI PRISON	PRISONNAME	PUL-E-CHARKHI PRISON
NEBRASKA STATE PENITENTIARY	PRISONNAME	NEBRASKA STATE PENITENTIARY
PONTIAC CORRECTIONAL CENTER	PRISONNAME	PONTIAC CORRECTIONAL CENTER
HOLMAN CORRECTIONAL FACILITY	PRISONNAME	HOLMAN CORRECTIONAL FACILITY
GEORGIA STATE PRISON	PRISONNAME	GEORGIA STATE PRISON
HUNTSVILLE UNIT	PRISONNAME	HUNTSVILLE UNIT
NORTHERN CORRECTIONAL INSTITUTION	PRISONNAME	NORTHERN CORRECTIONAL INSTITUTION
POTOSI CORRECTIONAL CENTER	PRISONNAME	POTOSI CORRECTIONAL CENTER
RIVERBEND MAXIMUM SECURITY INSTITUTION	PRISONNAME	RIVERBEND MAXIMUM SECURITY INSTITUTION
IDAHO MAXIMUM SECURITY INSTITUTION	PRISONNAME	IDAHO MAXIMUM SECURITY INSTITUTION
OREGON STATE PENITENTIARY	PRISONNAME	OREGON STATE PENITENTIARY
PENITENTIARY OF NEW MEXICO	PRISONNAME	PENITENTIARY OF NEW MEXICO
CHESAPEAKE DETENTION FACILITY	PRISONNAME	CHESAPEAKE DETENTION FACILITY
INDIANA STATE PRISON	PRISONNAME	INDIANA STATE PRISON
DENMAR CORRECTIONAL CENTER	PRISONNAME	DENMAR CORRECTIONAL CENTER
FEDERAL CORRECTIONAL INSTITUTION, DANBURY	PRISONNAME	FEDERAL CORRECTIONAL INSTITUTION, DANBURY
FEDERAL CORRECTIONAL INSTITUTION, DUBLIN	PRISONNAME	FEDERAL CORRECTIONAL INSTITUTION, DUBLIN
METROPOLITAN CORRECTIONAL CENTER, CHICAGO	PRISONNAME	METROPOLITAN CORRECTIONAL CENTER, CHICAGO
UNITED STATES PENITENTIARY, ATWATER	PRISONNAME	US PENITENTIARY, ATWATER
UNITED STATES PENITENTIARY, MCCREARY	PRISONNAME	UNITED STATES PENITENTIARY, MCCREARY
VARNER UNIT	PRISONNAME	VARNER UNIT
NORTH KERN STATE PRISON	PRISONNAME	NORTH KERN STATE PRISON
JAMES T. VAUGHN CORRECTIONAL CENTER	PRISONNAME	JAMES T. VAUGHN CORRECTIONAL CENTER
SHEA FARM HALFWAY HOUSE	PRISONNAME	SHEA FARM HALFWAY HOUSE
CALIFORNIA INSTITUTION FOR MEN	PRISONNAME	CALIFORNIA INSTITUTION FOR MEN
VALLEY STATE PRISON	PRISONNAME	VALLEY STATE PRISON
CENTRAL CALIFORNIA WOMEN'S FACILITY	PRISONNAME	CENTRAL CALIFORNIA WOMEN'S FACILITY
PRUNTYTOWN CORRECTIONAL CENTER	PRISONNAME	PRUNTYTOWN CORRECTIONAL CENTER
STATEVILLE CORRECTIONAL CENTER	PRISONNAME	STATEVILLE CORRECTIONAL CENTER
MASSACHUSETTS CORRECTIONAL INSTITUTION – PLYMOUTH	PRISONNAME	MCI - PLYMOUTH
UNITED STATES PENITENTIARY, COLEMAN	PRISONNAME	UNITED STATES PENITENTIARY, COLEMAN
MORIAH SHOCK INCARCERATION CORRECTIONAL FACILITY	PRISONNAME	MORIAH SHOCK INCARCERATION CORRECTIONAL FACILITY
HM PRISON USK	PRISONNAME	HMP USK
DEUEL VOCATIONAL INSTITUTION	PRISONNAME	DEUEL VOCATIONAL INSTITUTION
ORLEANS CORRECTIONAL FACILITY	PRISONNAME	ORLEANS CORRECTIONAL FACILITY
BUFFALO CORRECTIONAL FACILITY	PRISONNAME	BUFFALO CORRECTIONAL FACILITY
KUMLA PRISON	PRISONNAME	ANSTALTEN KUMLA
METROPOLITAN DETENTION CENTER, BROOKLYN	PRISONNAME	METROPOLITAN DETENTION CENTER, BROOKLYN
UNITED NATIONS DETENTION FACILITY	PRISONNAME	UNITED NATIONS DETENTION FACILITY
DRUMHELLER INSTITUTION	PRISONNAME	DRUMHELLER INSTITUTION
TENNESSEE STATE PRISON	PRISONNAME	TENNESSEE STATE PRISON
SOUTHERN OHIO CORRECTIONAL FACILITY	PRISONNAME	SOUTHERN OHIO CORRECTIONAL FACILITY
C MAX	PRISONNAME	C MAX
CLALLAM BAY CORRECTIONS CENTER	PRISONNAME	CLALLAM BAY CORRECTIONS CENTER
ALIPORE JAIL	PRISONNAME	ALIPORE JAIL
EDNA MAHAN CORRECTIONAL FACILITY FOR WOMEN	PRISONNAME	EDNA MAHAN CORRECTIONAL FACILITY FOR WOMEN
BIBB CORRECTIONAL FACILITY	PRISONNAME	BIBB CORRECTIONAL FACILITY
MENARD CORRECTIONAL CENTER	PRISONNAME	MENARD CORRECTIONAL CENTER
WABASH VALLEY CORRECTIONAL FACILITY	PRISONNAME	WABASH VALLEY CORRECTIONAL FACILITY
SOUTH CENTRAL CORRECTIONAL FACILITY	PRISONNAME	SOUTH CENTRAL CORRECTIONAL FACILITY
WAUPUN CORRECTIONAL INSTITUTION	PRISONNAME	WAUPUN CORRECTIONAL INSTITUTION
HM PRISON NORTH SEA CAMP	PRISONNAME	HMP NORTH SEA CAMP
MARYVILLE TREATMENT CENTER	PRISONNAME	MARYVILLE TREATMENT CENTER
UNITED STATES PENITENTIARY, ALLENWOOD	PRISONNAME	UNITED STATES PENITENTIARY, ALLENWOOD
HM PRISON WAKEFIELD	PRISONNAME	HMP WAKEFIELD
FEDERAL CORRECTIONAL INSTITUTION, TALLAHASSEE	PRISONNAME	FEDERAL CORRECTIONAL INSTITUTION, TALLAHASSEE
BEECHWORTH CORRECTIONAL CENTRE	PRISONNAME	BEECHWORTH CORRECTIONAL CENTRE
HM PRISON DONCASTER	PRISONNAME	HM PRISON DONCASTER
OKLAHOMA STATE PENITENTIARY	PRISONNAME	OKLAHOMA STATE PENITENTIARY
HM PRISON ABERDEEN	PRISONNAME	HMP ABERDEEN
FEDERAL DETENTION CENTER, PHILADELPHIA	PRISONNAME	FEDERAL DETENTION CENTER, PHILADELPHIA
WASHINGTON STATE PRISON	PRISONNAME	WASHINGTON STATE PRISON
HM PRISON CORNTON VALE	PRISONNAME	HMP YOI CORNTON VALE
HOCKING CORRECTIONAL FACILITY	PRISONNAME	HOCKING CORRECTIONAL FACILITY
UNITED STATES PENITENTIARY, ATLANTA	PRISONNAME	UNITED STATES PENITENTIARY, ATLANTA
FEDERAL CORRECTIONAL INSTITUTION, CUMBERLAND	PRISONNAME	FEDERAL CORRECTIONAL INSTITUTION, CUMBERLAND
GREAT MEADOW CORRECTIONAL FACILITY	PRISONNAME	GREAT MEADOW CORRECTIONAL FACILITY
HM PRISON DUMFRIES	PRISONNAME	HMP DUMFRIES
HM PRISON EDINBURGH	PRISONNAME	HMP EDINBURGH
UNITED STATES PENITENTIARY, MARION	PRISONNAME	US PENITENTIARY, MARION
WENTWORTH GAOL	PRISONNAME	OLD WENTWORTH JAIL
UNITED STATES PENITENTIARY, LEWISBURG	PRISONNAME	UNITED STATES PENITENTIARY, LEWISBURG
HM PRISON SWANSEA	PRISONNAME	HMP SWANSEA
WALNUT STREET PRISON	PRISONNAME	WALNUT STREET PRISON
HM PRISON LEEDS	PRISONNAME	HMP LEEDS
GROVELAND CORRECTIONAL FACILITY	PRISONNAME	GROVELAND CORRECTIONAL FACILITY
COYOTE RIDGE CORRECTIONS CENTER	PRISONNAME	COYOTE RIDGE CORRECTIONS CENTER
MASSACHUSETTS CORRECTIONAL INSTITUTION – CEDAR JUNCTION	PRISONNAME	MASSACHUSETTS CORRECTIONAL INSTITUTION—CEDAR JUNCTION
MASSACHUSETTS CORRECTIONAL INSTITUTION – NORFOLK	PRISONNAME	MASSACHUSETTS CORRECTIONAL INSTITUTION—NORFOLK
MASSACHUSETTS CORRECTIONAL INSTITUTION – FRAMINGHAM	PRISONNAME	MASSACHUSETTS CORRECTIONAL INSTITUTION- FRAMINGHAM
MASSACHUSETTS CORRECTIONAL INSTITUTION – CONCORD	PRISONNAME	MASSACHUSETTS CORRECTIONAL INSTITUTION-CONCORD
PUTNAMVILLE CORRECTIONAL FACILITY	PRISONNAME	PUTNAMVILLE CORRECTIONAL FACILITY
COLLINGWOOD STOCKADE	PRISONNAME	COLLINGWOOD STOCKADE
HM PRISON ONLEY	PRISONNAME	HMP ONLEY
STATE CORRECTIONAL INSTITUTION – ROCKVIEW	PRISONNAME	STATE CORRECTIONAL INSTITUTION ROCKVIEW
UNITED STATES PENITENTIARY, FLORENCE HIGH	PRISONNAME	US PENITENTIARY, FLORENCE HIGH
PENDLETON CORRECTIONAL FACILITY	PRISONNAME	PENDLETON CORRECTIONAL FACILITY
WESTVILLE CORRECTIONAL FACILITY	PRISONNAME	WESTVILLE CORRECTIONAL FACILITY
UNITED STATES PENITENTIARY, TERRE HAUTE	PRISONNAME	UNITED STATES PENITENTIARY, TERRE HAUTE
MIAMI CORRECTIONAL FACILITY	PRISONNAME	MIAMI CORRECTIONAL FACILITY
WILLARD DRUG TREATMENT CENTER	PRISONNAME	WILLARD DRUG TREATMENT CENTER
OTISVILLE CORRECTIONAL FACILITY	PRISONNAME	OTISVILLE CORRECTIONAL FACILITY
FEDERAL CORRECTIONAL INSTITUTION, OTISVILLE	PRISONNAME	FEDERAL CORRECTIONAL INSTITUTION, OTISVILLE
HM PRISON WAYLAND	PRISONNAME	HMP WAYLAND
OKLAHOMA STATE REFORMATORY	PRISONNAME	OKLAHOMA STATE REFORMATORY
HM PRISON ALTCOURSE	PRISONNAME	HM PRISON ALTCOURSE
FEDERAL CORRECTIONAL COMPLEX, TERRE HAUTE	PRISONNAME	FEDERAL CORRECTIONAL COMPLEX, TERRE HAUTE
HM PRISON WOODHILL	PRISONNAME	HMP WOODHILL
HM PRISON FULL SUTTON	PRISONNAME	HMP FULL SUTTON
AVENAL STATE PRISON	PRISONNAME	AVENAL STATE PRISON
CALIFORNIA SUBSTANCE ABUSE TREATMENT FACILITY AND STATE PRISON, CORCORAN	PRISONNAME	CALIFORNIA SUBSTANCE ABUSE TREATMENT FACILITY AND STATE PRISON, CORCORAN
KERN VALLEY STATE PRISON	PRISONNAME	KERN VALLEY STATE PRISON
FEDERAL CORRECTIONAL COMPLEX, BUTNER	PRISONNAME	FEDERAL CORRECTIONAL COMPLEX, BUTNER
MULE CREEK STATE PRISON	PRISONNAME	MULE CREEK STATE PRISON
VERNON C. BAIN CORRECTIONAL CENTER	PRISONNAME	VERNON C. BAIN CORRECTIONAL CENTER
PIED-DU-COURANT PRISON	PRISONNAME	PIED-DU-COURANT PRISON
METROPOLITAN CORRECTIONAL CENTER, NEW YORK	PRISONNAME	METROPOLITAN CORRECTIONAL CENTER, NEW YORK
PARRAMATTA FEMALE FACTORY	PRISONNAME	PARRAMATTA FEMALE FACTORY
HM PRISON PETERBOROUGH	PRISONNAME	HMP PETERBOROUGH
HM PRISON THE MOUNT	PRISONNAME	HMP THE MOUNT
HM PRISON ALBANY	PRISONNAME	HMP ISLE OF WIGHT – ALBANY BARRACKS
HM PRISON CAMP HILL	PRISONNAME	HMP CAMP HILL
HM PRISON WEALSTUN	PRISONNAME	HMP WEALSTUN
HM PRISON WETHERBY	PRISONNAME	HMP/YOI WETHERBY
HM PRISON WOLDS	PRISONNAME	HM PRISON WOLDS
HM PRISON THORN CROSS	PRISONNAME	HMP THORN CROSS
HM PRISON CARDIFF	PRISONNAME	HMP CARDIFF
OHIO REFORMATORY FOR WOMEN	PRISONNAME	OHIO REFORMATORY FOR WOMEN
HM PRISON HULL	PRISONNAME	HMP HULL
HM PRISON LINCOLN	PRISONNAME	HMP LINCOLN
HM PRISON NORTHALLERTON	PRISONNAME	HMP NORTHALLERTON
RICHMOND GAOL	PRISONNAME	RICHMOND GAOL
HM PRISON BRIXTON	PRISONNAME	HMP BRIXTON
HM PRISON MAIDSTONE	PRISONNAME	HMP MAIDSTONE
SANTA RITA JAIL	PRISONNAME	SANTA RITA JAIL
PANKRáC PRISON	PRISONNAME	PRAGUE PANKRáC REMAND PRISON
PANKRáC PRISON	PRISONNAME	VAZEBNí VěZNICE PRAHA PANKRáC
INDIANA WOMEN'S PRISON	PRISONNAME	INDIANA WOMEN'S PRISON
FEDERAL CORRECTIONAL INSTITUTION, WASECA	PRISONNAME	FEDERAL CORRECTIONAL INSTITUTION, WASECA
HUTCHINSON CORRECTIONAL FACILITY	PRISONNAME	HUTCHINSON CORRECTIONAL FACILITY
ADIRONDACK CORRECTIONAL FACILITY	PRISONNAME	ADIRONDACK CORRECTIONAL FACILITY
COLDBATH FIELDS PRISON	PRISONNAME	COLDBATH FIELDS PRISON
COLDBATH FIELDS PRISON	PRISONNAME	(\
RICHARD A. HANDLON CORRECTIONAL FACILITY	PRISONNAME	RICHARD A. HANDLON CORRECTIONAL FACILITY
HM PRISON MAGILLIGAN	PRISONNAME	HMP MAGILLIGAN
HM PRISON MAGHABERRY	PRISONNAME	HMP MAGHABERRY
BARE HILL CORRECTIONAL FACILITY	PRISONNAME	BARE HILL CORRECTIONAL FACILITY
UPSTATE CORRECTIONAL FACILITY	PRISONNAME	UPSTATE CORRECTIONAL FACILITY
LIMON CORRECTIONAL FACILITY, COLORADO	PRISONNAME	LIMON CORRECTIONAL FACILITY
HM PRISON BUCKLEY HALL	PRISONNAME	HMP BUCKLEY HALL
ELY STATE PRISON	PRISONNAME	ELY STATE PRISON
OGDENSBURG CORRECTIONAL FACILITY	PRISONNAME	OGDENSBURG CORRECTIONAL FACILITY
LEFORTOVO PRISON	PRISONNAME	LEFORTOVO PRISON
ÖSTERåKER PRISON	PRISONNAME	ÖSTERåKER PRISON
RIVERVIEW CORRECTIONAL FACILITY	PRISONNAME	RIVERVIEW CORRECTIONAL FACILITY
VESTRE FæNGSEL	PRISONNAME	VESTRE FæNGSEL
FEDERAL TRANSFER CENTER, OKLAHOMA CITY	PRISONNAME	FEDERAL TRANSFER CENTER, OKLAHOMA CITY
CLERKENWELL BRIDEWELL	PRISONNAME	CLERKENWELL BRIDEWELL
HM PRISON HOLLESLEY BAY	PRISONNAME	HMP HOLLESLEY BAY
TORONTO SOUTH DETENTION CENTRE	PRISONNAME	TORONTO SOUTH DETENTION CENTRE
TORONTO CENTRAL PRISON	PRISONNAME	TORONTO CENTRAL PRISON
COLUMBIA CORRECTIONAL INSTITUTION	PRISONNAME	COLUMBIA CORRECTIONAL INSTITUTION
SOUTHERN NEVADA CORRECTIONAL CENTER	PRISONNAME	SOUTHERN NEVADA CORRECTIONAL CENTER
MONTELUPICH PRISON	PRISONNAME	MONTELUPICH PRISON
FEDERAL CORRECTIONAL INSTITUTION, HERLONG	PRISONNAME	FEDERAL CORRECTIONAL INSTITUTION, HERLONG
FEDERAL CORRECTIONAL INSTITUTION, RAY BROOK	PRISONNAME	FEDERAL CORRECTIONAL INSTITUTION, RAY BROOK
MONROE CORRECTIONAL COMPLEX	PRISONNAME	MONROE CORRECTIONAL COMPLEX
UTAH STATE PRISON	PRISONNAME	UTAH STATE PRISON
WILDWOOD CORRECTIONAL COMPLEX	PRISONNAME	WILDWOOD CORRECTIONAL COMPLEX
HM PRISON GREENOCK	PRISONNAME	HMP GREENOCK
FEDERAL CORRECTIONAL INSTITUTION, SHERIDAN	PRISONNAME	FEDERAL CORRECTIONAL INSTITUTION, SHERIDAN
NEBRASKA DIAGNOSTIC AND EVALUATION CENTER	PRISONNAME	NEBRASKA DIAGNOSTIC AND EVALUATION CENTER
TECUMSEH STATE CORRECTIONAL INSTITUTION	PRISONNAME	TECUMSEH STATE CORRECTIONAL INSTITUTION
NEBRASKA CORRECTIONAL CENTER FOR WOMEN	PRISONNAME	NEBRASKA CORRECTIONAL CENTER FOR WOMEN
BASTøY PRISON	PRISONNAME	BASTøY PRISON
CALIFORNIA STATE PRISON, CENTINELA	PRISONNAME	CALIFORNIA STATE PRISON, CENTINELA
CENTRAL UTAH CORRECTIONAL FACILITY	PRISONNAME	CENTRAL UTAH CORRECTIONAL FACILITY
BULLOCK CORRECTIONAL FACILITY	PRISONNAME	BULLOCK CORRECTIONAL FACILITY
HALAWA CORRECTIONAL FACILITY	PRISONNAME	HAL
HM PRISON KIRKHAM	PRISONNAME	HMP KIRKHAM
PLöTZENSEE PRISON	PRISONNAME	JUSTIZVOLLZUGSANSTALT PLöTZENSEE
NEW CASTLE CORRECTIONAL FACILITY	PRISONNAME	NEW CASTLE CORRECTIONAL FACILITY
FEDERAL PRISON CAMP, PENSACOLA	PRISONNAME	FEDERAL PRISON CAMP, PENSACOLA
FEDERAL CORRECTIONAL INSTITUTION, MARIANNA	PRISONNAME	FEDERAL CORRECTIONAL INSTITUTION, MARIANNA
BLACK BEACH	PRISONNAME	BLACK BEACH
WALLENS RIDGE STATE PRISON	PRISONNAME	WALLENS RIDGE STATE PRISON
NORTHERN STATE CORRECTIONAL FACILITY	PRISONNAME	NORTHERN STATE CORRECTIONAL FACILITY
DORCHESTER PENITENTIARY	PRISONNAME	DORCHESTER PENITENTIARY
HM PRISON POLMONT	PRISONNAME	HMP POLMONT
MOUNTAIN VIEW UNIT	PRISONNAME	MOUNTAIN VIEW UNIT
CAMILLE GRIFFIN GRAHAM CORRECTIONAL INSTITUTION	PRISONNAME	CAMILLE GRIFFIN GRAHAM CORRECTIONAL INSTITUTION
HM PRISON DOVEGATE	PRISONNAME	HM PRISON DOVEGATE
HM PRISON GLEN PARVA	PRISONNAME	HMP GLEN PARVA
OHIO PENITENTIARY	PRISONNAME	OHIO PENITENTIARY
ALEXANDER MACONOCHIE CENTRE	PRISONNAME	ALEXANDER MACONOCHIE CENTRE
FEDERAL CORRECTIONAL INSTITUTION, EDGEFIELD	PRISONNAME	FEDERAL CORRECTIONAL INSTITUTION, EDGEFIELD
HM PRISON LANCASTER FARMS	PRISONNAME	HMP LANCASTER FARMS
JAMES V. ALLRED UNIT	PRISONNAME	JAMES V. ALLRED UNIT
LEATH CORRECTIONAL INSTITUTION	PRISONNAME	LEATH CORRECTIONAL INSTITUTION
HM PRISON LONG LARTIN	PRISONNAME	HMP LONG LARTIN
STATE CORRECTIONAL INSTITUTION – GREENE	PRISONNAME	STATE CORRECTIONAL INSTITUTION GREENE
SILVERDALE DETENTION CENTER	PRISONNAME	SILVERDALE DETENTION CENTER
BALLARAT GAOL	PRISONNAME	BALLARAT GAOL
DAVIS CORRECTIONAL FACILITY	PRISONNAME	DAVIS CORRECTIONAL FACILITY
MINNESOTA CORRECTIONAL FACILITY – ST. CLOUD	PRISONNAME	MINNESOTA CORRECTIONAL FACILITY &NDASH; ST. CLOUD
SUGAR HOUSE PRISON	PRISONNAME	SUGAR HOUSE PRISON
SUGAR HOUSE PRISON	PRISONNAME	(FORMERLY UTAH TERRITORIAL PENITENTIARY)
KENTUCKY STATE PENITENTIARY	PRISONNAME	KENTUCKY STATE PENITENTIARY
LOUGHAN HOUSE	PRISONNAME	LOUGHAN HOUSE OPEN CENTRE
PLYMOUTH COUNTY CORRECTIONAL FACILITY	PRISONNAME	PLYMOUTH COUNTY CORRECTIONAL FACILITY
FEDERAL MEDICAL CENTER, LEXINGTON	PRISONNAME	FEDERAL MEDICAL CENTER, LEXINGTON
HM PRISON SHEPTON MALLET	PRISONNAME	HMP SHEPTON MALLET
HM PRISON PETERHEAD	PRISONNAME	HMP PETERHEAD
POCAHONTAS STATE CORRECTIONAL CENTER	PRISONNAME	POCAHONTAS STATE CORRECTIONAL CENTER
WESTERN KENTUCKY CORRECTIONAL COMPLEX	PRISONNAME	WESTERN KENTUCKY CORRECTIONAL COMPLEX
KENTUCKY CORRECTIONAL INSTITUTE FOR WOMEN	PRISONNAME	KENTUCKY CORRECTIONAL INSTITUTE FOR WOMEN
GREEN RIVER CORRECTIONAL COMPLEX	PRISONNAME	GREEN RIVER CORRECTIONAL COMPLEX
SPRING CREEK CORRECTIONAL CENTER	PRISONNAME	SPRING CREEK CORRECTIONAL CENTER
LUTHER LUCKETT CORRECTIONAL COMPLEX	PRISONNAME	LUTHER LUCKETT CORRECTIONAL COMPLEX
OTTER CREEK CORRECTIONAL CENTER	PRISONNAME	OTTER CREEK CORRECTIONAL CENTER
KENTUCKY STATE REFORMATORY	PRISONNAME	KENTUCKY STATE REFORMATORY
EASTERN KENTUCKY CORRECTIONAL COMPLEX	PRISONNAME	EASTERN KENTUCKY CORRECTIONAL COMPLEX
ROEDERER CORRECTIONAL COMPLEX	PRISONNAME	ROEDERER CORRECTIONAL COMPLEX
LITTLE SANDY CORRECTIONAL COMPLEX	PRISONNAME	LITTLE SANDY CORRECTIONAL COMPLEX
LEOPOLDOV PRISON	PRISONNAME	LEOPOLDOV PRISON
CALEDONIA STATE PRISON FARM	PRISONNAME	CALEDONIA STATE PRISON FARM
HM PRISON SEND	PRISONNAME	HMP SEND
HM PRISON STYAL	PRISONNAME	HMP STYAL
HM PRISON BULLWOOD HALL	PRISONNAME	HMP BULLWOOD HALL
HM PRISON LEYHILL	PRISONNAME	HMP LEYHILL
INSEIN PRISON	PRISONNAME	INSEIN PRISON
HM PRISON STOCKEN	PRISONNAME	HMP STOCKEN
SPRINGHILL INSTITUTION	PRISONNAME	SPRINGHILL INSTITUTION
ATLANTIC INSTITUTION	PRISONNAME	ATLANTIC INSTITUTION
ROCKVILLE CORRECTIONAL FACILITY	PRISONNAME	ROCKVILLE CORRECTIONAL FACILITY
UNITED STATES MEDICAL CENTER FOR FEDERAL PRISONERS	PRISONNAME	UNITED STATES MEDICAL CENTER FOR FEDERAL PRISONERS
MABEL BASSETT CORRECTIONAL CENTER	PRISONNAME	MABEL BASSETT CORRECTIONAL CENTER
HM PRISON WINCHESTER	PRISONNAME	HMP WINCHESTER
CALIFORNIA CORRECTIONAL CENTER	PRISONNAME	CALIFORNIA CORRECTIONAL CENTER
GRAHAM CORRECTIONAL CENTER	PRISONNAME	GRAHAM CORRECTIONAL CENTER
CALIFORNIA CORRECTIONAL INSTITUTION	PRISONNAME	CALIFORNIA CORRECTIONAL INSTITUTION
HM PRISON GARTREE	PRISONNAME	HMP GARTREE
JUNCTION CITY PRISON	PRISONNAME	JUNCTION CITY PRISON
CENTRAL PRISON KARACHI	PRISONNAME	CENTRAL PRISON KARACHI
EDINBURGH CORRECTIONAL FACILITY	PRISONNAME	EDINBURGH CORRECTIONAL FACILITY
CORRECTIONAL INDUSTRIAL FACILITY	PRISONNAME	CORRECTIONAL INDUSTRIAL FACILITY
UNITED STATES PENITENTIARY, HAZELTON	PRISONNAME	US PENITENTIARY, HAZELTON
WAKULLA CORRECTIONAL INSTITUTION	PRISONNAME	WAKULLA CORRECTIONAL INSTITUTION
CALIFORNIA REHABILITATION CENTER	PRISONNAME	CALIFORNIA REHABILITATION CENTER
GOWANDA CORRECTIONAL FACILITY	PRISONNAME	GOWANDA CORRECTIONAL FACILITY
CALIFORNIA STATE PRISON, LOS ANGELES COUNTY	PRISONNAME	CALIFORNIA STATE PRISON, LOS ANGELES COUNTY
CALIFORNIA STATE PRISON, SACRAMENTO	PRISONNAME	CALIFORNIA STATE PRISON, SACRAMENTO
SHAWANGUNK CORRECTIONAL FACILITY	PRISONNAME	SHAWANGUNK CORRECTIONAL FACILITY
CALIFORNIA STATE PRISON, SOLANO	PRISONNAME	CALIFORNIA STATE PRISON, SOLANO
MARSHALSEA	PRISONNAME	MARSHALSEA
HM PRISON HIGHPOINT SOUTH	PRISONNAME	HMP HIGHPOINT SOUTH
FEDERAL CORRECTIONAL INSTITUTION, BASTROP	PRISONNAME	FEDERAL CORRECTIONAL INSTITUTION, BASTROP
FEDERAL CORRECTIONAL INSTITUTION, TERRE HAUTE	PRISONNAME	FEDERAL CORRECTIONAL INSTITUTION, TERRE HAUTE
HM PRISON BEDFORD	PRISONNAME	HMP BEDFORD
CUMBERLAND COUNTY JAIL	PRISONNAME	CUMBERLAND COUNTY JAIL
HM PRISON ASHFIELD	PRISONNAME	HM PRISON ASHFIELD
NEVADA STATE PRISON	PRISONNAME	NEVADA STATE PRISON
PATUXENT INSTITUTION	PRISONNAME	PATUXENT INSTITUTION
SAN DIEGO CORRECTIONAL FACILITY	PRISONNAME	SAN DIEGO CORRECTIONAL FACILITY
GREEN BAY CORRECTIONAL INSTITUTION	PRISONNAME	GREEN BAY CORRECTIONAL INSTITUTION
GEORGIA DIAGNOSTIC AND CLASSIFICATION STATE PRISON	PRISONNAME	GEORGIA DIAGNOSTIC AND CLASSIFICATION STATE PRISON
RED ONION STATE PRISON	PRISONNAME	RED ONION STATE PRISON
HM PRISON KINGSTON	PRISONNAME	HMP KINGSTON
METROPOLITAN TRANSITION CENTER	PRISONNAME	METROPOLITAN TRANSITION CENTER
CHILLICOTHE CORRECTIONAL INSTITUTION	PRISONNAME	CHILLICOTHE CORRECTIONAL INSTITUTION
IDAHO STATE CORRECTIONAL INSTITUTION	PRISONNAME	IDAHO STATE CORRECTIONAL INSTITUTION
FEDERAL CORRECTIONAL INSTITUTION, MILAN	PRISONNAME	FEDERAL CORRECTIONAL INSTITUTION, MILAN
PULASKI STATE PRISON	PRISONNAME	PULASKI STATE PRISON
FEDERAL DETENTION CENTER, HONOLULU	PRISONNAME	FEDERAL DETENTION CENTER, HONOLULU
CHANCHALGUDA CENTRAL JAIL	PRISONNAME	CHANCHALGUDA CENTRAL JAIL
TORONTO WEST DETENTION CENTRE	PRISONNAME	TORONTO WEST DETENTION CENTRE
CARABANCHEL PRISON	PRISONNAME	PRISIóN PROVINCIAL DE MADRID
SOUTHEASTERN CORRECTIONAL INSTITUTION	PRISONNAME	SOUTHEASTERN CORRECTIONAL INSTITUTION
BURRUSS CORRECTIONAL TRAINING CENTER	PRISONNAME	BURRUSS CORRECTIONAL TRAINING CENTER
NEW BILIBID PRISON	PRISONNAME	NEW BILIBID PRISON
COFFEE CREEK CORRECTIONAL FACILITY	PRISONNAME	COFFEE CREEK CORRECTIONAL FACILITY
ANDREW MERCER REFORMATORY FOR WOMEN	PRISONNAME	ANDREW MERCER REFORMATORY FOR WOMEN
BARRIE JAIL	PRISONNAME	BARRIE JAIL
BELLEVILLE JAIL	PRISONNAME	BELLEVILLE JAIL
BROAD RIVER CORRECTIONAL INSTITUTION	PRISONNAME	BROAD RIVER CORRECTIONAL INSTITUTION
CENTRAL NORTH CORRECTIONAL CENTRE	PRISONNAME	CENTRAL NORTH CORRECTIONAL CENTRE
BOGAMBARA PRISON	PRISONNAME	BOGAMBARA PRISON
EASTERN RECEPTION, DIAGNOSTIC AND CORRECTIONAL CENTER	PRISONNAME	EASTERN RECEPTION, DIAGNOSTIC AND CORRECTIONAL CENTER
BRAMPTON JAIL	PRISONNAME	BRAMPTON JAIL
OLD DUBBO GAOL	PRISONNAME	OLD DUBBO GAOL
BRACEBRIDGE JAIL	PRISONNAME	BRACEBRIDGE JAIL
KRESTY PRISON	PRISONNAME	KRESTY PRISON
BRAMPTON ADULT TRAINING CENTRE	PRISONNAME	BRAMPTON ADULT TRAINING CENTRE
KLONG PREM CENTRAL PRISON	PRISONNAME	KLONG PREM CENTRAL PRISON
DWIGHT CORRECTIONAL CENTER	PRISONNAME	DWIGHT CORRECTIONAL CENTER
FEDERAL CORRECTIONAL INSTITUTION, PEKIN	PRISONNAME	FEDERAL CORRECTIONAL INSTITUTION, PEKIN
PEOPLE DETAINED BY THE INTERNATIONAL CRIMINAL COURT	PRISONNAME	ICC DETENTION CENTRE
KAMUNTING DETENTION CENTRE	PRISONNAME	KAMUNTING DETENTION CENTRE
HM PRISON INVERNESS	PRISONNAME	HMP INVERNESS
PLAINFIELD CORRECTIONAL FACILITY	PRISONNAME	PLAINFIELD CORRECTIONAL FACILITY
HM PRISON ELMLEY	PRISONNAME	HMP ELMLEY
CHIPPEWA CORRECTIONAL FACILITY	PRISONNAME	CHIPPEWA CORRECTIONAL FACILITY
HM PRISON ASHWELL	PRISONNAME	HMP ASHWELL
IONIA CORRECTIONAL FACILITY	PRISONNAME	IONIA CORRECTIONAL FACILITY
ALLAN B. POLUNSKY UNIT	PRISONNAME	ALLAN B. POLUNSKY UNIT
FEDERAL CORRECTIONAL INSTITUTION, LOMPOC	PRISONNAME	FEDERAL CORRECTIONAL INSTITUTION, LOMPOC
UNITED STATES PENITENTIARY, LOMPOC	PRISONNAME	UNITED STATES PENITENTIARY, LOMPOC
HM PRISON HUNTERCOMBE	PRISONNAME	HMP HUNTERCOMBE
HM PRISON LIVERPOOL	PRISONNAME	HMP LIVERPOOL
MAINE STATE PRISON	PRISONNAME	MAINE STATE PRISON
HM PRISON ASKHAM GRANGE	PRISONNAME	HMP ASKHAM GRANGE
HM PRISON BLANTYRE HOUSE	PRISONNAME	HMP BLANTYRE HOUSE
TAYCHEEDAH CORRECTIONAL INSTITUTION	PRISONNAME	TAYCHEEDAH CORRECTIONAL INSTITUTION
HM PRISON BLUNDESTON	PRISONNAME	HMP BLUNDESTON
BRIDGEWATER STATE HOSPITAL	PRISONNAME	BRIDGEWATER STATE HOSPITAL
UNION CORRECTIONAL INSTITUTION	PRISONNAME	UNION CORRECTIONAL INSTITUTION
LOWELL CORRECTIONAL INSTITUTION	PRISONNAME	LOWELL CORRECTIONAL INSTITUTION
HM PRISON WYMOTT	PRISONNAME	HMP WYMOTT
HM PRISON WHATTON	PRISONNAME	HMP HHHH
LONDON CORRECTIONAL INSTITUTION	PRISONNAME	LONDON CORRECTIONAL FACILITY
FEDERAL CORRECTIONAL INSTITUTION, MIAMI	PRISONNAME	FEDERAL CORRECTIONAL INSTITUTION, MIAMI
FEDERAL CORRECTIONAL INSTITUTION, LORETTO	PRISONNAME	FEDERAL CORRECTIONAL INSTITUTION, LORETTO
HM PRISON EXETER	PRISONNAME	HMP EXETER
ALLEN CORRECTIONAL INSTITUTION	PRISONNAME	ALLEN CORRECTIONAL INSTITUTION
HM PRISON BULLINGDON	PRISONNAME	HMP BULLINGDON
HM PRISON CANTERBURY	PRISONNAME	HMP CANTERBURY
HM PRISON FOSTON HALL	PRISONNAME	HMP FOSTON HALL
HM PRISON CASTINGTON	PRISONNAME	HMP CASTINGTON
UNITED STATES PENITENTIARY, POLLOCK	PRISONNAME	UNITED STATES PENITENTIARY, POLLOCK
CAMP CUSINO	PRISONNAME	CAMP CUSINO CORRECTIONAL FACILITY
SINOP FORTRESS PRISON	PRISONNAME	SINOP FORTRESS PRISON
GRIERSON CENTRE	PRISONNAME	GRIERSON CENTRE
EDMONTON INSTITUTION	PRISONNAME	EDMONTON INSTITUTION
ISLE OF MAN PRISON	PRISONNAME	ISLE OF MAN PRISON
VICTORIA ROAD PRISON	PRISONNAME	VICTORIA ROAD PRISON
HM PRISON CHANNINGS WOOD	PRISONNAME	HMP CHANNINGS WOOD
HM PRISON CHELMSFORD	PRISONNAME	HMP CHELMSFORD
FEDERAL CORRECTIONAL INSTITUTION, FORT WORTH	PRISONNAME	FEDERAL CORRECTIONAL INSTITUTION, FORT WORTH
HM PRISON COLDINGLEY	PRISONNAME	HMP COLDINGLEY
HM PRISON HINDLEY	PRISONNAME	HMP HINDLEY
HM PRISON DEERBOLT	PRISONNAME	HMP/YOI DEERBOLT
HM PRISON STOKE HEATH	PRISONNAME	HMP STOKE HEATH
HM PRISON SWINFEN HALL	PRISONNAME	HMP SWINFEN HALL
DOVER IMMIGRATION REMOVAL CENTRE	PRISONNAME	IRC DOVER
HM PRISON DRAKE HALL	PRISONNAME	HMP DRAKE HALL
HM PRISON EAST SUTTON PARK	PRISONNAME	HMP EAST SUTTON PARK
HM PRISON EASTWOOD PARK	PRISONNAME	HMP EASTWOOD PARK
HM PRISON ERLESTOKE	PRISONNAME	HMP ERLESTOKE
HM PRISON EVERTHORPE	PRISONNAME	HMP EVERTHORPE
HM PRISON FEATHERSTONE	PRISONNAME	HMP FEATHERSTONE
HM PRISON GARTH	PRISONNAME	HMP GARTH
HM PRISON GUYS MARSH	PRISONNAME	HMP GUYS MARSH
HASLAR IMMIGRATION REMOVAL CENTRE	PRISONNAME	IRC HASLAR
MINNESOTA CORRECTIONAL FACILITY – LINO LAKES	PRISONNAME	MINNESOTA CORRECTIONAL FACILITY – LINO LAKES
HM PRISON HAVERIGG	PRISONNAME	HMP HAVERIGG
CORRECTIONAL TRAINING FACILITY	PRISONNAME	CORRECTIONAL TRAINING FACILITY
HM PRISON KENNET	PRISONNAME	HMP KENNET
HM PRISON LEWES	PRISONNAME	HMP LEWES
HM PRISON LITTLEHEY	PRISONNAME	HMP LITTLEHEY
HM PRISON LOWDHAM GRANGE	PRISONNAME	HMP LOWDHAM GRANGE
GHERLA PRISON	PRISONNAME	GHERLA
HM PRISON MOORLAND	PRISONNAME	HMP MOORLAND
HM PRISON HATFIELD	PRISONNAME	HMP & YOI HATFIELD
MORTON HALL IMMIGRATION REMOVAL CENTRE	PRISONNAME	IRC MORTON HALL
HM PRISON NORWICH	PRISONNAME	HMP NORWICH
HM PRISON NOTTINGHAM	PRISONNAME	HMP NOTTINGHAM
SOUTH WOODS STATE PRISON	PRISONNAME	SOUTH WOODS STATE PRISON
CAMP LEHMAN	PRISONNAME	CAMP LEHMAN CORRECTIONAL FACILITY
HM PRISON PORTLAND	PRISONNAME	HMP PORTLAND
ARBOUR HILL PRISON	PRISONNAME	ARBOUR HILL PRISON
HM PRISON PRESCOED	PRISONNAME	HMP PRESCOED
HM PRISON PRESTON	PRISONNAME	HMP PRESTON
HM PRISON PERTH	PRISONNAME	HMP PERTH
HM PRISON RANBY	PRISONNAME	HMP RANBY
HM PRISON RISLEY	PRISONNAME	HMP RISLEY
OLD COLONY CORRECTIONAL CENTER	PRISONNAME	OLD COLONY CORRECTIONAL CENTER
HM PRISON ROCHESTER	PRISONNAME	HMP ROCHESTER
HM PRISON RYE HILL	PRISONNAME	HMP RYE HILL
HM PRISON SPRING HILL	PRISONNAME	HMP SPRING HILL
HM PRISON STANDFORD HILL	PRISONNAME	HMP STANDFORD HILL
PREY SAR PRISON	PRISONNAME	PREY SAR PRISON
HM PRISON SWALESIDE	PRISONNAME	HMP SWALESIDE
HM PRISON SUDBURY	PRISONNAME	HMP SUDBURY
LOVELOCK CORRECTIONAL CENTER	PRISONNAME	LOVELOCK CORRECTIONAL CENTER
MILL CREEK CORRECTIONAL FACILITY	PRISONNAME	MILL CREEK CORRECTIONAL FACILITY
UNITED STATES PENITENTIARY, BEAUMONT	PRISONNAME	UNITED STATES PENITENTIARY, BEAUMONT
KILBY CORRECTIONAL FACILITY	PRISONNAME	KILBY CORRECTIONAL FACILITY
HM PRISON WARREN HILL	PRISONNAME	HMP WARREN HILL
EASTERN OREGON CORRECTIONAL INSTITUTION	PRISONNAME	EASTERN OREGON CORRECTIONAL INSTITUTION
HM PRISON WELLINGBOROUGH	PRISONNAME	HMP WELLINGBOROUGH
HM PRISON WERRINGTON	PRISONNAME	HMP WERRINGTON
HM PRISON HEWELL	PRISONNAME	HMP HEWELL
ERIE COUNTY HOLDING CENTER	PRISONNAME	ERIE COUNTY HOLDING CENTER
WASHINGTON CORRECTIONAL FACILITY	PRISONNAME	WASHINGTON CORRECTIONAL FACILITY
CHATHAM JAIL	PRISONNAME	CHATHAM JAIL
BROCKVILLE JAIL	PRISONNAME	BROCKVILLE JAIL
TORONTO EAST DETENTION CENTRE	PRISONNAME	TORONTO EAST DETENTION CENTRE
IDAHO STATE CORRECTIONAL CENTER	PRISONNAME	IDAHO STATE CORRECTIONAL CENTER
HM PRISON ISLE OF WIGHT	PRISONNAME	HMP ISLE OF WIGHT
BARNSTABLE COUNTY CORRECTIONAL FACILITY	PRISONNAME	BARNSTABLE COUNTY CORRECTIONAL FACILITY
ALBERT C. WAGNER YOUTH CORRECTIONAL FACILITY	PRISONNAME	ALBERT C. WAGNER YOUTH CORRECTIONAL FACILITY
FRANKLIN CORRECTIONAL FACILITY	PRISONNAME	FRANKLIN CORRECTIONAL FACILITY
NORTHERN STATE PRISON	PRISONNAME	NORTHERN STATE PRISON
DONALD W. WYATT DETENTION FACILITY	PRISONNAME	DONALD W. WYATT DETENTION FACILITY
NAINI CENTRAL PRISON	PRISONNAME	NAINI CENTRAL PRISON
FEDERAL CORRECTIONAL COMPLEX, FORREST CITY	PRISONNAME	FEDERAL CORRECTIONAL COMPLEX, FORREST CITY
TWO RIVERS DETENTION FACILITY	PRISONNAME	TWO RIVERS REGIONAL DETENTION FACILITY
GONAKUDZINGWA RESTRICTION CAMP	PRISONNAME	GONAKUDZINGWA RESTRICTION CAMP
MINNESOTA CORRECTIONAL FACILITY – FARIBAULT	PRISONNAME	MINNESOTA CORRECTIONAL FACILITY &NDASH; FARIBAULT
ASH STREET JAIL	PRISONNAME	ASH STREET JAIL AND REGIONAL LOCK-UP
CAMP KOEHLER	PRISONNAME	CAMP KOEHLER
PUZHAL CENTRAL PRISON	PRISONNAME	PUZHAL CENTRAL PRISON
MADRAS CENTRAL PRISON	PRISONNAME	MADRAS CENTRAL PRISON
HELSINKI PRISON	PRISONNAME	HELSINKI PRISON
CHIANG MAI CENTRAL PRISON	PRISONNAME	CHIANG MAI CENTRAL PRISON
UNITED STATES PENITENTIARY, CANAAN	PRISONNAME	UNITED STATES PENITENTIARY, CANAAN
FEDERAL CORRECTIONAL INSTITUTION, BECKLEY	PRISONNAME	FEDERAL CORRECTIONAL INSTITUTION, BECKLEY
JOHNSON STATE PRISON	PRISONNAME	JOHNSON STATE PRISON
MORGAN COUNTY CORRECTIONAL COMPLEX	PRISONNAME	MORGAN COUNTY CORRECTIONAL COMPLEX
ALBANY TRANSITIONAL CENTER	PRISONNAME	ALBANY TRANSITIONAL CENTER
AUGUSTA STATE MEDICAL PRISON	PRISONNAME	AUGUSTA STATE MEDICAL PRISON
JIMMY AUTRY STATE PRISON	PRISONNAME	JIMMY AUTRY STATE PRISON
BALDWIN STATE PRISON	PRISONNAME	BALDWIN STATE PRISON
CALHOUN STATE PRISON	PRISONNAME	CALHOUN STATE PRISON
COASTAL STATE PRISON	PRISONNAME	COASTAL STATE PRISON
COASTAL TRANSITIONAL CENTER	PRISONNAME	COASTAL TRANSITIONAL CENTER
CENTRAL STATE PRISON	PRISONNAME	CENTRAL STATE PRISON
STANDISH MAXIMUM CORRECTIONAL FACILITY	PRISONNAME	STANDISH MAXIMUM CORRECTIONAL FACILITY
TOWER STREET ADULT CORRECTIONAL CENTRE	PRISONNAME	TOWER STREET PRISON
ST. CATHERINE ADULT CORRECTIONAL CENTRE	PRISONNAME	SAINT CATHERINE PRISON
FORT AUGUSTA ADULT CORRECTIONAL CENTRE	PRISONNAME	FORT AUGUSTA PRISON
SOUTH CAMP ADULT CORRECTIONAL CENTRE	PRISONNAME	SOUTH CAMP PRISON
RICHMOND FARM CORRECTIONAL CENTRE	PRISONNAME	RICHMOND FARM CORRECTIONAL CENTRE
TAMARIND FARM CORRECTIONAL CENTRE	PRISONNAME	TAMARIND FARM CORRECTIONAL CENTRE
NEW BROUGHTON SUNSET CORRECTIONAL CENTRE	PRISONNAME	NEW BROUGHTON SUNSET CORRECTIONAL CENTRE
RIO COBRE JUVENILE CORRECTIONAL CENTRE	PRISONNAME	RIO COBRE JUVENILE CORRECTIONAL CENTRE
HORIZON ADULT REMAND CENTRE	PRISONNAME	HORIZON ADULT REMAND CENTRE
HILL TOP JUVENILE CORRECTIONAL CENTRE	PRISONNAME	HILL TOP JUVENILE CORRECTIONAL CENTRE
ARMADALE JUVENILE CORRECTIONAL CENTRE	PRISONNAME	ARMADALE JUVENILE CORRECTIONAL CENTRE
SAINT ANN'S BAY OLD JAIL	PRISONNAME	SAINT ANN&#39;S BAY OLD JAIL
SAINT JAGO WOMEN'S CENTRE	PRISONNAME	SAINT JAGO WOMEN&#39;S CENTRE
FRED C. NELLES YOUTH CORRECTIONAL FACILITY	PRISONNAME	FRED C. NELLES YOUTH CORRECTIONAL FACILITY
HIGH DESERT STATE PRISON	PRISONNAME	HIGH DESERT STATE PRISON
IRONWOOD STATE PRISON	PRISONNAME	IRONWOOD STATE PRISON
WASCO STATE PRISON	PRISONNAME	WASCO STATE PRISON-RECEPTION CENTER
SALINAS VALLEY STATE PRISON	PRISONNAME	SALINAS VALLEY STATE PRISON
SIERRA CONSERVATION CENTER	PRISONNAME	SIERRA CONSERVATION CENTER
RICHARD J. DONOVAN CORRECTIONAL FACILITY	PRISONNAME	RICHARD J. DONOVAN CORRECTIONAL FACILITY
MAPLEHURST CORRECTIONAL COMPLEX	PRISONNAME	MAPLEHURST CORRECTIONAL COMPLEX
HM PRISON HIGHPOINT NORTH	PRISONNAME	HMP HIGHPOINT NORTH
HM PRISON DORCHESTER	PRISONNAME	HMP DORCHESTER
HM PRISON HOLME HOUSE	PRISONNAME	HMP HOLME HOUSE
HM PRISON GRENDON	PRISONNAME	HMP GRENDON
HM PRISON GLOUCESTER	PRISONNAME	HMP GLOUCESTER
METROPOLITAN CORRECTIONAL CENTER, SAN DIEGO	PRISONNAME	METROPOLITAN CORRECTIONAL CENTER, SAN DIEGO
DODGE CORRECTIONAL INSTITUTION	PRISONNAME	DODGE CORRECTIONAL INSTITUTION
MACON STATE PRISON	PRISONNAME	MACON STATE PRISON
ELLIS UNIT	PRISONNAME	O.B. ELLIS UNIT
HM PRISON NEW HALL	PRISONNAME	HMP NEW HALL
HM PRISON BURE	PRISONNAME	HMP BURE
FEDERAL CORRECTIONAL INSTITUTION, TUCSON	PRISONNAME	FEDERAL CORRECTIONAL INSTITUTION, TUCSON
HM PRISON LA MOYE	PRISONNAME	HMP LA MOYE
FEDERAL CORRECTIONAL INSTITUTION, EL RENO	PRISONNAME	UNITED STATES PENITENTIARY, EL RENO
FLORENCE MCCLURE WOMEN'S CORRECTIONAL CENTER	PRISONNAME	FLORENCE MCCLURE WOMEN'S CORRECTIONAL CENTER
HM PRISON HYDEBANK WOOD	PRISONNAME	HER MAJESTY'S PRISON HYDEBANK WOOD
LINCOLN HEIGHTS JAIL	PRISONNAME	LINCOLN HEIGHTS JAIL
LUZIRA MAXIMUM SECURITY PRISON	PRISONNAME	LUZIRA MAXIMUM SECURITY PRISON
FEDERAL DETENTION CENTER, HOUSTON	PRISONNAME	FEDERAL DETENTION CENTER, HOUSTON
CLERKENWELL PRISON	PRISONNAME	CLERKENWELL  PRISON
PUGSLEY CORRECTIONAL FACILITY	PRISONNAME	PUGSLEY CORRECTIONAL FACILITY
LAFAYETTE PARISH CORRECTIONAL CENTER	PRISONNAME	LAFAYETTE PARISH CORRECTIONAL CENTER
W.J. ESTELLE UNIT	PRISONNAME	W. J. \
CLEMENS UNIT	PRISONNAME	CLEMENS UNIT
DEER ISLAND PRISON	PRISONNAME	DEER ISLAND PRISON
SILIVRI PRISON	PRISONNAME	SILIVRI PENITENTIARIES CAMPUS
DIYARBAKıR PRISON	PRISONNAME	DIYARBAKıR PRISON
THE BLACK DOG, DUBLIN	PRISONNAME	THE BLACK DOG
CENTRAL EAST CORRECTIONAL CENTRE	PRISONNAME	CENTRAL EAST CORRECTIONAL CENTRE
ALGOMA TREATMENT AND REMAND CENTRE	PRISONNAME	ALGOMA TREATMENT AND REMAND CENTRE
MONTEITH CORRECTIONAL COMPLEX	PRISONNAME	MONTEITH CORRECTIONAL COMPLEX
ELGIN-MIDDLESEX DETENTION CENTRE	PRISONNAME	ELGIN-MIDDLESEX DETENTION CENTRE
BAY STATE CORRECTIONAL CENTER	PRISONNAME	BAY STATE CORRECTIONAL CENTER
EL MANZANO	PRISONNAME	CARCéL EL MANZANO
GRAND VALLEY INSTITUTION FOR WOMEN	PRISONNAME	GRAND VALLEY INSITITUTION FOR WOMEN
NORTH CENTRAL CORRECTIONAL INSTITUTION	PRISONNAME	NORTH CENTRAL CORRECTIONAL INSTITUTION
CAMP KILPATRICK	PRISONNAME	CAMP KILPATRICK
WOMEN'S HURON VALLEY CORRECTIONAL FACILITY	PRISONNAME	WOMEN'S HURON VALLEY CORRECTIONAL FACILITY
FERNDALE INSTITUTION	PRISONNAME	FERNDALE INSTITUTION
CENTRAL NOVA SCOTIA CORRECTIONAL FACILITY	PRISONNAME	CENTRAL NOVA SCOTIA CORRECTIONAL FACILITY
ELAYN HUNT CORRECTIONAL CENTER	PRISONNAME	ELAYN HUNT CORRECTIONAL CENTER
UNITED STATES PENITENTIARY, BIG SANDY	PRISONNAME	U.S. PENITENTIARY, BIG SANDY
HALDEN PRISON	PRISONNAME	HALDEN PRISON
WYNNE UNIT	PRISONNAME	JOHN M. WYNNE UNIT
TERRELL UNIT	PRISONNAME	C.T. TERRELL UNIT
CENTRAL PRISON	PRISONNAME	CENTRAL PRISON
CAROL VANCE UNIT	PRISONNAME	CAROL S. VANCE UNIT
JESTER III UNIT	PRISONNAME	BEAUFORD H. JESTER III UNIT
DARRINGTON UNIT	PRISONNAME	DARRINGTON UNIT
WAYNE SCOTT UNIT	PRISONNAME	WAYNE SCOTT UNIT
CHRISTINA MELTON CRAIN UNIT	PRISONNAME	CHRISTINA MELTON CRAIN UNIT
CLEVELAND UNIT	PRISONNAME	CLEVELAND CORRECTIONAL CENTER
LOUIS C. POWLEDGE UNIT	PRISONNAME	LOUIS C. POWLEDGE UNIT
DR. LANE MURRAY UNIT	PRISONNAME	DR. LANE MURRAY UNIT
DALHART UNIT	PRISONNAME	DALHART UNIT
GEORGE BETO UNIT	PRISONNAME	GEORGE BETO UNIT
NORTH BAY JAIL	PRISONNAME	NORTH BAY JAIL
MONTLUC PRISON	PRISONNAME	MONTLUC
DóCHAS CENTRE	PRISONNAME	DóCHAS CENTRE
RICHMOND GENERAL PENITENTIARY	PRISONNAME	RICHMOND GENERAL PENITENTIARY
GOREE UNIT	PRISONNAME	THOMAS GOREE UNIT
FEDERAL CORRECTIONAL INSTITUTION, LA TUNA	PRISONNAME	FEDERAL CORRECTIONAL INSTITUTION, LA TUNA
TUCKER UNIT	PRISONNAME	TUCKER UNIT
FEDERAL DETENTION CENTER, MIAMI	PRISONNAME	FEDERAL DETENTION CENTER, MIAMI
EASTHAM UNIT	PRISONNAME	EASTHAM UNIT
FERGUSON UNIT	PRISONNAME	JIM FERGUSON UNIT
RAMSEY UNIT	PRISONNAME	W. F. RAMSEY UNIT
MARK STILES UNIT	PRISONNAME	MARK W. STILES UNIT
STRINGFELLOW UNIT	PRISONNAME	A.M. \
FEDERAL DETENTION CENTER, SEATAC	PRISONNAME	FEDERAL DETENTION CENTER, SEATAC
CENTRAL MISSISSIPPI CORRECTIONAL FACILITY	PRISONNAME	CENTRAL MISSISSIPPI CORRECTIONAL FACILITY
SOUTH MISSISSIPPI CORRECTIONAL INSTITUTION	PRISONNAME	SOUTH MISSISSIPPI CORRECTIONAL INSTITUTION
MARK W. MICHAEL UNIT	PRISONNAME	MARK W. MICHAEL UNIT
HILLTOP UNIT	PRISONNAME	HILLTOP UNIT
UNITED STATES PENITENTIARY, LEE	PRISONNAME	UNITED STATES PENITENTIARY, LEE
BRANDVLEI CORRECTIONAL CENTRE	PRISONNAME	BRANDVLEI CORRECTIONAL CENTRE
ARIZONA STATE PRISON – KINGMAN	PRISONNAME	ARIZONA STATE PRISON COMPLEX – KINGMAN
OAKS CORRECTIONAL FACILITY	PRISONNAME	OAKS CORRECTIONAL FACILITY
UNITED STATES PENITENTIARY, TUCSON	PRISONNAME	UNITED STATES PENITENTIARY, TUCSON
FEDERAL CORRECTIONAL COMPLEX, TUCSON	PRISONNAME	FEDERAL CORRECTIONAL COMPLEX, TUCSON
COFFIELD UNIT	PRISONNAME	H. H. COFFIELD UNIT
STATE CORRECTIONAL INSTITUTION – MUNCY	PRISONNAME	STATE CORRECTIONAL INSTITUTION MUNCY
LOUISIANA CORRECTIONAL INSTITUTE FOR WOMEN	PRISONNAME	LOUISIANA CORRECTIONAL INSTITUTE FOR WOMEN
AIUD PRISON	PRISONNAME	AIUD PRISON
DIXON CORRECTIONAL INSTITUTE	PRISONNAME	DIXON CORRECTIONAL INSTITUTE
METROPOLITAN DETENTION CENTER, GUAYNABO	PRISONNAME	FEDERAL CORRECTIONAL INSTITUTION, GUAYNABO
B.B. RAYBURN CORRECTIONAL CENTER	PRISONNAME	B.B. RAYBURN CORRECTIONAL CENTER
STATE CORRECTIONAL INSTITUTION – DALLAS	PRISONNAME	STATE CORRECTIONAL INSTITUTION – DALLAS
STATE CORRECTIONAL INSTITUTION – CAMP HILL	PRISONNAME	STATE CORRECTIONAL INSTITUTION CAMP HILL
STATE CORRECTIONAL INSTITUTION – COAL TOWNSHIP	PRISONNAME	STATE CORRECTIONAL INSTITUTION – COAL TOWNSHIP
JULIA TUTWILER PRISON FOR WOMEN	PRISONNAME	JULIA TUTWILER PRISON FOR WOMEN
WETUMPKA STATE PENITENTIARY	PRISONNAME	WETUMPKA STATE PENITENTIARY
FEDERAL CORRECTIONAL COMPLEX, OAKDALE	PRISONNAME	FEDERAL CORRECTIONAL COMPLEX, OAKDALE
FEDERAL CORRECTIONAL INSTITUTION, JESUP	PRISONNAME	FEDERAL CORRECTIONAL INSTITUTION, JESUP
DEVIZES COUNTY HOUSE OF CORRECTIONS	PRISONNAME	HMP DEVIZES HOUSE OF COUNTY CORRECTIONS
FEDERAL CORRECTIONAL INSTITUTION, ENGLEWOOD	PRISONNAME	FEDERAL CORRECTIONAL INSTITUTION, ENGLEWOOD
CHERLAPALLY CENTRAL JAIL	PRISONNAME	CHERLAPALLY CENTRAL JAIL
MUSHEERABAD JAIL	PRISONNAME	MUSHEERABAD JAIL
WEST TENNESSEE STATE PENITENTIARY	PRISONNAME	WEST TENNESSEE STATE PENITENTIARY
CENTRAL JAIL RAWALPINDI	PRISONNAME	CENTRAL JAIL RAWALPINDI
SAGUARO CORRECTIONAL CENTER	PRISONNAME	SAGUARO CORRECTIONAL CENTER
CENTRAL JAIL FAISALABAD	PRISONNAME	CENTRAL JAIL FAISALABAD
JAMES H. BYRD, JR. UNIT	PRISONNAME	JAMES \
DAVID WADE CORRECTIONAL CENTER	PRISONNAME	DAVID WADE CORRECTIONAL CENTER
WILLIAM E. DONALDSON CORRECTIONAL FACILITY	PRISONNAME	WILLIAM E. DONALDSON CORRECTIONAL FACILITY
WISCONSIN SECURE PROGRAM FACILITY	PRISONNAME	WISCONSIN SECURE PROGRAM FACILITY
CENTRAL PRISON, VIYYUR	PRISONNAME	CENTRAL PRISON, VIYYUR
LOGAN CORRECTIONAL CENTER	PRISONNAME	LOGAN CORRECTIONAL CENTER
DISTRICT JAIL RAWALPINDI	PRISONNAME	DISTRICT JAIL RAWALPINDI
TALLAHATCHIE COUNTY CORRECTIONAL FACILITY	PRISONNAME	TALLAHATCHIE COUNTY CORRECTIONAL FACILITY
CENTRAL JAIL LAHORE	PRISONNAME	CENTRAL JAIL LAHORE
PRAIRIE CORRECTIONAL FACILITY	PRISONNAME	PRAIRIE CORRECTIONAL FACILITY
CENTRAL JAIL MIANWALI	PRISONNAME	CENTRAL JAIL MIANWALI
NORTHERN NEVADA CORRECTIONAL CENTER	PRISONNAME	NORTHERN NEVADA CORRECTIONAL CENTER  AND STEWART CONSERVATION CAMP
HM PRISON FORD	PRISONNAME	HMP FORD
BURREL PRISON	PRISONNAME	INSTITUCIONI I EKZEKUTIMIT Të VENDIMIT PENAL BURREL
ALFRED D. HUGHES UNIT	PRISONNAME	ALFRED D. HUGHES UNIT
EAST MISSISSIPPI CORRECTIONAL FACILITY	PRISONNAME	EAST MISSISSIPPI CORRECTIONAL FACILITY
MOOSE LAKE	PRISONNAME	MINNESOTA CORRECTIONAL FACILITY &NDASH; MOOSE LAKE
MOOSE LAKE	PRISONNAME	MINNESOTA CORRECTIONAL FACILITY &NDASH; WILLOW RIVER
BOSTON PRE-RELEASE CENTER	PRISONNAME	BOSTON PRE-RELEASE CENTER
LEMUEL SHATTUCK HOSPITAL CORRECTIONAL UNIT	PRISONNAME	LEMUEL SHATTUCK HOSPITAL CORRECTIONAL UNIT
COLORADO STATE PENITENTIARY	PRISONNAME	COLORADO STATE PENITENTIARY
NORTHEASTERN CORRECTIONAL CENTER	PRISONNAME	NORTHEASTERN CORRECTIONAL CENTER
DISTRICT JAIL JHELUM	PRISONNAME	DISTRICT JAIL JHELUM
WALNUT GROVE CORRECTIONAL FACILITY	PRISONNAME	WALNUT GROVE CORRECTIONAL FACILITY
MCPHERSON UNIT	PRISONNAME	MCPHERSON UNIT
MACK ALFORD CORRECTIONAL CENTER	PRISONNAME	MACK ALFORD CORRECTIONAL CENTER
PONDVILLE CORRECTIONAL CENTER	PRISONNAME	PONDVILLE CORRECTIONAL CENTER
SOUTH MIDDLESEX CORRECTIONAL CENTER	PRISONNAME	SOUTH MIDDLESEX CORRECTIONAL CENTER
FLUVANNA CORRECTIONAL CENTER FOR WOMEN	PRISONNAME	FLUVANNA CORRECTIONAL CENTER FOR WOMEN
SPAç PRISON	PRISONNAME	SPAç PRISON
MEN'S STATE PRISON	PRISONNAME	MEN'S STATE PRISON
PRISON 313	PRISONNAME	PRISON 313
WYOMING MEDIUM CORRECTIONAL INSTITUTION	PRISONNAME	WYOMING MEDIUM CORRECTIONAL INSTITUTION
FEDERAL CORRECTIONAL INSTITUTION, THREE RIVERS	PRISONNAME	FEDERAL CORRECTIONAL INSTITUTION, THREE RIVERS
WHITEVILLE CORRECTIONAL FACILITY	PRISONNAME	WHITEVILLE CORRECTIONAL FACILITY
FEDERAL CORRECTIONAL INSTITUTION, PHOENIX	PRISONNAME	FEDERAL CORRECTIONAL INSTITUTION, PHOENIX
FENBROOK INSTITUTION	PRISONNAME	FENBROOK INSTITUTION
NEW CENTRAL JAIL BAHAWALPUR	PRISONNAME	NEW CENTRAL JAIL BAHAWALPUR
CENTRAL JAIL GUJRANWALA	PRISONNAME	CENTRAL JAIL GUJRANWALA
CENTRAL JAIL SAHIWAL	PRISONNAME	CENTRAL JAIL SAHIWAL
DISTRICT JAIL LAHORE	PRISONNAME	DISTRICT JAIL LAHORE
DISTRICT JAIL SHEIKHUPURA	PRISONNAME	DISTRICT JAIL SHEIKHUPURA
DISTRICT JAIL KASUR	PRISONNAME	DISTRICT JAIL KASUR
DISTRICT JAIL SIALKOT	PRISONNAME	DISTRICT JAIL SIALKOT
NEW CENTRAL JAIL MULTAN	PRISONNAME	CENTRAL JAIL MULTAN
BORSTAL INSTITUTION AND JUVENILE JAIL BAHAWALPUR	PRISONNAME	BORSTAL INSTITUTION & JUVENILE JAIL BAHAWALPUR
BORSTAL INSTITUTION AND JUVENILE JAIL FAISALABAD	PRISONNAME	BORSTAL INSTITUTION & JUVENILE JAIL FAISALABAD
FEDERAL CORRECTIONAL INSTITUTION, ASHLAND	PRISONNAME	FEDERAL CORRECTIONAL INSTITUTION, ASHLAND
DISTRICT JAIL GUJRAT	PRISONNAME	DISTRICT JAIL GUJRAT
DISTRICT JAIL MULTAN	PRISONNAME	DISTRICT JAIL MULTAN
DIXON CORRECTIONAL CENTER	PRISONNAME	DIXON CORRECTIONAL CENTER
KETTLE MORAINE CORRECTIONAL INSTITUTION	PRISONNAME	KETTLE MORAINE CORRECTIONAL INSTITUTION
CORK PRISON	PRISONNAME	CORK PRISON
MIDLANDS PRISON	PRISONNAME	MIDLANDS PRISON
TENNESSEE PRISON FOR WOMEN	PRISONNAME	TENNESSEE PRISON FOR WOMEN
RANDALL L. WILLIAMS CORRECTIONAL FACILITY	PRISONNAME	RANDALL L. WILLIAMS CORRECTIONAL FACILITY
EAST ARKANSAS REGIONAL UNIT	PRISONNAME	EAST ARKANSAS REGIONAL UNIT
WRIGHTSVILLE UNIT	PRISONNAME	WRIGHTSVILLE UNIT
MCNEIL ISLAND CORRECTIONS CENTER	PRISONNAME	MCNEIL ISLAND CORRECTIONS CENTER
HM PRISON ADDIEWELL	PRISONNAME	HMP ADDIEWELL
OTTAWA-CARLETON DETENTION CENTRE	PRISONNAME	OTTAWA-CARLETON DETENTION CENTRE
FEDERAL CORRECTIONAL INSTITUTION, SANDSTONE	PRISONNAME	FEDERAL CORRECTIONAL INSTITUTION, SANDSTONE
STATE CORRECTIONAL INSTITUTION – FAYETTE	PRISONNAME	STATE CORRECTIONAL INSTITUTION - FAYETTE
STATE CORRECTIONAL INSTITUTION – PITTSBURGH	PRISONNAME	STATE CORRECTIONAL INSTITUTION – PITTSBURGH
PRISON HOSPITAL OF TIRANA	PRISONNAME	PRISON HOSPITAL OF TIRANA
STATE CORRECTIONAL INSTITUTION – GREENSBURG	PRISONNAME	STATE CORRECTIONAL INSTITUTION - GREENSBURG
STATE CORRECTIONAL INSTITUTION – LAUREL HIGHLANDS	PRISONNAME	STATE CORRECTIONAL INSTITUTION - LAUREL HIGHLANDS
STATE CORRECTIONAL INSTITUTION – SOMERSET	PRISONNAME	STATE CORRECTIONAL INSTITUTION - SOMERSET
STATE CORRECTIONAL INSTITUTION – CRESSON	PRISONNAME	STATE CORRECTIONAL INSTITUTION - CRESSON
MOTIVATIONAL BOOTCAMP – QUEHANNA	PRISONNAME	QUEHANNA MOVATIONAL BOOT CAMP
STATE CORRECTIONAL INSTITUTION – HUNTINGDON	PRISONNAME	STATE CORRECTIONAL INSTITUTION - HUNTINGDON
STATE CORRECTIONAL INSTITUTION – SMITHFIELD	PRISONNAME	STATE CORRECTIONAL INSTITUTION - SMITHFIELD
STATE CORRECTIONAL INSTITUTION – MERCER	PRISONNAME	STATE CORRECTIONAL INSTITUTION – MERCER
STATE CORRECTIONAL INSTITUTION – HOUTZDALE	PRISONNAME	STATE CORRECTIONAL INSTITUTION - HOUTZDALE
STATE CORRECTIONAL INSTITUTION – WAYMART	PRISONNAME	STATE CORRECTIONAL INSTITUTION - WAYMART
STATE CORRECTIONAL INSTITUTION – RETREAT	PRISONNAME	STATE CORRECTIONAL INSTITUTION RETREAT
STATE CORRECTIONAL INSTITUTION – MAHANOY	PRISONNAME	STATE CORRECTIONAL INSTITUTION - MAHANOY
STATE CORRECTIONAL INSTITUTION – FRACKVILLE	PRISONNAME	STATE CORRECTIONAL INSTUITION - FRACKVILLE
STATE CORRECTIONAL INSTITUTION – FOREST	PRISONNAME	STATE CORRECTIONAL INSTITUTION - FOREST
STATE CORRECTIONAL INSTITUTION – CAMBRIDGE SPRINGS	PRISONNAME	STATE CORRECTIONAL INSTITUTION - CAMBRIDGE SPRINGS
STATE CORRECTIONAL INSTITUTION – CHESTER	PRISONNAME	STATE CORRECTIONAL INSTITUTION - CHESTER
STATE CORRECTIONAL INSTITUTION – ALBION	PRISONNAME	STATE CORRECTIONAL INSTITUTION - ALBION
QAFë BAR PRISON	PRISONNAME	QAFë BAR
NOVA INSTITUTION FOR WOMEN	PRISONNAME	NOVA INSTITUTION FOR WOMEN
MUSKEGON CORRECTIONAL FACILITY	PRISONNAME	MUSKEGON CORRECTIONAL FACILITY
%60ULAYSHA PRISON	PRISONNAME	`ULAYSHA PRISON
ADRA PRISON	PRISONNAME	ADRA PRISON
BARNSTABLE COUNTY JAIL AND HOUSE OF CORRECTION	PRISONNAME	BARNSTABLE COUNTY JAIL AND HOUSE OF CORRECTION
HALL PRISON	PRISONNAME	ANSTALTEN HALL
FOUNTAIN CORRECTIONAL FACILITY	PRISONNAME	FOUNTAIN CORRECTIONAL FACILITY
LINCOLN CORRECTIONAL FACILITY	PRISONNAME	LINCOLN CORRECTIONAL FACILITY
OREGON STATE CORRECTIONAL INSTITUTION	PRISONNAME	OREGON STATE CORRECTIONAL INSTITUTION
CENTRAL PRISON, KANNUR	PRISONNAME	CENTRAL PRISON, KANNUR
CENTRAL PRISON, POOJAPPURA	PRISONNAME	CENTRAL PRISON, POOJAPPURA
MINNESOTA CORRECTIONAL FACILITY – RED WING	PRISONNAME	MINNESOTA CORRECTIONAL FACILITY &NDASH; RED WING
BAYSIDE STATE PRISON	PRISONNAME	BAYSIDE STATE PRISON
SOUTHERN STATE CORRECTIONAL FACILITY	PRISONNAME	SOUTHERN STATE CORRECTIONAL FACILITY
WILLACY COUNTY CORRECTIONAL CENTER	PRISONNAME	WILLACY COUNTY CORRECTIONAL CENTER
L.V. HIGHTOWER UNIT	PRISONNAME	L.V. HIGHTOWER UNIT
HM PRISON ISIS	PRISONNAME	HMP ISIS
FEDERAL MEDICAL CENTER, DEVENS	PRISONNAME	FEDERAL MEDICAL CENTER, DEVENS
NORTH CAROLINA CORRECTIONAL INSTITUTION FOR WOMEN	PRISONNAME	NORTH CAROLINA CORRECTIONAL INSTITUTION FOR WOMEN
DOUG OWSTON CORRECTIONAL CENTRE	PRISONNAME	DOUG OWSTON CORRECTIONAL CENTRE
SOUTHERN QUEENSLAND CORRECTIONAL CENTRE	PRISONNAME	SOUTHERN QUEENSLAND CORRECTIONAL CENTRE
MEN'S CENTRAL JAIL	PRISONNAME	MEN'S CENTRAL JAIL
HM PRISON OAKWOOD	PRISONNAME	HMP OAKWOOD
TEMARA INTERROGATION CENTRE	PRISONNAME	TEMARA
ROSS FEMALE FACTORY	PRISONNAME	ROSS FEMALE FACTORY
STERLING CORRECTIONAL FACILITY	PRISONNAME	STERLING CORRECTIONAL FACILITY
CENTENNIAL CORRECTIONAL FACILITY	PRISONNAME	CENTENNIAL CORRECTIONAL FACILITY
FREMONT CORRECTIONAL FACILITY	PRISONNAME	FREMONT CORRECTIONAL FACILITY
YOUTHFUL OFFENDER SYSTEM	PRISONNAME	YOUTHFUL OFFENDER SYSTEM
LA VISTA CORRECTIONAL FACILITY	PRISONNAME	LA VISTA CORRECTIONAL FACILITY
SAN CARLOS CORRECTIONAL FACILITY	PRISONNAME	SAN CARLOS CORRECTIONAL FACILITY
COLORADO TERRITORIAL CORRECTIONAL FACILITY	PRISONNAME	COLORADO TERRITORIAL CORRECTIONAL FACILITY
FEDERAL CORRECTIONAL INSTITUTION, BERLIN	PRISONNAME	FEDERAL CORRECTIONAL INSTITUTION, BERLIN
YERWADA CENTRAL JAIL	PRISONNAME	YERWADA CENTRAL JAIL
BORDEAUX PRISON	PRISONNAME	BORDEAUX PRISON
OSHKOSH CORRECTIONAL INSTITUTION	PRISONNAME	OSHKOSH CORRECTIONAL INSTITUTION
FEDERAL PRISON CAMP, MONTGOMERY	PRISONNAME	FEDERAL PRISON CAMP, MONTGOMERY
BRITISH COLUMBIA PENITENTIARY	PRISONNAME	BRITISH COLUMBIA PENITENTIARY
WELLINGTON CORRECTIONAL CENTRE	PRISONNAME	WELLINGTON CORRECTIONAL CENTRE
MID NORTH COAST CORRECTIONAL CENTRE	PRISONNAME	MID NORTH COAST CORRECTIONAL CENTRE
FEDERAL CORRECTIONAL INSTITUTION, TALLADEGA	PRISONNAME	FCI TALLADEGA
FEDERAL CORRECTIONAL INSTITUTION, MCKEAN	PRISONNAME	FEDERAL CORRECTIONAL INSTITUTION, MCKEAN
FEDERAL CORRECTIONAL INSTITUTION, BENNETTSVILLE	PRISONNAME	FCI BENNETTSVILLE
FEDERAL CORRECTIONAL INSTITUTION, COLEMAN	PRISONNAME	FEDERAL CORRECTIONAL INSTITUTION, COLEMAN
ORYOL PRISON	PRISONNAME	ORYOL PRISON
FEDERAL CORRECTIONAL INSTITUTION, SAFFORD	PRISONNAME	FEDERAL CORRECTIONAL INSTITUTION, SAFFORD
FEDERAL CORRECTIONAL INSTITUTION, MCDOWELL	PRISONNAME	FEDERAL CORRECTIONAL INSTITUTION, MCDOWELL
FEDERAL CORRECTIONAL INSTITUTION, BEAUMONT	PRISONNAME	FEDERAL CORRECTIONAL INSTITUTION, BEAUMONT
METROPOLITAN DETENTION CENTER, LOS ANGELES	PRISONNAME	METROPOLITAN DETENTION CENTER, LOS ANGELES
VANIER CENTRE FOR WOMEN	PRISONNAME	VANIER CENTRE FOR WOMEN
FEDERAL CORRECTIONAL INSTITUTION, WILLIAMSBURG	PRISONNAME	FCI WILLIAMSBURG
FEDERAL PRISON CAMP, YANKTON	PRISONNAME	FEDERAL PRISON CAMP, YANKTON
FEDERAL CORRECTIONAL INSTITUTION, ESTILL	PRISONNAME	FEDERAL CORRECTIONAL INSTITUTION, ESTILL
FEDERAL CORRECTIONAL INSTITUTION, OAKDALE	PRISONNAME	FEDERAL CORRECTIONAL INSTITUTION, OAKDALE
FEDERAL CORRECTIONAL INSTITUTION, ALLENWOOD	PRISONNAME	FEDERAL CORRECTIONAL INSTITUTION, ALLENWOOD LOW
FEDERAL DETENTION CENTER, OAKDALE	PRISONNAME	FEDERAL DETENTION CENTER, OAKDALE
FEDERAL CORRECTIONAL INSTITUTION, MEMPHIS	PRISONNAME	FEDERAL CORRECTIONAL INSTITUTION, MEMPHIS
FEDERAL CORRECTIONAL COMPLEX, YAZOO CITY	PRISONNAME	FEDERAL CORRECTIONAL COMPLEX, YAZOO CITY
FEDERAL CORRECTIONAL INSTITUTION, YAZOO CITY	PRISONNAME	FEDERAL CORRECTIONAL INSTITUTION, YAZOO CITY
FEDERAL CORRECTIONAL INSTITUTION, ELKTON	PRISONNAME	FEDERAL CORRECTIONAL INSTITUTION, ELKTON
FEDERAL CORRECTIONAL INSTITUTION, FORT DIX	PRISONNAME	FEDERAL CORRECTIONAL INSTITUTION, FORT DIX
FEDERAL PRISON CAMP, BRYAN	PRISONNAME	FEDERAL PRISON CAMP, BRYAN
FEDERAL PRISON CAMP, DULUTH	PRISONNAME	FEDERAL PRISON CAMP, DULUTH
FEDERAL CORRECTIONAL COMPLEX, PETERSBURG	PRISONNAME	FEDERAL CORRECTIONAL COMPLEX, PETERSBURG
FEDERAL CORRECTIONAL INSTITUTION, GILMER	PRISONNAME	FEDERAL CORRECTIONAL INSTITUTION, GILMER
FEDERAL CORRECTIONAL INSTITUTION, MORGANTOWN	PRISONNAME	FEDERAL CORRECTIONAL INSTITUTION, MORGANTOWN
BORDELAIS CORRECTIONAL FACILITY	PRISONNAME	BORDELAIS CORRECTIONAL FACILITY
FEDERAL CORRECTIONAL INSTITUTION, OXFORD	PRISONNAME	FEDERAL CORRECTIONAL INSTITUTION, OXFORD
FEDERAL CORRECTIONAL INSTITUTION, MANCHESTER	PRISONNAME	FEDERAL CORRECTIONAL INSTITUTION, MANCHESTER
FEDERAL CORRECTIONAL INSTITUTION, BIG SPRING	PRISONNAME	FEDERAL CORRECTIONAL INSTITUTION, BIG SPRING
FEDERAL CORRECTIONAL INSTITUTION, FAIRTON	PRISONNAME	FEDERAL CORRECTIONAL INSTITUTION, FAIRTON
FEDERAL CORRECTIONAL INSTITUTION, MENDOTA	PRISONNAME	FEDERAL CORRECTIONAL INSTITUTION, MENDOTA
FEDERAL CORRECTIONAL INSTITUTION, SCHUYLKILL	PRISONNAME	FEDERAL CORRECTIONAL INSTITUTION, SCHUYLKILL
FEDERAL CORRECTIONAL COMPLEX, ALLENWOOD	PRISONNAME	FEDERAL CORRECTIONAL COMPLEX, ALLENWOOD
FEDERAL CORRECTIONAL INSTITUTION, VICTORVILLE	PRISONNAME	FEDERAL CORRECTIONAL INSTITUTION, VICTORVILLE
FEDERAL CORRECTIONAL COMPLEX, BEAUMONT	PRISONNAME	UNITED STATES PENITENTIARY, BEAUMONT
FEDERAL CORRECTIONAL COMPLEX, COLEMAN	PRISONNAME	FEDERAL CORRECTIONAL COMPLEX, COLEMAN
UNITED STATES PENITENTIARY, VICTORVILLE	PRISONNAME	UNITED STATES PENITENTIARY, VICTORVILLE
FEDERAL CORRECTIONAL COMPLEX, VICTORVILLE	PRISONNAME	FEDERAL CORRECTIONAL COMPLEX, VICTORVILLE
HM PRISON THAMESIDE	PRISONNAME	HMP THAMESIDE
FEDERAL MEDICAL CENTER, BUTNER	PRISONNAME	FEDERAL MEDICAL CENTER, BUTNER
FEDERAL CORRECTIONAL COMPLEX, LOMPOC	PRISONNAME	FEDERAL CORRECTIONAL COMPLEX, LOMPOC
FEDERAL CORRECTIONAL COMPLEX, POLLOCK	PRISONNAME	FEDERAL CORRECTIONAL COMPLEX, POLLOCK
FEDERAL CORRECTIONAL INSTITUTION, POLLOCK	PRISONNAME	FEDERAL CORRECTIONAL INSTITUTION, POLLOCK
FEDERAL CORRECTIONAL COMPLEX, FLORENCE	PRISONNAME	FEDERAL CORRECTIONAL COMPLEX,
FEDERAL CORRECTIONAL COMPLEX, FLORENCE	PRISONNAME	FLORENCE
FEDERAL CORRECTIONAL INSTITUTION, FORREST CITY	PRISONNAME	FEDERAL CORRECTIONAL INSTITUTION, FORREST CITY
FEDERAL CORRECTIONAL INSTITUTION, PETERSBURG	PRISONNAME	FEDERAL CORRECTIONAL INSTITUTION, PETERSBURG
HM PRISON GLENOCHIL	PRISONNAME	HMP GLENOCHIL
HM PRISON SHOTTS	PRISONNAME	HMP SHOTTS
RAJAHMUNDRY CENTRAL PRISON	PRISONNAME	RAJAHMUNDRY CENTRAL PRISON
ALCATRAZ FEDERAL PENITENTIARY	PRISONNAME	UNITED STATES PENITENTIARY,
ALCATRAZ FEDERAL PENITENTIARY	PRISONNAME	ALCATRAZ ISLAND
TORONTO CENTRAL PRISON CHAPEL	PRISONNAME	TORONTO CENTRAL PRISON CHAPEL
KRAKóW-PODGóRZE DETENTION CENTRE	PRISONNAME	KRAKóW-PODGóRZE DETENTION CENTRE
CEBU PROVINCIAL DETENTION AND REHABILITATION CENTER	PRISONNAME	CEBU PROVINCIAL DETENTION AND REHABILITATION CENTER
AVOYELLES CORRECTIONAL CENTER	PRISONNAME	AVOYELLES CORRECTIONAL CENTER
SUNGAI BULOH PRISON	PRISONNAME	SUNGAI BULOH PRISON
SNAKE RIVER CORRECTIONAL INSTITUTION	PRISONNAME	SNAKE RIVER CORRECTIONAL INSTITUTION
DETROIT REENTRY CENTER	PRISONNAME	DETROIT REENTRY CENTER
SUSSEX I STATE PRISON	PRISONNAME	SUSSEX I STATE PRISON
GRANDE CACHE INSTITUTION	PRISONNAME	GRANDE CACHE INSTITUTION
VANCOUVER ISLAND REGIONAL CORRECTIONAL CENTRE	PRISONNAME	VANCOUVER ISLAND REGIONAL CORRECTIONAL CENTRE
HM PRISON FINNAMORE WOOD	PRISONNAME	HMYOI FINNAMORE WOOD
FEDERAL CORRECTIONAL INSTITUTION, ALICEVILLE	PRISONNAME	FEDERAL CORRECTIONAL INSTITUTION, ALICEVILLE
W.J. MAXEY BOYS TRAINING SCHOOL	PRISONNAME	W.J. MAXEY BOYS TRAINING SCHOOL
THE MARSHALSEA, DUBLIN	PRISONNAME	THE CITY MARSHALSEA
HORSENS STATSFæNGSEL	PRISONNAME	HORSENS STATE PRISON
HORSENS STATSFæNGSEL	PRISONNAME	HORSENS PRISON MUSEUM
SOUTH BAY HOUSE OF CORRECTION	PRISONNAME	SOUTH BAY HOUSE OF CORRECTION
NASHUA STREET JAIL	PRISONNAME	NASHUA STREET JAIL
CLEMENTS UNIT	PRISONNAME	WILLIAM P. CLEMENTS UNIT
WESTMORLAND INSTITUTION	PRISONNAME	WESTMORLAND INSTITUTION
ORLEANS PARISH PRISON	PRISONNAME	NEW ORLEANS CITY PRISON
TIPTON CORRECTIONAL CENTER	PRISONNAME	TIPTON CORRECTIONAL CENTER
SUSSEX II STATE PRISON	PRISONNAME	SUSSEX II STATE PRISON
ESTES UNIT	PRISONNAME	SANDERS ESTES UNIT
CURAçAO CENTRE FOR CORRECTION AND DETENTION	PRISONNAME	CURAçAO CENTRE FOR CORRECTION AND DETENTION
BRIDGEPORT CORRECTIONAL CENTER	PRISONNAME	BRIDGEPORT CORRECTIONAL CENTER
BERGIN CORRECTIONAL INSTITUTION	PRISONNAME	BERGIN CORRECTIONAL INSTITUTION
MASSACHUSETTS CORRECTIONAL INSTITUTION - LANCASTER	PRISONNAME	MASSACHUSETTS CORRECTIONAL INSTITUTION-LANCASTER
WETHERSFIELD STATE PRISON	PRISONNAME	WETHERSFIELD STATE PRISON
CENTRAL NEW MEXICO CORRECTIONAL FACILITY	PRISONNAME	CENTRAL NEW MEXICO CORRECTIONAL FACILITY
WEST KIMBERLEY REGIONAL PRISON	PRISONNAME	WEST KIMBERLEY REGIONAL PRISON
ADELANTO DETENTION CENTER	PRISONNAME	ADELANTO DETENTION FACILITY
GIB LEWIS UNIT	PRISONNAME	GIB LEWIS UNIT
KUMANOVO PRISON	PRISONNAME	KUMANOVO PRISON Казнено-поправна установа Куманово
WILLIAM R. BOYD UNIT	PRISONNAME	WILLIAM R. BOYD UNIT
BARRY TELFORD UNIT	PRISONNAME	BARRY B. TELFORD UNIT
DOLPH BRISCOE UNIT	PRISONNAME	DOLPH BRISCOE UNIT
TORA PRISON	PRISONNAME	TORA PRISON
TORA PRISON	PRISONNAME	سجن طرة
AIN AOUDA SECRET PRISON	PRISONNAME	AIN AOUDA
LEE CORRECTIONAL INSTITUTION	PRISONNAME	LEE CORRECTIONAL INSTITUTION
PINCKNEYVILLE CORRECTIONAL CENTER	PRISONNAME	PINCKNEYVILLE CORRECTIONAL CENTER
CROSSROADS CORRECTIONAL FACILITY	PRISONNAME	CROSSROADS CORRECTIONAL FACILITY
CHARLES E. JOHNSON CORRECTIONAL CENTER	PRISONNAME	CHARLES E. JOHNSON CORRECTIONAL CENTER
ECTOR COUNTY CORRECTIONAL CENTER	PRISONNAME	ECTOR COUNTY CORRECTIONAL CENTER
WYOMING STATE PENITENTIARY	PRISONNAME	WYOMING STATE PENITENTIARY
TOPEKA CORRECTIONAL FACILITY	PRISONNAME	TOPEKA CORRECTIONAL FACILITY
DELTA CORRECTIONAL FACILITY	PRISONNAME	DELTA CORRECTIONAL FACILITY
LIMESTONE CORRECTIONAL FACILITY	PRISONNAME	LIMESTONE CORRECTIONAL FACILITY
FARQUHAR CATTLE RANCH	PRISONNAME	FARQUHAR CATTLE RANCH
GOOSE CREEK CORRECTIONAL CENTER	PRISONNAME	GOOSE CREEK CORRECTIONAL CENTER
MOSHANNON VALLEY CORRECTIONAL CENTER	PRISONNAME	MOSHANNON VALLEY CORRECTIONAL CENTER
HANCOCK STATE PRISON	PRISONNAME	HANCOCK STATE PRISON
RIDEAU CORRECTIONAL AND TREATMENT CENTRE	PRISONNAME	RIDEAU CORRECTIONAL AND TREATMENT CENTRE
HAYS STATE PRISON	PRISONNAME	HAYS STATE PRISON
ADAMS COUNTY CORRECTIONAL CENTER	PRISONNAME	ADAMS COUNTY CORRECTIONAL CENTER
LEA COUNTY CORRECTIONAL CENTER	PRISONNAME	LEA COUNTY CORRECTIONAL CENTER
ALEXANDER CORRECTIONAL INSTITUTION	PRISONNAME	ALEXANDER CORRECTIONAL INSTITUTION
ROSS CORRECTIONAL INSTITUTION	PRISONNAME	ROSS CORRECTIONAL INSTITUTION
MANSFIELD CORRECTIONAL INSTITUTION	PRISONNAME	MANSFIELD CORRECTIONAL INSTITUTION
TELFAIR STATE PRISON	PRISONNAME	TELFAIR STATE PRISON
WINN CORRECTIONAL CENTER	PRISONNAME	WINN CORRECTIONAL CENTER
LASALLE DETENTION CENTER	PRISONNAME	LASALLE DETENTION CENTER
BOWDEN INSTITUTION	PRISONNAME	BOWDEN INSTITUTION
STATON CORRECTIONAL FACILITY	PRISONNAME	STATON CORRECTIONAL FACILITY
DRAPER CORRECTIONAL FACILITY	PRISONNAME	DRAPER CORRECTIONAL FACILITY
VENTRESS CORRECTIONAL FACILITY	PRISONNAME	VENTRESS CORRECTIONAL FACILITY
PERRY COUNTY CORRECTIONAL FACILITY	PRISONNAME	PERRY COUNTY CORRECTIONAL FACILITY
BALTIMORE CITY DETENTION CENTER	PRISONNAME	BALTIMORE CITY DETENTION CENTER
MINNESOTA CORRECTIONAL FACILITY – RUSH CITY	PRISONNAME	MINNESOTA CORRECTIONAL FACILITY &NDASH; RUSH CITY
STAFFORD CREEK CORRECTIONS CENTER	PRISONNAME	STAFFORD CREEK CORRECTIONS CENTER
DICK CONNER CORRECTIONAL CENTER	PRISONNAME	DICK CONNER CORRECTIONAL CENTER
NORTH FORK CORRECTIONAL FACILITY	PRISONNAME	NORTH FORK CORRECTIONAL FACILITY
JAMES CRABTREE CORRECTIONAL CENTER	PRISONNAME	JAMES CRABTREE CORRECTIONAL CENTER
JOSEPH HARP CORRECTIONAL CENTER	PRISONNAME	JOSEPH HARP CORRECTIONAL CENTER
CIBOLA COUNTY CORRECTIONAL CENTER	PRISONNAME	CIBOLA COUNTY CORRECTIONAL CENTER
EAGLE MOUNTAIN COMMUNITY CORRECTIONAL FACILITY	PRISONNAME	EAGLE MOUNTAIN COMMUNITY CORRECTIONAL FACILITY
QUEENS DETENTION FACILITY	PRISONNAME	QUEENS DETENTION FACILITY
MOBERLY CORRECTIONAL CENTER	PRISONNAME	MOBERLY CORRECTIONAL CENTER
CROSSROADS CORRECTIONAL CENTER	PRISONNAME	CROSSROADS CORRECTIONAL CENTER
WESTERN MISSOURI CORRECTIONAL CENTER	PRISONNAME	WESTERN MISSOURI CORRECTIONAL CENTER
FARMINGTON CORRECTIONAL CENTER	PRISONNAME	FARMINGTON CORRECTIONAL CENTER
METRIS PRISON	PRISONNAME	METRIS PENITENTIARY
MIMICO CORRECTIONAL CENTRE	PRISONNAME	MIMICO CORRECTIONAL CENTRE
RHODE ISLAND MAXIMUM SECURITY PRISON	PRISONNAME	RHODE ISLAND MAXIMUM SECURITY PRISON
SOUTH LOUISIANA CORRECTIONAL FACILITY	PRISONNAME	SOUTH LOUISIANA CORRECTIONAL FACILITY
HARDEMAN COUNTY CORRECTIONAL CENTER	PRISONNAME	HARDEMAN COUNTY CORRECTIONAL FACILITY
RIVERS CORRECTIONAL INSTITUTION	PRISONNAME	RIVERS CORRECTIONAL INSTITUTION
BRANCHVILLE CORRECTIONAL FACILITY	PRISONNAME	BRANCHVILLE CORRECTIONAL FACILITY
CHESHIRE CORRECTIONAL INSTITUTION	PRISONNAME	CHESHIRE CORRECTIONAL INSTITUTION
ROBINSON CORRECTIONAL INSTITUTION	PRISONNAME	ROBINSON CORRECTIONAL INSTITUTION
CORRIGAN-RADGOWSKI CORRECTIONAL CENTER	PRISONNAME	CORRIGAN-RADGOWSKI CORRECTIONAL CENTER
MACDOUGALL-WALKER CORRECTIONAL INSTITUTION	PRISONNAME	MACDOUGALL-WALKER CORRECTIONAL INSTITUTION
SKYLINE CORRECTIONAL CENTER	PRISONNAME	SKYLINE CORRECTIONAL FACILITY
SUWANNEE CORRECTIONAL INSTITUTION	PRISONNAME	SUWANNEE CORRECTIONAL INSTITUTION
EVERGLADES CORRECTIONAL INSTITUTION	PRISONNAME	EVERGLADES CORRECTIONAL INSTITUTION
LAWTEY CORRECTIONAL INSTITUTION	PRISONNAME	LAWTEY CORRECTIONAL INSTITUTION
DOOLY STATE PRISON	PRISONNAME	DOOLY STATE PRISON
COLUMBUS CORRECTIONAL INSTITUTION	PRISONNAME	COLUMBUS CORRECTIONAL INSTITUTION
RAMO VERDE PRISON	PRISONNAME	RAMO VERDE PRISON
WALLACE PACK UNIT	PRISONNAME	WALLACE PACK UNIT
DADE CORRECTIONAL INSTITUTION	PRISONNAME	DADE CORRECTIONAL INSTITUTION
OULU PRISON	PRISONNAME	OULU PRISON
COLLINS BAY INSTITUTION	PRISONNAME	COLLINS BAY INSTITUTION
MILL POINT FEDERAL PRISON	PRISONNAME	MILL POINT FEDERAL PRISON
ALGOA CORRECTIONAL CENTER	PRISONNAME	ALGOA CORRECTIONAL CENTER
WEST CARROLL PARISH DETENTION CENTER	PRISONNAME	WEST CARROLL PARISH DETENTION CENTER
EDMONTON REMAND CENTRE	PRISONNAME	EDMONTON REMAND CENTRE
GRANT PARISH DETENTION CENTER	PRISONNAME	GRANT PARISH DETENTION CENTER
EAST CARROLL DETENTION CENTER	PRISONNAME	EAST CARROLL PARISH DETENTION CENTER
ALLEN CORRECTIONAL CENTER	PRISONNAME	ALLEN CORRECTIONAL CENTER
GEORGE W. HILL CORRECTIONAL FACILITY	PRISONNAME	GEORGE W. HILL CORRECTIONAL FACILITY
STATE CORRECTIONAL INSTITUTION – BENNER TOWNSHIP	PRISONNAME	STATE CORRECTIONAL INSTITUTION – BENNER TOWNSHIP
SOUTH TEXAS FAMILY RESIDENTIAL CENTER	PRISONNAME	SOUTH TEXAS FAMILY RESIDENTIAL CENTER
WOODLAND CENTER CORRECTIONAL FACILITY	PRISONNAME	WOODLAND CENTER CORRECTIONAL FACILITY
DETROIT DETENTION CENTER	PRISONNAME	DETROIT DETENTION CENTER
CENTRAL MICHIGAN CORRECTIONAL FACILITY	PRISONNAME	CENTRAL MICHIGAN CORRECTIONAL FACILITY
BEAVER CREEK INSTITUTION	PRISONNAME	BEAVER CREEK INSTITUTION
LOIS M. DEBERRY SPECIAL NEEDS FACILITY	PRISONNAME	LOIS M. DEBERRY SPECIAL NEEDS FACILITY
WANDOO REINTEGRATION FACILITY	PRISONNAME	WANDOO REINTEGRATION FACILITY
TABOR CITY CORRECTIONAL INSTITUTION	PRISONNAME	TABOR CITY CORRECTIONAL INSTITUTION
CORRECTIONAL INSTITUTION FOR WOMEN	PRISONNAME	CORRECTIONAL INSTITUTION FOR WOMEN
WILKINSON COUNTY CORRECTIONAL CENTER	PRISONNAME	WILKINSON COUNTY CORRECTIONAL CENTER
SCHRASSIG PRISON	PRISONNAME	SCHRASSIG PRISON
ALGER CORRECTIONAL FACILITY	PRISONNAME	ALGER CORRECTIONAL FACILITY
BARAGA CORRECTIONAL FACILITY	PRISONNAME	BARAGA CORRECTIONAL FACILITY
DETROIT HOUSE OF CORRECTION	PRISONNAME	DETROIT HOUSE OF CORRECTION
THUMB CORRECTIONAL FACILITY	PRISONNAME	THUMB CORRECTIONAL FACILITY
WEST SHORELINE CORRECTIONAL FACILITY	PRISONNAME	WEST SHORELINE CORRECTIONAL FACILITY
EARNEST C. BROOKS CORRECTIONAL FACILITY	PRISONNAME	EARNEST C. BROOKS CORRECTIONAL FACILITY
ST. LOUIS CORRECTIONAL FACILITY	PRISONNAME	ST. LOUIS CORRECTIONAL FACILITY
CARSON CITY CORRECTIONAL FACILITY	PRISONNAME	CARSON CITY CORRECTIONAL FACILITY
FLORENCE CRANE CORRECTIONAL FACILITY	PRISONNAME	FLORENCE CRANE CORRECTIONAL FACILITY
GUS HARRISON CORRECTIONAL FACILITY	PRISONNAME	GUS HARRISON CORRECTIONAL FACILITY
SAGINAW CORRECTIONAL FACILITY	PRISONNAME	SAGINAW CORRECTIONAL FACILITY
HARSUL CENTRAL JAIL	PRISONNAME	HARSUL CENTRAL JAIL
HARSUL CENTRAL JAIL	PRISONNAME	हर्सूल मध्यवर्ती कारागृह
BELLAMY CREEK CORRECTIONAL FACILITY	PRISONNAME	BELLAMY CREEK CORRECTIONAL FACILITY
FEDERAL CORRECTIONAL INSTITUTION, HAZELTON	PRISONNAME	FEDERAL CORRECTIONAL INSTITUTION, HAZELTON
JESSUP CORRECTIONAL INSTITUTION	PRISONNAME	JESSUP CORRECTIONAL INSTITUTION
BROCKBRIDGE CORRECTIONAL FACILITY	PRISONNAME	BROCKBRIDGE CORRECTIONAL FACILITY
ROXBURY CORRECTIONAL INSTITUTION	PRISONNAME	ROXBURY CORRECTIONAL INSTITUTION
MARYLAND CORRECTIONAL INSTITUTION FOR WOMEN	PRISONNAME	MARYLAND CORRECTIONAL INSTITUTION FOR WOMEN
D.C. JAIL	PRISONNAME	DISTRICT OF COLUMBIA JAIL
KALITI PRISON	PRISONNAME	KALITI PRISON
KINROSS CORRECTIONAL FACILITY	PRISONNAME	KINROSS CORRECTIONAL FACILITY
MACOMB CORRECTIONAL FACILITY	PRISONNAME	MACOMB CORRECTIONAL FACILITY
FUCHū PRISON	PRISONNAME	FUCHū PRISON
WEHRMACHT PRISON ANKLAM	PRISONNAME	WEHRMACHT PRISON ANKLAM
MAAFUSHI PRISON	PRISONNAME	MAAFUSHI PRISON
OSBORN CORRECTIONAL INSTITUTION	PRISONNAME	OSBORN CORRECTIONAL INSTITUTION
BLEGDAMSVEJ PRISON	PRISONNAME	BLEGDAMSVEJ PRISON
OUACHITA RIVER UNIT	PRISONNAME	OUACHITA RIVER UNIT
CIMARRON CORRECTIONAL FACILITY	PRISONNAME	CIMARRON CORRECTIONAL FACILITY
DANVILLE CORRECTIONAL CENTER	PRISONNAME	DANVILLE CORRECTIONAL CENTER
HILL CORRECTIONAL CENTER	PRISONNAME	HILL CORRECTIONAL CENTER
LAWRENCE CORRECTIONAL CENTER	PRISONNAME	LAWRENCE CORRECTIONAL CENTER
MONTGOMERY WOMEN'S FACILITY	PRISONNAME	MONTGOMERY WOMEN'S FACILITY
MASSACHUSETTS TREATMENT CENTER	PRISONNAME	MASSACHUSETTS TREATMENT CENTER
CRYSTAL CITY CORRECTIONAL CENTER	PRISONNAME	CRYSTAL CITY CORRECTIONAL CENTER
TOPO CHICO	PRISONNAME	TOPO CHICO
CENTRAL JUVENILE HALL	PRISONNAME	CENTRAL JUVENILE HALL
DUNDALK GAOL	PRISONNAME	DUNDALK GAOL
DEFENCE FORCE CORRECTIONAL ESTABLISHMENT	PRISONNAME	DEFENCE FORCE CORRECTIONAL ESTABLISHMENT
WASHINGTON CORRECTIONS CENTER	PRISONNAME	WASHINGTON CORRECTIONS CENTER
WASHINGTON CORRECTIONS CENTER FOR WOMEN	PRISONNAME	WASHINGTON CORRECTIONS CENTER FOR WOMEN
KANSAS CITY REENTRY CENTER	PRISONNAME	KANSAS CITY REENTRY CENTER
LINDA WOODMAN STATE JAIL	PRISONNAME	LINDA WOODMAN UNIT
SCOTLAND CORRECTIONAL INSTITUTION	PRISONNAME	SCOTLAND CORRECTIONAL INSTITUTION
LANESBORO CORRECTIONAL INSTITUTION	PRISONNAME	LANESBORO CORRECTIONAL INSTITUTION
BERTIE CORRECTIONAL INSTITUTION	PRISONNAME	BERTIE CORRECTIONAL INSTITUTION
BROWN CREEK CORRECTIONAL INSTITUTION	PRISONNAME	BROWN CREEK CORRECTIONAL INSTITUTION
KITALYA MAXIMUM SECURITY PRISON	PRISONNAME	KITALYA MAXIMUM SECURITY PRISON
ESCUELA INDUSTRIAL PARA MUJERES VEGA ALTA	PRISONNAME	ESCUELA INDUSTRIAL PARA MUJERES
DODGE STATE PRISON	PRISONNAME	DODGE STATE PRISON
PHILLIPS STATE PRISON	PRISONNAME	PHILLIPS STATE PRISON
ROGERS STATE PRISON	PRISONNAME	ROGERS STATE PRISON
FLORENCE CORRECTIONAL CENTER	PRISONNAME	FLORENCE CORRECTIONAL CENTER
NORTH LAKE CORRECTIONAL FACILITY	PRISONNAME	NORTH LAKE CORRECTIONAL FACILITY
RIO GRANDE DETENTION CENTER	PRISONNAME	RIO GRANDE DETENTION CENTER
WILLACY COUNTY REGIONAL DETENTION CENTER	PRISONNAME	WILLACY COUNTY REGIONAL DETENTION CENTER
WILLACY COUNTY STATE JAIL	PRISONNAME	WILLACY COUNTY STATE JAIL
BRADSHAW STATE JAIL	PRISONNAME	BRADSHAW STATE JAIL
ROGELIO SANCHEZ STATE JAIL	PRISONNAME	ROGELIO SANCHEZ STATE JAIL
ST. CLAIR CORRECTIONAL FACILITY	PRISONNAME	ST. CLAIR CORRECTIONAL FACILITY
ELMORE CORRECTIONAL FACILITY	PRISONNAME	ELMORE CORRECTIONAL FACILITY
EASTERLING CORRECTIONAL FACILITY	PRISONNAME	EASTERLING CORRECTIONAL FACILITY
STEWART DETENTION CENTER	PRISONNAME	STEWART DETENTION CENTER
BARTLETT STATE JAIL	PRISONNAME	BARTLETT STATE JAIL
BENT COUNTY CORRECTIONAL FACILITY	PRISONNAME	BENT COUNTY CORRECTIONAL FACILITY
WESTERN CORRECTIONAL INSTITUTION	PRISONNAME	WESTERN CORRECTIONAL INSTITUTION
NOBLE CORRECTIONAL INSTITUTION	PRISONNAME	NOBLE CORRECTIONAL INSTITUTION
TRUMBULL CORRECTIONAL INSTITUTION	PRISONNAME	TRUMBULL CORRECTIONAL INSTITUTION
LAKE ERIE CORRECTIONAL INSTITUTION	PRISONNAME	LAKE ERIE CORRECTIONAL INSTITUTION
MADISON CORRECTIONAL INSTITUTION	PRISONNAME	MADISON CORRECTIONAL INSTITUTION
HOLMES CORRECTIONAL INSTITUTION	PRISONNAME	HOLMES CORRECTIONAL INSTITUTION
COLUMBIA CORRECTIONAL INSTITUTION	PRISONNAME	COLUMBIA CORRECTIONAL INSTITUTION
MAYO CORRECTIONAL INSTITUTION ANNEX	PRISONNAME	MAYO CORRECTIONAL INSTITUTION ANNEX
BAY CORRECTIONAL FACILITY	PRISONNAME	BAY CORRECTIONAL FACILITY
TOMOKA CORRECTIONAL INSTITUTION	PRISONNAME	TOMOKA CORRECTIONAL INSTITUTION
GRACEVILLE CORRECTIONAL FACILITY	PRISONNAME	GRACEVILLE CORRECTIONAL FACILITY
BLACKWATER RIVER CORRECTIONAL FACILITY	PRISONNAME	BLACKWATER RIVER CORRECTIONAL FACILITY
GULF CORRECTIONAL INSTITUTION	PRISONNAME	GULF CORRECTIONAL INSTITUTION
LAKE CORRECTIONAL INSTITUTION	PRISONNAME	LAKE CORRECTIONAL INSTITUTION
LAKE CITY CORRECTIONAL FACILITY	PRISONNAME	LAKE CITY CORRECTIONAL FACILITY
SUMTER CORRECTIONAL INSTITUTION	PRISONNAME	SUMTER CORRECTIONAL INSTITUTION
POLK CORRECTIONAL INSTITUTION	PRISONNAME	POLK CORRECTIONAL INSTITUTION
CHARLOTTE CORRECTIONAL INSTITUTION	PRISONNAME	CHARLOTTE CORRECTIONAL INSTITUTION
CALHOUN CORRECTIONAL INSTITUTION	PRISONNAME	CALHOUN CORRECTIONAL INSTITUTION
WALTON CORRECTIONAL INSTITUTION	PRISONNAME	WALTON CORRECTIONAL INSTITUTION
MOORE HAVEN CORRECTIONAL FACILITY	PRISONNAME	MOORE HAVEN CORRECTIONAL FACILITY
JEFFERSON CORRECTIONAL INSTITUTION	PRISONNAME	JEFFERSON CORRECTIONAL INSTITUTION
APALACHEE CORRECTIONAL INSTITUTION, EAST UNIT	PRISONNAME	APALACHEE CORRECTIONAL INSTITUTION, EAST UNIT
LIBERTY CORRECTIONAL INSTITUTION	PRISONNAME	LIBERTY CORRECTIONAL INSTITUTION
BAKER CORRECTIONAL INSTITUTION	PRISONNAME	BAKER CORRECTIONAL INSTITUTION
FRANKLIN CORRECTIONAL INSTITUTION	PRISONNAME	FRANKLIN CORRECTIONAL INSTITUTION
OKEECHOBEE CORRECTIONAL INSTITUTION	PRISONNAME	OKEECHOBEE CORRECTIONAL INSTITUTION
MARTIN CORRECTIONAL INSTITUTION	PRISONNAME	MARTIN CORRECTIONAL INSTITUTION
NORTH CENTRAL CORRECTIONAL COMPLEX	PRISONNAME	NORTH CENTRAL CORRECTIONAL INSTITUTION
VANDALIA CORRECTIONAL CENTER	PRISONNAME	VANDALIA CORRECTIONAL INSTITUTION
ILLINOIS RIVER CORRECTIONAL CENTER	PRISONNAME	ILLINOIS RIVER CORRECTIONAL INSTITUTION
VIENNA CORRECTIONAL CENTER	PRISONNAME	VIENNA CORRECTIONAL INSTITUTION
SHAWNEE CORRECTIONAL CENTER	PRISONNAME	SHAWNEE CORRECTIONAL CENTER
TAYLORVILLE CORRECTIONAL CENTER	PRISONNAME	TAYLORVILLE CORRECTIONAL CENTER
AIRWAY HEIGHTS CORRECTIONS CENTER	PRISONNAME	AIRWAY HEIGHTS CORRECTIONS CENTER
ROBINSON CORRECTIONAL CENTER	PRISONNAME	ROBINSON CORRECTIONAL CENTER
CENTRALIA CORRECTIONAL CENTER	PRISONNAME	CENTRALIA CORRECTIONAL CENTER
WESTERN ILLINOIS CORRECTIONAL CENTER	PRISONNAME	WESTERN ILLINOIS CORRECTIONAL CENTER
BIG MUDDY RIVER CORRECTIONAL CENTER	PRISONNAME	BIG MUDDY RIVER CORRECTIONAL CENTER
CAYUGA CORRECTIONAL FACILITY	PRISONNAME	CAYUGA CORRECTIONAL FACILITY
GOUVERNEUR CORRECTIONAL FACILITY	PRISONNAME	GOUVERNEUR CORRECTIONAL FACILITY
FOX LAKE CORRECTIONAL INSTITUTION	PRISONNAME	FOX LAKE CORRECTIONAL INSTITUTION
EASTERN CORRECTIONAL INSTITUTION	PRISONNAME	EASTERN CORRECTIONAL INSTITUTION
GUADALUPE COUNTY CORRECTIONAL FACILITY	PRISONNAME	GUADALUPE COUNTY CORRECTIONAL FACILITY
OTERO COUNTY PRISON FACILITY	PRISONNAME	OTERO COUNTY PRISON FACILITY
SHERIDAN CORRECTIONAL CENTER	PRISONNAME	SHERIDAN CORRECTIONAL CENTER
EAST MOLINE CORRECTIONAL CENTER	PRISONNAME	EAST MOLINE CORRECTIONAL CENTER
LINCOLN CORRECTIONAL CENTER	PRISONNAME	LINCOLN CORRECTIONAL CENTER
JACKSONVILLE CORRECTIONAL CENTER	PRISONNAME	JACKSONVILLE CORRECTIONAL CENTER
DILLWYN CORRECTIONAL CENTER	PRISONNAME	DILLWYN CORRECTIONAL CENTER
HAYNESVILLE CORRECTIONAL CENTER	PRISONNAME	HAYNESVILLE CORRECTIONAL CENTER
LUNENBURG CORRECTIONAL CENTER	PRISONNAME	LUNENBURG CORRECTIONAL CENTER
INDIAN CREEK CORRECTIONAL CENTER	PRISONNAME	INDIAN CREEK CORRECTIONAL CENTER
DEERFIELD CORRECTIONAL CENTER	PRISONNAME	DEERFIELD CORRECTIONAL CENTER
HUTCHINS STATE JAIL	PRISONNAME	HUTCHINS STATE JAIL
LINDSEY STATE JAIL	PRISONNAME	LINDSEY STATE JAIL
LIEBER CORRECTIONAL INSTITUTION	PRISONNAME	LIEBER CORRECTIONAL INSTITUTION
TYGER RIVER CORRECTIONAL INSTITUTION	PRISONNAME	TYGER RIVER CORRECTIONAL INSTITUTION
TURBEVILLE CORRECTIONAL INSTITUTION	PRISONNAME	TURBEVILLE CORRECTIONAL INSTITUTION
GRIMES UNIT	PRISONNAME	GRIMES UNIT
WILLIAM S. KEY CORRECTIONAL CENTER	PRISONNAME	WILLIAM S. KEY CORRECTIONAL CENTER
LAWTON CORRECTIONAL FACILITY	PRISONNAME	LAWTON CORRECTIONAL CENTER
LEXINGTON ASSESSMENT AND RECEPTION CENTER	PRISONNAME	LEXINGTON ASSESSMENT AND RECEPTION CENTER
AUGUSTA CORRECTIONAL CENTER	PRISONNAME	AUGUSTA CORRECTIONAL CENTER
COFFEEWOOD CORRECTIONAL CENTER	PRISONNAME	COFFEEWOOD CORRECTIONAL CENTER
RIVER NORTH CORRECTIONAL CENTER	PRISONNAME	RIVER NORTH CORRECTIONAL CENTER
LAKELAND CORRECTIONAL FACILITY	PRISONNAME	LAKELAND CORRECTIONAL FACILITY
NEWBERRY CORRECTIONAL FACILITY	PRISONNAME	NEWBERRY CORRECTIONAL FACILITY
OJIBWAY CORRECTIONAL FACILITY	PRISONNAME	OJIBWAY CORRECTIONAL FACILITY
PARNALL CORRECTIONAL FACILITY	PRISONNAME	PARNALL CORRECTIONAL FACILITY
G. ROBERT COTTON CORRECTIONAL FACILITY	PRISONNAME	G. ROBERT COTTON CORRECTIONAL FACILITY
CHARLES EGELER RECEPTION AND GUIDANCE CENTER	PRISONNAME	CHARLES EGELER RECEPTION AND GUIDANCE CENTER
CENTRAL ARIZONA CORRECTIONAL FACILITY	PRISONNAME	CENTRAL ARIZONA CORRECTIONAL FACILITY
RED ROCK CORRECTIONAL CENTER	PRISONNAME	RED ROCK CORRECTIONAL FACILITY
CROWLEY COUNTY CORRECTIONAL FACILITY	PRISONNAME	CROWLEY COUNTY CORRECTIONAL FACILITY
HARDEE CORRECTIONAL INSTITUTION	PRISONNAME	HARDEE CORRECTIONAL INSTITUTION
CENTURY CORRECTIONAL INSTITUTION	PRISONNAME	CENTURY CORRECTIONAL INSTITUTION
CROSS CITY CORRECTIONAL INSTITUTION	PRISONNAME	CROSS CITY CORRECTIONAL INSTITUTION
NORTHWEST FLORIDA RECEPTION CENTER	PRISONNAME	NORTHWEST FLORIDA RECEPTION CENTER
SANTA ROSA CORRECTIONAL INSTITUTION	PRISONNAME	SANTA ROSA CORRECTIONAL INSTITUTION
SOUTH BAY CORRECTIONAL FACILITY	PRISONNAME	SOUTH BAY CORRECTIONAL FACILITY
CENTRAL FLORIDA RECEPTION CENTER	PRISONNAME	CENTRAL FLORIDA RECEPTION CENTER
KYLE UNIT	PRISONNAME	KYLE UNIT
BRIDGEPORT UNIT	PRISONNAME	BRIDGEPORT UNIT
DIBOLL UNIT	PRISONNAME	DIBOLL UNIT
TAYLOR CORRECTIONAL INSTITUTION	PRISONNAME	TAYLOR CORRECTIONAL INSTITUTION
DESOTO ANNEX	PRISONNAME	DESOTO ANNEX
HAMILTON CORRECTIONAL INSTITUTION	PRISONNAME	HAMILTON CORRECTIONAL INSTITUTION
GADSDEN CORRECTIONAL FACILITY	PRISONNAME	GADSDEN CORRECTIONAL FACILITY
RECEPTION AND MEDICAL CENTER	PRISONNAME	RECEPTION AND MEDICAL CENTER
CHILLICOTHE CORRECTIONAL CENTER	PRISONNAME	CHILLICOTHE CORRECTIONAL CENTER
LAWRENCEVILLE CORRECTIONAL CENTER	PRISONNAME	LAWRENCEVILLE CORRECTIONAL CENTER
EVANS CORRECTIONAL INSTITUTION	PRISONNAME	EVANS CORRECTIONAL INSTITUTION
ALLENDALE CORRECTIONAL INSTITUTION	PRISONNAME	ALLENDALE CORRECTIONAL INSTITUTION
KERSHAW CORRECTIONAL INSTITUTION	PRISONNAME	KERSHAW CORRECTIONAL INSTITUTION
KIRKLAND CORRECTIONAL INSTITUTION	PRISONNAME	KIRKLAND CORRECTIONAL INSTITUTION
MCCORMICK CORRECTIONAL INSTITUTION	PRISONNAME	MCCORMICK CORRECTIONAL INSTITUTION
RIDGELAND CORRECTIONAL INSTITUTION	PRISONNAME	RIDGELAND CORRECTIONAL INSTITUTION
BELMONT CORRECTIONAL INSTITUTION	PRISONNAME	BELMONT CORRECTIONAL INSTITUTION
RICHLAND CORRECTIONAL INSTITUTION	PRISONNAME	RICHLAND CORRECTIONAL INSTITUTION
GRAFTON CORRECTIONAL INSTITUTION	PRISONNAME	GRAFTON CORRECTIONAL INSTITUTION
TOLEDO CORRECTIONAL INSTITUTION	PRISONNAME	TOLEDO CORRECTIONAL INSTITUTION
SMITH STATE PRISON	PRISONNAME	SMITH STATE PRISON
VALDOSTA STATE PRISON	PRISONNAME	VALDOSTA STATE PRISON
WARE STATE PRISON	PRISONNAME	WARE STATE PRISON
WILCOX STATE PRISON	PRISONNAME	WILCOX STATE PRISON
COFFEE CORRECTIONAL FACILITY	PRISONNAME	COFFEE CORRECTIONAL FACILITY
JENKINS CORRECTIONAL FACILITY	PRISONNAME	JENKINS CORRECTIONAL FACILITY
WHEELER CORRECTIONAL FACILITY	PRISONNAME	WHEELER CORRECTIONAL FACILITY
RIVERBEND CORRECTIONAL FACILITY	PRISONNAME	RIVERBEND CORRECTIONAL FACILITY
ARKANSAS VALLEY CORRECTIONAL FACILITY	PRISONNAME	ARKANSAS VALLEY CORRECTIONAL FACILITY
BUENA VISTA CORRECTIONAL FACILITY	PRISONNAME	BUENA VISTA CORRECTIONAL FACILITY
KIT CARSON CORRECTIONAL CENTER	PRISONNAME	KIT CARSON CORRECTIONAL CENTER
YORK CORRECTIONAL INSTITUTION	PRISONNAME	YORK CORRECTIONAL INSTITUTION
WILLARD-CYBULSKI CORRECTIONAL INSTITUTION	PRISONNAME	WILLARD-CYBULSKI CORRECTIONAL INSTITUTION
HOWARD R. YOUNG CORRECTIONAL INSTITUTION	PRISONNAME	HOWARD R. YOUNG CORRECTIONAL INSTITUTION
SUSSEX CORRECTIONAL INSTITUTION	PRISONNAME	SUSSEX CORRECTIONAL INSTITUTION
JACKSON CORRECTIONAL INSTITUTION	PRISONNAME	JACKSON CORRECTIONAL INSTITUTION
SOUTH FLORIDA RECEPTION CENTER	PRISONNAME	SOUTH FLORIDA RECEPTION CENTER
FULTON RECEPTION AND DIAGNOSTIC CENTER	PRISONNAME	FULTON RECEPTION AND DIAGNOSTIC CENTER
ELOY DETENTION CENTER	PRISONNAME	ELOY DETENTION CENTER
LA PALMA CORRECTIONAL FACILITY	PRISONNAME	LA PALMA CORRECTIONAL FACILITY
CENTRAL ARIZONA DETENTION CENTER	PRISONNAME	CENTRAL ARIZONA DETENTION CENTER
TAFT CORRECTIONAL INSTITUTION	PRISONNAME	TAFT CORRECTIONAL INSTITUTION
EAST TEXAS MULTI-USE FACILITY	PRISONNAME	EAST TEXAS MULTI-USE FACILITY
EDEN DETENTION CENTER	PRISONNAME	EDEN DETENTION CENTER
MCRAE CORRECTIONAL INSTITUTION	PRISONNAME	MCRAE CORRECTIONAL INSTITUTION
CALIFORNIA CITY CORRECTIONAL CENTER	PRISONNAME	CALIFORNIA CITY CORRECTIONAL CENTER
GOLDEN STATE MEDIUM COMMUNITY CORRECTIONAL FACILITY	PRISONNAME	GOLDEN STATE MEDIUM COMMUNITY CORRECTIONAL FACILITY
FLORIDA WOMEN'S RECEPTION CENTER	PRISONNAME	FLORIDA WOMEN'S RECEPTION CENTER
NORTHEAST NEW MEXICO DETENTION FACILITY	PRISONNAME	NORTHEAST NEW MEXICO DETENTION FACILITY
MISSOURI EASTERN CORRECTIONAL CENTER	PRISONNAME	MISSOURI EASTERN CORRECTIONAL CENTER
SOUTH CENTRAL CORRECTIONAL CENTER	PRISONNAME	SOUTH CENTRAL CORRECTIONAL CENTER
MADISON CORRECTIONAL INSTITUTION	PRISONNAME	MADISON CORRECTIONAL INSTITUTION
MARION CORRECTIONAL INSTITUTION	PRISONNAME	MARION CORRECTIONAL INSTITUTION
MARION CORRECTIONAL INSTITUTION	PRISONNAME	MARION CORRECTIONAL INSTITUTION
JAMES LYNAUGH UNIT	PRISONNAME	JAMES LYNAUGH UNIT
CLARENCE N. STEVENSON UNIT	PRISONNAME	CLARENCE N. STEVENSON UNIT
RUBEN M. TORRES UNIT	PRISONNAME	RUBEN M. TORRES UNIT
NATHANIEL J. NEAL UNIT	PRISONNAME	NATHANIEL J. NEAL UNIT
RUFE JORDAN UNIT	PRISONNAME	RUFE JORDAN UNIT
T.L. ROACH JR. UNIT	PRISONNAME	T.L. ROACH JR. UNIT
PRICE DANIEL UNIT	PRISONNAME	PRICE DANIEL UNIT
JIM RUDD UNIT	PRISONNAME	JIM RUDD UNIT
PRESTON E. SMITH UNIT	PRISONNAME	PRESTON E. SMITH UNIT
DANIEL WEBSTER WALLACE UNIT	PRISONNAME	DANIEL WEBSTER WALLACE UNIT
O.L. LUTHER UNIT	PRISONNAME	O.L. LUTHER UNIT
GUERRERO CORRECTIONAL INSTITUTION	PRISONNAME	GUERRERO CORRECTIONAL INSTITUTION
STANLEY CORRECTIONAL INSTITUTION	PRISONNAME	STANLEY CORRECTIONAL INSTITUTION
NEW LISBON CORRECTIONAL INSTITUTION	PRISONNAME	NEW LISBON CORRECTIONAL INSTITUTION
RACINE CORRECTIONAL INSTITUTION	PRISONNAME	RACINE CORRECTIONAL INSTITUTION
MILWAUKEE SECURE DETENTION FACILITY	PRISONNAME	MILWAUKEE SECURE DETENTION FACILITY
GREENE CORRECTIONAL FACILITY	PRISONNAME	GREENE CORRECTIONAL FACILITY
MICHIGAN REFORMATORY	PRISONNAME	MICHIGAN REFORMATORY
COOPER STREET CORRECTIONAL FACILITY	PRISONNAME	COOPER STREET CORRECTIONAL FACILITY
TWO RIVERS CORRECTIONAL INSTITUTION	PRISONNAME	TWO RIVERS CORRECTIONAL INSTITUTION
DEER RIDGE CORRECTIONAL INSTITUTION	PRISONNAME	DEER RIDGE CORRECTIONAL INSTITUTION
SOUTHERN DESERT CORRECTIONAL CENTER	PRISONNAME	SOUTHERN DESERT CORRECTIONAL CENTER
NEW MEXICO WOMEN'S CORRECTIONAL FACILITY	PRISONNAME	NEW MEXICO WOMEN'S CORRECTIONAL FACILITY
GREAT PLAINS CORRECTIONAL INSTITUTION	PRISONNAME	GREAT PLAINS CORRECTIONAL INSTITUTION
GOODWOOD CENTRE OF EXCELLENCE	PRISONNAME	GOODWOOD CENTRE OF EXCELLENCE
JOHN J. MORAN MEDIUM SECURITY FACILITY	PRISONNAME	JOHN J. MORAN MEDIUM SECURITY FACILITY
ANTHONY P. TRAVISONO INTAKE SERVICE CENTER	PRISONNAME	ANTHONY P. TRAVISONO INTAKE SERVICE CENTER
D. RAY JAMES CORRECTIONAL INSTITUTION	PRISONNAME	D. RAY JAMES CORRECTIONAL INSTITUTION
GILES W. DALBY CORRECTIONAL INSTITUTION	PRISONNAME	GILES W. DALBY CORRECTIONAL INSTITUTION
BIG SPRING CORRECTIONAL CENTER	PRISONNAME	BIG SPRING CORRECTIONAL CENTER
VAL VERDE CORRECTIONAL FACILITY	PRISONNAME	VAL VERDE CORRECTIONAL FACILITY
NEWTON COUNTY CORRECTIONAL CENTER	PRISONNAME	NEWTON COUNTY CORRECTIONAL CENTER
MARYLAND CORRECTIONAL INSTITUTION - JESSUP	PRISONNAME	MARYLAND CORRECTIONAL INSTITUTION - JESSUP
MARYLAND CORRECTIONAL INSTITUTION - HAGERSTOWN	PRISONNAME	MARYLAND CORRECTIONAL INSTITUTION - HAGERSTOWN
NORTHEAST CORRECTIONAL CENTER	PRISONNAME	NORTHEAST CORRECTIONAL CENTER
SOUTHEAST CORRECTIONAL CENTER	PRISONNAME	SOUTHEAST CORRECTIONAL CENTER
CENTRAL RECEPTION AND ASSIGNMENT FACILITY	PRISONNAME	CENTRAL RECEPTION AND ASSIGNMENT FACILITY
GARDEN STATE YOUTH CORRECTIONAL FACILITY	PRISONNAME	GARDEN STATE YOUTH CORRECTIONAL FACILITY
MID-STATE CORRECTIONAL FACILITY	PRISONNAME	MID-STATE CORRECTIONAL FACILITY
MOUNTAINVIEW YOUTH CORRECTIONAL FACILITY	PRISONNAME	MOUNTAINVIEW YOUTH CORRECTIONAL FACILITY
LIVINGSTON CORRECTIONAL FACILITY	PRISONNAME	LIVINGSTON CORRECTIONAL FACILITY
MOHAWK CORRECTIONAL FACILITY	PRISONNAME	MOHAWK CORRECTIONAL FACILITY
TARTU VANGLA	PRISONNAME	TARTU VANGLA
BLEDSOE COUNTY CORRECTIONAL COMPLEX	PRISONNAME	BLEDSOE COUNTY CORRECTIONAL COMPLEX
TROUSDALE TURNER CORRECTIONAL CENTER	PRISONNAME	TROUSDALE TURNER CORRECTIONAL CENTER
LOCKHART UNIT	PRISONNAME	LOCKHART UNIT
BILLY MOORE UNIT	PRISONNAME	BILLY MOORE UNIT
DAYTON CORRECTIONAL INSTITUTION	PRISONNAME	DAYTON CORRECTIONAL INSTITUTION
CORRECTIONAL RECEPTION CENTER	PRISONNAME	CORRECTIONAL RECEPTION CENTER
TURNEY CENTER INDUSTRIAL COMPLEX	PRISONNAME	TURNEY CENTER INDUSTRIAL COMPLEX
NORTHWEST CORRECTIONAL COMPLEX	PRISONNAME	NORTHWEST CORRECTIONAL COMPLEX
NORTHEAST CORRECTIONAL COMPLEX	PRISONNAME	NORTHEAST CORRECTIONAL COMPLEX
CITRUS COUNTY DETENTION FACILITY	PRISONNAME	CITRUS COUNTY DETENTION FACILITY
SOUTH TEXAS DETENTION FACILITY	PRISONNAME	SOUTH TEXAS DETENTION FACILITY
MARSHALL COUNTY CORRECTIONAL FACILITY	PRISONNAME	MARSHALL COUNTY CORRECTIONAL CENTER
PAGLIARELLI	PRISONNAME	PAGLIARELLI
HERITAGE TRAIL CORRECTIONAL FACILITY	PRISONNAME	HERITAGE TRAIL CORRECTIONAL FACILITY
