COLUMBIA UNIVERSITY	PROVOST	JOHN HENRY COATSWORTH
STANFORD UNIVERSITY	PROVOST	JOHN ETCHEMENDY
SYRACUSE UNIVERSITY	PROVOST	MICHELE G. WHEATLY
UNIVERSITY OF MICHIGAN	PROVOST	MARTHA E. POLLACK
UNIVERSITY OF PENNSYLVANIA	PROVOST	VINCENT PRICE
UNIVERSITY OF CALIFORNIA, SANTA CRUZ	PROVOST	ALISON GALLOWAY
UNIVERSITY OF CALIFORNIA, DAVIS	PROVOST	KEN BURTIS, ACTING
UNIVERSITY OF VICTORIA	PROVOST	DR. VALERIE KUEHNE, PHD
UNIVERSITY OF CHICAGO	PROVOST	DANIEL DIERMEIER
UNIVERSITY OF CALIFORNIA, LOS ANGELES	PROVOST	SCOTT L. WAUGH
UNIVERSITY COLLEGE LONDON	PROVOST	MICHAEL ARTHUR
WASHINGTON UNIVERSITY IN ST. LOUIS	PROVOST	HOLDEN THORP
UNIVERSITY OF FLORIDA	PROVOST	JOSEPH GLOVER
IMPERIAL COLLEGE LONDON	PROVOST	JAMES STIRLING
JEWISH THEOLOGICAL SEMINARY OF AMERICA	PROVOST	ALAN COOPER
NANYANG TECHNOLOGICAL UNIVERSITY	PROVOST	FREDDY BOEY
TUFTS UNIVERSITY	PROVOST	DAVID R. HARRIS
UNIVERSITY OF CALGARY	PROVOST	DR. DRU MARSHALL
MOUNT HOLYOKE COLLEGE	PROVOST	JON WESTERN
GEORGETOWN UNIVERSITY	PROVOST	ROBERT GROVES
TECHNICAL UNIVERSITY OF DENMARK	PROVOST	HENRIK C. WEGENER
UNIVERSITY OF CENTRAL FLORIDA	PROVOST	LIST OF UNIVERSITY OF CENTRAL FLORIDA FACULTY AND ADMINISTRATORS
TRINITY COLLEGE, TORONTO	PROVOST	MAYO MORAN
NORTHWESTERN UNIVERSITY	PROVOST	DANIEL I. LINZER
UNIVERSITY OF CALIFORNIA, RIVERSIDE	PROVOST	PAUL D'ANIERI
WESLEYAN UNIVERSITY	PROVOST	JOYCE JACOBSEN
UNIVERSITY OF MASSACHUSETTS AMHERST	PROVOST	KATHERINE NEWMAN
CHINESE UNIVERSITY OF HONG KONG	PROVOST	BENJAMIN WAH
ROYAL COLLEGE OF ART	PROVOST	SIR JAMES DYSON
LETOURNEAU UNIVERSITY	PROVOST	PHILIP A. COYLE
THE EVERGREEN STATE COLLEGE	PROVOST	KEN TABAUTT
UNIVERSITY OF MARYLAND, BALTIMORE COUNTY	PROVOST	PHILIP ROUS
CALIFORNIA STATE UNIVERSITY, LONG BEACH	PROVOST	BRIAN JERSKY
GRADUATE CENTER, CUNY	PROVOST	JOY CONNOLLY
EMPORIA STATE UNIVERSITY	PROVOST	DAVID CORDLE
KRESGE COLLEGE	PROVOST	BEN LEEDS CARSON
SOUTHERN METHODIST UNIVERSITY	PROVOST	STEVEN C. CURRALL
UNIVERSITY OF ALABAMA AT BIRMINGHAM	PROVOST	LINDA C. LUCAS
WELLS COLLEGE	PROVOST	DR. CINDY J. SPEAKER
MATER DEI INSTITUTE OF EDUCATION	PROVOST	THE ROMAN CATHOLIC ARCHBISHOP OF DUBLIN
CATHOLIC UNIVERSITY OF AMERICA	PROVOST	ANDREW ABELA
LAPPEENRANTA UNIVERSITY OF TECHNOLOGY	PROVOST	LIISA-MAIJA SAINIO
BILKENT UNIVERSITY	PROVOST	METIN HEPER
LAWRENCE TECHNOLOGICAL UNIVERSITY	PROVOST	PROVOST BIO.ASP
NEW YORK INSTITUTE OF TECHNOLOGY	PROVOST	RAHMAT SHOURESHI
LONDON GUILDHALL UNIVERSITY	PROVOST	PROF. RODERICK C. FLOUD (MA PHD FBA FRSA FRHISTS)
PATRICK HENRY COLLEGE	PROVOST	GENE EDWARD VEITH
GORDON COLLEGE	PROVOST	JANEL CURRY
VISVESVARAYA TECHNOLOGICAL UNIVERSITY	PROVOST	REGISTRAR
AIR FORCE INSTITUTE OF TECHNOLOGY	PROVOST	BIOS.CFM?A=BIO&BIO=13&TABNAME=TAB1A
ST LEONARD'S COLLEGE	PROVOST	JOHN DEREK WOOLLINS
TOURO UNIVERSITY CALIFORNIA	PROVOST	MARILYN HOPKINS, D.N.SC.
BOSTON ARCHITECTURAL COLLEGE	PROVOST	DIANA RAMIREZ-JASSO (HARVARD UNIVERSITY)
NEW YORK UNIVERSITY	PROVOST	KATHERINE ELIZABETH FLEMING
CORNELL UNIVERSITY	PROVOST	MICHAEL KOTLIKOFF
MCGILL UNIVERSITY	PROVOST	CHRISTOPHER MANFREDI
BOSTON UNIVERSITY SCHOOL OF MEDICINE	PROVOST	KAREN H. ANTMAN
MAHARSHI DAYANAND UNIVERSITY	PROVOST	DR. JITENDER KUMAR, REGISTRAR
BERLIN MATHEMATICAL SCHOOL	PROVOST	GüNTER M. ZIEGLER
GEORGE WASHINGTON UNIVERSITY SCHOOL OF MEDICINE & HEALTH SCIENCES	PROVOST	STEVEN LERMAN
ABILENE CHRISTIAN UNIVERSITY	PROVOST	ROBERT L. RHODES
UNIVERSITY OF MISSOURI	PROVOST	GARNETT S. STOKES
KERALA UNIVERSITY OF HEALTH SCIENCES	PROVOST	SMT. K. K. SHAILAJA TEACHER, MINISTER FOR HEALTH AND SOCIAL JUSTICE, GOVERNMENT OF KERALA, INDIA.
CENTER FOR INTEGRATED PROTEIN SCIENCE MUNICH	PROVOST	THOMAS CARELL
GEORGIA INSTITUTE OF TECHNOLOGY	PROVOST	RAFAEL L. BRAS
RIYADH COLLEGE OF TECHNOLOGY	PROVOST	FAHAD ALZMAMI
A.T. STILL UNIVERSITY SCHOOL OF OSTEOPATHIC MEDICINE IN ARIZONA	PROVOST	CRAIG M. PHELPS
SOUTH UNIVERSITY OF SCIENCE AND TECHNOLOGY OF CHINA	PROVOST	WU CHUANYUE
TâN TạO UNIVERSITY	PROVOST	VO TONG XUAN
MADEENATHUL ULOOM ARABIC COLLEGE	PROVOST	M MUHAMMED MADANI
NATIONAL DEFENSE UNIVERSITY	PROVOST	REPUBLIC OF CHINA ARMY
NATIONAL DEFENSE UNIVERSITY	PROVOST	MAJ. GEN.
NATIONAL DEFENSE UNIVERSITY	PROVOST	YANG KI-JUNG
UNIVERSITY OF MICHIGAN DETROIT CENTER	PROVOST	MARTHA E. POLLACK
STATE UNIVERSITY OF PERFORMING AND VISUAL ARTS	PROVOST	AR.HARISH GUPTA, REGISTRAR
ADENIRAN OGUNSANYA COLLEGE OF EDUCATION	PROVOST	OMOLOLA LADELE
