MIKE TYSON	REALNAME	MICHAEL GERARD TYSON
LENNOX LEWIS	REALNAME	LENNOX CLAUDIUS LEWIS
ROBERTO DURáN	REALNAME	ROBERTO DURáN SAMANIEGO
JACK JOHNSON	REALNAME	JOHN ARTHUR JOHNSON
PEDRO ALCáZAR	REALNAME	GUILLERMO GONZALEZ
WILFREDO GóMEZ	REALNAME	WILFREDO GóMEZ RIVERA
JULIO CéSAR CHáVEZ	REALNAME	JULIO CéSAR CHáVEZ GONZáLEZ
FéLIX TRINIDAD	REALNAME	JUAN FéLIX TRINIDAD GARCíA
SALVADOR SáNCHEZ	REALNAME	SALVADOR SáNCHEZ NARVáEZ
DELIA GONZALEZ	REALNAME	DELIA GONZALES
EDWIN ROSARIO	REALNAME	EDWIN ROSARIO
TOMMY BURNS	REALNAME	NOAH BRUSSO
HéCTOR CAMACHO	REALNAME	HéCTOR LUIS CAMACHO MATíAS
CARLOS MONZóN	REALNAME	CARLOS ROQUE MONZóN
SUGAR RAY LEONARD	REALNAME	RAY CHARLES LEONARD
ADA VéLEZ	REALNAME	ADA VéLEZ
RAY MANCINI	REALNAME	RAYMOND MICHAEL MANCINO
JESúS GONZáLEZ	REALNAME	JESUS ERNESTO GONZALESJR
LAURA SERRANO	REALNAME	LAURA SERRANO GARCIA
VINNY PAZ	REALNAME	VINCENZO EDWARD PAZIENZA
BOBBY CZYZ	REALNAME	ROBERT EDWARD CZYZ
FERNANDO VARGAS	REALNAME	FERNANDO JAVIER VARGAS
MICHAEL CARBAJAL	REALNAME	MICHAEL CARBAJAL
SIXTO ESCOBAR	REALNAME	SIXTO ESCOBAR VARGAS
RANDOLPH TURPIN	REALNAME	RANDOLPH ADOLPHUS TURPIN
OSSIE OCASIO	REALNAME	OSVALDO OCASIO
JOSé TORRES	REALNAME	JOSé TORRES
LAILA ALI	REALNAME	LAILA AMARIA ALI
SANTOS LACIAR	REALNAME	SANTOS BENIGNO LACIAR
MAX SCHMELING	REALNAME	MAXIMILLIAN ADOLPH OTTO
MAX SCHMELING	REALNAME	SIEGFRIED SCHMELING
JOE LOUIS	REALNAME	JOSEPH LOUIS BARROW
JACK DEMPSEY	REALNAME	WILLIAM HARRISON DEMPSEY
ALBERTO DáVILA	REALNAME	ALBERT DáVILA
CHRISTY MARTIN	REALNAME	CHRISTY RENEA SALTERS
ALAN MINTER	REALNAME	ALAN MINTER
SONNY LISTON	REALNAME	CHARLES L. LISTON
JAKE LAMOTTA	REALNAME	GIACOBBE LAMOTTA
GEORGE FOREMAN	REALNAME	GEORGE EDWARD FOREMAN
HENRY ARMSTRONG	REALNAME	HENRY MELODY JACKSON JR.
EUSEBIO PEDROZA	REALNAME	EUSEBIO PEDROZA
CARLOS DE LEóN	REALNAME	CARLOS DE LEóN
SHANE MOSLEY	REALNAME	SHANE ANDRE MOSLEY
MICHAEL SPINKS	REALNAME	MICHAEL SPINKS
JACKIE FRAZIER-LYDE	REALNAME	JACQUELINE FRAZIER
JOHNNY TAPIA	REALNAME	JOHN LEE ANTHONY TAPIA
JOE FRAZIER	REALNAME	JOSEPH WILLIAM FRAZIER
CARLOS ZáRATE SERNA	REALNAME	CARLOS ZáRATE SERNA
BILLY BACKUS	REALNAME	HAROLD WILLIAM BACKUS
ROCKY MARCIANO	REALNAME	ROCCO FRANCIS MARCHEGIANO
EMILE GRIFFITH	REALNAME	EMILE ALPHONSE GRIFFITH
BARRY MCGUIGAN	REALNAME	FINBAR PATRICK MCGUIGAN
KEN NORTON	REALNAME	KENNETH HOWARD NORTON SR.
BARNEY ROSS	REALNAME	DOV-BER RASOFSKY
BOBBY CHACON	REALNAME	BOBBY CHACON
MARCEL CERDAN	REALNAME	MARCELLIN CERDAN
RON STANDER	REALNAME	RONALD STANDER
ESTEBAN DE JESúS	REALNAME	ESTEBAN DE JESúS
VíCTOR GALíNDEZ	REALNAME	VíCTOR EMILIO GALíNDEZ
GERRIE COETZEE	REALNAME	GERHARDUS CHRISTIAN COETZEE
JIRO WATANABE	REALNAME	JIRO WATANABE
JORGE CASTRO	REALNAME	JORGE FERNANDO CASTRO
KOSTYA TSZYU	REALNAME	KONSTANTIN BORISOVICH TSZYU
TONY CANZONERI	REALNAME	TONY CANZONERI
LáSZLó PAPP	REALNAME	LáSZLó PAPP
KID CHOCOLATE	REALNAME	ELIGIO SARDIñAS MONTALVO
ARCHIE MOORE	REALNAME	ARCHIBALD LEE WRIGHT
WILLIE PEP	REALNAME	GUGLIELMO PAPALEO
CHUCK WEPNER	REALNAME	CHARLES WEPNER
JEFF FENECH	REALNAME	JEFF FENECH
TEóFILO STEVENSON	REALNAME	TEóFILO STEVENSON LAWRENCE
LUPE PINTOR	REALNAME	JOSé GUADALUPE PINTOR GUZMáN
MIA ST. JOHN	REALNAME	MIA ROSALES ST. JOHN
DEMARCUS CORLEY	REALNAME	DEMARCUS DEON CORLEY
STANLEY KETCHEL	REALNAME	STANISłAW KIECAL
JOHN JOHN MOLINA	REALNAME	JUAN MOLINA
VITO ANTUOFERMO	REALNAME	VITO  ANTUOFERMO
JOSé ROMAN	REALNAME	JOSE ROMAN
JORGE PáEZ	REALNAME	JORGE ADOLFO FEBLES PáEZ
JIMMY WILDE	REALNAME	WILLIAM JAMES WILDE
PETE RADEMACHER	REALNAME	THOMAS PETER RADEMACHER
ABE ATTELL	REALNAME	ABRAHAM WASHINGTON ATTELL
BOB FOSTER	REALNAME	ROBERT LLOYD FOSTER'
KID GAVILáN	REALNAME	GERARDO GONZáLEZ
CARLOS HERNáNDEZ	REALNAME	CARLOS HERNáNDEZ
KIM DUK-KOO	REALNAME	KIM DEUK-GU
BUSTER MATHIS	REALNAME	BUSTER MATHIS
BUSTER DOUGLAS	REALNAME	JAMES DOUGLAS
KEN BUCHANAN	REALNAME	KEN BUCHANAN
VICTOR CALLEJAS	REALNAME	VICTOR CALLEJAS
RAFAEL LIMóN	REALNAME	RAFAEL LIMóN BURGOS
ROY JONES JR.	REALNAME	ROY LEVESTA JONES JR.
RUBéN OLIVARES	REALNAME	RUBéN OLIVARES
BOB FITZSIMMONS	REALNAME	ROBERT JAMES FITZSIMMONS
CORRIE SANDERS	REALNAME	CORNELIUS JOHANNES SANDERS
WILFREDO VáZQUEZ	REALNAME	WILFREDO VáZQUEZ OLIVERA
MARCO ANTONIO BARRERA	REALNAME	MARCO ANTONIO BARRERA TAPIA
MIGUEL COTTO	REALNAME	MIGUEL ÁNGEL COTTO VáZQUEZ
HéCTOR CAMACHO JR.	REALNAME	HéCTOR CAMACHO JR.
NIGEL BENN	REALNAME	NIGEL GREGORY BENN
CARLOS CRUZ	REALNAME	CARLOS TEóFILO ROSARIO CRUZ
GERALD MCCLELLAN	REALNAME	GERALD MCCLELLAN
MATTHEW SAAD MUHAMMAD	REALNAME	MATTHEW SAAD MUHAMMAD
BOBBY PACHO	REALNAME	ROBERT PACHO
MICHAEL MOORER	REALNAME	MICHAEL LEE MOORER
VINCENT GIGANTE	REALNAME	VINCENT GIGANTE
TOMMY MORRISON	REALNAME	TOMMY DAVID MORRISON
TONY TUCKER	REALNAME	TONY CRAIG TUCKER
IVáN CALDERóN	REALNAME	IVáN CALDERóN MARRERO
JERRY QUARRY	REALNAME	JERRY QUARRY
EARNIE SHAVERS	REALNAME	EARNIE DEE SHAVER
BENNY PARET	REALNAME	BERNARDO PARET
JOSé LUIS RAMíREZ	REALNAME	JOSE LUIS RAMIREZ
CHUCHO CASTILLO	REALNAME	JESúS CASTILLO AGUILLERA
PAUL SPADAFORA	REALNAME	PAUL ROSS SPADAFORA
JOSé NáPOLES	REALNAME	JOSé ÁNGEL NáPOLES
LUIS ORTIZ	REALNAME	LUIS ORTIZ
BENNY LYNCH	REALNAME	BENNY LYNCH
JERSEY JOE WALCOTT	REALNAME	ARNOLD RAYMOND CREAM
BILLY CONN	REALNAME	WILLIAM DAVID CONN
RIDDICK BOWE	REALNAME	RIDDICK LAMONT BOWE
JOSé CUEVAS	REALNAME	JOSé ISIDRO CUEVAS GONZáLEZ
CARLOS PALOMINO	REALNAME	CARLOS PALOMINO
DONALD CURRY	REALNAME	DONALD SAMPLE
SAOUL MAMBY	REALNAME	SAOUL PAUL MAMBY
GENE HATCHER	REALNAME	RONALD HATCHER, JR.
MIKE ROSSMAN	REALNAME	MICHAEL ALBERT DEPIANO
DANNY LOPEZ	REALNAME	DANNY LOPEZ
TOM HEENEY	REALNAME	THOMAS HEENEY
TOMMY LOUGHRAN	REALNAME	THOMAS LOUGHRAN
GENE TUNNEY	REALNAME	JAMES JOSEPH TUNNEY
HARRY GREB	REALNAME	EDWARD HENRY GREB
JORGE ARCE	REALNAME	JORGE ARMANDO ARCE ARMENTA
PEDRO CARRASCO	REALNAME	PEDRO JUAN
PEDRO CARRASCO	REALNAME	CARRASCO GARCíA
HUMBERTO GONZáLEZ	REALNAME	HUMBERTO GONZáLEZ
COLIN MCMILLAN	REALNAME	COLIN MCMILLAN
JOEY GIARDELLO	REALNAME	CARMINE ORLANDO TILELLI
JOSé COTTO	REALNAME	JOSé MIGUEL COTTO VáZQUEZ
GEORGE CHUVALO	REALNAME	JURE ČUVALO
VASSILIY JIROV	REALNAME	VASSILIY VALERYEVICH JIROV
CORNELIUS EDWARDS	REALNAME	BOZA
FRANCISCO BOJADO	REALNAME	FRANCISCO BOJADO
MUSTAFA HAMSHO	REALNAME	MUSTAFA HAMSHO
ANTONIO CERVANTES	REALNAME	ANTONIO CERVANTES REYES
PAULIE AYALA	REALNAME	PAUL ANTHONY AYALA
HASIM RAHMAN	REALNAME	HASIM SHARIFF RAHMAN
ROCKY GRAZIANO	REALNAME	THOMAS ROCCO BARBELLA
DONNY LALONDE	REALNAME	DONALD DREW LALONDE
KID MCCOY	REALNAME	NORMAN SELBY
FRANK BRUNO	REALNAME	FRANKLIN ROY BRUNO
MICKEY WALKER	REALNAME	MICKEY WALKER
JUAN ROLDáN	REALNAME	JUAN DOMINGO ROLDáN
MARTíN VARGAS	REALNAME	MARTíN VARGAS FUENTES
YVONNE CAPLES	REALNAME	YVONNE TARA CAPLES
DICK TIGER	REALNAME	RICHARD IHETU
ANTONIO MARGARITO	REALNAME	ANTONIO MARGARITO MONTIEL
JULIO CéSAR GONZáLEZ	REALNAME	JULIO CéSAR GONZáLEZ IBARRA
MELISSA DEL VALLE	REALNAME	MELISSA DEL VALLE
NINO BENVENUTI	REALNAME	GIOVANNI BENVENUTI
EZZARD CHARLES	REALNAME	EZZARD MACK CHARLES
WILLIE JORRíN	REALNAME	GUILLERMO JAIME JORRíN
WLADIMIR KLITSCHKO	REALNAME	VOLODYMYR VOLODYMYROVYCH KLYCHKO
JOHANN TROLLMANN	REALNAME	JOHANN WILHELM TROLLMANN
ROLANDO NAVARRETE	REALNAME	ROLANDO NAVARRETE
WILLIAM JOPPY	REALNAME	WILLIAM TORELLE JOPPY
LEONARD DOROFTEI	REALNAME	LEONARD DORIN DOROFTEI
LIONEL ROSE	REALNAME	LIONEL EDMUND ROSE
JOE BUGNER	REALNAME	JóZSEF KREUL BUGNER
FREDDIE MILLS	REALNAME	FREDERICK PERCIVAL MILLS
LLOYD HONEYGHAN	REALNAME	LLOYD HONEYGHAN
CHRIS EUBANK	REALNAME	CHRISTOPHER LIVINGSTONE EUBANKS
TONY ZALE	REALNAME	ANTONI FLORIAN ZALESKI
LEW JENKINS	REALNAME	VERLIN E. JENKINS
JIM WATT	REALNAME	JIM WATT
FéLIX SAVóN	REALNAME	FéLIX SAVóN FABRE
GENARO HERNáNDEZ	REALNAME	GENARO HERNáNDEZ
GEORGE DIXON	REALNAME	GEORGE DIXON
RODRIGO VALDéZ	REALNAME	RODRIGO VALDEZ
MAX BAER	REALNAME	MAXIMILIAN ADELBERT BAER
KIRK JOHNSON	REALNAME	KIRK CYRON JOHNSON
INGEMAR JOHANSSON	REALNAME	INGEMAR JOHANSSON
SCOTT WALKER	REALNAME	PERRY SCOTT WALKER
YVON DURELLE	REALNAME	YVON DURELLE
YORI BOY CAMPAS	REALNAME	LUIS RAMóN CAMPAS MEDINA
MAXIE ROSENBLOOM	REALNAME	MAX EVERITT ROSENBLOOM
VINCENZO NARDIELLO	REALNAME	VINCENZO NARDIELLO
LAMON BREWSTER	REALNAME	LAMON TAJUAN BREWSTER
MELDRICK TAYLOR	REALNAME	MELDRICK TAYLOR
PANAMA AL BROWN	REALNAME	ALFONSO TEOFILO BROWN
BILLY PAPKE	REALNAME	WILLIAM H. PAPKE
SAM LANGFORD	REALNAME	SAMUEL E. LANGFORD
JAMES TILLIS	REALNAME	JAMES THEODORE TILLIS
MAGNE HAVNå	REALNAME	MAGNE HAVNå
JAMES J. BRADDOCK	REALNAME	JAMES WALTER BRADDOCK
BRUCE STRAUSS	REALNAME	BRUCE STRAUSS
JAMES J. CORBETT	REALNAME	JAMES JOHN CORBETT
JACK SHARKEY	REALNAME	JOSEPH PAUL ZUKAUSKAS
JESS WILLARD	REALNAME	JESS MYRON WILLARD
FRANKIE RANDALL	REALNAME	FRANKIE BILLY RANDALL
JAMES J. JEFFRIES	REALNAME	JAMES JACKSON JEFFRIES
OSCAR BONAVENA	REALNAME	OSCAR NATALIO BONAVENA
ALEX SáNCHEZ	REALNAME	ALEX SáNCHEZ SEPULVEDA
JOHN L. SULLIVAN	REALNAME	JOHN LAWRENCE SULLIVAN
ANDREW FLINTOFF	REALNAME	ANDREW FLINTOFF
ÉRIK MORALES	REALNAME	ÉRIK ISAAC MORALES ELVIRA
MICHAEL DOKES	REALNAME	MICHAEL MARSHALL DOAKES
DANNY WILLIAMS	REALNAME	DANIEL PETER WILLIAMS
TOMMY FARR	REALNAME	TOMMY FARR
JESSE FERGUSON	REALNAME	JESSE FERGUSON
ÉDER JOFRE	REALNAME	ÉDER JOFRE
RICARDO DOMINGUEZ	REALNAME	RICARDO DOMINGUEZ
MIGUEL CANTO	REALNAME	MIGUEL CANTO
ALEXANDER POVETKIN	REALNAME	ALEXANDER VLADIMIROVICH POVETKIN
HAROLD JOHNSON	REALNAME	HAROLD JOHNSON
VIRGIL HILL	REALNAME	VIRGIL EUGENE HILL
TERRY NORRIS	REALNAME	TERRY NORRIS
HENRY MASKE	REALNAME	HENRY MASKE
JOHNNY OWEN	REALNAME	JOHN RICHARD OWENS
ANTONIO TARVER	REALNAME	ANTONIO DEON TARVER
CLEVELAND WILLIAMS	REALNAME	CLEVELAND WILLIAMS
BOBO OLSON	REALNAME	CARL OLSON
ANN WOLFE	REALNAME	ANN WOLFE
WAYNE MCCULLOUGH	REALNAME	WAYNE POCKET ROCKET MCCULLOUGH
BETULIO GONZáLEZ	REALNAME	BETULIO SEGUNDO GONZáLEZ
MARIO KINDELáN	REALNAME	MARIO CéSAR KINDELáN MESA
FREDDIE WELSH	REALNAME	FREDERICK HALL THOMAS
BILLY HARDY	REALNAME	WILLIAM HARDY
LEOTIS MARTIN	REALNAME	LEOTIS MARTIN
MAURO MINA	REALNAME	MAURO MINA BAYLON
JIMMY CARRUTHERS	REALNAME	JAMES WILLIAM CARRUTHERS
LES DARCY	REALNAME	JAMES LESLIE DARCY
DAVE SANDS	REALNAME	DAVID RITCHIE
VALERIE MAHFOOD	REALNAME	VALERIE REBECCA MAHFOOD
SHARMBA MITCHELL	REALNAME	SHARMBA DAVID MITCHELL
RICHIE SANDOVAL	REALNAME	RICHARD SANDOVAL
ÁNGEL ESPADA	REALNAME	ANGEL ESPADA
JIMMY MCLARNIN	REALNAME	JAMES MCLARNIN
DAVID TUA	REALNAME	MAFAUFAU TAVITA LIO MAFAUFAU SANERIVI TALIMATASI
JOHN TATE	REALNAME	JOHN TATE
SERGEI KOBOZEV	REALNAME	SERGEY VIKTOROVICH KOBOZEV
JOEY MAXIM	REALNAME	GIUSEPPE ANTONIO BERARDINELLI
NONPAREIL DEMPSEY	REALNAME	JOHN EDWARD KELLY
JUAN EVANGELISTA VENEGAS	REALNAME	JUAN EVANGELISTA VENEGAS TRINIDAD
PARA DRAINE	REALNAME	PARA DRAINE
ERNIE TERRELL	REALNAME	ERNEST TERRELL
DAISY OCASIO	REALNAME	DAISY OCASIO
CATHY DAVIS	REALNAME	CATHRINE DAVIS
TIM WITHERSPOON	REALNAME	TIM WITHERSPOON
REGINA HALMICH	REALNAME	REGINA HALMICH
MARCELA ACUñA	REALNAME	MARCELA ELIANA ACUñA
JOEY LAMOTTA	REALNAME	GIUSEPPE LAMOTTA
LEONA BROWN	REALNAME	LEONA BROWN
CHEVELLE HALLBACK	REALNAME	CHEVELLE LYNVETTE HALLBACK
AMIR KHAN	REALNAME	AMIR IQBAL KHAN
ELISEO CASTILLO	REALNAME	ELISEO CASTILLO
SAMUEL PETER	REALNAME	SAMUEL OKON PETER
RICHEL HERSISIA	REALNAME	RICHEL HERSISIA
AUDLEY HARRISON	REALNAME	AUDLEY HUGH HARRISON
RANDY NEUMANN	REALNAME	RANDY NEUMANN
SHANE SUTCLIFFE	REALNAME	SHANE SUTCLIFFE
PATRICE L'HEUREUX	REALNAME	PATRICE L'HEUREUX
TRACY BYRD	REALNAME	TRACY MICHELLE BYRD
OLEG MASKAEV	REALNAME	OLEG ALEXANDROVICH MASKAEV
CHRIS BYRD	REALNAME	CHRISTOPHER CORNELIUS BYRD
MICHELE ABORO	REALNAME	MICHELE ABORO
BRIDGETT RILEY	REALNAME	BRIDGETT RILEY
ROCKY LOCKRIDGE	REALNAME	RICK LOCKRIDGE
TONY GALENTO	REALNAME	DOMINICK ANTHONY GALENTO
KING LEVINSKY	REALNAME	HARRIS KRAKOW
BUDDY BAER	REALNAME	JACOB HENRY BAER
SANDY SADDLER	REALNAME	JOSEPH \
ELMER RAY	REALNAME	ELMO JOHN RAY
HARRY WILLS	REALNAME	HARRY WILLS
TIGER JACK FOX	REALNAME	JOHN LINWOOD FOX
BENNIE BRISCOE	REALNAME	BENNIE BRISCOE
FLORENTINO FERNáNDEZ	REALNAME	FLORENTINO FERNáNDEZ
CHALKY WRIGHT	REALNAME	ALBERT WRIGHT
TOMMY RYAN	REALNAME	JOSEPH YOUNGS
JOE GANS	REALNAME	JOSEPH GANT
GEORGE GODFREY	REALNAME	FEAB SMITH WILLIAMS
BARBADOS JOE WALCOTT	REALNAME	JOE WALCOTT
JEM MACE	REALNAME	JAMES MACE
CHARLEY BURLEY	REALNAME	CHARLES DUANE BURLEY
AL HOSTAK	REALNAME	ALBERT PAUL HOSTAK
AL DAVIS	REALNAME	ABRAHAM DAVIDOFF
MELISSA FIORENTINO	REALNAME	MELISSA FIORENTINO
VONDA WARD	REALNAME	VONDA WARD
ALFONSO ZAMORA	REALNAME	ALFONSO ZAMORA
ZAB JUDAH	REALNAME	ZABDIEL JUDAH
FLOYD MAYWEATHER JR.	REALNAME	FLOYD JOY MAYWEATHER JR.
BENNY LEONARD	REALNAME	BENJAMIN LEINER
GENE FULLMER	REALNAME	LAWRENCE GENE FULLMER
RUBY GOLDSTEIN	REALNAME	REUVEN GOLDSTEIN
JOE CHOYNSKI	REALNAME	JOE CHOYNSKI
JOHNNY DUNDEE	REALNAME	GIUSEPPE CURRERI
JUAN MARTIN COGGI	REALNAME	JUAN MARTIN COGGI
TERRY MCGOVERN	REALNAME	JOSEPH TERRENCE MCGOVERN
JOCK MCAVOY	REALNAME	JOSEPH PATRICK BAMFORD
GEORGE CHANEY	REALNAME	GEORGE HENRY CHANEY
FIGHTING HARADA	REALNAME	MASAHIKO HARADA
MICHAEL GRANT	REALNAME	MICHAEL ANTHONY GRANT
HORACIO ACCAVALLO	REALNAME	HORACIO ENRIQUE ACCAVALLO
CHARLEY WHITE	REALNAME	CHARLES ANCHOWITZ
PETE HERMAN	REALNAME	PETER GULOTTA
LOU AMBERS	REALNAME	LUIGI GIUSEPPE D'AMBROSIO
JOHNNY WILSON	REALNAME	GIOVANNI FRANCESCO PANICA
HARRY JEFFRA	REALNAME	IGNACIUS PASQUALE GUIFFI
ROCKY KANSAS	REALNAME	ROCCO TOZZO
PAOLO VIDOZ	REALNAME	PAOLO VIDOZ
WILLIE PASTRANO	REALNAME	WILFRED RALEIGH PASTRANO
JESSE JAMES LEIJA	REALNAME	JAMES LEIJA
RICKY HATTON	REALNAME	RICHARD JOHN HATTON
FIDEL LABARBA	REALNAME	FIDEL LA BARBA
FRANKIE GENARO	REALNAME	FRANK DIGENNARO
CHRISTOPHER BATTALINO	REALNAME	CHRISTOPHER BATTAGLIA
LOU SAVARESE	REALNAME	LOU SAVARESE
CORY SPINKS	REALNAME	CORY CALVIN
YOKO GUSHIKEN	REALNAME	YOKO GUSHIKEN
DAVARRYL WILLIAMSON	REALNAME	DAVARRYL JEROME WILLIAMSON
JACK DELANEY	REALNAME	OVILA CHAPDELAINE
PAUL BERLENBACH	REALNAME	PAUL BERLENBACH
DAVID HAYE	REALNAME	DAVID DERON HAYE
DIANA DUTRA	REALNAME	DIANA MARY DUTRA
MARCEL THIL	REALNAME	MARCEL THIL
FRED APOSTOLI	REALNAME	ALFREDO APOSTOLI
SAMMY ANGOTT	REALNAME	SAMUEL ENGOTTI
FREDDIE STEELE	REALNAME	FREDERICK EARL BURGETT
PETEY SCALZO	REALNAME	PETER DONATO SCALZO
PETE LATZO	REALNAME	PETE LATZO
JOE DUNDEE	REALNAME	SALVATORE LAZZARA
VINCE DUNDEE	REALNAME	VINCENZO LAZZARA
SAMMY MANDELL	REALNAME	SALVATORE MANDALA
JOEY ARCHIBALD	REALNAME	JOSEPH J ARCHIBALD
YOUNG CORBETT III	REALNAME	RAFFAELE GIORDANO
JOHNNY FAMECHON	REALNAME	JEAN-PIERRE FAMECHON
HUGO CORRO	REALNAME	HUGO PASTOR CORRO
BERNARDO MERCADO	REALNAME	BERNARDO MERCADO
SHONDELL ALFRED	REALNAME	SHONDELL ALFRED
FRANKIE CAMPBELL	REALNAME	FRANCESCO CAMILLI
JACK KID BERG	REALNAME	JUDAH BERGMAN
LUIS MANUEL RODRíGUEZ	REALNAME	LUIS MANUEL RODRíGUEZ
JAVIER CASTILLEJO	REALNAME	FRANCISCO JAVIER CASTILLEJO RODRíGUEZ
JULIO CéSAR CHáVEZ JR.	REALNAME	JULIO CéSAR CHáVEZ CARRASCO
JIM DRISCOLL	REALNAME	JAMES DRISCOLL
BOMBARDIER BILLY WELLS	REALNAME	WILLIAM THOMAS WELLS
NELSON DIEPPA	REALNAME	NELSON DIEPPA GERENA
JOE JEANETTE	REALNAME	JOSEPH JEANETTEI
ALFONSO GóMEZ	REALNAME	ALFONSO SALVADOR GóMEZ BECERRA
JOEY GILBERT	REALNAME	JOSEPH SALVATORE GILBERT
ISHE SMITH	REALNAME	ISHé OLUWA KAMAU ALI SMITH
AHMAD KADDOUR	REALNAME	AHMAD SAM KADDOUR
NAJAI TURPIN	REALNAME	NAJAI TURPIN
JUAN DE LA ROSA	REALNAME	JUAN PEDRO DE LA ROSA
WINKY WRIGHT	REALNAME	RONALD LAMONT WRIGHT
DON COCKELL	REALNAME	DONALD JOHN COCKELL
JEAN-MARC MORMECK	REALNAME	JEAN-MARC GILBERT MORMECK
SUGAR RAMOS	REALNAME	ULTIMINIO RAMOS ZAQUEIRA
GREG PAGE	REALNAME	GREG PAGE
MAHYAR MONSHIPOUR	REALNAME	MAHYAR MONSHIPOUR
KEVIN MCBRIDE	REALNAME	KEVIN MARTIN MCBRIDE
ARTURO GODOY	REALNAME	ARTURO GODOY
GLEN JOHNSON	REALNAME	GLENGOFFE DONOVAN JOHNSON
HOWARD EASTMAN	REALNAME	HOWARD ANTHONY EASTMAN
JAKE KILRAIN	REALNAME	JOHN JOSEPH KILLION
PETER MCNEELEY	REALNAME	PETER SMITH MCNEELEY
LOU NOVA	REALNAME	JAY L. NOVA
GREGORIO PERALTA	REALNAME	GREGORIO MANUEL PERALTA
STEVE COLLINS	REALNAME	STEPHEN COLLINS
COLIN JONES	REALNAME	COLIN JONES
VIVIAN HARRIS	REALNAME	IVAN VIVIAN HARRIS
CEFERINO GARCIA	REALNAME	CEFERINO GARCIA
EMANUEL AUGUSTUS	REALNAME	EMANUEL BURTON
SAM MCVEY	REALNAME	SAMUEL E. MACVEA
LARRY DONALD	REALNAME	LARRY ALI DONALD
BERT COOPER	REALNAME	BERTRAM COOPER
YASUTSUNE UEHARA	REALNAME	YASUTSUNE UEHARA
BEN VILLAFLOR	REALNAME	BENJAMIN VILLAFLOR
IZZY JANNAZZO	REALNAME	ISADORO ANTHONY JANNAZZO
PETE SANSTOL	REALNAME	PEDER OLAI SANSTøL
DAVEY MOORE	REALNAME	DAVEY MOORE
DAVEY MOORE	REALNAME	DAVID S. MOORE
JOHANNA PEñA ÁLVAREZ	REALNAME	JOANNA ALTAGRACIA PEñA ALVAREZ
GISELLE SALANDY	REALNAME	JOENETTE GISELLE IFE SALANDY
STEVE ROBINSON	REALNAME	STEVE ROBINSON
LENA ÅKESSON	REALNAME	LENA ÅKESSON
TONY MUNDINE	REALNAME	ANTHONY WILLIAM MUNDINE
ORLANDO ROMERO	REALNAME	ORLANDO ROMERO PERALTA
JACOB MATLALA	REALNAME	JACOB MATLALA
STANLEY POREDA	REALNAME	STANLEY POREDA
HERBIE HIDE	REALNAME	HERBERT OKECHUKWU MADUAGWU
NIKOLAI VALUEV	REALNAME	NIKOLAI SERGEYEVICH VALUEV
BUDDY MCGIRT	REALNAME	JAMES WALTER MCGIRT
GENNADY GOLOVKIN	REALNAME	GENNADY GENNADYEVICH GOLOVKIN
MUHAMMAD ABDULLAEV	REALNAME	MOHAMMADQODIR ABDULLAEV
GUILLERMO RIGONDEAUX	REALNAME	GUILLERMO RIGONDEAUX ORTIZ
ALEX RAMOS	REALNAME	ALEX RAMOS
NICOLINO LOCCHE	REALNAME	NICOLINO FELIPE LOCCHE
RICARDO LóPEZ	REALNAME	RICADO LóPEZ NAVA
CLINTON WOODS	REALNAME	CLINTON WOODS
JOHNNY COULON	REALNAME	JOHNNY COULON
HENRY AKINWANDE	REALNAME	HENRY AKINWANDE
ZDRAVKO MIćEVIć	REALNAME	ZDRAVKO MIćEVIć
LEAVANDER JOHNSON	REALNAME	LEAVANDER JOHNSON
MZUKISI SIKALI	REALNAME	MZUKISI SIKALI
SONNY BILL WILLIAMS	REALNAME	SONNY WILLIAM WILLIAMS
GARY MASON	REALNAME	GARY MICHAEL MASON
YOUNG FIRPO	REALNAME	GUIDO BARDELLI
REGILIO TUUR	REALNAME	REGILIO BENITO TUUR
JOEL CASAMAYOR	REALNAME	JOEL CASAMAYOR JOHNSON
MICHAEL NUNN	REALNAME	MICHAEL JOHN NUNN
JESúS CHáVEZ	REALNAME	JESúS GABRIEL SANDOVAL CHáVEZ
IKE QUARTEY	REALNAME	ISUFU QUARTEY
MICK GATTO	REALNAME	DOMENIC GATTO
BORIS LAGUTIN	REALNAME	BORIS NIKOLAYEVICH LAGUTIN
FRANCISCO GUILLEDO	REALNAME	FRANCISCO VILLARUEL GUILLEDO
GABRIEL ELORDE	REALNAME	GABRIEL ELORDE
RODOLFO GONZALES	REALNAME	RODOLFO GONZáLES
PAUL BRIGGS	REALNAME	PAUL BRIGGS
PEDRO ADIGUE	REALNAME	PEDRO ADIGUE, JR.
TERRY MARSH	REALNAME	TERRY MARSH
ARNOLD VANDERLYDE	REALNAME	ARNOLD PETRUS MARIA VANDERLYDE
PAUL GALLEN	REALNAME	PAUL GALLEN
JACKIE BROWN	REALNAME	JACKIE BROWN
AGAPITO SáNCHEZ	REALNAME	AGAPITO SANCHEZ
POLATAIVAO FOSI	REALNAME	AFIOGA POLATAIVAO
JEANNINE GARSIDE	REALNAME	JEANNINE GARSIDE
COLIN KENNA	REALNAME	COLIN KENNA
SUMBU KALAMBAY	REALNAME	PATRIZIO SUMBU KALAMBAY
KALI MEEHAN	REALNAME	KALIVATI MEEHAN
ESTEBAN GALLARD	REALNAME	ESTEBAN GALLARD
JEFF LACY	REALNAME	JEFFREY SCOTT LACY
VIC DARCHINYAN	REALNAME	VAKHTANG DARCHINYAN
JORGE ELIéCER JULIO	REALNAME	JORGE ELIéCER JULIO ROCHA
DUNCAN DOKIWARI	REALNAME	DUNCAN DALNAJENESO DANAGOGO DOKIWARI
DAVID IZONRITEI	REALNAME	DAVID IZONRITEI
DAVE MCAULEY	REALNAME	DAVID ANTHONY MCAULEY
DANNY GREEN	REALNAME	DANIEL THOMAS GREEN
TOMMY JACKSON	REALNAME	THOMAS JACKSON
ANDRE BERTO	REALNAME	ANDRE MICHAEL BERTO
RUSLAN CHAGAEV	REALNAME	RUSLAN SHAMILEVICH CHAGAEV
JASON ESTRADA	REALNAME	JASON MOSES ESTRADA
ROMAN KARMAZIN	REALNAME	ROMAN KARMAZIN
MZONKE FANA	REALNAME	MZONKE FANA
RAYMOND JOVAL	REALNAME	RAYMOND JOVAL
TYE FIELDS	REALNAME	WALTER TYESON FIELDS
JOEL JULIO	REALNAME	JOEL JALIL JULIO MEJIA
GARY STRETCH	REALNAME	GARY STRETCH
CARLOS BALDOMIR	REALNAME	CARLOS MANUEL BALDOMIR
KID AZTECA	REALNAME	LUIS VILLANUEVA PARAMO
ALDO COLLIANDER	REALNAME	ALDO COLLIANDER
ZORA FOLLEY	REALNAME	ZORA FOLLEY
HOWARD WINSTONE	REALNAME	HOWARD WINSTONE
HUMBERTO SOTO	REALNAME	ARMANDO HUMBERTO SOTO OCHOA
JOHNNY NELSON	REALNAME	IVANSON RANNY NELSON
JUAN MANUEL MáRQUEZ	REALNAME	JUAN MANUEL MáRQUEZ MéNDEZ
JOE MESI	REALNAME	JOE MESI
CLARENCE HILL	REALNAME	CLARENCE HILL
RUBEN CASTILLO	REALNAME	RUBEN CASTILLO
ORZUBEK NAZAROV	REALNAME	ORZUBEK NAZAROV
BARRY MICHAEL	REALNAME	BARRY MICHAEL SWETTENHAM
JOSé MARíA FLORES BURLóN	REALNAME	JOSé MARíA FLORES BURLóN
ALBERT FINCH	REALNAME	ALBERT FINCH
HAMID AIT BIGHRADE	REALNAME	حميد ايت بيغراد
GBENGA OLOUKUN	REALNAME	GBENGA OLOUKUN
GUNBOAT SMITH	REALNAME	EDWARD SMITH
ARTURO FRIAS	REALNAME	ARTURO FRIAS
MUSTAPHA MOUSSA	REALNAME	MUSTAPHA MOUSSA
YOUNG MUTLEY	REALNAME	LEE WOODLEY
DEMETRIUS HOPKINS	REALNAME	DEMETRIUS HOPKINS
CALVIN BROCK	REALNAME	CALVIN VANCE BROCK
MARTíN CASTILLO	REALNAME	JOSé MARTíN CASTILLO
CHRIS JOHN	REALNAME	YOHANNES CHRISTIAN JOHN
FRANKIE GAVIN	REALNAME	FRANKIE RAYMOND GAVIN
SIARHEI LIAKHOVICH	REALNAME	SIARHEI PETROVICH LIAKHOVICH
GILBERTO ROMáN	REALNAME	GILBERTO ROMáN
KENNY ANDERSON	REALNAME	KENNETH JOHN W. ANDERSON
RAúL MACíAS	REALNAME	RAúL MACíAS GUEVARA
BILLY MISKE	REALNAME	WILLIAM ARTHUR MISKE
JOSé RUíZ MATOS	REALNAME	JOSé RUíZ MATOS
CONJESTINA ACHIENG	REALNAME	CONJESTINA ACHIENG
JOHNNY KILBANE	REALNAME	JOHN PATRICK KILBANE
DOMINICK GUINN	REALNAME	DOMINICK ALEXANDER GUINN
ALLAN GREEN	REALNAME	ALLAN LAMAR GREEN
ROGER MAYWEATHER	REALNAME	ROGER L. MAYWEATHER
AL MCCOY	REALNAME	ALEXANDER RUDOLPH
TAURUS SYKES	REALNAME	TAURUS JABBAR SYKES
JEFF MAYWEATHER	REALNAME	JEFF MAYWEATHER
CARLOS GERENA	REALNAME	CARLOS GERENA.
GREGORIO VARGAS	REALNAME	GREGORIO VARGAS HERNáNDEZ
ODLANIER SOLíS	REALNAME	ODLANIER SOLíS FONTE
BOB MONTGOMERY	REALNAME	BOB MONTGOMERY
SULTAN IBRAGIMOV	REALNAME	SULTAN-AHMED
SULTAN IBRAGIMOV	REALNAME	MAGOMEDSALIHOVICH
SULTAN IBRAGIMOV	REALNAME	IBRAGIMOV
PAOLO ROBERTO	REALNAME	PAOLO ANTONIO ROBERTO
ERIC CRUMBLE	REALNAME	JAMES ERIC CRUMBLE
JUAN JOSé ESTRADA	REALNAME	JUAN JOSé ESTRADA
KōKI KAMEDA	REALNAME	KōKI KAMEDA
MIGUEL ÁNGEL GONZáLEZ	REALNAME	MIGUEL ÁNGEL GONZáLEZ DáVILA
SCOTT HARRISON	REALNAME	SCOTT HARRISON
PATRICK GRAHAM	REALNAME	PATRICK JOHN GRAHAM
BRIAN LONDON	REALNAME	BRIAN SYDNEY HARPER
MICHAEL HUNTER	REALNAME	MICHAEL HUNTER
JOE LYNCH	REALNAME	JOSEPH ALOYSIUS LYNCH
FRANCIE BARRETT	REALNAME	FRANCIS BARRETT
SHANE CAMERON	REALNAME	SHANE AARON CAMERON
ROCKY JUAREZ	REALNAME	RICARDO JUáREZ
MUHAMMAD RACHMAN	REALNAME	MOHAMAD RACHMAN SAWALUDIN BIN SUHAIMAT
NICO THOMAS	REALNAME	NICHOLAS THOMAS
ELLYAS PICAL	REALNAME	ELLYAS PICAL
PETER JACKSON	REALNAME	PETER JACKSON
ROBERTO VáSQUEZ	REALNAME	ROBERTO GASPAR VáSQUEZ RAMíREZ
PAULIE MALIGNAGGI	REALNAME	PAUL
FRITZIE ZIVIC	REALNAME	FERDINAND HENRY JOHN ZIVCICH
BOBBY QUARRY	REALNAME	ROBERT NEIL QUARRY
RAY EDWARDS	REALNAME	RAYMOND JAMES EDWARDS, JR.
MATE PARLOV	REALNAME	MATE PARLOV
JIM HALL	REALNAME	MONTAGUE JAMES FURLONG
CORNELIUS BUNDRAGE	REALNAME	CORNELIUS BUNDRAGE
DMITRY SALITA	REALNAME	DMITRIY ALEKSANDROVICH LEKHTMAN
IJEOMA EGBUNINE	REALNAME	IJEOMA EGBUNINE
SCOTT GAMMER	REALNAME	SCOTT GAMMER
ARTHUR ABRAHAM	REALNAME	AVETIK ABRAHAMYAN
VANES MARTIROSYAN	REALNAME	VANES NORIKOVICH MARTIROSYAN
MARVIS FRAZIER	REALNAME	MARVIS FRAZIER
DAVE BOY GREEN	REALNAME	DAVID ROBERT GREEN
PONGSAKLEK WONJONGKAM	REALNAME	PONGSAKORN WONJONGKAM
RAFAEL MáRQUEZ	REALNAME	RAFAEL MáRQUEZ MéNDEZ
RALF ROCCHIGIANI	REALNAME	RALF ROCCHIGIANI
JAMES MCGIRT JR.	REALNAME	JAMES ANTHONY MCGIRT
JORGE LUIS GONZáLEZ	REALNAME	JORGE LUIS GONZáLEZ
VICENTE SALDIVAR	REALNAME	VICENTE SAMUEL SALDíVAR GARCíA
ERIC AIKEN	REALNAME	ERIC AIKEN
RICKY LOPEZ	REALNAME	RICKY LóPEZ
ÓSCAR CORTéS	REALNAME	ÓSCAR OSWALDO CORTéS NAVARRO
YUTAKA NIIDA	REALNAME	YUTAKA NIIDA
MITCH GREEN	REALNAME	MITCHELL GREEN
MICHAEL CLARK	REALNAME	MICHAEL CLARK
NORBERTO BRAVO	REALNAME	NORBERTO BRAVO
GARY BALLETTO	REALNAME	GARY BALLETTO
EBO ELDER	REALNAME	EBO ELDER
STEVE FORBES	REALNAME	STEPHEN PHELIPE FORBES
FREDDY CURIEL	REALNAME	FREDDY CURIEL
GRADY BREWER	REALNAME	GRADY BREWER
FABRICE TIOZZO	REALNAME	FABRICE TIOZZO
MASAMORI TOKUYAMA	REALNAME	CHANG-SOO HONG
NOBUO NASHIRO	REALNAME	NOBUO NASHIRO
JUAN URANGO	REALNAME	JUAN FERNANDO URANGO RIVAS
TAKASHI KOSHIMOTO	REALNAME	TAKASHI KOSHIMOTO
PRINCE BADI AJAMU	REALNAME	BADI AJAMU
GAIRY ST. CLAIR	REALNAME	GAIRY ST CLAIR
JUNIOR WITTER	REALNAME	JUNIOR WITTER
FERNANDO MONTIEL	REALNAME	FERNANDO MONTIEL MARTíNEZ
TOMMY GIBBONS	REALNAME	THOMAS JOSEPH GIBBONS
IKE IBEABUCHI	REALNAME	IKEMEFULA CHARLES IBEABUCHI
MAURICE HARRIS	REALNAME	WILBUR MAURICE HARRIS
CARL WILLIAMS	REALNAME	CARL WILLIAMS
DERRICK GAINER	REALNAME	DERRICK EMORY GAINER
WALTER WRIGHT	REALNAME	WALTER WRIGHT
COREY SANDERS	REALNAME	COREY SANDERS
CHARLES SHUFFORD	REALNAME	CHARLES LAMONT SHUFFORD, JR.
ISRAEL VáZQUEZ	REALNAME	ISRAEL VáZQUEZ CASTAñEDA
LORENZO PARRA	REALNAME	LORENZO PARRA
JHONNY GONZáLEZ	REALNAME	JHONNY GONZáLEZ VERA
AL SEEGER	REALNAME	AL SEEGER
KEVIN KELLEY	REALNAME	KEVIN PHILIP KELLEY
JULIO DíAZ	REALNAME	JULIO C. DíAZ
FREDDIE ROACH	REALNAME	FREDERICK ROACH
MARK JOHNSON	REALNAME	MARCELLUS JOSEPH JOHNSON
HUGO CáZARES	REALNAME	HUGO FIDEL CáZARES
JOSé SANTA CRUZ	REALNAME	JOSé ARMANDO SANTA CRUZ
ULISES SOLíS	REALNAME	JOSé ULISES SOLíS PEREZ
VICENTE MOSQUERA	REALNAME	VICENTE EDUARDO MOSQUERA MENA
FREDDIE NORWOOD	REALNAME	FREDDIE NORWOOD
OMAR NARVáEZ	REALNAME	OMAR ANDRéS NARVáEZ
AL COLE	REALNAME	ALFRED RUDOLPH COLE
JOHNATHON BANKS	REALNAME	JOHNATHON MAURICE BANKS
DERRICK JEFFERSON	REALNAME	DERRICK LAVON JEFFERSON
TONY THOMPSON	REALNAME	ANTHONY TYRONE THOMPSON
VAUGHN BEAN	REALNAME	VAUGHN BEAN
ÓSCAR LARIOS	REALNAME	OSCAR LARIOS
YUDEL JOHNSON	REALNAME	YUDEL JHONSON CEDENO
TIM AUSTIN	REALNAME	TIMOTHY AUSTIN
DAVID DEFIAGBON	REALNAME	DAVID DEJIRO DEFIAGBON
RICARDO WILLIAMS	REALNAME	RICARDO WILLIAMS JR.
SIMON BROWN	REALNAME	SIMON BROWN
LAURENT BOUDOUANI	REALNAME	LAURENT BOUDOUANI
BRAHIM ASLOUM	REALNAME	BRAHIM ASLOUM
ALEKSANDR MIROSHNICHENKO	REALNAME	ALEKSANDR VIKTOROVICH
ALEKSANDR MIROSHNICHENKO	REALNAME	MIROSHNICHENKO
OMAR NIñO ROMERO	REALNAME	OMAR NIñO ROMERO
YURIORKIS GAMBOA	REALNAME	YURIORKIS GAMBOA TOLEDANO
PATRIZIO OLIVA	REALNAME	PATRIZIO OLIVA
DANIEL JUDAH	REALNAME	DANIEL HARVEY JUDAH
VIOREL SIMION	REALNAME	VIOREL SIMION
ORLIN NORRIS	REALNAME	ORLIN LEVANCE NORRIS
JIMMY THUNDER	REALNAME	JAMES PEAU
MIKE HUNTER	REALNAME	MIKE HUNTER
MONTELL GRIFFIN	REALNAME	MONTELL JULIAN GRIFFIN
REGGIE JOHNSON	REALNAME	REGGIE DWAYNE JOHNSON
ANDREAS KOTELNIK	REALNAME	ANDRIY KOTELNYK
SINAN ŞAMIL SAM	REALNAME	SINAN ŞAMIL SAM
HéCTOR LóPEZ	REALNAME	HéCTOR LóPEZ COLíN
PABLO CHACóN	REALNAME	JULIO PABLO CHACóN
VITALI TAJBERT	REALNAME	VITALIJ TAJBERT
LAWRENCE CLAY-BEY	REALNAME	LAWRENCE MARVIN CLAY-BEY
OWEN BECK	REALNAME	OWEN LEFRANC BECK
TIMUR IBRAGIMOV	REALNAME	TIMUR IBRAGIMOV
CEDRIC BOSWELL	REALNAME	CEDRIC BOSWELL
FRES OQUENDO	REALNAME	FRES OQUENDO
LAKVA SIM	REALNAME	DUGARBAATARYN LKHAGVA
SAúL MONTANA	REALNAME	SAúL MONTANA
OBED SULLIVAN	REALNAME	OBED BENJAMIN SULLIVAN
JEREMY BATES	REALNAME	JEREMY BATES
BOBBY PACQUIAO	REALNAME	ALBERTO DAPIDRAN PACQUIAO
BRIAN MINTO	REALNAME	BRIAN MATTHEW MINTO
VINNY MADDALONE	REALNAME	VINCENT MADDALONE
DENIS BOYTSOV	REALNAME	DENIS NIKOLAYEVICH BOYTSOV
VOLODYMYR VIRCHIS	REALNAME	Володимир Вірчіс
ANDRE PURLETTE	REALNAME	ANDRE PURLETTE
ELIECER CASTILLO	REALNAME	ELIESER RAMOS CASTILLO
BUSTER MATHIS JR.	REALNAME	BUSTER DAMATO MATHIS
LOUIS MONACO	REALNAME	LOUIS MONACO
CLIFF COUSER	REALNAME	CLIFFORD EUGENE COUSER
MALCOLM TANN	REALNAME	MALCOLM EARL TANN
PHIL JACKSON	REALNAME	PHIL JACKSON
FRIDAY AHUNANYA	REALNAME	FRIDAY CHINEDU AHUNANYA
DARROLL WILSON	REALNAME	DARROLL LAMONT WILSON
DANIEL SANTOS	REALNAME	DANIEL SANTOS PEñA
RAúL MáRQUEZ	REALNAME	RAúL MáRQUEZ
BYRON MITCHELL	REALNAME	BYRON DEANGELO-TARONE MITCHELL
ÉRIC LUCAS	REALNAME	ÉRIC LUCAS
TRAVIS SIMMS	REALNAME	TRAVIS SIMMS
HARRY SIMON	REALNAME	HARRY SIMON
ISRAEL HéCTOR PEREZ	REALNAME	ISRAEL HECTOR ENRIQUE PEREZ
JULIO CéSAR VáSQUEZ	REALNAME	JULIO CéSAR VáSQUEZ
VERNO PHILLIPS	REALNAME	VERNO JEREMIAS PHILLIPS
JULIO CéSAR GARCíA	REALNAME	JULIO CéSAR GARCíA
KEITH HOLMES	REALNAME	KEITH PICKETT HOLMES
CARLOS TAKAM	REALNAME	ARMAND CARLOS NETSING TAKAM
WILLIAM GUTHRIE	REALNAME	WILLIAM DOUGLAS GUTHRIE
QUINCY TAYLOR	REALNAME	QUINCY TAYLOR
STEVE LITTLE	REALNAME	STEVEN K. LITTLE
HERCULES KYVELOS	REALNAME	HERCULES KYVELOS
STEVIE JOHNSTON	REALNAME	STEVEN EARL JOHNSTON
VINCE PHILLIPS	REALNAME	VINCENT EDWARDS PHILLIPS
TERRON MILLETT	REALNAME	TERRON MILLETT
LOU DEL VALLE	REALNAME	LOUIS DEL VALLE
CARLOS GABRIEL SALAZAR	REALNAME	CARLOS GABRIEL SALAZAR
ALEJANDRO GARCíA	REALNAME	ALEJANDRO GARCíA HERNáNDEZ
BRONCO MCKART	REALNAME	BRONCO BANYON MCKART
TONY WILLIS	REALNAME	ANTHONY WILLIS
HACINE CHERIFI	REALNAME	HACINE CHERIFI
DENNIS ANDRIES	REALNAME	DENNIS ANDRIES
JOEY SPINA	REALNAME	JOE SPINA
SANTIAGO SAMANIEGO	REALNAME	SANTIAGO RYCE SAMANIEGO
PAUL JONES	REALNAME	PAUL JONES
CARL FROCH	REALNAME	CARL MARTIN FROCH
GABRIEL RUELAS	REALNAME	GABRIEL RUELAS
BRIAN MITCHELL	REALNAME	BRIAN MITCHELL
RODOLFO GONZáLEZ	REALNAME	RODOLFO GONZáLEZ
TIGER FLOWERS	REALNAME	THEODORE FLOWERS
KRZYSZTOF KOSEDOWSKI	REALNAME	KRZYSZTOF KAZIMIERZ KOSEDOWSKI
RYAN BARRETT	REALNAME	RYAN BARRETT
ROBERT GUERRERO	REALNAME	ROBERT JOSEPH GUERRERO
SOULEYMANE M'BAYE	REALNAME	SOULEYMANE M'BAYE
JOE BERNSTEIN	REALNAME	YOUSELLE BERNSTEIN
ORLANDO CANIZALES	REALNAME	ORLANDO CANIZALES
ANDREW LEWIS	REALNAME	ANDREW LEWIS
LUISITO ESPINOSA	REALNAME	LUISITO PIO ESPINOSA
GREG HAUGEN	REALNAME	GREG LEE HAUGEN
DANIEL ZARAGOZA	REALNAME	DANIEL ZARAGOZA
ANDRE ANDERSON	REALNAME	FRED ROESENILERN
BILL BRENNAN	REALNAME	WILHELM SCHENCK
FRANK MORAN	REALNAME	CHARLES FRANCIS MORAN
EDDIE MACHEN	REALNAME	EDWARD MILLS MACHEN
LONNIE SMITH	REALNAME	HARLAN ALONSO SMITH
FRANK KLAUS	REALNAME	FRANCIS KLAUS
ANTONIO CERMEñO	REALNAME	ANTONIO JOSé VERDú CERMAK
JACK ROOT	REALNAME	JANOS RUTHALY
GEORGE CHIP	REALNAME	GEORGE CHIPULONIS
MANUEL ORTIZ	REALNAME	MANUEL ORTIZ
FREDDIE MILLER	REALNAME	FREDDIE MILLER
MIKE GIBBONS	REALNAME	MICHAEL J. GIBBONS
JIMMY ELLIOTT	REALNAME	JIMMY ELLIOT
MIKE O'DOWD	REALNAME	MICHAEL JOSEPH O'DOWD
PETER MAHER	REALNAME	PETER MAHER
TRACY HARRIS PATTERSON	REALNAME	TRACY HARRIS PATTERSON
KELCIE BANKS	REALNAME	KELCIE HERRON BANKS
ALEXANDER IRELAND	REALNAME	ALEXANDER IRELAND
REMIGIO MOLINA	REALNAME	REMIGIO DANIEL MOLINA
CRISTIAN MIJARES	REALNAME	CRISTIAN RICARDO LUCIO MIJARES
CHI IN-JIN	REALNAME	CHI IN-JIN
CASSIUS BALOYI	REALNAME	PONANI CASSIUS BALOYI
GUTY ESPADAS JR.	REALNAME	GUSTAVO ESPINOSA ESPADAS JR.
STEVE CRUZ	REALNAME	ESTEVAN CRUZ JR
MORRIS EAST	REALNAME	MORRIS EAST
SHINJI TAKEHARA	REALNAME	SHINJI TAKEHARA
VALDEMIR PEREIRA	REALNAME	VALDEMIR PEREIRA
BERNARD DUNNE	REALNAME	BERNARD DUNNE
CHARLIE NASH	REALNAME	CHARLES NASH
MIKE MCTIGUE	REALNAME	MICHAEL FRANCIS MCTIGUE
BATTLING LEVINSKY	REALNAME	BARNEY LEBROWITZ
JASON LITZAU	REALNAME	JASON JOHN LITZAU
JAY NADY	REALNAME	JAY NADY
ROBBIE MURRAY	REALNAME	ROBERT MURRAY
DAVE CHARNLEY	REALNAME	DAVID FRASER CHARNLEY
ANDY MURRAY	REALNAME	ANDREW MURRAY
DAMAEN KELLY	REALNAME	DAMAEN KELLY
SOLLY KRIEGER	REALNAME	SOLLY KRIEGER
BILLY SCHWER	REALNAME	BILLY SCHWER
ANTHONY PETERSON	REALNAME	ANTHONY PETERSON
KELLY PAVLIK	REALNAME	KELLY ROBERT PAVLIK
KID DIAMOND	REALNAME	ALMAZBEK RAIYMKULOV
PAUL PENDER	REALNAME	PAUL PENDER
NEIL SINCLAIR	REALNAME	NEIL SINCLAIR
DANELL NICHOLSON	REALNAME	DANELL NICHOLSON
KELSON PINTO	REALNAME	KELSON CARLOS PINTO
STEVE EARLY	REALNAME	STEVE EARLY
YURI ARBACHAKOV	REALNAME	YURI YAKOVLEVICH ARBACHAKOV
JAMES MOORE	REALNAME	JAMES MOORE
OISIN FAGAN	REALNAME	OISíN SEAN FAGAN
ORLANDO SALIDO	REALNAME	ORLANDO SALIDO RIVERA
RICARDO MORENO	REALNAME	RICARDO MORENO ESCAMILLA
ANTONIO ESPARRAGOZA	REALNAME	ANTONIO ESPARRAGOZA
KATSUNARI TAKAYAMA	REALNAME	KATSUNARI TAKAYAMA
CHAZZ WITHERSPOON	REALNAME	CHAZZ WITHERSPOON
KATSUSHIGE KAWASHIMA	REALNAME	KATSUSHIGE KAWASHIMA
NICKY PIPER	REALNAME	NICKY PIPER
TERENCE SPINKS	REALNAME	TERENCE SPINKS
JACK THOMPSON	REALNAME	CECIL LEWIS THOMPSON
RICARDO TORRES	REALNAME	RICARDO ANTONIO TORRES TAFUR
NEHOMAR CERMEñO	REALNAME	NEHOMAR ANDRéS CERMEñO
JOACHIM ALCINE	REALNAME	JOACHIM ALCINE
EDDIE MUSTAFA MUHAMMAD	REALNAME	EDDIE MUSTAFA MUHAMMAD
BUDDY DAYE	REALNAME	DELMORE WILLIAM DAYE
ZURI LAWRENCE	REALNAME	ZURI LAWRENCE
STEPHANIE JARAMILLO	REALNAME	STEPHANIE JARAMILLO
ROSENDO ÁLVAREZ	REALNAME	ROSENDO JOSé ÁLVAREZ HERNáNDEZ
ERIC FIELDS	REALNAME	ERIC FIELDS
JOSé MARíA GATICA	REALNAME	JOSé MARíA GATICA
JOAN TIPON	REALNAME	JOAN TIPON
KARL MILDENBERGER	REALNAME	KARL MILDENBERGER
TRAVIS WALKER	REALNAME	TRAVIS WALKER
VIJENDER SINGH	REALNAME	VIJENDER SINGH BENIWAL
CHARLIE MAGRI	REALNAME	CHARLIE MAGRI
MARIANO NATALIO CARRERA	REALNAME	MARIANO NATALIO CARRERA
ARMAND KRAJNC	REALNAME	ARMAND KRAJNC
DENNIS MILTON	REALNAME	DENNIS MILTON
MATT GODFREY	REALNAME	MATT GODFREY
JAIDON CODRINGTON	REALNAME	JAIDON OLAJUWON CODRINGTON
BJ FLORES	REALNAME	BENJAMIN FLORES
BENJAMIN BRAIN	REALNAME	BENJAMIN BRAIN
MELISSA HERNáNDEZ	REALNAME	MELISSA HERNáNDEZ
PHILADELPHIA JACK O'BRIEN	REALNAME	JAMES FRANCIS HAGEN
ISMAEL LAGUNA	REALNAME	ISMAEL LAGUNA MENESES
JOE MANLEY	REALNAME	JOE LOUIS MANLEY, JR.
LOUIS SALICA	REALNAME	LUIGI SALICA
BOB BAKER	REALNAME	ROBERT BAKER
NIñO VALDéS	REALNAME	GERALDO RAMOS PONCIANO VALDéS
TAKANORI HATAKEYAMA	REALNAME	TAKANORI HATAKEYAMA
ROBERT GARCIA	REALNAME	ROBERTO GARCIA CORTEZ
ANTHONY THOMPSON	REALNAME	ANTHONY TYRONE THOMPSON
LARRY MOSLEY	REALNAME	LARRY DENNIS MOSLEY
KOICHI WAJIMA	REALNAME	KOICHI WAJIMA
JORGE VACA	REALNAME	JORGE VACA
ARTURO MORUA	REALNAME	ARTURO MORUA
LENIN ARROYO	REALNAME	LENIN ARROYO
REGGIE STRICKLAND	REALNAME	REGGIE STRICKLAND
JIMMY SLATTERY	REALNAME	JAMES EDWARD SLATTERY
JULIE KOGON	REALNAME	JULIUS KOGON
KID KAPLAN	REALNAME	LOUIS KAPLAN
DAVID OBREGóN	REALNAME	JOSé DAVID OBREGóN
JIMMY WARNOCK	REALNAME	JAMES WARNOCK
YOAN PABLO HERNáNDEZ	REALNAME	YOAN PABLO HERNáNDEZ SUáREZ
JUAN MANUEL LóPEZ	REALNAME	JUAN MANUEL LóPEZ RIVERA
MATTHEW HATTON	REALNAME	MATTHEW JAMES HATTON
ANTON CHRISTOFORIDIS	REALNAME	Αντώνης Χριστοφορίδης
MATT VANDA	REALNAME	MATT VANDA
ANTHONY SMALL	REALNAME	ANTHONY SMALL
SAMAN SORJATURONG	REALNAME	SAMAN SRIPRATED
RINTY MONAGHAN	REALNAME	JOHN JOSEPH MONAGHAN
JACK PETERSEN	REALNAME	JOHN CHARLES PETERSON
TED %22KID%22 LEWIS	REALNAME	GERSHON MENDELOFF
JACK DILLON	REALNAME	ERNEST CUTLER PRICE
TEDDY YAROSZ	REALNAME	THADDEUS YAROSZ
JIMMY BIVINS	REALNAME	JAMES LOUIS BIVINS
BILLY GRAHAM	REALNAME	WILLIAM WALTER GRAHAM JR.
FRED BRETONNEL	REALNAME	FRED BRETONNEL
MUSHY CALLAHAN	REALNAME	VINCENT MORRIS SCHEER
PINKY MITCHELL	REALNAME	MYRON HERBERT MITCHELL
JOHNNY WILLIAMS	REALNAME	JOHNNY WILLIAMS
WILLIAM ABELYAN	REALNAME	WILLIAM ABELYAN
NICK BURLEY	REALNAME	NICHOLAS BAROVICH
ARTHUR CHAMBERS	REALNAME	ARTHUR CHAMBERS
JOHN CLARK	REALNAME	JOHN H. CLARK
MIKE CLEARY	REALNAME	MIKE CLEARY
PAULUS AMBUNDA	REALNAME	PAULUS NATANGWE AMBUNDA
GEORGE %22ELBOWS%22 MCFADDEN	REALNAME	GEORGE MCFADDEN
JIMMY BARRY	REALNAME	JIMMY BARRY
JUAN CARLOS PAYANO	REALNAME	JUAN CARLOS PAYANO
ALI ISMAYILOV	REALNAME	ƏLI ŞAMIL İSMAYıLOV
FéLIX DíAZ	REALNAME	FéLIX MANUEL DíAZ GUZMAN
VICTOR BISBAL	REALNAME	VICTOR JOSé BISBAL MELERO
SERGEY ROZHNOV	REALNAME	SERGEY ROZHNOV
ABNER MARES	REALNAME	ABNER MARES MARTíNEZ
ALFREDO ANGULO	REALNAME	ALFREDO ANGULO LóPEZ
DOMINICK MCCAFFREY	REALNAME	DOMINICK MCCAFFREY
JACK MCAULIFFE	REALNAME	JACK MCAULIFFE
ALEXANDER ALEXEEV	REALNAME	ALEXANDER VYACHESLAVOVICH ALEKSEEV
CRAIG MCEWAN	REALNAME	CRAIG MACINTOSH MCEWAN
VALERY BRUDOV	REALNAME	VALERY BRUDOV
NATE CAMPBELL	REALNAME	NATHANIEL CAMPBELL III
MICHAEL KATSIDIS	REALNAME	MICHAEL ALAN KATSIDIS
ALEJANDRO BERRIO	REALNAME	ALEJANDRO BERRIO HERNáNDEZ
VíCTOR BURGOS	REALNAME	JOSé VíCTOR FLORES BURGOS
ARTIE LEVINE	REALNAME	ARTHUR LINDSLEY LEVIEN
PETER BODDINGTON	REALNAME	PETER BODDINGTON
WALTER MCGOWAN	REALNAME	WALTER MCGOWAN
JEFF THOMAS	REALNAME	JEFF CHARLES THOMAS
DAVEY ARMSTRONG	REALNAME	DAVEY LEE ARMSTRONG
SCOTT LEDOUX	REALNAME	ALAN SCOTT LEDOUX
PETER MCDONAGH	REALNAME	PETER MCDONAGH
EAMONN LOUGHRAN	REALNAME	EAMONN LOUGHRAN
ROBBIE SIMS	REALNAME	ROBBIE SIMS
PETER BUCKLEY	REALNAME	PETER BUCKLEY
HENRY COYLE	REALNAME	HENRY COYLE
MICHAEL BRODIE	REALNAME	MICHAEL BRODIE
MARTIN CONCEPCION	REALNAME	MARTIN CONCEPCION
ROSS MINTER	REALNAME	ROSS MINTER
COLIN MCNEIL	REALNAME	COLIN MCNEIL
DEREK ROCHE	REALNAME	DEREK ROCHE
PAUL BUCHANAN	REALNAME	PAUL BUCHANAN
NIGEL WRIGHT	REALNAME	NIGEL WRIGHT
PAUL SMITH	REALNAME	PAUL SMITH JR.
LIBRADO ANDRADE	REALNAME	LIBRADO ANDRADE ORNELAS
MALIK SCOTT	REALNAME	DOHONNA MALIK SCOTT
TAKALOO	REALNAME	MERDUD TAKALOBIGASHI
ANTHONY HANSHAW	REALNAME	ANTHONY LAVAR HANSHAW
STEVE CUNNINGHAM	REALNAME	STEVEN ORMAIN CUNNINGHAM
TAKEFUMI SAKATA	REALNAME	TAKEFUMI SAKATA
ERISLANDY LARA	REALNAME	ERISLANDY LARA SANTOYA
DARNELL WILSON	REALNAME	DARNELL WILSON
JOHNNY BREDAHL	REALNAME	JOHNNY BREDAHL JOHANSEN
ERNIE SCHAAF	REALNAME	ERNIE SCHAAF
BOB MIROVIC	REALNAME	BOB MIROVIC
ALONZO BUTLER	REALNAME	ALONZO BUTLER
TED LOWRY	REALNAME	TED LOWRY
KOBA GOGOLADZE	REALNAME	კობა გოგოლაძე
LEE SAVOLD	REALNAME	LEE HULVER
SUSIANNA KENTIKIAN	REALNAME	SUSIANNA LEVONOVNA KENTIKIAN
DAVID KOTEI	REALNAME	DAVID KOTEY
RATANACHAI SOR VORAPIN	REALNAME	CHAIYA POTHANG
RATANAPOL SOR VORAPIN	REALNAME	PREECHA CHAROENTHADA
RATANAPOL SOR VORAPIN	REALNAME	ANUCHA PHOTHONG
GEORGE GODFREY	REALNAME	GEORGE GODFREY
AL SINGER	REALNAME	ABRAHAM SINGER
BENNY BASS	REALNAME	BENJAMIN BARUCH J. BASS
JACK BERNSTEIN	REALNAME	JOHN DODICK
CHARLIE PHIL ROSENBERG	REALNAME	CHARLES GREEN
ISADORE SCHWARTZ	REALNAME	ISADORE SCHWARTZ
HARRY LEWIS	REALNAME	HENRY BESTERMAN
HARRY HARRIS	REALNAME	HARRY HARRIS
LEW TENDLER	REALNAME	LEW TENDLER
JULIUS FOGLE	REALNAME	JULIUS FOGLE
VEERAPHOL SAHAPROM	REALNAME	THEERAPHOL SAMRANKLANG
JOICHIRO TATSUYOSHI	REALNAME	JOICHIRO TATSUYOSHI
SID TERRIS	REALNAME	SYDNEY TERRIS
GUTS ISHIMATSU	REALNAME	YUJI SUZUKI
JORGE SOLíS	REALNAME	JORGE LUIS SOLIS RIVERA
MAXIE BERGER	REALNAME	MAXIE BERGER
BENNY GOLDBERG	REALNAME	BENJAMIN GOLDBERG
ÉDGAR SOSA	REALNAME	ÉDGAR ALEJANDRO SOSA MEDINA
CHRIS ARREOLA	REALNAME	CRISTOBAL ARREOLA
KATSUYA ONIZUKA	REALNAME	TAKASHI ONIZUKA
HIROKI IOKA	REALNAME	HIROKI IOKA
EDDIE CHAMBERS	REALNAME	EDWARD CHAMBERS
FREDDIE PENDLETON	REALNAME	FREDDIE PENDLETON
AKINOBU HIRANAKA	REALNAME	NOBUAKI HIRANAKA
WILFREDO NEGRóN	REALNAME	WILFREDO NEGRON
DIEGO MORALES	REALNAME	DIEGO ADáN MORALES
LOU BROUILLARD	REALNAME	LUCIEN PIERRE BROUILLARD
ŽELJKO MAVROVIć	REALNAME	ŽELJKO MAVROVIć
CELES KOBAYASHI	REALNAME	SHOJI KOBAYASHI
TUFFY GRIFFITHS	REALNAME	GERALD AMBROSE GRIFFITHS
RENALDO SNIPES	REALNAME	REENAOLD SNIPES
JOHNNY DU PLOOY	REALNAME	JOHNNY DU PLOOY
STIPE DREWS	REALNAME	STIPE DRVIš
VICENTE RONDóN	REALNAME	VICENTE PAUL RONDóN
HéCTOR JAVIER VELAZCO	REALNAME	HéCTOR JAVIER VELAZCO
GORILLA JONES	REALNAME	WILLIAM LANDON JONES
SAMMY LUFTSPRING	REALNAME	SAMMY LUFTSPRING
Z GORRES	REALNAME	ZETA CELESTINO OLIVEROS GORRES
YASUEI YAKUSHIJI	REALNAME	YASUEI YAKUSHIJI
HIDEYUKI OHASHI	REALNAME	HIDEYUKI OHASHI
MARIO PRESKAR	REALNAME	MARIO PRESKAR
HIDEKI TODAKA	REALNAME	HIDEKI TODAKA
KATSUO TOKASHIKI	REALNAME	KATSUO TOKASHIKI
DAIKI KAMEDA	REALNAME	DAIKI KAMEDA
TOMOKI KAMEDA	REALNAME	TOMOKI KAMEDA
BATTLING NELSON	REALNAME	OSCAR MATHæUS NIELSEN
JUAN CARLOS GIMéNEZ FERREYRA	REALNAME	JUAN CARLOS GIMENEZ FERREYRA
JOE BAKSI	REALNAME	JOSEPH WILLIAM BAKSI
MIKE WILLIAMS	REALNAME	MICHAEL WILLIAMS
GLENN MCCRORY	REALNAME	GLENN MCCRORY
MANDO RAMOS	REALNAME	ARMANDO RAMOS
MASAO OHBA	REALNAME	MASAO OHBA
JUAN SANTIAGO	REALNAME	JUAN SANTIAGO
DARREN CORBETT	REALNAME	DARREN CORBETT
YOSHIO SHIRAI	REALNAME	YOSHIO SHIRAI
TAKESHI FUJI	REALNAME	PAUL TAKESHI FUJII
MASASHI KUDO	REALNAME	MASASHI KUDO
KUNIAKI SHIBATA	REALNAME	KUNIAKI SHIBATA
HIROSHI KAWASHIMA	REALNAME	HIROSHI KAWASHIMA
VICENTE ESCOBEDO	REALNAME	VICENTE ESCOBEDO
KEN OVERLIN	REALNAME	KEN OVERLIN
STEVE BENDALL	REALNAME	STEVEN BENDALL
SHOZO SAIJO	REALNAME	SHOZO SAIJO
SIMONE MALUDROTTU	REALNAME	SIMONE MALUDROTTU
NOEL MAGEE	REALNAME	NOEL MAGEE
RAY CLOSE	REALNAME	RAY CLOSE
SAM STOREY	REALNAME	SAM STOREY
PAUL HODKINSON	REALNAME	PAUL HODKINSON
TERRY MAGEE	REALNAME	TERRY MAGEE
TARAS BIDENKO	REALNAME	Тарас Біденко
DONNELL HOLMES	REALNAME	DONNELL HOLMES
CHARLEY FUSARI	REALNAME	CALOGERO FUSARI
FRANCISCO FIGUEROA	REALNAME	FRANCISCO FIGUEROA
ROCKY CASTELLANI	REALNAME	ATTILLIO CASTELLANI
DEONTAY WILDER	REALNAME	DEONTAY LESHUN WILDER
DENNIS BAKHTOV	REALNAME	DENIS BAKHTOV
JAVIER MOLINA	REALNAME	JAVIER MOLINA
NANA KONADU	REALNAME	NANA YAW KONADU YEBOAH
NAPA KIATWANCHAI	REALNAME	SUWIT SAE-TANG
MICHAEL HUNTER	REALNAME	MICHAEL HUNTER, JR.
CARL THOMPSON	REALNAME	ADRIAN CARL THOMPSON
JAMES RED HERRING	REALNAME	JAMES BRYAN HERRING
SEBASTIAN SYLVESTER	REALNAME	SEBASTIAN SYLVESTER
ROMAN ARAMIAN	REALNAME	ROMAN ARAMIAN
ALEXANDER AWDIJAN	REALNAME	ALICHAN AWDIJAN
LEVAN KIRAKOSYAN	REALNAME	LEVAN KIRAKOSYAN
FIRAT ARSLAN	REALNAME	FIRAT ARSLAN
JUAN CARLOS REVECO	REALNAME	JUAN CARLOS REVECO
TONY GRANO	REALNAME	TONY GRANO
ZAURBEK BAYSANGUROV	REALNAME	ZAURBEK BAYSANGUROV
MARION WILSON	REALNAME	MARION WILSON
MARIO SANTIAGO	REALNAME	MARIO SANTIAGO FIGUEROA
WAYNE JOHNSEN	REALNAME	WAYNE JOHNSEN
RONNIE CLAYTON	REALNAME	RONNIE CLAYTON
BATTLING SHAW	REALNAME	JOSé PéREZ FLORES
JOHNNY JADICK	REALNAME	JOHN J. JADICK
JOE ERSKINE	REALNAME	JOSEPH HAROLD ERSKINE
NONITO DONAIRE	REALNAME	NONITO GONZALES DONAIRE JR.
FLORANTE CONDES	REALNAME	FLORANTE CONDES, JR.
MEDGOEN SINGSURAT	REALNAME	BOONSAI SANGSURAT
JULIEN LORCY	REALNAME	JULIEN LORCY
YOUNG STRIBLING	REALNAME	WILLIAM LAWRENCE STRIBLING JR.
DAISUKE NAITO	REALNAME	DAISUKE NAITO
PINKY SILVERBERG	REALNAME	PINCUS SILVERBERG
ROLANDO BOHOL	REALNAME	ROLANDO BOHOL
CORN GRIFFIN	REALNAME	JOHN GRIFFIN
ALEX DE JESúS	REALNAME	ALEXANDER DE JESúS
WILFREDO VáZQUEZ JR.	REALNAME	WILFREDO VáZQUEZ JR.
GUTY ESPADAS	REALNAME	GUSTAVO HERNAN ESPADAS CRUZ
SANDY FERGUSON	REALNAME	JOHN H. FERGUSON
JORGE LINARES	REALNAME	JORGE LUIS LINARES PALENCIA
MAUREEN SHEA	REALNAME	MAUREEN CARRANZA SHEA
ELIO ROJAS	REALNAME	ELIO ENAI ROJAS
HUGO GARAY	REALNAME	HUGO HERNáN GARAY
DAVID RODRIGUEZ	REALNAME	DAVID RODRIGUEZ
GLENN DONAIRE	REALNAME	GLENN GONZALES DONAIRE
MARY JO SANDERS	REALNAME	MARY JO SANDERS
BAEK IN-CHUL	REALNAME	BAEK IN-CHUL
ERIC MOREL	REALNAME	ERIC ARTURO MOREL
BUCK SMITH	REALNAME	BUCK SMITH
JOE GREENE	REALNAME	JOE GREENE
DIOSDADO GABI	REALNAME	DIOSDADO GABI
GERRY PEñALOSA	REALNAME	GERONIMO PEñALOSA
DODIE BOY PEñALOSA	REALNAME	DIOSDADO PEñALOSA
KINGSLEY IKEKE	REALNAME	KINGSLEY IKEKE
REYNALDO BAUTISTA	REALNAME	REYNALDO BAUTISTA
DIOSBELYS HURTADO	REALNAME	DIOSBELYS HURTADO
DANNY SANTIAGO	REALNAME	DANNY SANTIAGO
BRIAN VERA	REALNAME	BRYAN LEE VERA
JEAN PASCAL	REALNAME	JEAN-THENISTOR PASCAL
EUGèNE CRIQUI	REALNAME	EUGèNE CRIQUI
LUIS YáñEZ	REALNAME	LUIS YáñEZ
QUANTIS GRAVES	REALNAME	QUANTIS GRAVES
DIDIER BENCE	REALNAME	DIDIER BENCE
RICARDO ARREDONDO	REALNAME	RICARDO ARREDONDO
DEMETRIUS ANDRADE	REALNAME	DEMETRIUS CESAR ANDRADE
CHARLES PIERCE DAVEY	REALNAME	CHARLES PIERCE DAVEY
DERYA AKTOP	REALNAME	DERYA AKTOP AKı
NURCAN ÇARKçı	REALNAME	NURCAN ÇARKçı GöKSEL
FULGENCIO ZúñIGA	REALNAME	FULGENCIO ZúñIGA
ELOY ROJAS	REALNAME	ELOY DAVID ROJAS LEANDRO
CHRIS FINNEGAN	REALNAME	CHRISTOPHER MARTIN FINNEGAN
KHOREN GEVOR	REALNAME	KHOREN GEVORGYAN
KIRKLAND LAING	REALNAME	KIRKLAND LAING
YOSHIAKI NUMATA	REALNAME	YOSHIAKI NUMATA
AD WOLGAST	REALNAME	ADOLPHUS WOLGAST
JEAN BAPTISTE MENDY	REALNAME	JEAN-BAPTISTE MENDY
ARTUR GRIGORIAN	REALNAME	ARTUR GRIGORYAN
HüLYA ŞAHIN	REALNAME	HüLYA ŞAHIN
MARIJAN BENEš	REALNAME	MARIJAN BENEš
A. J. BANAL	REALNAME	ALEX JOHN BANAL
ATTILA LEVIN	REALNAME	ATTILA SHERIFF ALEXANDER LEVIN
LEE SALA	REALNAME	LEE SALA
DONNIE NIETES	REALNAME	DONNIE LIBOON NIETES
JOEY ABELL	REALNAME	JOEY ABELL
ZACH WALTERS	REALNAME	ZACH WALTERS
CALEB TRUAX	REALNAME	CALEB TRUAX
ANDY KOLLE	REALNAME	ANDY KOLLE
ART ARAGON	REALNAME	ARTHUR BENJAMIN ARAGON
PADDY DEMARCO	REALNAME	PADDY DEMARCO
EDDIE CAMPAGNUOLO	REALNAME	EDWARD CAMPAGNUOLO
AKAASH BHATIA	REALNAME	AKAASH BHATIA
DIMITRI KIRILOV	REALNAME	DIMITRI KIRILOV
JOHNNY BRATTON	REALNAME	JOHNNY BRATTON
CéSAR BAZáN	REALNAME	CéSAR BAZáN PéREZ
YUH MYUNG-WOO	REALNAME	YUH MYUNG-WOO
OLIVIA SPIKER	REALNAME	OLIVIA SPIKER
FIDEL ORTIZ	REALNAME	FIDEL ORTIZ TOVAR
BILLY WALKER	REALNAME	WILLIAM WALKER
EVA WAHLSTRöM	REALNAME	EVA ULRIKA BIRGITTA WAHLSTRöM
RAFAEL HERRERA	REALNAME	RAFAEL HERRERA
LAURENT DAUTHUILLE	REALNAME	LAURENT DAUTHUILLE
GEORGE GARDINER	REALNAME	GEORGE GARDINER
KUBRAT PULEV	REALNAME	KUBRAT VENKOV PULEV
BERT BATAWANG	REALNAME	BERTOLDO BATAWANG, JR.
ALFONSO BLANCO	REALNAME	ALFONSO BLANCO PARRA
WILLIE HARMON	REALNAME	HERMAN EISMAN
VYACHESLAV GLAZKOV	REALNAME	VYACHESLAV VALERIYOVYCH GLAZKOV
ARTUR BETERBIEV	REALNAME	ARTUR ASILBEKOVICH BETERBIEV
RAKHIM CHAKHKIEV	REALNAME	RAKHIM RUSLANOVICH CHAKHKIEV
MATT KOROBOV	REALNAME	MATVEY GEORGIYEVICH KOROBOV
ALFREDO EVANGELISTA	REALNAME	ALFREDO EVANGELISTA
ZHANG ZHILEI	REALNAME	张 志磊
JOE MURRAY	REALNAME	JOSEPH MURRAY
MCJOE ARROYO	REALNAME	MCJOE ARROYO ACEVEDO
STEFFEN KRETSCHMANN	REALNAME	STEFFEN KRETSCHMANN
MCWILLIAMS ARROYO	REALNAME	MCWILLIAMS ARROYO ACEVEDO
KEVIN FINNEGAN	REALNAME	KEVIN FINNEGAN
CARLOS CUADRAS	REALNAME	CARLOS ROBERTO CUADRAS QUIROA
RANDY GRIFFIN	REALNAME	RANDY GRIFFIN
STEPHEN HAUGHIAN	REALNAME	STEPHEN HAUGHIAN
ÓSCAR RIVAS	REALNAME	OSCAR ANDRES RIVAS TORRES
PAULUS MOSES	REALNAME	PAULUS MOSES
GUILLERMO JONES	REALNAME	GUILLERMO AGUSTIN JONES
JEAN-PIERRE COOPMAN	REALNAME	JEAN-PIERRE COOPMAN
JACK BODELL	REALNAME	JACK BODELL
LYN PHILP	REALNAME	LYNLEY V PHILP
MARCO HUCK	REALNAME	MUAMER HUKIć
THOMAS THOMAS	REALNAME	THOMAS JOHN THOMAS
KHABIB ALLAKHVERDIEV	REALNAME	KHABIB MEVLIDINOVICH ALLAKHVERDIEV
CON O'KELLY	REALNAME	GEORGE CORNELIUS O'KELLY
DAVID DOLAN	REALNAME	DAVID DOLAN
ELEIDER ÁLVAREZ	REALNAME	ELEYDER ALVAREZ BAYTAR
ISMAIL SILLAKH	REALNAME	Ісмаїл Сіллах
ERROL CHRISTIE	REALNAME	ERROL CHRISTIE
YORDANIS DESPAIGNE	REALNAME	YORDANIS DESPAIGNE HERRERA
VASYL LOMACHENKO	REALNAME	VASYL ANATOLIYOVICH LOMACHENKO
STEPHEN SMITH	REALNAME	STEPHEN FRANCIS SMITH
YURIY NUZHNENKO	REALNAME	Юрій Нужненко
HENRY BRUSELES	REALNAME	HENRY BRUSELES
EILEEN OLSZEWSKI	REALNAME	EILEEN MIYOKO KUWAYE OLSZEWSKI
JONATHAN GONZáLEZ	REALNAME	JONATHAN GONZáLEZ ORTIZ
ABNER COTTO	REALNAME	ABNER JOEL COTTO ROMáN
JOHN BALDWIN	REALNAME	JOHN LEE BALDWIN
ANTONIO ROLDáN	REALNAME	ANTONIO ROLDáN REYNA
BRUNO JULIE	REALNAME	LOUIS RICHARD BRUNO JULIE
TYSON FURY	REALNAME	TYSON LUKE FURY
PAUL SYKES	REALNAME	PAUL SYKES
MARK DELANEY	REALNAME	MARK DELANEY
CHOI YO-SAM	REALNAME	YO-SAM CHOI
PATRICK KILLEN	REALNAME	PATRICK J. KILLEN
JOE GODDARD	REALNAME	JOSEPH JOHN GODDARD
DAN FLYNN	REALNAME	DAN FLYNN
JAMES BROAD	REALNAME	JAMES W. BROAD
ROBERT HAWKINS	REALNAME	ROBERT HAWKINS
JORGE SCLARANDI	REALNAME	JORGE ANDRéS SCLARANDI
JOSé ALFARO	REALNAME	JOSé ALBERTO ALFARO GAZO
ÁNGEL LEYES	REALNAME	ÁNGEL LEONIDES LEYES
SANTA CAMARãO	REALNAME	JOSé SOARES SANTA
BABY ARIZMENDI	REALNAME	ALBERTO ARIZMENDI
JIMMI BREDAHL	REALNAME	JIMMY BREDAHL JOHANSEN
MICHI MUNOZ	REALNAME	JORGE MICHAEL MUñOZ
KIKO MARTíNEZ	REALNAME	FRANCISCO MARTíNEZ SANCHEZ
JOSé LEGRá	REALNAME	JOSé LEGRá
MYSTERIOUS BILLY SMITH	REALNAME	AMOS SMITH
MIKE ANCHONDO	REALNAME	MICHAEL ALFRED ANCHONDO
TOM PADDOCK	REALNAME	THOMAS PADDOCK
SUGAR JACKSON	REALNAME	JACKSON OSEI BONSU
WALID SMICHET	REALNAME	WALID SMICHET
SAENSAK MUANGSURIN	REALNAME	BOONSONG MANSRI
ROMáN GONZáLEZ	REALNAME	ROMáN ALBERTO GONZáLEZ LUNA
KID WILLIAMS	REALNAME	JOHN GUTENKO
JACK BLOOMFIELD	REALNAME	SOL BLUMENFELD
JOSé LUIS LóPEZ	REALNAME	JOSE LUIS LOPEZ
SAL BARTOLO	REALNAME	SALVATORE INTERBARTOLO
JOHNNY BUFF	REALNAME	JOHN LESKY
ROGéRIO LOBO	REALNAME	ROGéRIO LOBO
CLEMENTE SáNCHEZ	REALNAME	CLEMENTE SáNCHEZ
PEDRO RUBEN DECIMA	REALNAME	PEDRO RUBEN DECIMA
JULIAN WHEELER	REALNAME	JULIAN WHEELER
ISHO SHIBA	REALNAME	ISHO SHIBA
MIKE PEREZ	REALNAME	ISMAIKEL PéREZ
ARGENIS MENDEZ	REALNAME	ARGENIS ALEXANDER MéNDEZ ZAPATA
ERNESTO ESPAñA	REALNAME	ERNESTO ESPAñA
OLEG PLATOV	REALNAME	Олег Платов
BEN TACKIE	REALNAME	BENJAMIN TACKIE
ALBERT SOSNOWSKI	REALNAME	ALBERT DARIUSZ SOSNOWSKI
KEVIN MCINTYRE	REALNAME	KEVIN MCINTYRE
YURI ROMANOV	REALNAME	YURI ROMANOV
JASON MCKAY	REALNAME	JASON MCKAY
GARY JACOBS	REALNAME	GARY JACOBS
SERGIO MARTíNEZ	REALNAME	SERGIO GABRIEL MARTíNEZ
ALO KELLY	REALNAME	ALOYSIUS KELLY
TONY JEFFRIES	REALNAME	TONY DAVID JEFFRIES
PHIL MARTIN	REALNAME	PHILIP MARTIN ADELAGAN
REGGIE GROSS	REALNAME	REGINALD GROSS
JACK CULCAY-KETH	REALNAME	JACK ROBERT CULCAY-KETH
TORPEDO BILLY MURPHY	REALNAME	THOMAS WILLIAM MURPHY
MICHEL ROSALES	REALNAME	MICHEL ROSALES
JON THAXTON	REALNAME	JONATHAN THAXTON
DARLEYS PéREZ	REALNAME	DARLEYS PéREZ
DANNY GARCíA	REALNAME	DANNY OSCAR GARCíA
RANDIE CARVER	REALNAME	RANDIE DELMONT CARVER
JIMMY DOYLE	REALNAME	JAMES EMERSON DELANEY
OMAR CHáVEZ	REALNAME	OMAR ALONZO CHáVEZ CARRASCO
JOHN LOWEY	REALNAME	JOHN LOWEY
MARTIN LINDSAY	REALNAME	MARTIN LINDSAY
SILENCE MABUZA	REALNAME	SILENCE MABUZA
HIROYUKI ENOKI	REALNAME	HIROYUKI ENOKI
TAKAHIRO AO	REALNAME	TAKAHIRO AO
THOMAS MASHABA	REALNAME	THOMAS MASHABA
CHONLATARN PIRIYAPINYO	REALNAME	SURIYA TATAKHUN
PANOMROONGLEK KRATINGDAENGGYM	REALNAME	BOONSOM IAMSIRI
MALCOLM TUñACAO	REALNAME	MALCOLM ALINDAJAO TUñACAO
MIGUEL BARRERA	REALNAME	MIGUEL ANGEL BARRERA ESTRADA
JUAN LAZCANO	REALNAME	JUAN ERNESTO LAZCANO
CHATCHAI SASAKUL	REALNAME	CHATCHAI SASAKUL
WILLIE PALMS	REALNAME	WILLIAM L. PALMS
DICKY EKLUND	REALNAME	RICHARD EKLUND,JR.
ANDRZEJ WAWRZYK	REALNAME	ANDRZEJ WAWRZYK
OLEKSANDR USYK	REALNAME	Олександр Усик
LEN HARVEY	REALNAME	LEONARD AUSTEN HARVEY
SCOTT BELSHAW	REALNAME	SCOTT BELSHAW
DICK RICHARDSON	REALNAME	RICHARD ALEXANDER RICHARDSON
MAURICE CULLEN	REALNAME	MAURICE CULLEN
VINNY FEENEY	REALNAME	VINCENT FEENEY
PADDY BARNES	REALNAME	PATRICK BARNES
JOHN CONTEH	REALNAME	JOHN CONTEH
ADONIS RIVAS	REALNAME	ADONIS ANTONIO RIVAS ORDóñEZ
AL MELLO	REALNAME	ALFONS TAVARES
CHARLIE PURDY	REALNAME	CHARLES FRANCIS PURDY
JACK BLACKBURN	REALNAME	CHARLES HENRY BLACKBURN
JACK LONDON	REALNAME	JOHN GEORGE HARPER
BILLY COLLINS, JR.	REALNAME	WILLIAM RAY COLLINS, JR.
JOHN JACKSON	REALNAME	JOHN JACKSON
DAVID JACO	REALNAME	DAVID LEE JACO
JESUS SALUD	REALNAME	JESUS YAGIN SALUD
CARLOS NEGRóN	REALNAME	CARLOS JOSé NEGRóN COLóN
ÓSCAR VALDEZ	REALNAME	ÓSCAR RAFAEL VALDEZ FIERRO
JOE CALZAGHE	REALNAME	JOSEPH WILLIAM CALZAGHE
GOLDEN JOHNSON	REALNAME	GOLDEN DEMOND JOHNSON
FRANK TOLEDO	REALNAME	FRANK TOLEDO
MARTIN KRISTJANSEN	REALNAME	MARTIN KRISTJANSEN
STEFANO ZOFF	REALNAME	STEFANO ZOFF
ROSS PURITTY	REALNAME	ROSS PURITTY
MICKEY VANN	REALNAME	MICHAEL VAN NORMAN
CHOI TSEVEENPUREV	REALNAME	CHOIJILJAVYN TSEVEENPüREV
DERRY MATHEWS	REALNAME	DERRY MATHEWS
MAC FOSTER	REALNAME	MACARTHUR FOSTER
ELVIR MURIQI	REALNAME	ELVIR MURIQI
DICK TURPIN	REALNAME	DICK TURPIN
DARREN SUTHERLAND	REALNAME	DARREN JOHN SUTHERLAND
KENNY EGAN	REALNAME	KENNETH EGAN
PAUL BUTLIN	REALNAME	PAUL BUTLIN
MARTIN ROGAN	REALNAME	MARTIN ROGAN
OLA AFOLABI	REALNAME	OLAWALE O. AFOLABI
CARLOS MELO	REALNAME	CARLOS BOLíVAR MELO
CHIC CALDERWOOD	REALNAME	CHARLES CALDERWOOD
ART HOVHANNISYAN	REALNAME	ARTYOM HOVHANNISYAN
TONY BELLEW	REALNAME	ANTHONY BELLEW
ELIJAH TILLERY	REALNAME	CARLTON ELIJAH TILLERY
ART LASKY	REALNAME	ARTHUR LAKOFSKY
ROCKY SEKORSKI	REALNAME	ROCKY SEKORSKI
JOHN MCDERMOTT	REALNAME	JOHN MCDERMOTT
ALEXANDER GUROV	REALNAME	ALEXANDER GUROV
PETEY SARRON	REALNAME	PETER SARRON
LEE MEAGER	REALNAME	LEE TERENCE MEAGER
IVAN KIRPA	REALNAME	IVAN KIRPA
FéLIX MACHADO	REALNAME	FéLIX MACHADO
NEL TARLETON	REALNAME	NELSON TARLETON
DEANDREY ABRON	REALNAME	DEANDREY ABRON
BRAD PITT	REALNAME	BRADLEY MICHAEL PITT
WILLIE RITCHIE	REALNAME	GERHARDT ANTHONY STEFFEN
RUBE FERNS	REALNAME	JAMES FERNS
OLANREWAJU DURODOLA	REALNAME	OLANREWAJU DURODOLA
JULIUS JACKSON	REALNAME	JULIUS JACKSON
TUREANO JOHNSON	REALNAME	TAUREANO DEXTER JOHNSON
JAMES DEGALE	REALNAME	JAMES FREDERICK DEGALE
SHAWN ESTRADA	REALNAME	SHAWN ESTRADA
JOSé PEDRAZA	REALNAME	JOSé PEDRAZA GONZáLEZ
DARRYL TYSON	REALNAME	DARRYL TYSON
EZRA SELLERS	REALNAME	EZRA NATHAN SELLERS
JULIO GAMBOA	REALNAME	JULIO GAMBOA
ANDRáS GáLFI	REALNAME	ANDRáS GáLFI
JOHN JOE NEVIN	REALNAME	JOHN JOSEPH NEVIN
ERBITO SALAVARRIA	REALNAME	ERBITO C. SALAVARRIA
PERCY VEAR	REALNAME	HERMAN VEAR
EZEQUIEL MADERNA	REALNAME	EZEQUIEL OSVALDO MADERNA
TIMOTHY BRADLEY	REALNAME	TIMOTHY RAY BRADLEY JR.
CHRIS EUBANK JR.	REALNAME	CHRISTOPHER LIVINGSTONE EUBANK JR.
DANIEL REYES	REALNAME	DANIEL REYES TORRES
DIGGER STANLEY	REALNAME	GEORGE STANLEY
CLARENCE ADAMS	REALNAME	CLARENCE RICHARD ADAMS
THAD SPENCER	REALNAME	THAD SPENCER
SHAUN GEORGE	REALNAME	SHAUNA RACKEEM GEORGE
JACKIE BROWN	REALNAME	JACKIE BROWN
YUSUKE KOBORI	REALNAME	YUSUKE KOBORI
SID SMITH	REALNAME	SID SMITH
MELCHOR COB CASTRO	REALNAME	MELCHOR COB CASTRO
TERRY ALLEN	REALNAME	EDWARD ALBERT GOVIER
TAVORIS CLOUD	REALNAME	TAVORIS KAROD CLOUD
HéCTOR LIZáRRAGA	REALNAME	HéCTOR LIZáRRAGA
DADO MARINO	REALNAME	SALVADOR MARINO
KEVIN LEAR	REALNAME	KEVIN LEAR
DEAN PITHIE	REALNAME	DEAN PITHIE
LáSZLó BOGNáR	REALNAME	LáSZLó BOGNáR
TONY OAKEY	REALNAME	TONY OAKEY
PAUL APPLEBY	REALNAME	PAUL APPLEBY
IAN MCLEOD	REALNAME	IAN MCLEOD
LARRY MARKS	REALNAME	LARRY MARKS
PARK YONG-KYUN	REALNAME	PARK YONG-KYUN
WETHYA SAKMUANGKLANG	REALNAME	FOIJAN PRAWET
VITALI TSYPKO	REALNAME	Віталій Ципко
SéBASTIEN DEMERS	REALNAME	SéBASTIEN DEMERS
ENRIQUE ORNELAS	REALNAME	ENRIQUE ANDRADE ORNELAS
MICHAEL GOMEZ	REALNAME	MICHAEL ARMSTRONG
HéCTOR VELáZQUEZ	REALNAME	HéCTOR VELáZQUEZ MARTíNEZ
JAMES KIRKLAND	REALNAME	JAMES DERICK KIRKLAND
LITTLE DADO	REALNAME	ELEUTERIO ZAPANTA
RAúL GARCíA	REALNAME	RAUL GARCIA HIRALES
HONG SOO-HWAN	REALNAME	HONG SOO-HWAN
PATRICK HYLAND	REALNAME	PATRICK JOSEPH HYLAND
PAUL HYLAND	REALNAME	PAUL HYLAND
ADíLSON RODRIGUES	REALNAME	JOSé ADíLSON RODRIGUES DOS SANTOS
BARRY MORRISON	REALNAME	BARRY MORRISON
LUIS DEL VALLE	REALNAME	LUIS ORLANDO DEL VALLE VALENTíN
GEORGIE ABRAMS	REALNAME	GEORGIE FREEDOM ABRAMS
KID LAVIGNE	REALNAME	GEORGE HENRY LAVIGNE
JUAN ZURITA	REALNAME	JUAN BAUTISTA ZURITA FERRER
BILLY SOOSE	REALNAME	BILLY SOOSE
PELé REID	REALNAME	PELé REID
MANNING GALLOWAY	REALNAME	MANNING GALLOWAY
GERT BO JACOBSEN	REALNAME	GERT BO JACOBSEN
ROB CALLOWAY	REALNAME	ROB CALLOWAY
PATRICK CHARPENTIER	REALNAME	PATRICK CHARPENTIER
CHANGO CARMONA	REALNAME	CHANGO CARMONA
ADONIS STEVENSON	REALNAME	STEVENSON ADONIS
RAY DOMENGE	REALNAME	RAY DOMENGE
MARCOS VILLASANA	REALNAME	MARCOS VILLASANA PéREZ
NEWSBOY BROWN	REALNAME	DAVID MONTROSE
SPEEDY DADO	REALNAME	DIOSDADO B. POSADAS
YOUNG TOMMY	REALNAME	FERNANDO OPAO
TIPPY LARKIN	REALNAME	ANTONIO PILLITERI
ANDY BOWEN	REALNAME	ANDY BOWEN
WILLIE JOYCE	REALNAME	WILLIAM JOYCE
FRANKIE COVELLI	REALNAME	FRANKIE COVELLI
TOMMY PAUL	REALNAME	GAETANO ALFONSO PAPA
PHIL ZWICK	REALNAME	PHILLIP ZWICK
BUD TAYLOR	REALNAME	CHARLES TAYLOR
MEMPHIS PAL MOORE	REALNAME	THOMAS WILSON MOORE
FIREMAN JIM FLYNN	REALNAME	ANDREW CHIARIGLIONE
EMMANUEL NWODO	REALNAME	EMMANUEL JOHN CHUKUWUEMEKA NWODO
EHINOMEN EHIKHAMENOR	REALNAME	EHINOMEN EHIKHAMENOR
SHAWN HAWK	REALNAME	SHAWN HAWK
CHAS SYMONDS	REALNAME	CHAS SYMONDS
FRANKIE BURNS	REALNAME	FRANKIE BURNS
LEO RODAK	REALNAME	LEO RODAK
BUSHY GRAHAM	REALNAME	ANGELO GERACI
DAVID KUI KONG YOUNG	REALNAME	DAVID KUI KONG YOUNG
JACKIE WILSON	REALNAME	JACK BENJAMIN WILSON
MEL COOGAN	REALNAME	MELVIN GEORGE COOGAN
FRANKIE CALLAHAN	REALNAME	SAMUEL HOLTZMAN
HARLEM TOMMY MURPHY	REALNAME	TOMMY MURPHY
MATTY BALDWIN	REALNAME	MATTHEW M BALDWIN
JOHNNY SUMMERS	REALNAME	JOHNNY SUMMERS
YOUNG ERNE	REALNAME	HUGH FRANK CLAVIN
JOSE DE JESUS	REALNAME	JOSE DE JESUS
RAFAEL CONCEPCIóN	REALNAME	RAFAEL CONCEPCIóN
YOUNG CORBETT II	REALNAME	WILLIAM J. ROTHWELL
CéSAR CANCHILA	REALNAME	CéSAR CANCHILA
BERT COLIMA	REALNAME	EPHRAM ROMERO
CéSAR VáZQUEZ	REALNAME	CéSAR GUSTAVO VáZQUEZ GóMEZ
SATOSHI SHINGAKI	REALNAME	SATOSHI SHINGAKI
DRIAN FRANCISCO	REALNAME	ADRIAN FRANCISCO
ALESIA GRAF	REALNAME	ALESIA KLIMOVIC
BEAU JACK	REALNAME	SIDNEY WALKER
TOR HAMER	REALNAME	TOR HAMER
RICARDO CORDOBA	REALNAME	RICARDO ALBERTO CORDOBA MOSQUE
BILLY PETROLLE	REALNAME	WILLIAM MICHAEL PETROLLE
YOUNG GRIFFO	REALNAME	ALBERT GRIFFITHS
IMRE SZELLő	REALNAME	IMRE SZELLő
PACKEY MCFARLAND	REALNAME	PATRICK MCFARLAND
MIDGET WOLGAST	REALNAME	JOSEPH ROBERT LOSCALZO
OWEN MORAN	REALNAME	OWEN MORAN
PAULUS ALI NUUMBEMBE	REALNAME	PAULUS ALI NUUMBEMBE
KID NORFOLK	REALNAME	WILLIAM WARD
ŁUKASZ MASZCZYK	REALNAME	ŁUKASZ MASZCZYK
GEORGIAN POPESCU	REALNAME	GEORGIAN POPESCU
CYRIL PANTHER	REALNAME	CYRIL PANTHER
DAN DONNELLY	REALNAME	DANIEL DONNELLY
KENNY LANE	REALNAME	KENNETH L. LANE
JAMIE ARTHUR	REALNAME	JAMIE ARTHUR
GILBERT LENIN CASTILLO	REALNAME	GILBERT LENIN CASTILLO RIVERA
JORGE TERON	REALNAME	JORGE LUIS TERON
EGIDIJUS KAVALIAUSKAS	REALNAME	EGIDIJUS KAVALIAUSKAS
RODNEY MOORE	REALNAME	RODNEY MOORE
JAVONTAE STARKS	REALNAME	JAVONTAE STARKS
DAI DOWER	REALNAME	DAVID WILLIAM DOWER
JANE COUCH	REALNAME	JANE COUCH
CURT MCCUNE	REALNAME	CURT MCCUNE
JACK LESTER	REALNAME	JACK JUBECK
IAN NAPA	REALNAME	IAN NAPA
JERRY SHEA	REALNAME	JEREMIAH SHEA
DON BROADHURST	REALNAME	DON GARETH BROADHURST
ALEXEI COLLADO	REALNAME	ALEXEI COLLADO ACOSTA
RENDALL MUNROE	REALNAME	RENDALL MUNROE
ARSEN MARTIROSIAN	REALNAME	ARSEN MARTIROSIAN
BREIDIS PRESCOTT	REALNAME	BREIDIS ENRIQUE PRESCOTT CONSUEGRA
MARTIN GETHIN	REALNAME	MARTIN GETHIN
MANENO OSWALD	REALNAME	MANENO OSWALD
AMER KHAN	REALNAME	AMER KHAN
IVAN GONTSA	REALNAME	ION GONţA
DAVE PARRIS	REALNAME	DAVE PARRIS
ALFREDO XEQUE	REALNAME	ALFREDO XEQUE
ALEX IBBS	REALNAME	ALEX IBBS
KONSTANTIN AIRICH	REALNAME	KONSTANTIN AIRICH
LUKE SIMPKIN	REALNAME	LUKE SIMPKIN
DAVE FERGUSON	REALNAME	DAVID MARK FERGUSON
MZOLISI YOYO	REALNAME	MZOLISI YOYO
GEORGE ARIAS	REALNAME	GEORGE ARIAS
ANTONIO PITALúA	REALNAME	EDUARDO ANTONIO OSPINO PITALUA
OSCAR DíAZ	REALNAME	OSCAR DIAZ
DAVE NEEDHAM	REALNAME	DAVE NEEDHAM
PADDY MAGUIRE	REALNAME	PADDY MAGUIRE
OSUMANA AKABA	REALNAME	OSUMANA AKABA
PAUL TRUSCOTT	REALNAME	PAUL TRUSCOTT
WALDEMAR HOLBERG	REALNAME	WALDEMAR BIRGER HOLBERG
TSHIFHIWA MUNYAI	REALNAME	TSHIFHIWA MUNYAI
MARTIN POWER	REALNAME	MARTIN POWER
LEE HASKINS	REALNAME	LEE HASKINS
AJOSE OLUSEGUN	REALNAME	SEGUN AJOFE
JOHN REID MCGOWAN	REALNAME	JOHN REID MCGOWAN
COLIN LYNES	REALNAME	COLIN LYNES
DAVID BARNES	REALNAME	DAVID BARNES
GARY DE ROUX	REALNAME	GARY DE'ROUX
CRAIG WATSON	REALNAME	CRAIG WATSON
DEAN BYRNE	REALNAME	DEAN BYRNE
JAMIE COX	REALNAME	JAMES SIMON RUSSAN
CRISTóBAL CRUZ	REALNAME	CRISTóBAL CRUZ RIVERA
MATTHEW MARSH	REALNAME	MATTHEW MARSH
TED BAMI	REALNAME	TED BAMI MINSENDE
MICHAEL LOMAX	REALNAME	MICHAEL LOMAX
ANDY BELL	REALNAME	ANDY BELL
RONALD HEARNS	REALNAME	RONALD HEARNS
JASON BOOTH	REALNAME	JASON BOOTH
KELL BROOK	REALNAME	EZEKIEL BROOK
KEVIN ANDERSON	REALNAME	KEVIN ANDERSON
DANIEL AGUILLóN	REALNAME	DANIEL AGUILLóN RAMíREZ
HIPPOLYTE ANNEX	REALNAME	HIPPOLYTE ANNEX
EGOR MEKHONTSEV	REALNAME	Егор Леонидович Мехонцев
ROMEO ANAYA	REALNAME	ROMEO ANAYA MALPICA
SALAMO AROUCH	REALNAME	SALAMON AROUCH
JOHN O'DONNELL	REALNAME	JOHN O'DONNELL
ALEXANDER MUñOZ	REALNAME	ALEXANDER MUñOZ
CELLO RENDA	REALNAME	MARCELLO RENDA
DAULIS PRESCOTT	REALNAME	DAULIS PRESCOTT CONSUEGRA
ALAN BOSWORTH	REALNAME	ALAN BOSWORTH
DANNY MCINTOSH	REALNAME	DANNY MCINTOSH
JOHN SIMPSON	REALNAME	JOHN SIMPSON
JUAN DOMíNGUEZ	REALNAME	JUAN DOMINGUEZ
LEONARDO ZAPPAVIGNA	REALNAME	LEONARDO ZAPPAVIGNA
SCOTT LAWTON	REALNAME	SCOTT LAWTON
MANUEL VARGAS	REALNAME	MANUEL MAGDALENO VARGAS
JASON COOK	REALNAME	JASON COOK
DANNY CODLING	REALNAME	DANIEL EMILE CODLING
NATHAN ADAM MORLEY	REALNAME	NATHAN ADAM MORLEY
POLI DíAZ	REALNAME	POLICARPO DíAZ ARéVALO
KALLIE KNOETZE	REALNAME	NIKOLAAS JACOBUS KNOETZE
CéSAR SOTO	REALNAME	CéSAR SOTO ESQUIVEL
BILLY DIB	REALNAME	BILAL DIB
RICO HOYE	REALNAME	RICO HOYE
ALVIN LEWIS	REALNAME	ALVIN LEWIS
CLINTON MCKENZIE	REALNAME	CLINTON MCKENZIE
LAWRENCE TAUASA	REALNAME	LAWRENCE TAUASA
FELIX CORA, JR.	REALNAME	FELIX CORA JR.
MADS LARSEN	REALNAME	MADS LARSEN
CHRIS EDWARDS	REALNAME	CHRIS EDWARDS
DAVID BEY	REALNAME	DAVID BEY
FLOYD CUMMINGS	REALNAME	FLOYD CUMMINGS
DICK CORBETT	REALNAME	RICHARD COLEMAN
ROBERT NORTON	REALNAME	ROBERT NORTON
RAY MOYLETTE	REALNAME	RAYMOND MOYLETTE
RUBEN EDUARDO ACOSTA	REALNAME	RUBEN ACOSTA
MAURICIO PASTRANA	REALNAME	MAURICIO ANTONIO PASTRANA TAPI
ALEXANDER ABRAHAM	REALNAME	ALEXANDER ABRAHAMYAN
KINA MALPARTIDA	REALNAME	KINA MALPARTIDA DYSON
MARCEL ZELLER	REALNAME	MARCEL ZELLER
PEDLAR PALMER	REALNAME	THOMAS PALMER
KENNY GALARZA	REALNAME	KENNY OMAR GALARZA AROCHO
GRZEGORZ KIELSA	REALNAME	GRZEGORZ KIELSA
JOSé LUIS BUENO	REALNAME	JOSé LUIS BUENO
EDDIE HYLAND	REALNAME	EDWARD HYLAND
CHRIS OKOH	REALNAME	CHRIS OKOH
JJ BIRD	REALNAME	JOE-JOHN BIRD
LEE SWABY	REALNAME	LEE SWABY
RICARDO CORTéS	REALNAME	RICARDO CORTES
CECILIA BRæKHUS	REALNAME	CECILIA CARMEN LINDA BRæKHUS
GIOVANI SEGURA	REALNAME	GIOVANI SEGURA AGUILAR
GEORGE TAHDOOAHNIPPAH	REALNAME	GEORGE TAHDOOAHNIPPAH
CARLOS QUINTANA	REALNAME	CARLOS QUINTANA
JOSé LóPEZ	REALNAME	JOSé ÁNGEL LóPEZ RIVERA
SERGEY GULYAKEVICH	REALNAME	SERGEY GULYAKEVICH
GARY DAVIES	REALNAME	GARY DAVIES
OLIVIER LONTCHI	REALNAME	OLIVIER LONTCHI
POONSAWAT KRATINGDAENGGYM	REALNAME	CHALERMWONG UDOMNA
JEFFREY MATHEBULA	REALNAME	JEFFREY MATHEBULA
BERNABE CONCEPCION	REALNAME	BERNABE CONCEPCION
LAVERN ROACH	REALNAME	RAYMOND LAVERN ROACH
JOHNNY HANKS	REALNAME	RAMON JOHN HANKS
OVILL MCKENZIE	REALNAME	OVILL MCKENZIE
JOHN KEETON	REALNAME	JOHN KEETON
MARK HOBSON	REALNAME	MARK HOBSON
BOB GOSLIN	REALNAME	COLIN HIGGS GOSLIN
GEORGE FOREMAN III	REALNAME	GEORGE EDWARD FOREMAN III
BERNARD HOPKINS	REALNAME	BERNARD HUMPHREY HOPKINS JR.
CANELO ÁLVAREZ	REALNAME	SANTOS SAúL ÁLVAREZ BARRAGáN
WILLI BESMANOFF	REALNAME	WILLIAM DAVID BESMANOFF
JOSé MANUEL SáNCHEZ	REALNAME	JOSé MANUEL SáNCHEZ TERRONES
ROY HARRIS	REALNAME	ROY HARRIS
HARPAL TALHAN	REALNAME	HARPAL TALHAN
TANVEER AHMED	REALNAME	TANVEER AHMED
JUSTANN CRAWFORD	REALNAME	JUSTANN CRAWFORD
MARCOS MAIDANA	REALNAME	MARCOS RENé MAIDANA
SEBASTIAN ZBIK	REALNAME	SEBASTIAN ZBIK
BOONE KIRKMAN	REALNAME	DANIEL VICTOR KIRKMAN
KIP DIGGS	REALNAME	KIP ANDRE DIGGS
BILLY BAKER	REALNAME	BILLY BAKER
TOMáS ROJAS	REALNAME	TOMáS ROJAS GóMEZ
GIPSY DANIELS	REALNAME	WILLIAM DANIEL
MARCO ANTONIO NAZARETH	REALNAME	MARCO ANTONIO NAZARETH
JUAN DE DIOS NAVARRO	REALNAME	JUAN DE DIOS NAVARRO RAMíREZ
MARVIN SONSONA	REALNAME	MARVIN DOECADEZ SONSONA
YOUSSEF AL-HAMIDI	REALNAME	YOUSSEF AL HAMIDI
ROCKY DEAN	REALNAME	ROCKY DEAN
ESHAM PICKERING	REALNAME	ESHAM PICKERING
P. J. GALLAGHER	REALNAME	PATRICK JOSEPH GALLAGHER
ROBERT STIEGLITZ	REALNAME	SERGEY SHTIKHLITS
HUMBERTO MAURO GUTIéRREZ	REALNAME	HUMBERTO MAURO GUTIERREZ
INNOCENT ANYANWU	REALNAME	INNOCENT ANYANWU
NOBUHIRO ISHIDA	REALNAME	NOBUHIRO ISHIDA
PAUL BONSON	REALNAME	PAUL BONSON
PATRICK WILSON	REALNAME	PATRICK WILSON
NANAO SINGH THOKCHOM	REALNAME	THOKCHOM NANAO SINGH
RAYMOND OCHIENG	REALNAME	RAYMOND ANDREW OCHIENG
FRANKIE GóMEZ	REALNAME	JESúS FRANCISCO GóMEZ
SIMPHIWE NONGQAYI	REALNAME	SIMPHIWE NONGQAYI
LENNY DAWS	REALNAME	LENNY DAWS
WILLIE CASEY	REALNAME	WILLIE CASEY
ERNIE LOPEZ	REALNAME	ERNIE LOPEZ
JUAN CARLOS SALGADO	REALNAME	JUAN CARLOS SALGADO
ANTONIO DEMARCO	REALNAME	ANTONIO DE MARCO SOTO
JONATHAN GONZáLEZ	REALNAME	JONATHAN GONZáLEZ
CARLOS MOLINA	REALNAME	CARLOS MOLINA
LOU FILIPPO	REALNAME	LOU FILIPPO
ALBERTO ROSSEL	REALNAME	ALBERTO ROSSEL CONTRERAS
JOSé JUAN COTTO	REALNAME	JOSé JUAN COTTO
MONTY BETHAM	REALNAME	MONTGOMERY RICHARD BETHAM
LLEW EDWARDS	REALNAME	LLEWELLYN EDWARDS
KRESHNIK QATO	REALNAME	KRESHNIK QATO
ANTONIO VALENCIA	REALNAME	ANTONIO VALENCIA
DEL FONTAINE	REALNAME	RAYMOND HENRY BOUSQUET
MORUTI MTHALANE	REALNAME	MORUTI MTHALANE
RODEL MAYOL	REALNAME	RODEL BRYAN GENERALAO MAYOL
FRANCISCO RODRIGUEZ	REALNAME	FRANCISCO RODRíGUEZ
JIMMY BRITT	REALNAME	JAMES EDWARD BRITT
TSUYOSHI HAMADA	REALNAME	TSUYOSHI HAMADA
JOY ALI	REALNAME	ZULFIKAR JOY ALI
CHARLES LEDOUX	REALNAME	CHARLES LEDOUX
CHARLES ADAMU	REALNAME	CHARLES ADAMU
RYAN BRAWLEY	REALNAME	RYAN BRAWLEY
SHINNY BAYAAR	REALNAME	SHINEBAYAR SUKHBAATAR
JAN ZAVECK	REALNAME	DEJAN ZAVEC
TURORI GEORGE	REALNAME	TURORI GEORGE
CRUZ CARBAJAL	REALNAME	CRUZ CARBAJAL
YUH HWAN-KIL	REALNAME	YUH HWAN-KIL
CHOI YONG-SOO	REALNAME	YONG-SOO CHOI
KIM SUNG-JUN	REALNAME	KIM SUNG-JUN
OH MIN-KEUN	REALNAME	OH MIN-KEUN
STEVE ROLLS	REALNAME	STEVEN MICHAEL ROLLS
JOHNRIEL CASIMERO	REALNAME	JOHN RIEL CASIMERO
BRADLEY HORE	REALNAME	BRADLEY ARTHUR HORE
CARL BAKER	REALNAME	CARL BAKER
TOSHIYUKI IGARASHI	REALNAME	TOSHIYUKI IGARASHI
ERCüMENT ASLAN	REALNAME	ERCUMENT ASLAN
SANTIAGO ACOSTA	REALNAME	SANTIAGO IVáN ACOSTA
LUCAS MATTHYSSE	REALNAME	LUCAS MARTIN MATTHYSSE
FABIAN VELARDES	REALNAME	FABIAN LEONARDO VELARDES
WALTER MATTHYSSE	REALNAME	WALTER DARIO MATTHYSSE
AARON GARCIA	REALNAME	AARON GARCíA
NATASCHA RAGOSINA	REALNAME	NATALIA YURIEVNA RAGOZINA
RICHARD TOWERS	REALNAME	RICHARD TOWERS
JOHN WATSON	REALNAME	JOHN WATSON
DENTON VASSELL	REALNAME	DENTON VASSELL
GARY SYKES	REALNAME	GARY SYKES
ADRIEN BRONER	REALNAME	ADRIEN JEROME BRONER
EDMUND GERBER	REALNAME	EDMUND GERBER
WILL TOMLINSON	REALNAME	WILL TOMLINSON
PETER FELIX	REALNAME	PETER FELIX
TAKASHI UCHIYAMA	REALNAME	TAKASHI UCHIYAMA
GARTH WOOD	REALNAME	GARTH WOOD
JORGE AHUMADA	REALNAME	JORGE VICTOR AHUMADA
YUM DONG-KYUN	REALNAME	YUM DONG-KYUN
RICHIE LAMONTAGNE	REALNAME	RICHARD LAMONTAGNE
CHANG JUNG-KOO	REALNAME	CHANG JUNG-KOO
KIM CHUL-HO	REALNAME	KIM CHUL-HO
CHOI CHANG-HO	REALNAME	CHOI CHANG-HO
KIM TAE-SHIK	REALNAME	KIM TAE-SHIK
YUH JAE-DOO	REALNAME	YUH JAE-DOO
CHUN JU-DO	REALNAME	CHUN JU-DO
TONY DEMARCO	REALNAME	LEONARDO LIOTTA
BAEK JONG-KWON	REALNAME	BAEK JONG-KWON
CHO IN-JOO	REALNAME	CHO IN-JOO
FRANK OPPONG	REALNAME	FRANK OPPONG
CISO MORALES	REALNAME	NARCISO ROSALES MORALES JR.
JASON PAGARA	REALNAME	JASON HEROGALEM PAGARA
MARK MELLIGEN	REALNAME	MARK JASON MELLIGEN
JUNDY MARAON	REALNAME	JUNDY MARAON
ROLANDO MAGBANUA	REALNAME	ROLANDO MAGBANUA
CZAR AMONSOT	REALNAME	AUGUSTO CAESAR AMONSOT
ABMERK SHINDJUU	REALNAME	ABMERK SHINDJUU
ANA MARíA TORRES	REALNAME	ANA MARíA TORRES RAMíREZ
PADDINGTON TOM JONES	REALNAME	TOM JONES
MILAN MELINDO	REALNAME	MILAN MELINDO
MICHAEL DOMINGO	REALNAME	MICHAEL BARROA DOMINGO
JAMIE MCDONNELL	REALNAME	JAMIE MCDONNELL
VIKAPITA MERORO	REALNAME	VIKAPITA MERORO
DAUD YORDAN	REALNAME	DAUD YORDAN
ANDY MORRIS	REALNAME	ANDY MORRIS
BILLY MOELLER	REALNAME	BILLY MOELLER
PRINCE ARRON	REALNAME	ARRON JONES
JUANITO RUBILLAR	REALNAME	JUANITO RUBILLAR
MICHAEL FARENAS	REALNAME	MICHAEL FARENAS
DENVER CUELLO	REALNAME	DENVER CUELLO
DENNIS LAURENTE	REALNAME	DENNIS LAURENTE
SMALL MONTANA	REALNAME	BENJAMIN GAN
NKOSINATHI JOYI	REALNAME	NKOSINATHI JOYI
SAM WEBB	REALNAME	SAM WEBB
JOSé BENAVIDEZ	REALNAME	JOSé LUIS BENAVIDEZ, JR.
RIGOBERTO ÁLVAREZ	REALNAME	RIGOBERTO ÁLVAREZ BARRAGáN
BILL LANG	REALNAME	WILLIAM LANFRANCHI
MIKEY GARCIA	REALNAME	MIGUEL ANGEL GARCIA CORTEZ
ANTONIO LOZADA, JR.	REALNAME	ANTONIO LOZADA JR.
MIGUEL VáZQUEZ	REALNAME	MIGUEL ÁNGEL VáZQUEZ BAUTISTA
ROGELIO MEDINA	REALNAME	ROGELIO MEDINA
JUAN CARLOS BURGOS	REALNAME	JUAN CARLOS BURGOS CASTILLO
BRIAN CAMECHIS	REALNAME	JAMES BRIAN CAMECHIS
LANARDO TYNER	REALNAME	LANARDO TYNER
ANTONIO FITCH	REALNAME	ANTONIO FITCH
GABRIEL MARTíNEZ	REALNAME	GABRIEL ALEJANDRO MARTíNEZ
JEFFERSON GONçALO	REALNAME	JEFFERSON LUíS GONçALO
EURI GONZáLEZ	REALNAME	EURI GONZALEZ
MARAT KHUZEEV	REALNAME	MARAT KHUZEEV
CARLOS HERRERA	REALNAME	CARLOS LEONARDO HERRERA
FRANCISCO VILLANUEVA	REALNAME	FRANCISCO VILLANUEVA
YURI BARASHIAN	REALNAME	Юрій Барашян
JON-LEWIS DICKINSON	REALNAME	JON-LEWIS DICKINSON
JAMIE KAVANAGH	REALNAME	JAMIE KAVANAGH
ELOY PéREZ	REALNAME	ELOY PéREZ
PAWEł KOłODZIEJ	REALNAME	PAWEł KOłODZIEJ
MATEUSZ MASTERNAK	REALNAME	MATEUSZ MASTERNAK
CARLOS ADáN JEREZ	REALNAME	CARLOS ADAN JEREZ
BILLY KELLY	REALNAME	WILLIAM KELLY
MIKE DALLAS JR.	REALNAME	MICHAEL DALLAS JR.
MARCO ANTONIO PERIBáN	REALNAME	MARCO ANTONIO PERIBáN HERNáNDEZ
LUIS GRAJEDA	REALNAME	LUIS ENRíQUEZ GRAJEDA
DANTE JARDóN	REALNAME	DANTE JARDóN
DAVID RODELA	REALNAME	DAVID RODELA
JAMES DE LA ROSA	REALNAME	JAMES MICHAEL DE LA ROSA
PABLO CéSAR CANO	REALNAME	PABLO CéSAR CANO GARCíA
FREDDY HERNáNDEZ	REALNAME	FREDDY HERNáNDEZ GóMEZ
LUCIANO LEONEL CUELLO	REALNAME	LUCIANO LEONEL CUELLO
JOSé EMILIO PEREA	REALNAME	JOSé EMILIO PEREA TRUJILLO
DANIEL ESTRADA	REALNAME	PEDRO DANIEL ESTRADA ESPITIA
JUAN PABLO LóPEZ	REALNAME	JUAN PABLO LóPEZ
GILBERTO RAMíREZ	REALNAME	GILBERTO RAMíREZ SáNCHEZ
JUAN CARLOS VIRGEN	REALNAME	JUAN CARLOS SALADO VIRGEN
MARIO MERAZ	REALNAME	MARIO MERAZ
ÁLVARO GAONA	REALNAME	ÁLVARO GAONA VEGA
RICHIE MEPRANUM	REALNAME	RICHIE MEPRANUM
EDWARD ROLLINS	REALNAME	EDWARD ROLLINS
IVáN POPOCA	REALNAME	REY IVáN POPOCA
JUAN JOSé MONTES	REALNAME	JUAN JOSé MONTES VALDERRAMA
ÁNGEL HERNáNDEZ	REALNAME	JOSé ÁNGEL HERNáNDEZ
RAMSEY LUNA	REALNAME	RAMSEY LUNA
LUIS ABREGú	REALNAME	LUIS CARLOS ABREGU
ANDY RUIZ	REALNAME	ANDRéS PONCE RUIZ JR.
MIGUEL ANGEL CASTELLINI	REALNAME	MIGUEL ANGEL CASTELLINI
JOSé DURáN	REALNAME	JOSé MANUEL DURáN PéREZ
ROBERTO CRUZ	REALNAME	ROBERTO DE LA CRUZ
CLAUDE NOEL	REALNAME	CLAUDE NOEL
RAUL HORACIO BALBI	REALNAME	RAUL HORACIO BALBI
LUIS ALBERTO LAZARTE	REALNAME	LUIS ALBERTO LAZARTE
MARCOS RAMIREZ	REALNAME	MARCOS RAMíREZ
ALFONSO LóPEZ III	REALNAME	ALFONSO LóPEZ III
MICK LEAHY	REALNAME	MICHAEL LEAHY
BRAD SOLOMON	REALNAME	BRAD SOLOMON
MERCITO GESTA	REALNAME	MERCITO MOYA GESTA
ANTONIO GóMEZ	REALNAME	ANTONIO GOMEZ
MANUEL PéREZ	REALNAME	MANUEL PéREZ
BRANDON RíOS	REALNAME	BRANDON LEE RíOS
HANK LUNDY	REALNAME	HENRY LUNDY
GARY BUCKLAND	REALNAME	GARY BUCKLAND
RAFAEL ORTEGA	REALNAME	RAFAEL ORTEGA
HERNáN MáRQUEZ	REALNAME	HERNáN MáRQUEZ BELTRáN
ASHLEY SEXTON	REALNAME	ASHLEY SEXTON
TONY QUIGLEY	REALNAME	TONY QUIGLEY
JULIO CéSAR MIRANDA	REALNAME	JULIO CESAR MIRANDA
EDEN SONSONA	REALNAME	EDEN SONSONA
DANNY O'CONNOR	REALNAME	DANIEL THOMAS O'CONNOR
LARRY GONZáLES	REALNAME	LARRY NELSON GONZáLES
CHAD AQUINO	REALNAME	CHAD AQUINO
BRANDON GONZáLES	REALNAME	BRANDON GILBERT GONZáLES
OBA CARR	REALNAME	OBA DIALLO CARR
ISTVáN KECSKéS	REALNAME	ISTVáN KECSKéS
JUAN CARLOS CANDELO	REALNAME	JUAN CARLOS GARCíA
SALVADOR SáNCHEZ II	REALNAME	SALVADOR SáNCHEZ CASTRO
ZOLANI MARALI	REALNAME	ZOLANI MARALI
MAHENGE ZULU	REALNAME	EKOLI MAHENGE ZULU
TEON KENNEDY	REALNAME	TEON KENNEDY
PATRICK MENDY	REALNAME	PATRICK TAYLOR MENDY
ROBERTO MARROQUIN	REALNAME	ROBERTO MARROQUIN
DAT NGUYEN	REALNAME	NGUYEN TIEN DAT
RICARDO ÁLVAREZ	REALNAME	RICARDO ÁLVAREZ BARRAGáN
RICO RAMOS	REALNAME	RICO DASHON RAMOS
JONATHAN MAICELO	REALNAME	JONATHAN MAICELO ROMáN
CéSAR CUENCA	REALNAME	CéSAR RENé CUENCA
ISRAEL GARCIA	REALNAME	ISRAEL CARLOS GARCIA
RYDELL BOOKER	REALNAME	RYDELL BOOKER
MELISSA ST. VIL	REALNAME	MELISSA ST. VIL
GILBERTO SERRANO	REALNAME	GILBERTO RAFAEL SERRANO
GIOVANNI CARO	REALNAME	GIOVANNI CARO
JUAN NAZARIO	REALNAME	JUAN NAZARIO
CHUNG KI-YOUNG	REALNAME	KI-YOUNG CHUNG
ALFREDO LAYNE	REALNAME	ALFREDO LAYNE
ROBERT ŠULGAN	REALNAME	ROBERT ŠULGAN
ALFREDO MARCANO	REALNAME	ALFREDO MARCANO
ALEXANDER PETKOVIC	REALNAME	ALEXANDER SLAVISA PETKOVIC
FRANCISCO SIERRA	REALNAME	FRANCISCO SANTIAGO SIERRA LEDEZMA
FRANTIšEK KASANIč	REALNAME	FRANTIšEK KASANIč
ROMAN BUGAJ	REALNAME	ROMAN BUGAJ
HUGO HERNáNDEZ	REALNAME	HUGO HERNáNDEZ
DENIS LEBEDEV	REALNAME	DENIS ALEKSANDROVICH LEBEDEV
RüDIGER MAY	REALNAME	RüDIGER MAY
MARVIN CORDOVA, JR.	REALNAME	MARVIN DALE CORDOVA
BAE KI-SUK	REALNAME	BAE KI-SUK
PHON MARTDEE	REALNAME	SURAPHON MARTDEE
RAMóN GARCíA HIRALES	REALNAME	RAMóN GARCíA HIRALES
KARO MURAT	REALNAME	KAREN MURATYAN
MARCOS REYES	REALNAME	MARCO ANTONIO REYES NEVAREZ
JOSé LUIS ZERTUCHE	REALNAME	JOSé LUIS ZERTUCHE CHáVEZ
ROBERTO ORTIZ	REALNAME	ROBERTO ORTIZ CERVANTES
IRMA SáNCHEZ	REALNAME	IRMA SáNCHEZ
JUAN ALBERTO ROSAS	REALNAME	JUAN ALBERTO ROSAS
DMITRY PIROG	REALNAME	DMITRY YURIEVICH PIROG
ANTONIO DíAZ	REALNAME	JOSé ANTONIO DíAZ
HAROLD GOMES	REALNAME	HAROLD GOMES
RAFAł JACKIEWICZ	REALNAME	RAFAł JACKIEWICZ
ASHLEY THEOPHANE	REALNAME	ASHLEY THEOPHANE
DOMONIQUE DOLTON	REALNAME	DOMONIQUE DOLTON
KEITH THURMAN	REALNAME	KEITH THURMAN JR.
AKIM TAFER	REALNAME	HAKIM TAFER
CECILIO LASTRA	REALNAME	CECILIO LASTRA
CHARLES HUERTA	REALNAME	CHARLES HUERTA
ANDRé ROUTIS	REALNAME	ANDRé ROUTIS
TOBIA GIUSEPPE LORIGA	REALNAME	TOBIA GIUSEPPE LORIGA
JASON LEHOULLIER	REALNAME	JASON LEHOULLIER
MICHAEL MEDINA	REALNAME	MICHAEL MEDINA FRANCO
TADASHI MIHARA	REALNAME	TADASHI MIHARA
HENRI PIET	REALNAME	HENRI PIET
JAVIER MORA	REALNAME	JAVIER MORA
GERMáN ALTAMíRANO	REALNAME	GERMáN ALTAMíRANO GARCíA
MARLON REID	REALNAME	MARLON REID
GERARDO BISBAL	REALNAME	GERARDO MIGUEL BISBAL MELERO
JOSé CABRERA	REALNAME	JOSé CABRERA
JUAN HERNáNDEZ	REALNAME	JUAN HERNáNDEZ
HEINZ LAZEK	REALNAME	HEINZ LAZEK
JOSé JULIO MENDOZA	REALNAME	JOSé JULIO MENDOZA LóPEZ
DANIEL SANDOVAL	REALNAME	DANIEL SANDOVAL NAVARRO
PETER TILL	REALNAME	PETER TILL
RAMóN ÁLVAREZ	REALNAME	RAMóN ALVAREZ BARRAGáN
ALFREDO CHáVEZ	REALNAME	ALFREDO CHáVEZ
MISAEL CASTILLO	REALNAME	MISAEL CASTILLO
ROBERTO RUIZ	REALNAME	ROBERTO RUIZ
ALEJANDRO BARRERA	REALNAME	ALEJANDRO BARRERA
CARLOS VELARDE	REALNAME	CARLOS VELARDE
JOSé ALFREDO RODRíGUEZ	REALNAME	JOSé ALFREDO RODRíGUEZ
MAXIM VLASOV	REALNAME	MAXIM VLASOV
MARTIN ÁNGEL MARTíNEZ	REALNAME	MARTIN ÁNGEL MARTíNEZ VELARDE
ANDRéS GUTIéRREZ	REALNAME	ANDRéS GUTIéRREZ VERA
JHEAN CARLO APARICIO	REALNAME	JHEAN CARLO APARICIO ROMéRO
MARIO BRIONES	REALNAME	MARIO ALBERTO BRIONES LEOS
HUMBERTO TRINIDAD	REALNAME	HUMBERTO TRINIDAD RAMOS
JORGE PáEZ JR.	REALNAME	JORGE PáEZ JR.
EMMANUEL RODRíGUEZ	REALNAME	EMMANUEL RODRíGUEZ VáZQUEZ
CARLOS ZáRATE, JR.	REALNAME	CARLOS JESúS ZáRATE SCOTT
JOEL LUNA ZáRATE	REALNAME	JOEL LUNA ZáRATE
RODOLFO MARTíNEZ	REALNAME	RODOLFO MARTíNEZ ESTRADA
ALONSO LóPEZ	REALNAME	ALONSO LóPEZ
DARREN MCDERMOTT	REALNAME	DARREN MCDERMOTT
TOM STALKER	REALNAME	THOMAS LEE STALKER
IAIN WEAVER	REALNAME	IAIN WEAVER
GAMAL YAFAI	REALNAME	GAMAL YAFAI
ALEJANDRO MARTíN GONZáLEZ	REALNAME	ALEJANDRO MARTíN GONZáLEZ
ANTONIO AVELAR	REALNAME	JOSE ANTONIO RODRíGUEZ AVELAR
ISAAC BUSTOS	REALNAME	ISAAC BUSTOS
VICTOR RABANALES	REALNAME	VICTOR MANUEL RABANALES
MAURICIO ACEVES	REALNAME	MAURICIO ACEVES
ANTONIO ESCALANTE	REALNAME	ANTONIO ESCALANTE
NIPPER PAT DALY	REALNAME	PATRICK CLIFFORD DALEY
PHIL GILL	REALNAME	PHILIP ROY GILL
DANNY MORGAN	REALNAME	DANNY MORGAN
JESúS CHONG	REALNAME	JESúS ALBERTO CHONG
AMADO URSUA	REALNAME	AMADO URSUA
JULIO CéSAR BORBOA	REALNAME	JULIO CéSAR BORBOA GARCíA
ENRIQUE SáNCHEZ	REALNAME	ENRIQUE JOSé SáNCHEZ LEóN
NéSTOR GARZA	REALNAME	NéSTOR GABRIEL GARZA
LEO FLORIAN HAUCK	REALNAME	LEO FLORIAN HAUCK
RANDY CABALLERO	REALNAME	RANDY MICHAELS CABALLERO
IVáN HERNáNDEZ	REALNAME	IVáN HERNáNDEZ RANGEL
JOSé QUIRINO	REALNAME	JOSé QUIRINO
JUAN HERRERA	REALNAME	JUAN HERRERA
ISIDRO PéREZ	REALNAME	ISIDRO PéREZ
ISIDRO GARCíA	REALNAME	ISIDRO GARCíA AYALA
ALBERTO JIMéNEZ	REALNAME	ALBERTO JIMéNEZ
RUBéN SáNCHEZ LEóN	REALNAME	RUBéN SáNCHEZ LEóN
PEDRO FLORES	REALNAME	PEDRO FLORES
ROBERTO CARLOS LEYVA	REALNAME	ROBERTO CARLOS LEYVA CORTéZ
EDGAR CARDENAS	REALNAME	EDGAR CARDENAS
FERNANDO BELTRáN, JR.	REALNAME	FERNANDO MANUEL BELTRáN MACHADO
JOSé LUIS SOTO KARASS	REALNAME	JOSé LUIS SOTO KARASS
EMMANUEL LUCERO	REALNAME	EMMANUEL LUCERO
JAMAL JAMES	REALNAME	JAMAL JAMES
STEPHEN FOSTER	REALNAME	STEPHEN FOSTER
DIEGO MAGDALENO	REALNAME	DIEGO ARMANDO MAGDALENO
JESSIE MAGDALENO	REALNAME	JESúS GABRIEL MAGDALENO
MICHAEL KENNETH FINNEY	REALNAME	MICHAEL KENNETH FINNEY
FIDEL MALDONADO	REALNAME	FIDEL MALDONADO
JOSé TOLUCO LóPEZ	REALNAME	JOSé LóPEZ HERNáNDEZ
FRANK PEñA	REALNAME	FRANCISCO PEñA
GERMáN OHM	REALNAME	GERMAN OHM GóMEZ
JOSé MEDEL	REALNAME	JOSé MEDEL
CARLOS COTTO	REALNAME	CARLOS COTTO CRUZ
PADDY GALLAGHER	REALNAME	PATRICK GALLAGHER
ROCKY GATTELLARI	REALNAME	ROCCO GATTELLARI
KARIM AYARI	REALNAME	KARIM AYARI
JACKIE NAVA	REALNAME	JACQUELINE NAVA MOUETT
OMAR FIGUEROA	REALNAME	OMAR FIGUEROA JR.
AUSTIN TROUT	REALNAME	AUSTIN DWAYNE TROUT
FRANKLIN EGOBI	REALNAME	FRANKLIN GEORGE EGOBI
SAMMY GUTIéRREZ	REALNAME	SAMUEL GUTIéRREZ
SHIVA THAPA	REALNAME	SHIVA THAPA
FAHPRAKORB RAKKIATGYM	REALNAME	FAHPRAKORB RAKKIATGYM
CLEOTIS PENDARVIS	REALNAME	CLEOTIS PENDARVIS
TOSH POWELL	REALNAME	THOMAS MORGAN POWELL
JOSE RAMíREZ	REALNAME	JOSé CARLOS RAMíREZ
GINGER JONES	REALNAME	BRYN JONES
USHA NAGISETTY	REALNAME	USHA NAGISETTY
RICHIE LEMOS	REALNAME	RICHIE LEMOS
SOLLY SMITH	REALNAME	SOLOMON GARCIA SMITH
JESúS GéLES	REALNAME	JESúS GELES VáSQUEZ
GILBERTO KEB BAAS	REALNAME	GILBERTO JOSé KEB BAAS
OSCAR MEZA	REALNAME	OSCAR MEZA
OMRI LOWTHER	REALNAME	OMRI LOWTHER
FRANCISCO ARCE ARMENTA	REALNAME	FRANCISCO ARCE ARMENTA
RONNIE JAMES	REALNAME	RONNIE JAMES
SEBASTIáN LUJáN	REALNAME	SEBASTIáN ANDRéS LUJáN
DANNY PEREZ RAMíREZ	REALNAME	DANNY PEREZ
DAVID KAMAU	REALNAME	DAVID NGANGA KAMAU
RODNEY JONES	REALNAME	RODNEY JONES
RAMON LEDON	REALNAME	RAMON LEDON-GONZáLEZ
HAROLD WARREN	REALNAME	HAROLD RAY WARREN
SIMON VALLILY	REALNAME	SIMON VALLILY
JOEL DíAZ	REALNAME	JOEL DíAZ
IGNACIO BERISTáIN	REALNAME	IGNACIO BERISTáIN
CALLUM JOHNSON	REALNAME	CALLUM JOHNSON
ALBERTO GARZA	REALNAME	ALBERTO JESúS GARZA
HUGO VALDEZ	REALNAME	HUGO VALDEZ
CHARLES HATLEY	REALNAME	CHARLES HATLEY
JAIME GARZA	REALNAME	JAIME GARZA
RODOLFO CASANOVA	REALNAME	RODOLFO CASANOVA
GASPAR ORTEGA	REALNAME	GASPAR ORTEGA
JONATHAN VICTOR BARROS	REALNAME	JONATHAN VICTOR BARROS
IRVING BERRY	REALNAME	IRVING BERRY
JOSé PINZóN	REALNAME	JOSé PINZóN
WILLIE NELSON	REALNAME	WILLIE NELSON
IVáN MORALES	REALNAME	JOSé IVáN MORALES ELVIRA
ARMANDO ROBLES	REALNAME	ARMANDO ROBLES
RAMóN MONTAñO	REALNAME	RAMóN CARLOS MONTAñO CORDOVA
DANIEL SARMIENTO	REALNAME	PABLO DANIEL SARMIENTO
SETH MITCHELL	REALNAME	SETH MITCHELL
TOMMY DAVIES	REALNAME	THOMAS GLANVILLE DAVIES
HEIN TEN HOFF	REALNAME	HEIN TEN HOFF
MICKY WARD	REALNAME	GEORGE MICHAEL WARD JR.
HUGO RUIZ	REALNAME	HUGO RUIZ DOMINGUEZ
DAVID DE LA MORA	REALNAME	DAVID DE LA MORA ZAMBRANO
MARCO ANTONIO LóPEZ	REALNAME	MARCO ANTONIO LóPEZ BALDERAS
ÁLVARO ROBLES	REALNAME	ÁLVARO ROBLES
DANIEL ROSAS	REALNAME	DANIEL ROSAS REYES
FELIPE ORUCUTA	REALNAME	FELIPE GUADALUPE ORUCUTA RAMIREZ
JUAN GARCíA MéNDEZ	REALNAME	TLOXING JUAN GARCíA MéNDEZ
NERY SAGUILáN	REALNAME	NERY ANTONIO SANGUILáN VARGAS
JOSé FéLIX, JR.	REALNAME	JOSé FéLIX SOTO
JORGE COTA	REALNAME	JORGE COTA
MANUEL MARIANO MARTíNEZ	REALNAME	MANUEL MARIANO MARTíNEZ
BRIAN SáNCHEZ	REALNAME	BRIAN SáNCHEZ
ENRIQUE COLIN	REALNAME	ENRIQUE COLIN REYES
RICKY CONCHA	REALNAME	KIYOSHI CONCHA RENDóN
AARON HERRERA	REALNAME	AARóN HERRERA CEN
GERARDO ROJAS	REALNAME	GERARDO ROJAS CORONADO
GILBERTO JOSUé GONZáLEZ	REALNAME	GILBERTO JOSUé GONZáLEZ
FELIPE UGALDE	REALNAME	FELIPE UGALDE
EDUARDO ESCOBEDO	REALNAME	EDUARDO FELIPE ESCOBEDO MATEO
JOE HANKS	REALNAME	JOE HANKS
FRANCISCO LORENZO	REALNAME	FRANCISCO LORENZO
ARISTIDES PéREZ	REALNAME	ARISTIDES PéREZ TORRES
OSCAR LEóN	REALNAME	OSCAR LEóN NAVAS
WILSON ALCORRO	REALNAME	WILSON ALCORRO
FIDEL MUñOZ	REALNAME	FIDEL ALEXANDER MONTERROSA MUñOZ
HUMBERTO TOLEDO	REALNAME	HUMBERTO TOLEDO VALVERDE
BENOIT GAUDET	REALNAME	BENOIT GAUDET
ANTONIO DAVIS	REALNAME	ANTONIO LARELL DAVIS
MARCO ANGEL PéREZ	REALNAME	MARCO ÁNGEL PéREZ
CéSAR FIGUEROA	REALNAME	CéSAR FIGUEROA HERNáNDEZ
LUIS FUENTE	REALNAME	LUIS ALBERTO FUENTE
IVAN VALLE	REALNAME	IVAN DEJESUS VALLE VELAZQUEZ
CARLOS URíAS	REALNAME	CARLOS URíAS
GAMALIEL DíAZ	REALNAME	GAMALIEL DíAZ MAGAñA
FERNANDO ORLANDO VELáRDEZ	REALNAME	FERNANDO ORLANDO VELáRDEZ
EDWARD LEE CROFT	REALNAME	EDWARD LEE CROFT
MIKE JUáREZ	REALNAME	MICHAEL LEROY JUáREZ
JUAN CARLOS RAMíREZ	REALNAME	JUAN CARLOS RAMíREZ
ÁNGEL CHACóN	REALNAME	ÁNGEL CHACóN
REYNANTE JAMILI	REALNAME	REYNANTE JAMILI
JEFFREY RESTO	REALNAME	JEFFREY RESTO
EMMANUEL CLOTTEY	REALNAME	EMMANUEL CLOTTEY
TOMAS BARRIENTES	REALNAME	TOMAS BARRIENTES
ROBERTO DAVID ARRIETA	REALNAME	ROBERTO DAVID ARRIETA
DAIRO JOSé ESALAS	REALNAME	DAIRO JOSé ESALAS
JASON MCCALMON	REALNAME	JASON AARON MCCALMON
SYLVESTER LOPEZ	REALNAME	SILVESTER LOPEZ
JOSé SALGADO FERNáNDEZ	REALNAME	JOSé ENRIQUE SALGADO FERNáNDEZ
JUAN ANTONIO RODRíGUEZ	REALNAME	JUAN ANTONIO RODRíGUEZ MOZO
CARL DAVIS	REALNAME	CARL DAVIS
JESúS ÁNGEL NERIO	REALNAME	JESúS ÁNGEL NERIO
FREDERICK PARKS	REALNAME	FREDERICK MOSTYN PARKS
GIDEON BUTHELEZI	REALNAME	GIDEON BONGANI
CHRISTOPHER MARTIN	REALNAME	CHRISTOPHER JOSHUA MARTIN PIñA
CHRIS AVALOS	REALNAME	CHRISTOPHER MATTHEW AVALOS
LUIS RAMOS, JR.	REALNAME	LUIS RAMOS JR
JAVIER TORRES	REALNAME	JAVIER TORRES
IVAN REDKACH	REALNAME	IVAN REDKACH
ARTURO GóMEZ	REALNAME	LUIS ARTURO GóMEZ TORRES
CORNELIUS LOCK	REALNAME	CORNELIUS EUGENE LOCK
PATRICK MCGUIGAN	REALNAME	PATRICK MCGUIGAN
YESICA BOPP	REALNAME	YESICA YOLANDA BOPP
JOSEPH AWINONGYA	REALNAME	JOSEPH AWINONGYA
JEAN PIERO PéREZ	REALNAME	JEAN PIERO PéREZ
HEDGEMON LEWIS	REALNAME	HEDGEMON LEWIS
SHEA NEARY	REALNAME	JAMES PATRICK NEARY
FIDEL BASSA	REALNAME	FIDEL BASSA
JACK CHASE	REALNAME	ISAIAH JAMES CHASE
ROGELIO VARGAS	REALNAME	ROGELIO VARGAS
JOSESITO LóPEZ	REALNAME	JOSé MANUEL LóPEZ
FERNANDO RODRíGUEZ	REALNAME	FERNANDO RODRíGUEZ
MATT REMILLARD	REALNAME	MATTHEW PATRICK REMILLARD
MATTHEW VILLANUEVA	REALNAME	MATTHEW VILLANUEVA
MANUEL ÁVILA	REALNAME	MANUEL ÁVILA
ÉRIC MOLINA	REALNAME	ÉRIC LEE MOLINA
DAVID ALONSO LóPEZ	REALNAME	DAVID ALONSO LóPEZ
MANUEL JIMéNEZ	REALNAME	MANUEL JIMéNEZ
MARTíN CARDONA	REALNAME	ISAíAS MARTíN CARDONA ASCENCIO
HORACIO GARCíA	REALNAME	HORACIO GARCíA RUBIO
LéO SANTA CRUZ	REALNAME	LéODEGARIO SANTA CRUZ
OCTAVIO MONTERO	REALNAME	JESúS OCTAVIO MONTERO GONZáLEZ
RAúL HIRALES JR.	REALNAME	RAúL BENJAMIN HIRALES CUEVAS
HUGO CENTENO, JR.	REALNAME	HUGO CENTENO, JR.
ADRIáN HERNáNDEZ	REALNAME	ADRIáN HERNáNDEZ
DAVID CAVITA	REALNAME	DAVID CAVITA
CARLOS GALLEGOS	REALNAME	CARLOS GALLEGOS
KAZUTO IOKA	REALNAME	KAZUTO IOKA
LUIS DAVID SERRANO	REALNAME	LUIS DAVID SERRANO
ADRíAN GRANADOS	REALNAME	ADRIáN RENé GRANADOS
IGNACIO ESPARZA	REALNAME	IGNACIO ESPARZA LOZANO
TONY DODSON	REALNAME	TONY DODSON
JOHN DUDDY	REALNAME	JOHN FRANCIS DUDDY
ALI CHEBAH	REALNAME	ALI CHEBAH
ANWAR OSHANA	REALNAME	ANWAR OSHANA
YūICHI KASAI	REALNAME	YūICHI KASAI
FRANK LOPORTO	REALNAME	FRANK LOPORTO
SOFIANE SEBIHI	REALNAME	SOFIANE SEBIHI
FRANCISCO CONTRERAS	REALNAME	FRANCISCO CONTRERAS
JAVIER FORTUNA	REALNAME	JAVIER FORTUNA
CHAUNCY WELLIVER	REALNAME	CHAUNCY WELLIVER
ALEJANDRO PéREZ	REALNAME	ALEJANDRO PéREZ
EDDIE MCGOORTY	REALNAME	EDWARD MARTIN MCGOORTY
TAKALANI NDLOVU	REALNAME	TAKALANI HYWETH NDLOVU
FELIPE CAMPA	REALNAME	FELIPE CAMPA
HARRY HAFT	REALNAME	HERSCHEL  HAFT
DANIEL COTA	REALNAME	DANIEL COTA
HUMBERTO TAPIA	REALNAME	HUMBERTO TAPIA ARMENTA
MARTIN SANTIAGO AUGUSTO CASTILLO	REALNAME	MARTIN SANTIAGO AUGUSTO CASTILLO
ERNESTO ZAVALA	REALNAME	ERNESTO ZAVALA
YAQUI LóPEZ	REALNAME	ÁLVARO LóPEZ
KARIM MAYFIELD	REALNAME	KARIM RASHEED MAYFIELD
LEE PURDY	REALNAME	LEE PURDY
RAY NARH	REALNAME	RAYMOND AKWETE NARH
JUAQUIN GALLARDO	REALNAME	JUAQUIN GALLARDO
MANUEL GARNICA	REALNAME	HECTOR MANUEL GARNICA VENEGAS
MIGUEL ÁNGEL HUERTA	REALNAME	MIGUEL ÁNGEL HUERTA MEDINA
ARIS AMBRíZ	REALNAME	ARIS AMBRíZ
SAúL ROMáN	REALNAME	SAúL ROMáN MARTíNEZ CASTAñEDA
RON CISNEROS	REALNAME	RON CISNEROS
FRANCISCO PALACIOS	REALNAME	FRANCISCO PALACIOS
JAVIER GALLO	REALNAME	JAVIER GALLO GONZáLEZ
TEPPARITH SINGWANCHA	REALNAME	PHANTEP MOONLEEPUM
MARK SUáREZ	REALNAME	MARK ANTHONY SUáREZ
SCOTT WELCH	REALNAME	SCOTT WELCH
VICTORIA CISNEROS	REALNAME	VICTORIA CISNEROS
TRAVIS DICKINSON	REALNAME	TRAVIS DICKINSON
JACKIE JURICH	REALNAME	JACKIE JURICH
CLAUS BERTINO	REALNAME	CLAUS BERTINO
SERGIO VILLANUEVA	REALNAME	SERGIO VILLANUEVA
SILVERIO ORTIZ	REALNAME	SILVERIO JOSé ORTIZ LEY
MIGUEL BELTRáN JR.	REALNAME	MIGUEL BELTRáN RUIZ JR.
MIGUEL CARTAGENA	REALNAME	MIGUEL CARTAGENA
NAGY AGUILERA	REALNAME	NAGY AGUILERA DE LA ROSA
EFRAIN ESQUIVIAS, JR.	REALNAME	EFRAIN ESQUIVIAS
ANDREY KLIMOV	REALNAME	ANDREY KLIMOV
KENDRICK RELEFORD	REALNAME	KENDRICK RELEFORD
MANUEL OSSIE	REALNAME	LEE MANUEL OSSIE
ZAKEEM GRAHAM	REALNAME	ZAKEEM GRAHAM
THOMAS HAYES	REALNAME	THOMAS HAYES
DAMIAN NORRIS	REALNAME	DAMIEN ARNET ESPINOSA
LAMAR RUSS	REALNAME	LAMAR RUSS
NEIL HADDOCK	REALNAME	NEIL HADDOCK
FLOYD HAVARD	REALNAME	FLOYD HAVARD
BILLY LYELL	REALNAME	WILLIAM LYELL
CARLOS MOLINA	REALNAME	CARLOS AMADO MOLINA
JOSé MANUEL OSóRIO	REALNAME	JOSé MANUEL OSóRIO
JESúS SILVESTRE	REALNAME	JOSé JESúS SILVESTRE
CRAWFORD GRIMSLEY	REALNAME	CRAWFORD GRIMSLEY
STEVE SIMS	REALNAME	STEVE SIMS
CARLOS PéREZ SUáREZ	REALNAME	CARLOS PéREZ SUáREZ
JUAN CARLOS SáNCHEZ, JR.	REALNAME	JUAN CARLOS SáNCHEZ TERRONES
ALBERTO SANDOVAL	REALNAME	ALBERTO SANDOVAL
SILVIU OLTEANU	REALNAME	SILVIU MARIUS OLTEANU
GIULIAN ILIE	REALNAME	IULIAN GEORGE ILIE
SHERMAN WILLIAMS	REALNAME	SHERMAN ALEXANDER WILLIAMS
ROBERT FRANKEL	REALNAME	ROBERT FRANKEL
DUSTY HERNáNDEZ-HARRISON	REALNAME	ARTURO HARRISON-HERNáNDEZ
ARTURO BADILLO	REALNAME	ARTURO BADILLO
IVáN RAMíREZ	REALNAME	IVáN RAMíREZ
MAHONRI MONTES	REALNAME	MAHONRY MONTES CASTILLO
JOSé EDUARDO LóPEZ	REALNAME	JOSé EDUARDO LóPEZ RODRíGUEZ
HUMBERTO SOTO	REALNAME	HUMBERTO SOTO
ADAM FLORES	REALNAME	ADAM FLORES CRUZ
RAúL JORGE MUñOZ	REALNAME	RAúL JORGE MUñOZ
RUBéN GALVáN	REALNAME	RUBéN GALVáN
RAY SáNCHEZ	REALNAME	RAY SáNCHEZ III
JOSé CELAYA	REALNAME	JOSé ANTONIO CELAYA
ADAM WYNANT	REALNAME	ADAM WYNANT
JERMAINE WHITE	REALNAME	JERMAINE GAVIN WHITE
GROVER WILEY	REALNAME	JAMES GROVER WILEY
LOUIS BROWN	REALNAME	LOUIS EDWARD BROWN
ANTHONY SHULER	REALNAME	ANTHONY SHULER
RAFAEL GUZMáN	REALNAME	RAFAEL GUZMáN HERNáNDEZ
JOSEPH PARKER	REALNAME	JOSEPH DENNIS PARKER
HENRY AURAD	REALNAME	HENRY AURAD
SAMMY MERZA	REALNAME	SAMMY MERZA
OMAR SALADO	REALNAME	OMAR ALEJANDRO SALADO FUENTES
ERIK RUIZ	REALNAME	ÉRIK RUíZ
PAUL EDWARDS	REALNAME	PAUL EDWARDS
TIGER SMALLS	REALNAME	PRIEST GEORGE YOUNGS SMALLS
ALFREDO ZUANY	REALNAME	ALFREDO ZUANY
ANTONIO DE LA FUENTE	REALNAME	ANTONIO DE LA FUENTE
ARTURO LóPEZ CASTRO	REALNAME	ARTURO LóPEZ CASTRO
BENNETTO PAYNE	REALNAME	BENNETTO PAYNE
PHIL LO GRECO	REALNAME	PHIL LO GRECO
ARMANDO MUñíZ	REALNAME	ARMANDO MUñIZ
JESúS ANTONIO HERNáNDEZ	REALNAME	JESúS ANTONIO HERNáNDEZ
CéSAR CHáVEZ	REALNAME	CéSAR CHáVEZ
HANZEL MARTíNEZ	REALNAME	HANZEL MARTíNEZ
CRUZ ANTONIO FLORES	REALNAME	CRUZ ANTONIO FLORES
EDGAR MONARREZ	REALNAME	EDGAR MONARREZ
DANIEL EVANGELISTA, JR.	REALNAME	DANIEL EVANGELISTA FLORES
MARCOS ANTONIO LóPEZ	REALNAME	MARCOS ANTONIO LóPEZ
JORGE SILVA	REALNAME	JORGE SILVA
JOSé NABOR	REALNAME	JOSé NABOR
ABRAR HUSSAIN	REALNAME	SYED ABRAR HUSSAIN SHAH
RAúL CARRILLO	REALNAME	RAúL CARRILLO
RICARDO CASTILLO	REALNAME	RICARDO EDGAR CASTILLO
VICENTE MIJARES	REALNAME	VICENTE MIJARES SALDIVAR
RICARDO MIJARES	REALNAME	RICARDO MIJARES
ROBERTO ARREDONDO	REALNAME	ROBERTO ARREDONDO
ALEJANDRO MONTIEL	REALNAME	ALEJANDRO FéLIX MONTIEL
JOE WARD	REALNAME	JOSEPH WARD
DANNY MALLOY	REALNAME	DANIEL MALLOY
DURRELL RICHARDSON	REALNAME	DURRELL RICHARDSON
DHAFIR SMITH	REALNAME	DHAFIR SMITH
PATRICK NIELSEN	REALNAME	PATRICK REINHARD NIELSEN
KALIESHA WEST	REALNAME	KALIESHA WEST
KOSTAS PETROU	REALNAME	KOSTAS PETROU
ARMANDO TORRES	REALNAME	ARMANDO HERNáNDEZ TORRES
PORNSAWAN PORPRAMOOK	REALNAME	SOMPORN SEETA
JUNIOR FARZAN ALI	REALNAME	JUNIOR FARZAN ALI
JONATHAN HAMM	REALNAME	JONATHAN HAMM
ERROL SPENCE	REALNAME	ERROL SPENCE JR.
JESSE HART	REALNAME	JESSE HART
JAMEL HERRING	REALNAME	JAMEL ELLIBY HERRING
MIKE AYALA	REALNAME	MIKE AYALA
FRANKIE BALTAZAR	REALNAME	FRANKIE BALTAZAR
ROBERT BALTAZAR	REALNAME	ROBERT EDWARD BALTAZAR
VINNIE CURTO	REALNAME	VINCENT JOSEPH CURTO
JERRY ROSENBERG	REALNAME	JERRY ROSENBERG
GáBOR VETő	REALNAME	GáBOR VETő
THOMAS DULORME	REALNAME	THOMAS DULORME CORDERO
SURIYAN SOR RUNGVISAI	REALNAME	SURIYAN KAIGANHA
WALE OMOTOSO	REALNAME	OYEWALE OMOTOSO
MOISéS FUENTES	REALNAME	MOISéS FUENTES RUBIO
TOMONOBU SHIMIZU	REALNAME	TOMONOBU SHIMIZU
RODRIGO GUERRERO	REALNAME	RODRIGO GUERRERO
GENE PUKALL	REALNAME	GENE PUKALL
ROYAL KOBAYASHI	REALNAME	KAZUO KOBAYASHI
KIYOSHI HATANAKA	REALNAME	KIYOSHI HATANAKA
J'LEON LOVE	REALNAME	J'LEON LOVE
KENJI YONEKURA	REALNAME	KENJI YONEKURA
SHIGEO NAKAJIMA	REALNAME	SHIGEO NAKAJIMA
TAKUYA MUGURUMA	REALNAME	TAKUYA MUGURUMA
MIKAYL ARREOLA	REALNAME	MIKAYL ARREOLA
ROBERT MANZANAREZ	REALNAME	ROBERT MANZANáREZ SANDOVAL
MIGUEL BERCHELT	REALNAME	MIGUEL ÁNGEL BERCHELT CERVERA
JOSé CHARLES	REALNAME	JOSE CHARLES
ROQUE MEX	REALNAME	ROQUE MEX CERVERA
SERGIO VARGAS GONZALEZ	REALNAME	SERGIO VARGAS GONZáLEZ
CéSAR GAYTAN	REALNAME	CéSAR GAYTAN
KōJI KOBAYASHI	REALNAME	KōJI KOBAYASHI
TADASHI TOMORI	REALNAME	TADASHI TOMORI
HAIRON SOCARRAS	REALNAME	HAIRON SOCARRAS
MIGUEL FLORES	REALNAME	MIGUEL FLORES
LUIS CRUZ	REALNAME	LUIS A. CRUZ
DERRIC ROSSY	REALNAME	DERRIC ROSSY
LORENZO VILLANUEVA	REALNAME	LORENZO G. VILLANUEVA
ANDREW SELBY	REALNAME	ANDREW SELBY
ANTHONY JOSHUA	REALNAME	ANTHONY OLUWAFEMI OLASENI JOSHUA
CHRIS PEARSON	REALNAME	CHRIS PEARSON
TOMMY STUBBS	REALNAME	TOMMY STUBBS
MATTY ASKIN	REALNAME	MATTHEW ASKIN
RHYS ROBERTS	REALNAME	RHYS ROBERTS
JEZ WILSON	REALNAME	JEREMY WILSON
VICENTE MARTíN RODRíGUEZ	REALNAME	VICENTE MARTíN RODRíGUEZ
FRANK CEDENO	REALNAME	FRANKLIN CEDENO
RICHAR ABRIL	REALNAME	RICHAR ABRIL
HOCINE KHALFI	REALNAME	HOCINE KHALFI
DELVIN RODRíGUEZ	REALNAME	DELVIN ANTONIO RODRíGUEZ
AKIRA YAEGASHI	REALNAME	AKIRA YAEGASHI
NEVILLE MEADE	REALNAME	NEVILLE MEADE
ELLEY BENNETT	REALNAME	ELLIOT BENNETT
WILL ROSINSKY	REALNAME	WILLIAM M. ROSINSKY
JUSTO SUáREZ	REALNAME	JUSTO ANTONIO SUáREZ
GLEN TAPIA	REALNAME	GLEN TAPIA
ARTEMIO REYES	REALNAME	ARTEMIO REYES
MARIO MACIAS	REALNAME	MARIO ANTONIO MACIAS OROZCO
BRYAN VáZQUEZ	REALNAME	BRYAN VáZQUEZ
SHINSUKE YAMANAKA	REALNAME	SHINSUKE YAMANAKA
RYōTA MURATA	REALNAME	村田 諒太
PAIPHAROB KOKIETGYM	REALNAME	PAI PHAROB
MICHAEL OLIVEIRA	REALNAME	MICHAEL OLIVEIRA
FERNANDO CASTAñEDA	REALNAME	FERNANDO CASTAñEDA
VICTOR TERRAZAS	REALNAME	VíCTOR JOSé TERRAZAS MARTíNEZ
ROGELIO RUVALCABA	REALNAME	ROGELIO RUVALCABA
MARK DAVIS	REALNAME	MARK DAVIS
JUAN HIRACHETA	REALNAME	JUAN ISIDRO HIRACHETA MARTíNEZ
SEAN MONAGHAN	REALNAME	SEAN MONAGHAN
ALOIZS TUMIņš	REALNAME	ALOIZS TUMIņš
ZACHARY WOHLMAN	REALNAME	ZACHARY WOHLMAN
DENYS BERINCHYK	REALNAME	Денис Беринчик
BOBBY LYNN BRYANT	REALNAME	BOBBY LYNN BRYANT
XAVIER MONTELONGO	REALNAME	XAVIER MONTELONGO JR
ADRIAN MORA	REALNAME	ADRIáN MORA
HERBERT LEWIS HARDWICK	REALNAME	HERBERT LEWIS HARDWICK
LIBORIO SOLíS	REALNAME	LIBORIO SOLíS MARTURET
JOHAN PéREZ	REALNAME	JOHAN ALFREDO PéREZ MORA
EVGENY GRADOVICH	REALNAME	EVGENY PAVLOVICH GRADOVICH
ANDREW RUIZ	REALNAME	ANDREW GARCíA RUIZ
MAIRTIN THORNTON	REALNAME	MAIRTIN Ó DROIGHNEáIN
VICTOR LUPO PUIU	REALNAME	VICTOR PUIU
BRAIMAH KAMOKO	REALNAME	ISAAC BRAIMAH KAMOKO
JOE JOHNS	REALNAME	JOE JOHN
LEN WICKWAR	REALNAME	LEONARD ARTHUR WICKWAR
LOGAN MCGUINNESS	REALNAME	LOGAN COTTON MCGUINNESS
TYRONE TRICE	REALNAME	TYRONE TRICE
JERMELL CHARLO	REALNAME	JERMELL DE'AVANTE CHARLO
CLIFF CURVIS	REALNAME	CLIFF NANCURVIS
KARLO MAQUINTO	REALNAME	KARLO P. MAQUINTO
LIVIO MINELLI	REALNAME	LIVIO MINELLI
NOEL TRIGG	REALNAME	NOEL F. TRIGG
ELVIN AYALA	REALNAME	ELVIN AYALA
SHEMUEL PAGAN	REALNAME	SHEMUEL ISRAEL PAGAN
REDVERS SANGOE	REALNAME	REDVERS SANGOE
MARK KAYLOR	REALNAME	MARK KAYLOR
HAMID RAHIMI	REALNAME	HAMIDULLAH RAHIMI
SONNY BOY JARO	REALNAME	SONNY BOY JARO
TOMMY KARPENCY	REALNAME	TOMMY KARPENCY
PHINEAS JOHN	REALNAME	PHINEAS GLADNEY JOHN
ANGELO SANTANA	REALNAME	CARLOS ANGELO SANTANA
IMARJOE MILLER	REALNAME	IMARJOE MILLER
YOTA SATO	REALNAME	YOTA SATO
ALEXANDER FLORES	REALNAME	ALEXANDER FLORES
DENNIS AVOTH	REALNAME	DENNIS AVOTH
PIERRE VOGEL	REALNAME	PIERRE VOGEL
RONNY RIOS	REALNAME	RONNY RIOS
WAYNE ELLIS	REALNAME	WAYNE ELLIS
FRED DYER	REALNAME	FREDERICK WILLIAM O'DWYER
NYAMBAYARYN TöGSTSOGT	REALNAME	TUGSTSOGT NYAMBAYAR
JAMES KINCHEN	REALNAME	JAMES KINCHEN
PIER-OLIVIER CôTé	REALNAME	PIER-OLIVIER CôTé
CAMERON HAMMOND	REALNAME	CAMERON JAMES HAMMOND
PIERRE FOURIE	REALNAME	PIERRE JACY FOURIE
CHRIS BACON	REALNAME	CHRISTOPHER BACON
VICTOR PASILLAS	REALNAME	VíCTOR MANUEL PASILLAS
JEYVIER CINTRóN	REALNAME	JEYVIER J. CINTRóN OCASIO
JANTONY ORTIZ	REALNAME	JANTONY ORTIZ MARCANO
OBIE WALKER	REALNAME	OBIE DIA WALKER
BILL TATE	REALNAME	WILLIAM G. TATE
ED MARTIN	REALNAME	ED MARTIN
TONY DOMINGUEZ JR.	REALNAME	ANTONIO DOMINGUEZ, JR.
CORNELIUS CARR	REALNAME	JOHN THOMAS CARR
CHARLES C. SMITH	REALNAME	CHARLES C. SMITH
SEAL HARRIS	REALNAME	CECIL HARRIS
LARRY ESTRIDGE	REALNAME	LARRY ESTRIDGE
YOUNG PETER JACKSON	REALNAME	SIM THOMPKINS
YOUNG PETER JACKSON	REALNAME	PETER MARTIN
ARTHUR PELKEY	REALNAME	ANDREW ARTHUR PELLETIER
ZOLANI PETELO	REALNAME	ZOLANI PETELO
MANUEL CHARR	REALNAME	MAHMOUD OMEIRAT CHARR
JOHNNY HOULSTON	REALNAME	JOHNNY HOULSTON
JACK MORAN	REALNAME	JOHN RALPH CIZEK
CHRIS ALGIERI	REALNAME	CHRISTOPHER MARK ALGIERI
MARIO HEREDIA	REALNAME	MARIO HEREDIA
ANDREAS SIDON	REALNAME	ANDREAS SIDON
PATRICK MAJEWSKI	REALNAME	PRZEMYSłAW MAJEWSKI
NURI SEFERI	REALNAME	NURI SEFERI
PEDRO GUEVARA	REALNAME	PEDRO GUEVARA
STEFAN HäRTEL	REALNAME	STEFAN HAERTEL
ENAD LIčINA	REALNAME	ENAD LIčINA
SERDAR HUDAYBERDIYEV	REALNAME	SERDAR HUDAýBERDIýEW
OLEKSANDR HVOZDYK	REALNAME	OLEKSANDR GVOZDYK
JAVIER LOYA	REALNAME	JAVIER LOYA
IRVING GARCíA	REALNAME	IRVING GARCíA
RONALD ELLIS	REALNAME	RONALD ELLIS
DUKE MICAH	REALNAME	DUKE AKUETTEH MICAH
MARIO RODRIGUEZ	REALNAME	MARIO RODRíGUEZ
SERGEY RABCHENKO	REALNAME	SIARHEI RABCHANKA
MOHAMED BOUDCHICHE	REALNAME	MOHAMED BOUDCHICHE
GERALD WASHINGTON	REALNAME	GERALD WASHINGTON
MAHIR ORAL	REALNAME	MAHIR ORAL
DOMENICO SPADA	REALNAME	DOMENICO SPADA
CARSON JONES	REALNAME	CARSON JONES
JAYSON VéLEZ	REALNAME	JAYSON VELEZ JIMENEZ
ALEX MISKIRTCHIAN	REALNAME	ALEXANDER MISKIRTCHIAN
RUDY MARKUSSEN	REALNAME	RUDY MARKUSSEN
DENNIS TALBOT	REALNAME	DENNIS ALAN TALBOT
RYO MIYAZAKI	REALNAME	RYO MIYAZAKI
KOHEI KONO	REALNAME	KOHEI KONO
ERIC JAMILI	REALNAME	ERIC JAMILI
DONALD BRAITHWAITE	REALNAME	DONALD G. BRAITHWAITE
MALCOLM COLLINS	REALNAME	MALCOLM COLLINS
MARCOS GERALDO	REALNAME	MARCOS LóPEZ
MARK LLOYD	REALNAME	MARK LLOYD
RUSLAN PROVODNIKOV	REALNAME	RUSLAN MIKHAILOVICH PROVODNIKOV
EISA AL DAH	REALNAME	EISA AL DAH
MERLITO SABILLO	REALNAME	MERLITO LABRADOR SABILLO JR.
JUAN FRANCISCO ESTRADA	REALNAME	JUAN FRANCISCO ESTRADA ROMERO
SULEM URBINA	REALNAME	SULEM URBINA
THOMAS WILLIAMS JR.	REALNAME	THOMAS WILLIAMS, JR.
ERNIE FIELD	REALNAME	ERNEST FIELD
NOé GONZáLEZ ALCOBA	REALNAME	NOé TULIO GONZáLEZ ALCOBA
JOHNNY JARRETT	REALNAME	JOHN TREVOR PATTEN
SRISAKET SOR RUNGVISAI	REALNAME	WISAKSIL WANGEK
LUCIAN BOT	REALNAME	LUCIAN TUDOR BOT
JULIO CéSAR CEJA PEDRAZA	REALNAME	JULIO CéSAR CEJA PEDRAZA
KRZYSZTOF ZIMNOCH	REALNAME	KRZYSZTOF ZIMNOCH
KEITH TATE	REALNAME	KEITH M. TATE
ALAN RICHARDSON	REALNAME	ALAN RICHARDSON
SIDNEY PARKINSON	REALNAME	SIDNEY F. PARKINSON
HUGHIE FURY	REALNAME	HUGHIE LEWIS FURY
HAPPY PIETERSE	REALNAME	JAN HAPPY PIETERSE
KARL DAVEY	REALNAME	KARL DAVEY
MARK DAVEY	REALNAME	MARK DAVEY
DAVE SHADE	REALNAME	CHARLES D. SHADE
DIEGO DE LA HOYA	REALNAME	DIEGO DE LA HOYA
TERRY DOLAN	REALNAME	TERENCE DOLAN
BOB TUCKETT	REALNAME	BOB TUCKETT
BRUNO SANDOVAL	REALNAME	BRUNO SANDOVAL NúñEZ
ROBERT WOGE	REALNAME	ROBERT WOGE
SERGEY KOVALEV	REALNAME	SERGEY ALEXANDROVICH KOVALEV
KEVIN SATCHELL	REALNAME	KEVIN SATCHELL
GONZALO BASILE	REALNAME	GONZALO OMAR BASILE
CARLOS BUITRAGO	REALNAME	CARLOS ALBERTO BUITRAGO ROJAS
HIROYUKI HISATAKA	REALNAME	HIROYUKI HISATAKA
DAVID ZEGARRA	REALNAME	DAVID MARTIN ZEGARRA
JESúS CUELLAR	REALNAME	JESúS MARCELO ANDRéS CUELLAR
CHRIS JENKINS	REALNAME	CHRIS JENKINS
NAT JACOBS	REALNAME	NATHANIEL J. S. JACOBS
RUSTICO TORRECAMPO	REALNAME	ESCOLASTICO P. TORRECAMPO JR.
JIMMY CABLE	REALNAME	JAMES T. CABLE
JACK ROWAN	REALNAME	FRANK ROWAN
CLAUDIO MARRERO	REALNAME	CLAUDIO MARRERO
MATTHEW CURRAN	REALNAME	MATTHEW CURRAN
MARCIN REKOWSKI	REALNAME	MARCIN REKOWSKI
DAMIAN JONAK	REALNAME	DAMIAN JONAK
FRED STORBECK	REALNAME	FRED STORBECK
JOE BECKETT	REALNAME	JOSEPH BECKETT
PHIL SCOTT	REALNAME	PHILIP SCOTT SUFFLING
OMARI KIMWERI	REALNAME	OMARI IDD KIMWERI
BEN FOORD	REALNAME	BENJAMIN FOORD
TOM BERRY	REALNAME	TOM BERRY
ROLAND TODD	REALNAME	ROLAND GRIFFITH TODD
BOBBY HALPERN	REALNAME	ROBERT HALPERN
LEN JOHNSON	REALNAME	LEONARD BENKER JOHNSON
CHARLIE WEIR	REALNAME	CHARLES HENRY HUGHWRIGHT WEIR
TOMMY MILLIGAN	REALNAME	THOMAS MILLIGAN
TOM MCCORMICK	REALNAME	THOMAS MCCORMICK
TOMMY FAIRHALL	REALNAME	THOMAS FAIRHALL
AL FOREMAN	REALNAME	ALBERT FOREMAN
LEO ROY	REALNAME	LEO PARADIS
TOMMY HARRISON	REALNAME	THOMAS HARRISON
HARRY LAKE	REALNAME	HENRY LAKE
JOHNNY BROWN	REALNAME	PHILIP HICKMAN
TEDDY BALDOCK	REALNAME	ALFRED STEPHEN BALDOCK
HORACE NOTICE	REALNAME	HORACE G. NOTICE
DEREK WILLIAMS	REALNAME	DEREK WILLIAMS
STEWART LITHGO	REALNAME	STEWART LITHGO
CHISANDA MUTTI	REALNAME	CHISANDA MUTTI
JOHN SICHULA	REALNAME	JOHN SICHULA
CHARM CHITEULE	REALNAME	CHARM CHITEULE
FRANCO WANYAMA	REALNAME	FRANCO WANYAMA
JUSTIN JUUKO	REALNAME	JUSTIN JUUKO
MODESTY NAPUNYI	REALNAME	MODEST NAPUNYI ODUORI
TOMMY WAITE	REALNAME	THOMAS WAITE
DANIEL WARD	REALNAME	DANIEL WARD
ANDRE THYSSE	REALNAME	ANDRE THYSSE
JOHNSON TSHUMA	REALNAME	JOHNSON TSHUMA
LANGTON TINAGO	REALNAME	LANGTON TINAGO
PATRICK MAMBWE	REALNAME	PATRICK MAMBWE
NEIL SWAIN	REALNAME	NEIL SWAIN
JOHNNY ABA	REALNAME	JOHNNY ABA
AL KOROVOU	REALNAME	ALIPATE KOROVOU
SYLVESTER MITTEE	REALNAME	SYLVESTER MITTEE
BERNARD PAUL	REALNAME	BERNARD PAUL
HIROFUMI MUKAI	REALNAME	HIROFUMI MUKAI
KENNY BRISTOL	REALNAME	KENNY BRISTOL
ANDREW MURRAY	REALNAME	ANDREW MURRAY
LENNOX BLACKMOORE	REALNAME	LENNOX BLACKMOORE
DENNIS ADAMS	REALNAME	DENNIS ADAMS
JAKE TULI	REALNAME	JACOB NTULI
JOHNNY VAN RENSBURG	REALNAME	JOHNNY VAN RENSBURG
MIKE HOLT	REALNAME	ANTIONE MICHAEL HOLTHAUSEN
MANNY SANTOS	REALNAME	MANOEL SANTOS
TUNA SCANLAN	REALNAME	TUNA WILLIARD SCANLAN
BARRY BROWN	REALNAME	BARRINGTON REGINALD BROWN
BOS MURPHY	REALNAME	RICHARD BOSWELL MURPHY
PERCY HAYLES	REALNAME	PERCIVAL HAYLES
BUNNY GRANT	REALNAME	GEORGE LESLIE GRANT
MILO CALHOUN	REALNAME	CEPHAS COLQUHOUN
EMANUELE DELLA ROSA	REALNAME	EMANUELE DELLA ROSA
EDDIE NDUKWU	REALNAME	EDWARD NDUKWU
YAQUB KAREEM	REALNAME	YAKUBA KARIM
FATAI ONIKEKE	REALNAME	FATAI ONIKEKE ISIAKA
ARTHUR KING	REALNAME	ARTHUR AUGUSTUS KING
PERCY COMMEY	REALNAME	PERCY OBLITEI COMMEY
FLOYD ROBERTSON	REALNAME	FLOYD CLOTTEY QUARTEY
ROY ANKRAH	REALNAME	JOHN THEOPHILUS OTI ANKRAH
LOVE ALLOTEY	REALNAME	SUMOO PAPPOE ALLOTEY
DAVID TETTEH	REALNAME	DAVID ODOI TETTEH
JOSHUA OKINE	REALNAME	BUKOM TSATSU
OSSIE DURAN	REALNAME	OSUMANU YAHAYA
JIM WEST	REALNAME	JAMES WEST
HENRY NISSEN	REALNAME	HENRY NISSENBAUM
PAUL FERRERI	REALNAME	PAULO FERRERI
DARBY BROWN	REALNAME	LESLIE BROWN
LEO YOUNG	REALNAME	LEO YUREWICZ
KEN SALISBURY	REALNAME	KENNETH E. SALISBURY
NAOYA INOUE	REALNAME	NAOYA INOUE
CHARKEY RAMON	REALNAME	DAVE BRUCE BALLARD
AL BOURKE	REALNAME	ALAN STAMFORD
RON RICHARDS	REALNAME	RANOLD/RANDELL WILLIAM RICHARDS
SHIG FUKUYAMA	REALNAME	SHIGEFUMI FUKUYAMA
SHIG FUKUYAMA	REALNAME	福山茂文
LOU CAFARO	REALNAME	LUCIANO CAFARO
STAN ROWAN	REALNAME	STANLEY J. ROWAN
JON JO IRWIN	REALNAME	JOHN IRWIN
MARK REEFER	REALNAME	MARK THOMPSON
JOSE ZEPEDA	REALNAME	JOSE ZEPEDA
JOHNNY PRESCOTT	REALNAME	JOHN M. PRESCOTT
MO HUSSEIN	REALNAME	MURAD HUSSEIN
PAT DOHERTY	REALNAME	PATRICK P. M. DOHERTY
FRANK JOHNSON	REALNAME	FRANK WILLIAMSON
ANDY HOLLIGAN	REALNAME	ANDREW FREDERICK HOLLIGAN
KID GALAHAD	REALNAME	ABDUL-BARI AWAD
WALLY THOM	REALNAME	WALTER THOM
KITIONE LAVE	REALNAME	LAVEMAI KITIONE TAKITAU
STEVE FOSTER	REALNAME	STEPHEN C. FOSTER
MICKEY HUGHES	REALNAME	MICHAEL HUGHES
LLOYD HIBBERT	REALNAME	GLENROY LLOYD HIBBERT
NICKY WILSHIRE	REALNAME	NICHOLAS C. WILSHIRE
MARK ROWE	REALNAME	MARK W. ROWE
JOHNNY PRITCHETT	REALNAME	JOHN G. PRITCHETT
LES MCATEER	REALNAME	LESLIE MCATEER
PAT MCATEER	REALNAME	EDWARD PATRICK MCATEER
DEREK ANGOL	REALNAME	DEREK STEVE ANGOL
CRAWFORD ASHLEY	REALNAME	GARY CRAWFORD
KELVIN SMART	REALNAME	KELVIN SMART
HEKKIE BUDLER	REALNAME	HECTOR BUDLER
DAI ST. JOHN	REALNAME	DAVID JONES
RANCES BARTHELEMY	REALNAME	RANCES BARTHELEMY
ALI RAYMI	REALNAME	ALI IBRAHIM ALI AL-RAIMI
JOHNNY ERTEL	REALNAME	JOHNNE ERTEL
MAIRIS BRIEDIS	REALNAME	MAIRIS BRIEDIS
LOOKRAK KIATMUNGMEE	REALNAME	LOOKRAK KIATMUNGMEE
ALEX LEAPAI	REALNAME	ELISE LEAPAI
JOSé UZCáTEGUI	REALNAME	JOSé UZCáTEGUI
YOUNG ALLSOPP	REALNAME	WILLIAM JONATHAN ALSOP
PHIL EDWARDS	REALNAME	PHILIP CILIA
MARCELINO NICOLAS LOPEZ	REALNAME	MARCELINO NICOLAS LOPEZ
LEIGH WOOD	REALNAME	LEIGH WOOD
MIKE REED	REALNAME	MICHAEL REED
COURTNEY FRY	REALNAME	COURTNEY FRY
GAVIN MCDONNELL	REALNAME	GAVIN MCDONNELL
MILORAD ŽIžIć	REALNAME	MILORAD ŽIžIć
JOE GRIM	REALNAME	SAVERIO GIANNONE
MATTY MATTHEWS	REALNAME	WILLIAM ROBERT MATTHEWS
OSWALDO NOVOA	REALNAME	OSWALDO NOVOA MORA
BILL FARNAN	REALNAME	BILL FARNAN
NIHITO ARAKAWA	REALNAME	NIHITO ARAKAWA
FRANCISCO RODRíGUEZ JR.	REALNAME	JOSE FRANCISCO RODRIGUEZ TAMAYO
JEFF SMITH	REALNAME	JEROME JEFFERDS
CLIVE ATWELL	REALNAME	CLIVE ATWELL
GUSTAV SCHOLZ	REALNAME	GUSTAV WILHELM HERMANN SCHOLZ
CHRIS VAN HEERDEN	REALNAME	CHRIS VAN HEERDEN
WESLEY RAMEY	REALNAME	WESLEY RAMEY
MILTON SANTIAGO	REALNAME	MILTON SANTIAGO, JR.
VIKTOR POSTOL	REALNAME	VIKTOR VASYLOVYCH POSTOL
WALTER NEUSEL	REALNAME	WALTER NEUSEL
DAVID SáNCHEZ	REALNAME	DAVID SáNCHEZ CANTú
DIRCEU CABARCA	REALNAME	DIRCEU CABARCA
ALBERT PAGARA	REALNAME	ALBERT HEROGALEM PAGARA
YOURI KAYEMBRE KALENGA	REALNAME	YOURI KAYEMBRE KALENGA
STEPHEN SIMMONS	REALNAME	STEPHEN SIMMONS
BLAKE CAPARELLO	REALNAME	BLAKE CAPARELLO
ZOLANI TETE	REALNAME	ZOLANI TETE
ANNE SOPHIE MATHIS	REALNAME	ANNE-SOPHIE MATHIS
DARRELL SPINKS	REALNAME	DARRELL CALVIN
SHAWN CORBIN	REALNAME	SHAWN CORBIN
MANDEEP JANGRA	REALNAME	MANDEEP JANGRA
SCOTT FITZGERALD	REALNAME	SCOTT FITZGERALD
CHARLIE PILKINGTON	REALNAME	CHARLES PILKINGTON
RYAN SERMONA	REALNAME	RYAN PABILLO SERMONA
CHARLIE FLYNN	REALNAME	CHARLES FLYNN
TYRON ZEUGE	REALNAME	TYRON ZEUGE
THABISO MCHUNU	REALNAME	THABISO MCHUNU
DIANA PRAZAK	REALNAME	DIANA PRAZAK
RANDY PETALCORIN	REALNAME	RANDY FORMENTERA PETALCORIN
HANS HENRIK PALM	REALNAME	HANS HENRIK PALM
MICKEY BEY, JR.	REALNAME	MICKEY BEY, JR.
ROSS BURKINSHAW	REALNAME	ROSS BURKINSHAW
RICHARD COMMEY	REALNAME	RICHARD OBLITEY COMMEY
CARLOS ORTEGA	REALNAME	CARLOS ALEXIS ORTEGA BADILLO
JAVIER MENDOZA	REALNAME	JAVIER MENDOZA
GUNNER MOIR	REALNAME	JAMES MOIR
JACK PALMER	REALNAME	JOHN LIDDELL
HUGHROY CURRIE	REALNAME	TREVOR CURRIE
KNOCKOUT CP FRESHMART	REALNAME	THAMMANOON NIYOMTRONG
SATISH KUMAR	REALNAME	SATISH KUMAR
HARRY REEVE	REALNAME	HARRY ISAACS
NOEL %22BOY%22 MCCORMICK	REALNAME	NOEL HUGH MCCORMICK
SONYA LAMONAKIS	REALNAME	SONYA LAMONAKIS
ALEX BUXTON	REALNAME	ALEX LAURELL BUXTON
WANHENG MENAYOTHIN	REALNAME	CHAYAPHOL MOONSUREE
JACK HARRISON	REALNAME	JOHN HARRISON
BANDSMAN JACK BLAKE	REALNAME	JOHN BLAKE
TOM GUMMER	REALNAME	THOMAS GUMMER
GUS PLATTS	REALNAME	AUGUSTUS T. PLATTS
KOSEI TANAKA	REALNAME	KOSEI TANAKA
BYRON ROJAS	REALNAME	BYRON HASAEL ROJAS HERNANDEZ
ISMAIL KETA	REALNAME	ISMAIL  KETA
TYRONE EVERETT	REALNAME	TYRONE EVERETT
RYOICHI TAGUCHI	REALNAME	RYOICHI TAGUCHI
VINCE HAWKINS	REALNAME	VINCENT GREGORY HAWKINS
RYAN MARTIN	REALNAME	RYAN MARTIN
CARLOS RIOS	REALNAME	CARLOS ALBERTO RAMON RIOS
YOUNG JOSEPH	REALNAME	ASCHEL JOSEPH
PARK CHONG-PAL	REALNAME	PARK CHONG-PAL
SCOTTY OLSON	REALNAME	SCOTTY ROBERT OLSON
JOHNNY BROWN	REALNAME	JOHN FLEMING
JAKE KILRAIN	REALNAME	HENRY OWENS
BOB AJISAFE	REALNAME	ABUBAKER AJISAFE
ARTHUR VILLANUEVA	REALNAME	ARTHUR CORDERO VILLANUEVA
TAISHAN DONG	REALNAME	DONG JIANJUN
DEL BRYAN	REALNAME	DELROY BRIAN
TEE JAY	REALNAME	TAJU AKAY
GENESIS SERVANIA	REALNAME	GENESIS LLASOS SERVANIA
GEORGE BLADES	REALNAME	GEORGE BLADES
YOUNG MCCORMACK	REALNAME	JOHN MCCORMACK
ABRAHAM JACOB HOLLANDERSKY	REALNAME	ABRAHAM JACOB HOLLANDERSKY
ADY LEWIS	REALNAME	ADRIAN LEWIS
TANCY LEE	REALNAME	JAMES LEE
BOB MARRIOTT	REALNAME	ROBERT MARRIOTT
ERNIE RICE	REALNAME	JOHN TOMASSO
SEAMAN NOBBY HALL	REALNAME	JAMES HALL
SAMUEL VARGAS	REALNAME	SAMUEL ANDRES VARGAS ARIZA
MOSEY KING	REALNAME	MOSES KING
IAGO KILADZE	REALNAME	Яго Кіладзе
ERNIE IZZARD	REALNAME	ERNEST ALFRED IZZARD
JACK SILVER	REALNAME	JOHN SILVERSTEIN
MIKE SCHUTTE	REALNAME	MICHAEL RICHARD SCHUTTE
JERRY BELMONTES	REALNAME	JERRY BELMONTES
JIMMY GOODRICH	REALNAME	JAMES EDWARD MORAN
MICHAEL MERZ	REALNAME	MICHAEL ANTHONY MERZ, JR.
SOLLY SEEMAN	REALNAME	SHULIM SEEMAN
MATIAS RUEDA	REALNAME	MATíAS CARLOS ADRíAN RUEDA
PRINCE RODNEY	REALNAME	NOEL RODNEY
SAM EGGINGTON	REALNAME	SAM EGGINGTON
EDDIE KELLY	REALNAME	EDDIE KELLY
ANGEL ROBINSON GARCIA	REALNAME	ANGEL ROBINSON GARCIA
JOE BENJAMIN	REALNAME	JOSEPH BENJAMIN
HECTOR SALDIVIA	REALNAME	HECTOR DAVID SALDIVIA
MIKE %22TWIN%22 SULLIVAN	REALNAME	MICHAEL SULLIVAN
YOUSSOUF DJIBABA	REALNAME	YOUSSOUF DJIBABA
WILLIAM %22HONEY%22 MELLODY	REALNAME	WILLIAM J. MELLODY
FRANK ERNE	REALNAME	ERWIN ERNE
MICHEL SORO	REALNAME	MICHEL ABOU SORO
ERICA FARIAS	REALNAME	ERICA ANABELLA FARIAS
ALEJANDRA OLIVERAS	REALNAME	ALEJANDRA MARINA OLIVERAS
ZHANG JUNLONG	REALNAME	JUNLONG ZHANG
KEITH SAUNDERS	REALNAME	KEITH B. SAUNDERS
IK YANG	REALNAME	YANG LIAN HUI
YUNIESKI GONZALEZ	REALNAME	YUNIESKI GONZALEZ
JULIETTE WINTER	REALNAME	JULIETTE ANNE WINTER
ROBERTO BOLONTI	REALNAME	ROBERTO FELICIANO BOLONTI
BILLY WRIGHT	REALNAME	BILLY WRIGHT
JAVIER PRIETO	REALNAME	FRANCISCO JAVIER PRIETO ÁLVAREZ
JOE SYMONDS	REALNAME	HUBERT TOMS
DAZZO WILLIAMS	REALNAME	DARREN WILLIAMS
JAZZA DICKENS	REALNAME	JAMES DICKENS
JOHN THOMPSON	REALNAME	JOHN THOMPSON
ERICKSON LUBIN	REALNAME	ERICKSON LUBIN
GRETCHEN ABANIEL	REALNAME	GRETCHEN MAGBANUA ABANIEL
KALI REIS	REALNAME	KALI REIS
ARMANDO SANTOS	REALNAME	ARMANDO SANTOS MARCELO
ABE GOLDSTEIN	REALNAME	ABRAHAM ATTELL GOLDSTEIN
RYUJI HARA	REALNAME	RYUJI HARA
DES REA	REALNAME	DESMOND REA
STEPHANE JAMOYE	REALNAME	STEPHANE JAMOYE
LLOYD CHRISTIE	REALNAME	WESLEY LLOYD CHRISTIE
ILUNGA MAKABU	REALNAME	ILUNGA MAKABU
PRICHARD COLóN	REALNAME	PRICHARD COLóN MELéNDEZ
EMANUELE BLANDAMURA	REALNAME	EMANUELE NICOLA BLANDAMURA
TOMMY SPIDER KELLY	REALNAME	TOMMY KELLY
RYAN FARRAG	REALNAME	RYAN FARRAG
EDUARD TROYANOVSKY	REALNAME	EDUARD VALENTINOVICH TROJANOVSKY
YU KIMURA	REALNAME	YU KIMURA
WALTER TELLO	REALNAME	WALTER TELLO
GLEN KELLY	REALNAME	GLEN KELLY
WILLIAM BEZERRA	REALNAME	WILLIAM FERNANDO SOUZA BEZERRA
JO JO DAN	REALNAME	IONUț DAN ION
NOEL GEVOR	REALNAME	NORAIR GEVORGYAN
ALEX DICKSON	REALNAME	ALEXANDER DICKSON
JOSE ARGUMEDO	REALNAME	JOSE EDUARDO ARGUMEDO BARRAZA
CHRISTINA HAMMER	REALNAME	CHRISTINA HAMMER
AHMED KOTIEV	REALNAME	AHMED KOTIEV
TOMMY FREEMAN	REALNAME	THOMAS JEWEL FREEMAN
OKTAY TAKALAK	REALNAME	OKTAY TAKALAK
HARRY CORBETT	REALNAME	HENRY WILLIAM COLEMAN
JOHNNY MILER	REALNAME	JOHN MILETICH
MIKE KETA	REALNAME	GJETAN KETA
ARTEM KARPETS	REALNAME	ARTEM KARPETS
TOMMY WATSON	REALNAME	THOMAS WATSON
MAX BURSAK	REALNAME	*MAKSYM BURSAK\N*MAD MAX
JUNIOR FA	REALNAME	UAINE FA JR.
VENICE BORKHORSOR	REALNAME	PRAWET PONCHIENGKWANG
MICKI NIELSEN	REALNAME	MICKI REINHARD NIELSEN
DENIS SHAFIKOV	REALNAME	DENIS FUATOVICH SHAFIKOV
ARNOLD GJERGJAJ	REALNAME	ARNOLD GJERGJAJ
VICTOR CAYO	REALNAME	VICTOR MANUEL CAYO
JEZREEL CORRALES	REALNAME	JEZREEL CORRALES GONZáLEZ
KARIM EL OUAZGHARI	REALNAME	KARIM EL OUAZGHARI EL BOAZZATI
DANIEL RASILLA	REALNAME	DANIEL RASILLA COLASO
ISMAEL BARROSO	REALNAME	ISMAEL JOSE BARROSO BERNAY
ADRIAN TAIHIA	REALNAME	ADRIAN TAIHIA
FRANKIE NEIL	REALNAME	FRANCIS JAMES NEIL
JOSE GONZALEZ	REALNAME	JOSE A GONZALEZ
CHERIF HAMIA	REALNAME	CHERIF HAMIA
EDDIE MARTIN	REALNAME	EDUARDO VITTORIA MARTINO
CYRUS RAMONE PATTINSON	REALNAME	CYRUS RAMONE PATTINSON
JONATHAN TACONING	REALNAME	JONATHAN INGUITO TACONING
DMYTRO KUCHER	REALNAME	DMYTRO KUCHER
JIMMY REAGAN	REALNAME	JAMES REAGAN
MICHAEL O'REILLY	REALNAME	MICHAEL O'REILLY
GIEMEL MAGRAMO	REALNAME	GIEMEL ABUAN MAGRAMO
IKE WEIR	REALNAME	ISAAC O'NEIL WEIR
JUAN MIGUEL ELORDE	REALNAME	JUAN MIGUEL ELORDE
JUAN MARTIN ELORDE	REALNAME	JUAN MARTIN VICENCIO ELORDE
BILLEL DIB	REALNAME	BILLEL DIB
DMITRY SUKHOTSKY	REALNAME	DMITRY VLADIMIROVICH SUKHOTSKY
EDDIE SANTRY	REALNAME	EDWARD M. SANTRY
JONAS JUNIAS	REALNAME	JONAS JUNIAS JONAS
STEVE SULLIVAN	REALNAME	STEVEN JOHN TRICAMO
TOM LEES	REALNAME	THOMAS JAMES LEES
ROCKY SELVARAJOO	REALNAME	SELVARAJOO S/O MALAYAPPAN KRISHNASAMY
FRANKIE KLICK	REALNAME	FRANK KLICH
MGER MKRTCHYAN	REALNAME	MGER MKRTCHYAN
YA'ACOV SHMUEL	REALNAME	יעקב שמואל
BRANKO SOBOT	REALNAME	BRANKO SOBOT
DAVID EMANUEL PERALTA	REALNAME	DAVID EMANUEL PERALTA TOLEDO
SANDY MCVEA	REALNAME	SANDY MCPHERSON
TONY MARINO	REALNAME	ANTHONY MARINO
GENNADY MARTIROSYAN	REALNAME	GENNADY MARTIROSYAN
CONOR BENN	REALNAME	CONOR NIGEL BENN
YVAN MENDY	REALNAME	YVAN MENDY
ROMMEL ASENJO	REALNAME	ROMMEL L. ASENJO
EDDIE CONNOLLY	REALNAME	EDWARD CONNOLLY
DAVID AVANESYAN	REALNAME	DAVID GAVRUSHEVICH AVANESYAN
JERWIN ANCAJAS	REALNAME	JERWIN JUNTILLA ANCAJAS
CHORDALE BOOKER	REALNAME	CHORDALE BOOKER
JULIUS LONG	REALNAME	JULIUS LONG
IAN LEWISON	REALNAME	IAN JASON LEWISON
DANNY MCFARLANE	REALNAME	DANIEL MCFARLANE
JACK %22KID%22 WOLFE	REALNAME	JACKSON KENNETH WOLFE
CARL DUANE	REALNAME	CARL DUANE YACCONETTI
RIGOBERTO RIASCO	REALNAME	RIGOBERTO RODRIGO RIASCO ESQUIVEL
