VICTORIA, BRITISH COLUMBIA	SHOPPINGMALLNAME	MAYFAIR SHOPPING CENTRE
VICTORIA, BRITISH COLUMBIA	SHOPPINGMALLNAME	TILLICUM CENTRE
LES HALLES	SHOPPINGMALLNAME	FORUM DES HALLES
BRAEHEAD	SHOPPINGMALLNAME	INTU BRAEHEAD
CORNWALL, ONTARIO	SHOPPINGMALLNAME	CORNWALL SQUARE
OAKVILLE, ONTARIO	SHOPPINGMALLNAME	OAKVILLE PLACE
BULL RING, BIRMINGHAM	SHOPPINGMALLNAME	THE BULLRING
PANTIP PLAZA	SHOPPINGMALLNAME	PANTIP PLAZA
LIVINGSTON, WEST LOTHIAN	SHOPPINGMALLNAME	ALMONDVALE/ LIVINGSTON DESIGNER OUTLET/ THE ELEMENTS
WEST EDMONTON MALL	SHOPPINGMALLNAME	WEST EDMONTON MALL
PLAZA LAS AMéRICAS	SHOPPINGMALLNAME	PLAZA LAS AMéRICAS
MEADOWHALL CENTRE	SHOPPINGMALLNAME	MEADOWHALL
THE GALLERIA	SHOPPINGMALLNAME	THE GALLERIA
TORONTO EATON CENTRE	SHOPPINGMALLNAME	TORONTO EATON CENTRE
HIGHCROSS LEICESTER	SHOPPINGMALLNAME	HIGHCROSS LEICESTER
BUCUREșTI MALL	SHOPPINGMALLNAME	BUCUREşTI MALL
RIDEAU CENTRE	SHOPPINGMALLNAME	CF RIDEAU CENTRE
ROYAL EXCHANGE, LONDON	SHOPPINGMALLNAME	ROYAL EXCHANGE
ONTARIO MILLS	SHOPPINGMALLNAME	ONTARIO MILLS
AVENTURA MALL	SHOPPINGMALLNAME	AVENTURA MALL
EDEN CENTER	SHOPPINGMALLNAME	EDEN CENTER
WATER TOWER PLACE	SHOPPINGMALLNAME	WATER TOWER PLACE
KING OF PRUSSIA MALL	SHOPPINGMALLNAME	KING OF PRUSSIA MALL
MALL OF GEORGIA	SHOPPINGMALLNAME	MALL OF GEORGIA
MIAMI INTERNATIONAL MALL	SHOPPINGMALLNAME	MIAMI INTERNATIONAL MALL
SOUTH COAST PLAZA	SHOPPINGMALLNAME	SOUTH COAST PLAZA
MALL OF NEW HAMPSHIRE	SHOPPINGMALLNAME	MALL OF NEW HAMPSHIRE
TYSONS CORNER CENTER	SHOPPINGMALLNAME	TYSONS CORNER CENTER
SHOPS OF GRAND AVENUE	SHOPPINGMALLNAME	SHOPS OF GRAND AVENUE
PROVIDENCE PLACE	SHOPPINGMALLNAME	PROVIDENCE PLACE
THE SHOPS AT PRUDENTIAL CENTER	SHOPPINGMALLNAME	THE SHOPS AT PRUDENTIAL CENTER
QUEENS CENTER	SHOPPINGMALLNAME	QUEENS CENTER
STATEN ISLAND MALL	SHOPPINGMALLNAME	STATEN ISLAND MALL
THE FASHION CENTRE AT PENTAGON CITY	SHOPPINGMALLNAME	THE FASHION CENTRE AT PENTAGON CITY
WESTFIELD GARDEN STATE PLAZA	SHOPPINGMALLNAME	WESTFIELD GARDEN STATE PLAZA
ROOSEVELT FIELD	SHOPPINGMALLNAME	ROOSEVELT FIELD
COPLEY PLACE	SHOPPINGMALLNAME	COPLEY PLACE
STANFORD SHOPPING CENTER	SHOPPINGMALLNAME	STANFORD SHOPPING CENTER
BRAMALEA CITY CENTRE	SHOPPINGMALLNAME	BRAMALEA CITY CENTRE
ST. ENOCH CENTRE	SHOPPINGMALLNAME	ST ENOCH CENTRE
NORTHGATE SHOPPING CENTRE	SHOPPINGMALLNAME	NORTHGATE SHOPPING CENTRE
THE FLORIDA MALL	SHOPPINGMALLNAME	THE FLORIDA MALL
ALA MOANA CENTER	SHOPPINGMALLNAME	ALA MOANA CENTER
COUNTRY CLUB PLAZA	SHOPPINGMALLNAME	COUNTRY CLUB PLAZA
MALL OF ARABIA	SHOPPINGMALLNAME	MALL OF ARABIA
LAKESIDE SHOPPING CENTRE	SHOPPINGMALLNAME	LAKESIDE
METROCENTRE	SHOPPINGMALLNAME	INTU METROCENTRE
BRENT CROSS	SHOPPINGMALLNAME	BRENT CROSS
METROCENTER MALL	SHOPPINGMALLNAME	METROCENTER MALL
THE MAILBOX	SHOPPINGMALLNAME	THE MAILBOX
DESTINY USA	SHOPPINGMALLNAME	DESTINY USA
BAY PARK SQUARE	SHOPPINGMALLNAME	BAY PARK SQUARE
TOWER CITY CENTER	SHOPPINGMALLNAME	THE AVENUE AT TOWER CITY CENTER
FOX RIVER MALL	SHOPPINGMALLNAME	FOX RIVER MALL
PEARLRIDGE	SHOPPINGMALLNAME	PEARLRIDGE
NEWPORT CENTRE	SHOPPINGMALLNAME	NEWPORT CENTRE
SHOPPER'S WORLD	SHOPPINGMALLNAME	SHOPPER'S WORLD
TRAFFORD CENTRE	SHOPPINGMALLNAME	TRAFFORD CENTRE
MACQUARIE CENTRE	SHOPPINGMALLNAME	MACQUARIE CENTRE
YORKDALE SHOPPING CENTRE	SHOPPINGMALLNAME	YORKDALE SHOPPING CENTRE
FASHION ISLAND	SHOPPINGMALLNAME	FASHION ISLAND
THE OUTLETS AT ORANGE	SHOPPINGMALLNAME	THE OUTLETS AT ORANGE
INTERCITY SHOPPING CENTRE	SHOPPINGMALLNAME	INTERCITY SHOPPING CENTRE
WESTFIELD PARRAMATTA	SHOPPINGMALLNAME	WESTFIELD PARRAMATTа
MAHATMA JYOTIBA PHULE MANDAI	SHOPPINGMALLNAME	CRAWFORD MARKET
BILLINGS BRIDGE PLAZA	SHOPPINGMALLNAME	BILLINGS BRIDGE CENTRE
CHADSTONE SHOPPING CENTRE	SHOPPINGMALLNAME	CHADSTONE SHOPPING CENTRE
MIZNER PARK	SHOPPINGMALLNAME	MIZNER PARK
UNDERGROUND CITY, MONTREAL	SHOPPINGMALLNAME	RÉSO
CROSS COUNTY SHOPPING CENTER	SHOPPINGMALLNAME	CROSS COUNTY SHOPPING CENTER
UNIVERSITY VILLAGE, SEATTLE	SHOPPINGMALLNAME	UNIVERSITY VILLAGE
SHOPPING CITY SüD	SHOPPINGMALLNAME	SHOPPING CITY SüD
KENNEDY MALL	SHOPPINGMALLNAME	KENNEDY MALL
SCOTTSDALE FASHION SQUARE	SHOPPINGMALLNAME	SCOTTSDALE FASHION SQUARE
BLUEWATER	SHOPPINGMALLNAME	BLUEWATER SHOPPING CENTRE
THE LIBERTY	SHOPPINGMALLNAME	THE LIBERTY
PATH	SHOPPINGMALLNAME	PATH
CORN EXCHANGE, MANCHESTER	SHOPPINGMALLNAME	CORN EXCHANGE, MANCHESTER
SANDTON CITY	SHOPPINGMALLNAME	SANDTON CITY
EASTGATE SHOPPING CENTRE, JOHANNESBURG	SHOPPINGMALLNAME	EASTGATE
VAUGHAN MILLS	SHOPPINGMALLNAME	VAUGHAN MILLS
RIVERCHASE GALLERIA	SHOPPINGMALLNAME	RIVERCHASE GALLERIA
THE SUMMIT	SHOPPINGMALLNAME	THE SUMMIT
GATEWAY DISTRICT	SHOPPINGMALLNAME	THE GATEWAY
FARMERS MARKET	SHOPPINGMALLNAME	FARMERS MARKET
CRIBBS CAUSEWAY	SHOPPINGMALLNAME	THE MALL
TROLLEY SQUARE	SHOPPINGMALLNAME	TROLLEY SQUARE
BOX HILL CENTRAL SHOPPING CENTRE	SHOPPINGMALLNAME	BOX HILL CENTRAL SHOPPING CENTRE
GALERIES LAFAYETTE	SHOPPINGMALLNAME	GALERIES LAFAYETTE
EASTLAND SHOPPING CENTRE	SHOPPINGMALLNAME	EASTLAND SHOPPING CENTRE
PALISADES CENTER	SHOPPINGMALLNAME	PALISADES CENTER MALL
VICTORIA CENTRE	SHOPPINGMALLNAME	INTU VICTORIA CENTRE
DANBURY FAIR	SHOPPINGMALLNAME	DANBURY FAIR MALL
JOHOR BAHRU CITY SQUARE	SHOPPINGMALLNAME	JOHOR BAHRU CITY SQUARE
CARREFOUR LAVAL	SHOPPINGMALLNAME	CARREFOUR LAVAL
FAIRVIEW POINTE-CLAIRE	SHOPPINGMALLNAME	FAIRVIEW POINTE-CLAIRE
GALERIES D'ANJOU	SHOPPINGMALLNAME	GALERIES D'ANJOU
SURIA KLCC	SHOPPINGMALLNAME	SURIA KLCC
PHIPPS PLAZA	SHOPPINGMALLNAME	PHIPPS PLAZA
DEL AMO FASHION CENTER	SHOPPINGMALLNAME	DEL AMO FASHION CENTER
KATY MILLS	SHOPPINGMALLNAME	KATY MILLS
IRVINE SPECTRUM	SHOPPINGMALLNAME	IRVINE SPECTRUM CENTER
STOCKLAND GLENDALE	SHOPPINGMALLNAME	STOCKLAND GLENDALE
GREENDALE MALL	SHOPPINGMALLNAME	GREENDALE MALL
NORTHRIDGE MALL	SHOPPINGMALLNAME	NORTHRIDGE MALL
MONROEVILLE MALL	SHOPPINGMALLNAME	MONROEVILLE MALL
CENTURY III MALL	SHOPPINGMALLNAME	CENTURY III MALL
FAIRVIEW MALL	SHOPPINGMALLNAME	FAIRVIEW MALL
SOUTHPARK MALL	SHOPPINGMALLNAME	SOUTHPARK
EASTLAND MALL	SHOPPINGMALLNAME	EASTLAND MALL
CAROLINA PLACE MALL	SHOPPINGMALLNAME	CAROLINA PLACE MALL
CRABTREE VALLEY MALL	SHOPPINGMALLNAME	CRABTREE VALLEY MALL
LENOX SQUARE	SHOPPINGMALLNAME	LENOX SQUARE
FOUR SEASONS TOWN CENTRE	SHOPPINGMALLNAME	FOUR SEASONS TOWN CENTRE
HANES MALL	SHOPPINGMALLNAME	HANES MALL
APACHE PLAZA	SHOPPINGMALLNAME	APACHE PLAZA
FORESTSIDE SHOPPING CENTRE	SHOPPINGMALLNAME	FORESTSIDE SHOPPING CENTRE
LIVERPOOL ONE	SHOPPINGMALLNAME	LIVERPOOL ONE
BEVERLY CENTER	SHOPPINGMALLNAME	BEVERLY CENTER
CORAL RIDGE MALL	SHOPPINGMALLNAME	CORAL RIDGE MALL
JORDAN CREEK TOWN CENTER	SHOPPINGMALLNAME	JORDAN CREEK TOWN CENTER
VICTORIA GARDENS SHOPPING CENTRE	SHOPPINGMALLNAME	VICTORIA GARDENS
BLANCHARDSTOWN CENTRE	SHOPPINGMALLNAME	BLANCHARDSTOWN CENTRE
THE LANDMARK	SHOPPINGMALLNAME	THE LANDMARK
SOUTHPARK MALL	SHOPPINGMALLNAME	SOUTHPARK MALL
NORTHPARK MALL	SHOPPINGMALLNAME	NORTHPARK MALL
HUDSON VALLEY MALL	SHOPPINGMALLNAME	HUDSON VALLEY MALL
NGEE ANN CITY	SHOPPINGMALLNAME	NGEE ANN CITY
SOUTHPARK MALL	SHOPPINGMALLNAME	SOUTHPARK MALL
SQUARE ONE SHOPPING CENTRE	SHOPPINGMALLNAME	SQUARE ONE SHOPPING CENTRE
PITTSBURGH MILLS	SHOPPINGMALLNAME	PITTSBURGH MILLS
THE SQUARE TALLAGHT	SHOPPINGMALLNAME	THE SQUARE TALLAGHT
GREAT MALL OF THE BAY AREA	SHOPPINGMALLNAME	GREAT MALL OF THE BAY AREA
MARITIME SQUARE	SHOPPINGMALLNAME	MARITIME SQUARE
ASHEVILLE MALL	SHOPPINGMALLNAME	ASHEVILLE MALL
ASHEVILLE OUTLETS	SHOPPINGMALLNAME	ASHEVILLE OUTLETS
POTOMAC MILLS	SHOPPINGMALLNAME	POTOMAC MILLS
COCOWALK	SHOPPINGMALLNAME	COCOWALK
DAYTON MALL	SHOPPINGMALLNAME	DAYTON MALL
THE MALL AT FAIRFIELD COMMONS	SHOPPINGMALLNAME	THE MALL AT FAIRFIELD COMMONS
CHESHIRE OAKS DESIGNER OUTLET	SHOPPINGMALLNAME	CHESHIRE OAKS DESIGNER OUTLET
HAR MAR MALL	SHOPPINGMALLNAME	HAR MAR MALL
DIXIE SQUARE MALL	SHOPPINGMALLNAME	DIXIE SQUARE SHOPPING CENTER
CAUSEWAY POINT	SHOPPINGMALLNAME	CAUSEWAY POINT
FASHION SHOW MALL	SHOPPINGMALLNAME	FASHION SHOW MALL
SCARBOROUGH TOWN CENTRE	SHOPPINGMALLNAME	SCARBOROUGH TOWN CENTRE
ANTELOPE VALLEY MALL	SHOPPINGMALLNAME	ANTELOPE VALLEY MALL
THE ORACLE, READING	SHOPPINGMALLNAME	THE ORACLE
BROAD STREET MALL	SHOPPINGMALLNAME	BROAD STREET MALL
MERRY HILL SHOPPING CENTRE	SHOPPINGMALLNAME	INTU MERRY HILL
WESTFIELD KOTARA	SHOPPINGMALLNAME	WESTFIELD KOTARA
FESTIVAL WALK	SHOPPINGMALLNAME	FESTIVAL WALK
HOLLYWOOD AND HIGHLAND CENTER	SHOPPINGMALLNAME	HOLLYWOOD & HIGHLAND CENTER
METREON	SHOPPINGMALLNAME	METREON
METROPOLIS AT METROTOWN	SHOPPINGMALLNAME	METROPOLIS AT METROTOWN
WESTSHORE PLAZA	SHOPPINGMALLNAME	WESTSHORE PLAZA
BUENA PARK DOWNTOWN	SHOPPINGMALLNAME	BUENA PARK DOWNTOWN
MYYRMANNI	SHOPPINGMALLNAME	MYYRMANNI
MID VALLEY MEGAMALL	SHOPPINGMALLNAME	MID VALLEY MEGAMALL
DEVONSHIRE MALL	SHOPPINGMALLNAME	DEVONSHIRE MALL
SHERMAN OAKS GALLERIA	SHOPPINGMALLNAME	SHERMAN OAKS GALLERIA
THIRD STREET PROMENADE	SHOPPINGMALLNAME	THIRD STREET PROMENADE
LANDOVER MALL	SHOPPINGMALLNAME	LANDOVER MALL
LAKEHURST MALL	SHOPPINGMALLNAME	LAKEHURST
FESTIVAL PLACE	SHOPPINGMALLNAME	FESTIVAL PLACE
GUNWHARF QUAYS	SHOPPINGMALLNAME	GUNWHARF QUAYS
ERINA FAIR	SHOPPINGMALLNAME	ERINA FAIR
CONCORD MILLS	SHOPPINGMALLNAME	CONCORD MILLS
CHERRY HILL MALL	SHOPPINGMALLNAME	CHERRY HILL MALL
OXFORD VALLEY MALL	SHOPPINGMALLNAME	OXFORD VALLEY MALL
SOUTHDALE CENTER	SHOPPINGMALLNAME	SOUTHDALE CENTER
BOTANY TOWN CENTRE	SHOPPINGMALLNAME	BOTANY TOWN CENTRE
WHEELOCK PLACE	SHOPPINGMALLNAME	WHEELOCK PLACE
THE GALLERY AT MARKET EAST	SHOPPINGMALLNAME	THE GALLERY AT MARKET EAST
WESTQUAY	SHOPPINGMALLNAME	WESTQUAY SHOPPING CENTRE
ST. LOUIS OUTLET MALL	SHOPPINGMALLNAME	ST. LOUIS OUTLET MALL
BILTMORE FASHION PARK	SHOPPINGMALLNAME	BILTMORE FASHION PARK
ARUNDEL MILLS	SHOPPINGMALLNAME	ARUNDEL MILLS MALL
QUEENS ARCADE	SHOPPINGMALLNAME	QUEENS ARCADE
SOUTHSIDE WANDSWORTH	SHOPPINGMALLNAME	SOUTHSIDE WANDSWORTH
THE GROVE AT FARMERS MARKET	SHOPPINGMALLNAME	THE GROVE
NORTHLAKE MALL	SHOPPINGMALLNAME	NORTHLAKE MALL
NORTHLAKE MALL	SHOPPINGMALLNAME	NORTHLAKE MALL
MIC MAC MALL	SHOPPINGMALLNAME	MIC MAC MALL
NEW TOWN PLAZA	SHOPPINGMALLNAME	NEW TOWN PLAZA
MIDDLETON GRANGE SHOPPING CENTRE	SHOPPINGMALLNAME	MIDDLETON GRANGE SHOPPING CENTRE
ELDON SQUARE SHOPPING CENTRE	SHOPPINGMALLNAME	INTU ELDON SQUARE
BIG TOWN MALL	SHOPPINGMALLNAME	BIG TOWN MALL
ARIZONA MILLS	SHOPPINGMALLNAME	ARIZONA MILLS
SM MEGAMALL	SHOPPINGMALLNAME	SM MEGAMALL
PARKWAY PARADE	SHOPPINGMALLNAME	PARKWAY PARADE
PARKWAY PARADE	SHOPPINGMALLNAME	百汇广场
PARKWAY PARADE	SHOPPINGMALLNAME	பார்க்வே அணிவகுப்பு
OCEAN TERMINAL, HONG KONG	SHOPPINGMALLNAME	OCEAN TERMINAL
ITIS SHOPPING CENTRE	SHOPPINGMALLNAME	ITIS
OPRY MILLS	SHOPPINGMALLNAME	OPRY MILLS
COUNTY SQUARE	SHOPPINGMALLNAME	COUNTY SQUARE SHOPPING CENTRE
BERJAYA TIMES SQUARE	SHOPPINGMALLNAME	BERJAYA TIMES SQUARE KUALA LUMPUR
PACIFIC MALL	SHOPPINGMALLNAME	PACIFIC MALL
WHITE OAKS MALL	SHOPPINGMALLNAME	WHITE OAKS MALL
PARK PLACE	SHOPPINGMALLNAME	PARK PLACE
BELLEVUE SQUARE	SHOPPINGMALLNAME	BELLEVUE SQUARE
DUNDRUM TOWN CENTRE	SHOPPINGMALLNAME	DUNDRUM TOWN CENTRE
PUENTE HILLS MALL	SHOPPINGMALLNAME	PUENTE HILLS MALL
CRESTA SHOPPING CENTRE	SHOPPINGMALLNAME	CRESTA SHOPPING CENTRE
BREA MALL	SHOPPINGMALLNAME	BREA MALL
WESTFIELD STRATFORD CITY	SHOPPINGMALLNAME	WESTFIELD STRATFORD CITY
WOODFIELD MALL	SHOPPINGMALLNAME	WOODFIELD MALL
NORDSTAN	SHOPPINGMALLNAME	NORDSTAN
GALLERIA AT ERIEVIEW	SHOPPINGMALLNAME	GALLERIA AT ERIEVIEW
GRAND CENTRAL, BIRMINGHAM	SHOPPINGMALLNAME	GRAND CENTRAL
PHILADELPHIA MILLS	SHOPPINGMALLNAME	PHILADELPHIA MILLS
THE GALLERIA AT WHITE PLAINS	SHOPPINGMALLNAME	THE GALLERIA AT WHITE PLAINS
CRESCENT SHOPPING CENTRE	SHOPPINGMALLNAME	CRESCENT SHOPPING CENTRE
TOUCHWOOD, SOLIHULL	SHOPPINGMALLNAME	TOUCHWOOD
GALLERIA DALLAS	SHOPPINGMALLNAME	GALLERIA DALLAS
NORTHPARK CENTER	SHOPPINGMALLNAME	NORTHPARK CENTER
ATLANTIC TERMINAL	SHOPPINGMALLNAME	ATLANTIC TERMINAL
ATLANTIC TERMINAL	SHOPPINGMALLNAME	ATLANTIC CENTER
SOUTHLANDS BOULEVARDE	SHOPPINGMALLNAME	SOUTHLANDS BOULEVARDE
OVERGATE CENTRE	SHOPPINGMALLNAME	OVERGATE
FOREST FAIR VILLAGE	SHOPPINGMALLNAME	FOREST FAIR VILLAGE
LAKEFOREST MALL	SHOPPINGMALLNAME	LAKEFOREST MALL
UNIVERSITY MALL	SHOPPINGMALLNAME	UNIVERSITY MALL
SILVER CITY GALLERIA	SHOPPINGMALLNAME	SILVER CITY GALLERIA
PLACE D'ORLéANS	SHOPPINGMALLNAME	PLACE D'ORLéANS
SOUTHGATE CENTRE	SHOPPINGMALLNAME	SOUTHGATE CENTRE
CANBERRA CENTRE	SHOPPINGMALLNAME	CANBERRA CENTRE
WESTFIELD FOUNTAIN GATE	SHOPPINGMALLNAME	WESTFIELD FOUNTAIN GATE
NEW ROC CITY	SHOPPINGMALLNAME	NEW ROC CITY
DOVER MALL	SHOPPINGMALLNAME	DOVER MALL
CLACKAMAS TOWN CENTER	SHOPPINGMALLNAME	CLACKAMAS TOWN CENTER
WASHINGTON SQUARE	SHOPPINGMALLNAME	WASHINGTON SQUARE
LLOYD CENTER	SHOPPINGMALLNAME	LLOYD CENTER
PIONEER PLACE	SHOPPINGMALLNAME	PIONEER PLACE
JORDAN LANDING	SHOPPINGMALLNAME	JORDAN LANDING
LOS CERRITOS CENTER	SHOPPINGMALLNAME	LOS CERRITOS CENTER
MALL TAMAN ANGGREK	SHOPPINGMALLNAME	MALL TAMAN ANGGREK
GLORIETTA	SHOPPINGMALLNAME	GLORIETTA
THE BLOCK NORTHWAY	SHOPPINGMALLNAME	THE BLOCK NORTHWAY
QUEENS PLACE MALL	SHOPPINGMALLNAME	QUEENS PLACE
MASONVILLE PLACE	SHOPPINGMALLNAME	MASONVILLE PLACE
SHOPPERS WORLD BRAMPTON	SHOPPINGMALLNAME	SHOPPERS WORLD BRAMPTON
IBN BATTUTA MALL	SHOPPINGMALLNAME	IBN BATTUTA MALL
CENTRE LAVAL	SHOPPINGMALLNAME	CENTRE LAVAL
ORCHARD SQUARE	SHOPPINGMALLNAME	ORCHARD SQUARE
BEAVER VALLEY MALL	SHOPPINGMALLNAME	BEAVER VALLEY MALL
FAIRVIEW PARK MALL	SHOPPINGMALLNAME	CF FAIRVIEW PARK
MBK CENTER	SHOPPINGMALLNAME	MBK CENTER
VALLEY WEST MALL	SHOPPINGMALLNAME	VALLEY WEST MALL
SHERWAY GARDENS	SHOPPINGMALLNAME	SHERWAY GARDENS
HAYMARKET SHOPPING CENTRE	SHOPPINGMALLNAME	HAYMARKET SHOPPING CENTRE
WESTFIELD MIRANDA	SHOPPINGMALLNAME	WESTFIELD MIRANDA
VIVOCITY	SHOPPINGMALLNAME	VIVOCITY
KAMPPI CENTER	SHOPPINGMALLNAME	KAMPPI CENTRE
MERLE HAY MALL	SHOPPINGMALLNAME	MERLE HAY MALL
PHEASANT LANE MALL	SHOPPINGMALLNAME	PHEASANT LANE MALL
HOLYOKE MALL AT INGLESIDE	SHOPPINGMALLNAME	HOLYOKE MALL
LOGAN HYPERDOME	SHOPPINGMALLNAME	HYPERDOME
WESTFIELD HELENSVALE	SHOPPINGMALLNAME	WESTFIELD HELENSVALE
ROBINA TOWN CENTRE	SHOPPINGMALLNAME	ROBINA TOWN CENTRE
SIM LIM SQUARE	SHOPPINGMALLNAME	SIM LIM SQUARE
FUNAN DIGITALIFE MALL	SHOPPINGMALLNAME	FUNAN DIGITALIFE MALL
QUEENSPLAZA	SHOPPINGMALLNAME	QUEENSPLAZA
PACIFIC FAIR SHOPPING CENTRE	SHOPPINGMALLNAME	PACIFIC FAIR SHOPPING CENTRE
AUSTRALIA FAIR SHOPPING CENTRE	SHOPPINGMALLNAME	AUSTRALIA FAIR
SOMERSET COLLECTION	SHOPPINGMALLNAME	300
CAPE COD MALL	SHOPPINGMALLNAME	CAPE COD MALL
NORTHSHORE MALL	SHOPPINGMALLNAME	NORTHSHORE MALL
SOUTH SHORE PLAZA	SHOPPINGMALLNAME	SOUTH SHORE PLAZA
BURLINGTON MALL	SHOPPINGMALLNAME	BURLINGTON MALL
EMERALD SQUARE	SHOPPINGMALLNAME	EMERALD SQUARE
KINGSTON COLLECTION	SHOPPINGMALLNAME	KINGSTON COLLECTION
EASTLANDS SHOPPING CENTRE	SHOPPINGMALLNAME	EASTLANDS SHOPPING CENTRE
TWELVE OAKS MALL	SHOPPINGMALLNAME	TWELVE OAKS MALL
CHINOOK CENTRE	SHOPPINGMALLNAME	CHINOOK CENTRE
DIMOND CENTER	SHOPPINGMALLNAME	DIMOND CENTER
WESTFIELD KNOX	SHOPPINGMALLNAME	WESTFIELD KNOX
HAMILTON PLACE	SHOPPINGMALLNAME	HAMILTON PLACE
MALL OF THE EMIRATES	SHOPPINGMALLNAME	MALL OF THE EMIRATES
NEW STRAND SHOPPING CENTRE	SHOPPINGMALLNAME	NEW STRAND SHOPPING CENTRE
THE BOULEVARD AT THE CAPITAL CENTRE	SHOPPINGMALLNAME	BOULEVARD AT THE CAPITAL CENTRE
HILLTOP MALL	SHOPPINGMALLNAME	HILLTOP MALL
BAYFAIR CENTER	SHOPPINGMALLNAME	BAYFAIR CENTER
LUCKY PLAZA	SHOPPINGMALLNAME	LUCKY PLAZA
THE SHOPS AT TANFORAN	SHOPPINGMALLNAME	THE SHOPS AT TANFORAN
EL CERRITO PLAZA	SHOPPINGMALLNAME	EL CERRITO PLAZA
RIVER PARK	SHOPPINGMALLNAME	RIVER PARK
EDMONTON CITY CENTRE	SHOPPINGMALLNAME	EDMONTON CITY CENTRE
MONTREAL EATON CENTRE	SHOPPINGMALLNAME	MONTREAL EATON CENTRE
ROSS PARK MALL	SHOPPINGMALLNAME	ROSS PARK MALL
SOUTHSIDE WORKS	SHOPPINGMALLNAME	SOUTHSIDE WORKS
SOUTH HILLS VILLAGE	SHOPPINGMALLNAME	SOUTH HILLS VILLAGE
WESTMORELAND MALL	SHOPPINGMALLNAME	WESTMORELAND MALL
THE MALL AT ROBINSON	SHOPPINGMALLNAME	THE MALL AT ROBINSON
MARINA SQUARE	SHOPPINGMALLNAME	MARINA SQUARE
SHAW HOUSE AND CENTRE	SHOPPINGMALLNAME	SHAW HOUSE
SHAW HOUSE AND CENTRE	SHOPPINGMALLNAME	SHAW CENTRE
NORTHGATE MALL	SHOPPINGMALLNAME	NORTHGATE MALL
THE GALLERIES, BRISTOL	SHOPPINGMALLNAME	THE GALLERIES
COLUMBUS CITY CENTER	SHOPPINGMALLNAME	COLUMBUS CITY CENTER
WESTFIELD GEELONG	SHOPPINGMALLNAME	WESTFIELD GEELONG
CAVENDISH MALL	SHOPPINGMALLNAME	CAVENDISH MALL
THE FORUM SHOPS AT CAESARS	SHOPPINGMALLNAME	THE FORUM SHOPS AT CAESARS
CENTRALE	SHOPPINGMALLNAME	CENTRALE
GREAT LAKES CROSSING OUTLETS	SHOPPINGMALLNAME	GREAT LAKES CROSSING OUTLETS
HUNTINGTON MALL	SHOPPINGMALLNAME	HUNTINGTON MALL
ALGONQUIN COMMONS	SHOPPINGMALLNAME	ALGONQUIN COMMONS
THE WATERFRONT	SHOPPINGMALLNAME	THE WATERFRONT
SAWGRASS MILLS	SHOPPINGMALLNAME	SAWGRASS MILLS
SUMMIT PLACE MALL	SHOPPINGMALLNAME	SUMMIT PLACE MALL
STRATHPINE CENTRE	SHOPPINGMALLNAME	STRATHPINE CENTRE
FRIENDLY CENTER	SHOPPINGMALLNAME	FRIENDLY CENTER
MENLO PARK MALL	SHOPPINGMALLNAME	MENLO PARK MALL
UNIVERSAL MALL	SHOPPINGMALLNAME	UNIVERSAL MALL
TEESSIDE PARK	SHOPPINGMALLNAME	TEESSIDE PARK
SAINT LOUIS GALLERIA	SHOPPINGMALLNAME	SAINT LOUIS GALLERIA
REGENCY MALL	SHOPPINGMALLNAME	REGENCY MALL
HIGHPOINT SHOPPING CENTRE	SHOPPINGMALLNAME	HIGHPOINT SHOPPING CENTRE
PLAZA CôTE-DES-NEIGES	SHOPPINGMALLNAME	PLAZA CôTE-DES-NEIGES
MAYFAIR MALL	SHOPPINGMALLNAME	MAYFAIR MALL
FIREWHEEL TOWN CENTER	SHOPPINGMALLNAME	FIREWHEEL TOWN CENTER
COLUMBIA MALL	SHOPPINGMALLNAME	COLUMBIA MALL
MALL OF MEMPHIS	SHOPPINGMALLNAME	MALL OF MEMPHIS
TANGLEWOOD MALL	SHOPPINGMALLNAME	TANGLEWOOD MALL
LAKESIDE MALL	SHOPPINGMALLNAME	LAKESIDE MALL
BROADMARSH	SHOPPINGMALLNAME	THE  BROADMARSH CENTRE
AKMERKEZ	SHOPPINGMALLNAME	AKMERKEZ
CAMBRIDGESIDE GALLERIA	SHOPPINGMALLNAME	CAMBRIDGESIDE GALLERIA
GALLERIA ATAKöY	SHOPPINGMALLNAME	GALLERIA ATAKöY
PROFILO SHOPPING CENTER	SHOPPINGMALLNAME	PROFILO SHOPPING CENTER
CROSS CREEK MALL	SHOPPINGMALLNAME	CROSS CREEK MALL
TEPE NAUTILUS	SHOPPINGMALLNAME	TEPE NAUTILUS
CRYSTAL PEAKS	SHOPPINGMALLNAME	CRYSTAL PEAKS
SOUTH SQUARE MALL	SHOPPINGMALLNAME	SOUTH SQUARE MALL
SOUTHWEST CENTER MALL	SHOPPINGMALLNAME	SOUTHWEST CENTER MALL
WEST ACRES SHOPPING CENTER	SHOPPINGMALLNAME	WEST ACRES SHOPPING CENTER
KIRKWOOD MALL	SHOPPINGMALLNAME	KIRKWOOD MALL
HANSA EMPORIUM	SHOPPINGMALLNAME	HANSA EMPORIUM
WHITE ROSE CENTRE	SHOPPINGMALLNAME	WHITE ROSE SHOPPING CENTRE
INTU DERBY	SHOPPINGMALLNAME	INTU DERBY
CITYPLAZA	SHOPPINGMALLNAME	CITYPLAZA
WESTFIELD CAROUSEL	SHOPPINGMALLNAME	WESTFIELD CAROUSEL
POLO PARK	SHOPPINGMALLNAME	POLO PARK
SOUTHRIDGE MALL	SHOPPINGMALLNAME	SOUTHRIDGE MALL
CATHAY CINELEISURE ORCHARD	SHOPPINGMALLNAME	CATHAY CINELEISURE ORCHARD
JUNCTION 8 SHOPPING CENTRE	SHOPPINGMALLNAME	JUNCTION 8
PLAZA SINGAPURA	SHOPPINGMALLNAME	PLAZA SINGAPURA
PLAZA SINGAPURA	SHOPPINGMALLNAME	狮城68
PLAZA SINGAPURA	SHOPPINGMALLNAME	மையத்தையும் சிங்கப்பூர்
SIAM PARAGON	SHOPPINGMALLNAME	SIAM PARAGON
BUGIS JUNCTION	SHOPPINGMALLNAME	BUGIS JUNCTION
CARLINGFORD COURT	SHOPPINGMALLNAME	CARLINGFORD COURT
TAMPINES MALL	SHOPPINGMALLNAME	TAMPINES MALL
ISTANBUL CEVAHIR	SHOPPINGMALLNAME	ISTANBUL CEVAHIR
WAGGA WAGGA MARKETPLACE	SHOPPINGMALLNAME	WAGGA WAGGA MARKETPLACE
STURT MALL	SHOPPINGMALLNAME	STURT MALL
SM MALL OF ASIA	SHOPPINGMALLNAME	SM MALL OF ASIA
ATIRUS SHOPPING CENTER	SHOPPINGMALLNAME	ATIRUS SHOPPING CENTER
ATIRUS SHOPPING CENTER	SHOPPINGMALLNAME	(ATIRUS AVM)
SANTA MONICA PLACE	SHOPPINGMALLNAME	SANTA MONICA PLACE
WESTFIELD DONCASTER	SHOPPINGMALLNAME	WESTFIELD DONCASTER
WESTFIELD WODEN	SHOPPINGMALLNAME	WESTFIELD WODEN
WESTFIELD VALLEY FAIR	SHOPPINGMALLNAME	WESTFIELD VALLEY FAIR
VALLEY FAIR SHOPPING CENTER	SHOPPINGMALLNAME	VALLEY FAIR MALL
FORUM MALL	SHOPPINGMALLNAME	FORUM CULIACáN
MILLER HILL MALL	SHOPPINGMALLNAME	MILLER HILL MALL
OGLETHORPE MALL	SHOPPINGMALLNAME	OGLETHORPE MALL
SAVANNAH MALL	SHOPPINGMALLNAME	SAVANNAH MALL
NEW HARBOUR MALL	SHOPPINGMALLNAME	NEW HARBOUR MALL
MICRONESIA MALL	SHOPPINGMALLNAME	MICRONESIA MALL
VALLEY MALL	SHOPPINGMALLNAME	VALLEY MALL
HOLLY HILL MALL AND BUSINESS CENTER	SHOPPINGMALLNAME	HOLLY HILL MALL AND BUSINESS CENTER
WESTLAKE CENTER	SHOPPINGMALLNAME	WESTLAKE CENTER
MERRION CENTRE, LEEDS	SHOPPINGMALLNAME	MERRION CENTRE
SOUTHRIDGE MALL	SHOPPINGMALLNAME	SOUTHRIDGE MALL
PACIFIC PLACE	SHOPPINGMALLNAME	PACIFIC PLACE
ABERDEEN CENTRE	SHOPPINGMALLNAME	ABERDEEN CENTRE
DARTMOUTH MALL	SHOPPINGMALLNAME	DARTMOUTH MALL
NORTHGATE MALL	SHOPPINGMALLNAME	NORTHGATE MALL
SENAYAN CITY	SHOPPINGMALLNAME	SENAYAN CITY
NEW MARKET, KOLKATA	SHOPPINGMALLNAME	NEW MARKET
ANDERSON MALL	SHOPPINGMALLNAME	ANDERSON MALL
THE CATHAY	SHOPPINGMALLNAME	THE CATHAY
PARK ROYAL SHOPPING CENTRE	SHOPPINGMALLNAME	PARK ROYAL
EMPORIUM	SHOPPINGMALLNAME	EMPORIUM
THE GALLERIA OF MT. LEBANON	SHOPPINGMALLNAME	THE GALLERIA OF MT. LEBANON
SUNSHINE PLAZA	SHOPPINGMALLNAME	SUNSHINE PLAZA
RHODES WATERSIDE	SHOPPINGMALLNAME	RHODES WATERSIDE
AMERICAN DREAM MEADOWLANDS	SHOPPINGMALLNAME	AMERICAN DREAM MEADOWLANDS
SOUTHMALL MANUREWA	SHOPPINGMALLNAME	SOUTHMALL MANUREWA
BASHUNDHARA CITY	SHOPPINGMALLNAME	BASHUNDHARA CITY
KYOVA MALL	SHOPPINGMALLNAME	KYOVA MALL
10 DUNDAS EAST	SHOPPINGMALLNAME	10
KARCHER MALL	SHOPPINGMALLNAME	KARCHER MALL
RICHMOND CENTRE	SHOPPINGMALLNAME	RICHMOND CENTRE
CINDERELLA CITY	SHOPPINGMALLNAME	CINDERELLA CITY MALL
WESTFIELD HORNSBY	SHOPPINGMALLNAME	WESTFIELD HORNSBY
PRIORY MEADOW SHOPPING CENTRE	SHOPPINGMALLNAME	PRIORY MEADOW SHOPPING CENTRE
PARK PLACE MALL	SHOPPINGMALLNAME	PARK PLACE SHOPPING CENTRE
TOWSON TOWN CENTER	SHOPPINGMALLNAME	TOWSON TOWN CENTER
WHITE MARSH MALL	SHOPPINGMALLNAME	WHITE MARSH MALL
CROSSGATES MALL	SHOPPINGMALLNAME	CROSSGATES MALL
NESHAMINY MALL	SHOPPINGMALLNAME	NESHAMINY MALL
SQUARE ONE MALL	SHOPPINGMALLNAME	SQUARE ONE MALL
MALL AT ROCKINGHAM PARK	SHOPPINGMALLNAME	MALL AT ROCKINGHAM PARK
GALLERIA CENTER	SHOPPINGMALLNAME	ALGONQUIN GALLERIA
FASHION OUTLETS OF LAS VEGAS	SHOPPINGMALLNAME	FASHION OUTLETS OF LAS VEGAS
WALDEN GALLERIA	SHOPPINGMALLNAME	WALDEN GALLERIA
COLONIE CENTER	SHOPPINGMALLNAME	COLONIE CENTER
BOISE TOWNE SQUARE	SHOPPINGMALLNAME	BOISE TOWNE SQUARE
POUGHKEEPSIE GALLERIA	SHOPPINGMALLNAME	POUGHKEEPSIE GALLERIA
NORTHPOINT SHOPPING CENTRE	SHOPPINGMALLNAME	FILE:NORTHPOINT SHOPPING CENTRE.JPG
LOT ONE	SHOPPINGMALLNAME	LOT ONE
SHORT PUMP TOWN CENTER	SHOPPINGMALLNAME	SHORT PUMP TOWN CENTER
FASHION CENTER	SHOPPINGMALLNAME	FASHION CENTER
KIERLAND COMMONS	SHOPPINGMALLNAME	KIERLAND COMMONS
SOUTH HILLS MALL	SHOPPINGMALLNAME	SOUTH HILLS MALL
JUNCTION 10	SHOPPINGMALLNAME	JUNCTION 10
GRAND CENTRAL STOCKPORT	SHOPPINGMALLNAME	GRAND CENTRAL STOCKPORT
COLONIAL BROOKWOOD VILLAGE	SHOPPINGMALLNAME	BROOKWOOD VILLAGE
WILTON MALL	SHOPPINGMALLNAME	WILTON MALL
PALM BEACH OUTLETS	SHOPPINGMALLNAME	PALM BEACH OUTLETS
AVALON MALL	SHOPPINGMALLNAME	AVALON MALL
TOWN CENTER AT BOCA RATON	SHOPPINGMALLNAME	TOWN CENTER AT BOCA RATON
EASTVIEW MALL	SHOPPINGMALLNAME	EASTVIEW MALL
THE GARDENS MALL	SHOPPINGMALLNAME	THE GARDENS MALL
THE MALL AT WELLINGTON GREEN	SHOPPINGMALLNAME	THE MALL AT WELLINGTON GREEN
DADELAND MALL	SHOPPINGMALLNAME	DADELAND MALL
BOGYOKE MARKET	SHOPPINGMALLNAME	BOGYOKE AUNG SAN MARKET
BOGYOKE MARKET	SHOPPINGMALLNAME	ဗိုလ်ချုပ်အောင်ဆန်းဈေး
POMPANO CITI CENTRE	SHOPPINGMALLNAME	POMPANO CITI CENTRE
FASHION FAIR MALL	SHOPPINGMALLNAME	FASHION FAIR MALL
AVIATION MALL	SHOPPINGMALLNAME	AVIATION MALL
COBB CENTER	SHOPPINGMALLNAME	COBB CENTER MALL
AVONDALE MALL	SHOPPINGMALLNAME	AVONDALE MALL / COLUMBIA MALL
CENTRAL PARK	SHOPPINGMALLNAME	CENTRAL PARK
THE DUBAI MALL	SHOPPINGMALLNAME	THE DUBAI MALL
NORTH DEKALB MALL	SHOPPINGMALLNAME	NORTH DEKALB MALL
CUMBERLAND MALL	SHOPPINGMALLNAME	CUMBERLAND MALL
TOWN CENTER AT COBB	SHOPPINGMALLNAME	TOWN CENTER AT COBB
EASTWOOD VILLAGE	SHOPPINGMALLNAME	EASTWOOD VILLAGE
LAGUNA HILLS MALL	SHOPPINGMALLNAME	LAGUNA HILLS MALL
COASTAL GRAND MALL	SHOPPINGMALLNAME	COASTAL GRAND MALL
WESTFIELD SAN FRANCISCO CENTRE	SHOPPINGMALLNAME	WESTFIELD SAN FRANCISCO CENTRE
MEMORIAL CITY MALL	SHOPPINGMALLNAME	MEMORIAL CITY MALL
BROADWAY AT THE BEACH	SHOPPINGMALLNAME	BROADWAY AT THE BEACH
GALLERIA AT CRYSTAL RUN	SHOPPINGMALLNAME	GALLERIA AT CRYSTAL RUN
SEMIAHMOO SHOPPING CENTRE	SHOPPINGMALLNAME	SEMIAHMOO SHOPPING CENTRE
WESTERN HILLS MALL	SHOPPINGMALLNAME	WESTERN HILLS MALL
DUFFERIN MALL	SHOPPINGMALLNAME	DUFFERIN MALL
GREAT NORTHERN MALL	SHOPPINGMALLNAME	GREAT NORTHERN MALL
CITYLINK MALL	SHOPPINGMALLNAME	CITYLINK MALL
GEORGIA SQUARE MALL	SHOPPINGMALLNAME	GEORGIA SQUARE MALL
NORTH POINT MALL	SHOPPINGMALLNAME	NORTH POINT MALL
APACHE MALL	SHOPPINGMALLNAME	APACHE MALL
CHAMPLAIN PLACE	SHOPPINGMALLNAME	CHAMPLAIN PLACE
GARDEN CITY	SHOPPINGMALLNAME	GARDEN CITY SHOPPING CENTRE
VOLUSIA MALL	SHOPPINGMALLNAME	VOLUSIA MALL
SHOPPINGTOWN MALL	SHOPPINGMALLNAME	SHOPPINGTOWN MALL
VIAPORT ROTTERDAM	SHOPPINGMALLNAME	VIA PORT ROTTERDAM
THE MARKET PLACE	SHOPPINGMALLNAME	THE MARKET PLACE
SOUTHLAND MALL	SHOPPINGMALLNAME	SOUTHLAND MALL
NORTHGATE MALL	SHOPPINGMALLNAME	NORTHGATE MALL
GWINNETT PLACE MALL	SHOPPINGMALLNAME	GWINNETT PLACE MALL
ARBOR PLACE MALL	SHOPPINGMALLNAME	ARBOR PLACE MALL
STONY POINT FASHION PARK	SHOPPINGMALLNAME	STONY POINT FASHION PARK
THE GALLERIA AT FORT LAUDERDALE	SHOPPINGMALLNAME	THE GALLERIA AT FORT LAUDERDALE
BANKSTOWN CENTRAL SHOPPING CENTRE	SHOPPINGMALLNAME	BANKSTOWN CENTRAL SHOPPING CENTRE
PARK PLACE	SHOPPINGMALLNAME	PARK PLACE
THE MALL AT MILLENIA	SHOPPINGMALLNAME	THE MALL AT MILLENIA
WESTFIELD BRANDON	SHOPPINGMALLNAME	WESTFIELD BRANDON
DRAGON CENTRE	SHOPPINGMALLNAME	DRAGON CENTRE
EAST TOWNE MALL	SHOPPINGMALLNAME	EAST TOWNE MALL
NORTHLAND CENTER	SHOPPINGMALLNAME	NORTHLAND CENTER
WESTFIELD TUGGERAH	SHOPPINGMALLNAME	WESTFIELD TUGGERAH
THE FALLS	SHOPPINGMALLNAME	THE FALLS
TUGGERANONG HYPERDOME	SHOPPINGMALLNAME	TUGGERANONG HYPERDOME
OAKRIDGE CENTRE	SHOPPINGMALLNAME	OAKRIDGE CENTRE
DULLES TOWN CENTER	SHOPPINGMALLNAME	DULLES TOWN CENTER
HAMILTON MALL	SHOPPINGMALLNAME	HAMILTON MALL
JANESVILLE MALL	SHOPPINGMALLNAME	JANESVILLE MALL
WEST TOWNE MALL	SHOPPINGMALLNAME	WEST TOWNE MALL
ECLIPSE CENTER	SHOPPINGMALLNAME	ECLIPSE CENTER
SUNWAY PUTRA MALL	SHOPPINGMALLNAME	SUNWAY PUTRA MALL
MELBOURNE CENTRAL SHOPPING CENTRE	SHOPPINGMALLNAME	MELBOURNE CENTRAL
GRIFFITH CENTRAL	SHOPPINGMALLNAME	GRIFFITH CENTRAL
ALTONA GATE SHOPPING CENTRE	SHOPPINGMALLNAME	ALTONA GATE SHOPPING CENTRE
TZUM	SHOPPINGMALLNAME	TZUM
ROCKAWAY TOWNSQUARE	SHOPPINGMALLNAME	ROCKAWAY TOWNSQUARE
SUBANG PARADE	SHOPPINGMALLNAME	SUBANG PARADE
WESTFIELD BELCONNEN	SHOPPINGMALLNAME	WESTFIELD BELCONNEN
PLAZA SENAYAN	SHOPPINGMALLNAME	PLAZA SENAYAN
TRINITY CENTRE, ABERDEEN	SHOPPINGMALLNAME	TRINITY CENTRE
RHODE ISLAND MALL	SHOPPINGMALLNAME	RHODE ISLAND MALL
CHRISTOWN SPECTRUM MALL	SHOPPINGMALLNAME	CHRISTOWN SPECTRUM MALL
LONDONDERRY MALL	SHOPPINGMALLNAME	LONDONDERRY MALL
KINGSWAY MALL	SHOPPINGMALLNAME	KINGSWAY MALL
CWMBRAN SHOPPING CENTRE	SHOPPINGMALLNAME	CWMBRAN SHOPPING CENTRE
WINTERGARDEN, BRISBANE	SHOPPINGMALLNAME	WINTERGARDEN
CHARLESTOWN SQUARE	SHOPPINGMALLNAME	CHARLESTOWN SQUARE
HARBOURFRONT CENTRE	SHOPPINGMALLNAME	HARBOURFRONT CENTRE
AMERICANA MANHASSET	SHOPPINGMALLNAME	AMERICANA MANHASSET
SOLOMON POND MALL	SHOPPINGMALLNAME	SOLOMON POND MALL
ABASTO DE BUENOS AIRES	SHOPPINGMALLNAME	ABASTO SHOPPING
CASCADES SHOPPING CENTRE	SHOPPINGMALLNAME	CASCADES SHOPPING CENTRE
VICTORIA QUARTER	SHOPPINGMALLNAME	VICTORIA QUARTER
CITYPLACE	SHOPPINGMALLNAME	CITYPLACE
BOULEVARD MALL	SHOPPINGMALLNAME	BOULEVARD MALL
EASTERN HILLS MALL	SHOPPINGMALLNAME	EASTERN HILLS MALL
BROADWAY ON THE MALL	SHOPPINGMALLNAME	BROADWAY ON THE MALL
CHURCHILL SQUARE	SHOPPINGMALLNAME	CHURCHILL SQUARE
PENN-CAN MALL	SHOPPINGMALLNAME	DRIVER'S VILLAGE
DELTA CITY	SHOPPINGMALLNAME	DELTA CITY
DELTA CITY	SHOPPINGMALLNAME	DELTA PLANET
MANCHESTER ARNDALE	SHOPPINGMALLNAME	MANCHESTER ARNDALE
NORTH STAR MALL	SHOPPINGMALLNAME	NORTH STAR MALL
FOREST HILL CHASE SHOPPING CENTRE	SHOPPINGMALLNAME	FOREST HILL CHASE SHOPPING CENTRE
MONMOUTH MALL	SHOPPINGMALLNAME	MONMOUTH MALL
NORTH HILLS	SHOPPINGMALLNAME	NORTH HILLS MALL
OCEAN COUNTY MALL	SHOPPINGMALLNAME	OCEAN COUNTY MALL
THE MALL AT PRINCE GEORGES	SHOPPINGMALLNAME	THE MALL AT PRINCE GEORGES
MCKINLEY MALL	SHOPPINGMALLNAME	MCKINLEY MALL
VILLAGE SHOPPING CENTRE	SHOPPINGMALLNAME	VILLAGE SHOPPING CENTRE
LATHAM CIRCLE MALL	SHOPPINGMALLNAME	LATHAM CIRCLE MALL
WOODBURY COMMON PREMIUM OUTLETS	SHOPPINGMALLNAME	WOODBURY COMMON PREMIUM OUTLETS - A SIMON CENTER
BAL HARBOUR SHOPS	SHOPPINGMALLNAME	BAL HARBOUR SHOPS
GALLERIA SHOPPING CENTRE	SHOPPINGMALLNAME	GALLERIA SHOPPING CENTRE
COLUMBIA CENTER MALL	SHOPPINGMALLNAME	COLUMBIA CENTER MALL
HAMPSHIRE MALL	SHOPPINGMALLNAME	HAMPSHIRE MALL
BON ACCORD & ST NICHOLAS	SHOPPINGMALLNAME	BON ACCORD & ST NICHOLAS
BON ACCORD & ST NICHOLAS	SHOPPINGMALLNAME	SHOPPING CENTRES
MILLCREEK MALL	SHOPPINGMALLNAME	MILLCREEK MALL
SOUTH BAY GALLERIA	SHOPPINGMALLNAME	SOUTH BAY GALLERIA
WESTGATE, OXFORD	SHOPPINGMALLNAME	WESTGATE SHOPPING CENTRE
SUNWAY PYRAMID	SHOPPINGMALLNAME	SUNWAY PYRAMID
WESTDALE MALL	SHOPPINGMALLNAME	WESTDALE MALL
LINDALE MALL	SHOPPINGMALLNAME	LINDALE MALL
AMPANG PARK	SHOPPINGMALLNAME	AMPANG PARK
SHAW CENTREPOINT	SHOPPINGMALLNAME	SHAW CENTREPOINT
VOORHEES TOWN CENTER	SHOPPINGMALLNAME	VOORHEES TOWN CENTER
FREEHOLD RACEWAY MALL	SHOPPINGMALLNAME	FREEHOLD RACEWAY MALL
THE MALL AT SHORT HILLS	SHOPPINGMALLNAME	THE MALL AT SHORT HILLS
PLAZA ROMANIA	SHOPPINGMALLNAME	PLAZA ROMANIA
MIRACLE MILE SHOPS	SHOPPINGMALLNAME	MIRACLE MILE SHOPS
GROVE CITY PREMIUM OUTLETS	SHOPPINGMALLNAME	GROVE CITY PREMIUM OUTLETS
WATERWORKS MALL	SHOPPINGMALLNAME	WATERWORKS MALL
108 NORTH STATE STREET	SHOPPINGMALLNAME	108
CHATSWOOD CHASE	SHOPPINGMALLNAME	CHATSWOOD CHASE
ARDEN FAIR MALL	SHOPPINGMALLNAME	ARDEN FAIR MALL
TRINITY LEEDS	SHOPPINGMALLNAME	TRINITY LEEDS
MUSIC CITY MALL	SHOPPINGMALLNAME	MUSIC CITY MALL
ROBINSON TOWN CENTRE	SHOPPINGMALLNAME	ROBINSON TOWN CENTRE
NORTHLAND SHOPPING CENTRE	SHOPPINGMALLNAME	NORTHLAND SHOPPING CENTRE
LEXINGTON MALL	SHOPPINGMALLNAME	LEXINGTON MALL
BURJUMAN	SHOPPINGMALLNAME	BURJUMAN
CAPILANO MALL	SHOPPINGMALLNAME	CAPILANO MALL
HEMPSTEAD, KENT	SHOPPINGMALLNAME	HEMPSTEAD VALLEY SHOPPING CENTRE
PERISUR	SHOPPINGMALLNAME	PERISUR
BRASS MILL CENTER	SHOPPINGMALLNAME	BRASS MILL CENTER
WESTFIELD WHITFORD CITY	SHOPPINGMALLNAME	WESTFIELD WHITFORD CITY
COQUITLAM CENTRE	SHOPPINGMALLNAME	COQUITLAM CENTRE
CENTRAL CITY SHOPPING CENTRE	SHOPPINGMALLNAME	CENTRAL CITY SHOPPING CENTRE
NEWBURGH MALL	SHOPPINGMALLNAME	NEWBURGH MALL
CHAPELFIELD	SHOPPINGMALLNAME	INTU CHAPELFIELD
WESTFIELD ANNAPOLIS	SHOPPINGMALLNAME	ANNAPOLIS MALL
GOLDEN CROSS, OXFORD	SHOPPINGMALLNAME	GOLDEN CROSS
SYLVIA PARK	SHOPPINGMALLNAME	SYLVIA PARK
LOUGHEED TOWN CENTRE	SHOPPINGMALLNAME	LOUGHEED TOWN CENTRE
BRENTWOOD TOWN CENTRE	SHOPPINGMALLNAME	BRENTWOOD TOWN CENTRE
MALL OF SOFIA	SHOPPINGMALLNAME	MALL OF SOFIA
LEHIGH VALLEY MALL	SHOPPINGMALLNAME	LEHIGH VALLEY MALL
MAL KELAPA GADING	SHOPPINGMALLNAME	MAL KELAPA GADING
MAL KELAPA GADING	SHOPPINGMALLNAME	KELAPA GADING MALL
OAKBROOK CENTER	SHOPPINGMALLNAME	OAKBROOK CENTER
LAFAYETTE SQUARE MALL	SHOPPINGMALLNAME	LAFAYETTE SQUARE MALL
VALLEY VIEW MALL	SHOPPINGMALLNAME	VALLEY VIEW MALL
WESTFIELD WARRINGAH MALL	SHOPPINGMALLNAME	WESTFIELD WARRINGAH MALL
KINGSWAY SHOPPING CENTRE	SHOPPINGMALLNAME	KINGSWAY CENTRE
MACARTHUR SQUARE	SHOPPINGMALLNAME	MACARTHUR SQUARE
WESTFIELD CHATSWOOD	SHOPPINGMALLNAME	WESTFIELD CHATWOOD
WESTFIELD BURWOOD	SHOPPINGMALLNAME	WESTFIELD BURWOOD
WESTFIELD CHERMSIDE	SHOPPINGMALLNAME	WESTFIELD CHERMSIDE
ST DAVID'S, CARDIFF	SHOPPINGMALLNAME	ST DAVID'S
ST DAVID'S, CARDIFF	SHOPPINGMALLNAME	DEWI SANT
CAPITOL CENTRE	SHOPPINGMALLNAME	CAPITOL CENTRE
OASIS SHOPPING CENTRE	SHOPPINGMALLNAME	OASIS SHOPPING CENTRE
RIVER OAKS CENTER	SHOPPINGMALLNAME	RIVER OAKS CENTER
WESTEND CITY CENTER	SHOPPINGMALLNAME	WESTEND CITY CENTER
MERIDIAN MALL	SHOPPINGMALLNAME	MERIDIAN MALL
CITADEL MALL	SHOPPINGMALLNAME	CITADEL MALL
WOLLONGONG CENTRAL	SHOPPINGMALLNAME	WOLLONGONG CENTRAL
TOOMBUL SHOPPING CENTRE	SHOPPINGMALLNAME	TOOMBUL SHOPPING CENTRE
WESTFIELD BONDI JUNCTION	SHOPPINGMALLNAME	WESTFIELD BONDI JUNCTION
CHANDLER FASHION CENTER	SHOPPINGMALLNAME	CHANDLER FASHION CENTER
GRAND INDONESIA SHOPPING TOWN	SHOPPINGMALLNAME	GRAND INDONESIA SHOPPING TOWN
HAWTHORN MALL	SHOPPINGMALLNAME	HAWTHORN MALL
LIVINGSTON MALL	SHOPPINGMALLNAME	LIVINGSTON MALL
CRYSTAL MALL	SHOPPINGMALLNAME	CRYSTAL MALL
MIRAMAR ENTERTAINMENT PARK	SHOPPINGMALLNAME	MIRAMAR ENTERTAINMENT PARK
MIRAMAR ENTERTAINMENT PARK	SHOPPINGMALLNAME	美麗華百樂園
NORTH EAST MALL	SHOPPINGMALLNAME	NORTH EAST MALL
WESTFIELD CARINDALE	SHOPPINGMALLNAME	WESTFIELD CARINDALE
YORKVILLE VILLAGE	SHOPPINGMALLNAME	YORKVILLE VILLAGE
PLAZA LOW YAT	SHOPPINGMALLNAME	LOW YAT PLAZA
PLAZA LOW YAT	SHOPPINGMALLNAME	PLAZA LOW YAT
CONNECTICUT POST MALL	SHOPPINGMALLNAME	CONNECTICUT POST MALL
ERIN MILLS TOWN CENTRE	SHOPPINGMALLNAME	ERIN MILLS TOWN CENTRE
DIRECT FACTORY OUTLETS	SHOPPINGMALLNAME	DIRECT FACTORY OUTLETS
THE STREETS OF TANASBOURNE	SHOPPINGMALLNAME	THE STREETS OF TANASBOURNE
NORTHBROOK COURT	SHOPPINGMALLNAME	NORTHBROOK COURT
LYNNMALL	SHOPPINGMALLNAME	LYNNMALL
THE MALL AT FOX RUN	SHOPPINGMALLNAME	FOX RUN MALL
WASHINGTON CROWN CENTER	SHOPPINGMALLNAME	WASHINGTON CROWN CENTER
WASHINGTON MALL	SHOPPINGMALLNAME	WASHINGTON MALL
PLATINUM FASHION MALL	SHOPPINGMALLNAME	PLATINUM FASHION MALL
SIAM CENTER	SHOPPINGMALLNAME	SIAM CENTER
PARK CENTRAL MALL	SHOPPINGMALLNAME	PARK CENTRAL MALL
COOLSPRINGS GALLERIA	SHOPPINGMALLNAME	COOLSPRINGS GALLERIA
LAWRENCE PLAZA	SHOPPINGMALLNAME	LAWRENCE PLAZA MALL
UNIVERSITY MALL	SHOPPINGMALLNAME	UNIVERSITY MALL
MADISON SQUARE MALL	SHOPPINGMALLNAME	MADISON SQUARE MALL
CENTERPOINTE MALL	SHOPPINGMALLNAME	THE SHOPS AT CENTERPOINTE
ROLLING ACRES MALL	SHOPPINGMALLNAME	ROLLING ACRES MALL
CROSSGATES COMMONS	SHOPPINGMALLNAME	CROSSGATES COMMONS
FRIARS WALK, NEWPORT	SHOPPINGMALLNAME	FRIARS WALK
LAKESIDE JOONDALUP SHOPPING CITY	SHOPPINGMALLNAME	LAKESIDE JOONDALUP SHOPPING CITY
CENTRALWORLD	SHOPPINGMALLNAME	300
THE MALLS, BASINGSTOKE	SHOPPINGMALLNAME	THE MALLS
THE GYLE SHOPPING CENTRE	SHOPPINGMALLNAME	THE GYLE SHOPPING CENTRE
FORT SAGINAW MALL	SHOPPINGMALLNAME	FORT SAGINAW MALL
EXTON SQUARE MALL	SHOPPINGMALLNAME	EXTON SQUARE MALL
LAURIER QUéBEC	SHOPPINGMALLNAME	LAURIER QUéBEC
QUAKER BRIDGE MALL	SHOPPINGMALLNAME	QUAKER BRIDGE MALL
CASTLETON SQUARE	SHOPPINGMALLNAME	CASTLETON SQUARE MALL
THE CITADEL	SHOPPINGMALLNAME	THE CITADEL MALL
GRAND CANAL SHOPPES	SHOPPINGMALLNAME	GRAND CANAL SHOPPES
ORLAND SQUARE MALL	SHOPPINGMALLNAME	ORLAND SQUARE MALL
WESTLAND MALL	SHOPPINGMALLNAME	WESTLAND MALL
THE MALL AT TUTTLE CROSSING	SHOPPINGMALLNAME	THE MALL AT TUTTLE CROSSING
WESTFIELD INNALOO	SHOPPINGMALLNAME	WESTFIELD INNALOO
WESTFIELD SOUTHCENTER	SHOPPINGMALLNAME	WESTFIELD SOUTHCENTER
STOCKLAND THE PINES	SHOPPINGMALLNAME	STOCKLAND THE PINES
SUMMIT MALL	SHOPPINGMALLNAME	SUMMIT MALL
SWAN SHOPPING CENTRE	SHOPPINGMALLNAME	SWAN SHOPPING CENTRE
CHAPEL HILL MALL	SHOPPINGMALLNAME	CHAPEL HILL MALL
WESTFIELD PENRITH	SHOPPINGMALLNAME	WESTFIELD PENRITH
CITY SQUARE MALL	SHOPPINGMALLNAME	CITY SQUARE MALL
PACIFIC CENTRE	SHOPPINGMALLNAME	PACIFIC CENTRE
THE FORUM	SHOPPINGMALLNAME	THE FORUM MALL
MACARTHUR CENTER	SHOPPINGMALLNAME	MACARTHUR CENTER
GENESEE VALLEY CENTER	SHOPPINGMALLNAME	GENESEE VALLEY CENTER
RIVER FALLS MALL	SHOPPINGMALLNAME	RIVER FALLS
SELLO	SHOPPINGMALLNAME	SELLO
RANDALL PARK MALL	SHOPPINGMALLNAME	RANDALL PARK MALL
MARKET MALL	SHOPPINGMALLNAME	MARKET MALL
DALTON PARK	SHOPPINGMALLNAME	DALTON PARK OUTLET
BANNISTER MALL	SHOPPINGMALLNAME	BANNISTER MALL
INDEPENDENCE CENTER	SHOPPINGMALLNAME	INDEPENDENCE CENTER
STOCKLAND TOWNSVILLE	SHOPPINGMALLNAME	STOCKLAND TOWNSVILLE
CENTRAL MILTON KEYNES SHOPPING CENTRE	SHOPPINGMALLNAME	CENTRAL MILTON KEYNES SHOPPING CENTRE
CLIFTON PARK CENTER	SHOPPINGMALLNAME	CLIFTON PARK CENTER
DUTCHESS MALL	SHOPPINGMALLNAME	DUTCHESS MALL
TIMMINS SQUARE	SHOPPINGMALLNAME	TIMMINS SQUARE
CAIRNS CENTRAL	SHOPPINGMALLNAME	CAIRNS CENTRAL
UNIREA SHOPPING CENTER	SHOPPINGMALLNAME	UNIREA SHOPPING CENTER
THE PEN CENTRE	SHOPPINGMALLNAME	THE PEN CENTRE
COLUMBIA PLACE	SHOPPINGMALLNAME	COLUMBIA PLACE
ARBOR LAKES	SHOPPINGMALLNAME	ARBOR LAKES
MARLBOROUGH MALL	SHOPPINGMALLNAME	MARLBOROUGH MALL
HILLSDALE SHOPPING CENTER	SHOPPINGMALLNAME	HILLSDALE SHOPPING CENTER
SALISBURY MALL	SHOPPINGMALLNAME	SALISBURY MALL
CLARENDON SHOPPING CENTRE	SHOPPINGMALLNAME	CLARENDON CENTRE
WESTFIELD OAKRIDGE	SHOPPINGMALLNAME	WESTFIELD OAKRIDGE
DOWNTOWN COMMONS	SHOPPINGMALLNAME	DOWNTOWN COMMONS
WESTFIELD GALLERIA AT ROSEVILLE	SHOPPINGMALLNAME	WESTFIELD GALLERIA AT ROSEVILLE
MAINPLACE MALL	SHOPPINGMALLNAME	MAINPLACE MALL
WESTFIELD HORTON PLAZA	SHOPPINGMALLNAME	HORTON PLAZA
CAPITAL MALL	SHOPPINGMALLNAME	CAPITAL MALL
VANCOUVER MALL	SHOPPINGMALLNAME	VANCOUVER MALL
FOX VALLEY MALL	SHOPPINGMALLNAME	FOX VALLEY MALL
THE SHOPS AT NORTH BRIDGE	SHOPPINGMALLNAME	THE SHOPS AT NORTH BRIDGE
CHICAGO RIDGE MALL	SHOPPINGMALLNAME	CHICAGO RIDGE MALL
WESTFIELD OLD ORCHARD	SHOPPINGMALLNAME	WESTFIELD OLD ORCHARD
LOUIS JOLIET MALL	SHOPPINGMALLNAME	LOUIS JOLIET MALL
SOUTHLAKE MALL	SHOPPINGMALLNAME	SOUTHLAKE MALL
FRANKLIN PARK MALL	SHOPPINGMALLNAME	FRANKLIN PARK MALL
WESTFIELD VALENCIA TOWN CENTER	SHOPPINGMALLNAME	WESTFIELD VALENCIA TOWN CENTER
SOUTHPARK MALL	SHOPPINGMALLNAME	SOUTHPARK MALL
GREAT NORTHERN MALL	SHOPPINGMALLNAME	GREAT NORTHERN MALL
EASTLAND CENTER	SHOPPINGMALLNAME	EASTLAND CENTER
PLAZA WEST COVINA	SHOPPINGMALLNAME	PLAZA WEST COVINA
WESTFIELD COUNTRYSIDE	SHOPPINGMALLNAME	WESTFIELD COUNTRYSIDE
WESTFIELD CITRUS PARK	SHOPPINGMALLNAME	WESTFIELD CITRUS PARK
WESTFIELD SARASOTA SQUARE	SHOPPINGMALLNAME	WESTFIELD SARASOTA
SOLANO TOWN CENTER	SHOPPINGMALLNAME	SOLANO MALL
WESTFIELD SANTA ANITA	SHOPPINGMALLNAME	WESTFIELD SANTA ANITA
WESTFIELD CULVER CITY	SHOPPINGMALLNAME	WESTFIELD CULVER CITY
WESTFIELD CENTURY CITY	SHOPPINGMALLNAME	WESTFIELD CENTURY CITY
WESTFIELD FASHION SQUARE	SHOPPINGMALLNAME	WESTFIELD FASHION SQUARE/SHERMAN OAKS FASHION SQUARE
THE SHOPPES AT CARLSBAD	SHOPPINGMALLNAME	THE SHOPPES AT CARLSBAD
PARKWAY PLAZA	SHOPPINGMALLNAME	PARKWAY PLAZA
WESTFIELD NORTH COUNTY	SHOPPINGMALLNAME	WESTFIELD NORTH COUNTY
SAHARA MALL	SHOPPINGMALLNAME	SAHARA MALL
SAHARA MALL	SHOPPINGMALLNAME	صحارى مول
WESTFIELD PLAZA BONITA	SHOPPINGMALLNAME	WESTFIELD PLAZA BONITA
WESTFIELD UTC	SHOPPINGMALLNAME	WESTFIELD UTC
WESTFIELD MISSION VALLEY	SHOPPINGMALLNAME	WESTFIELD MISSION VALLEY
TUCSON MALL	SHOPPINGMALLNAME	TUCSON MALL
WILLOWS SHOPPING CENTRE	SHOPPINGMALLNAME	WILLOWS SHOPPING CENTRE
HILLDALE SHOPPING CENTER	SHOPPINGMALLNAME	HILLDALE SHOPPING CENTER
CHERRYVALE MALL	SHOPPINGMALLNAME	CHERRYVALE MALL
STRATFORD SQUARE MALL	SHOPPINGMALLNAME	STRATFORD SQUARE MALL
SPRING HILL MALL	SHOPPINGMALLNAME	SPRING HILL MALL
UNIVERSITY PARK MALL	SHOPPINGMALLNAME	UNIVERSITY PARK MALL
PARK FOREST PLAZA	SHOPPINGMALLNAME	PARK FOREST PLAZA
THE SHOPS AT WILLOW BEND	SHOPPINGMALLNAME	THE SHOPS AT WILLOW BEND
INGRAM PARK MALL	SHOPPINGMALLNAME	INGRAM PARK MALL
RIVERCENTER	SHOPPINGMALLNAME	SHOPS AT RIVERCENTER
SOUTH PARK MALL	SHOPPINGMALLNAME	SOUTH PARK MALL
ROLLING OAKS MALL	SHOPPINGMALLNAME	ROLLING OAKS MALL
BARTON CREEK SQUARE	SHOPPINGMALLNAME	BARTON CREEK SQUARE
BRIARWOOD MALL	SHOPPINGMALLNAME	BRIARWOOD MALL
FAIRLANE TOWN CENTER	SHOPPINGMALLNAME	FAIRLANE TOWN CENTER
EMPIRE MALL	SHOPPINGMALLNAME	THE EMPIRE MALL
CROSSROADS CENTER	SHOPPINGMALLNAME	CROSSROADS CENTER
RIVERTOWN CROSSINGS	SHOPPINGMALLNAME	RIVERTOWN CROSSINGS
HULEN MALL	SHOPPINGMALLNAME	HULEN MALL
CENTRO	SHOPPINGMALLNAME	CENTRO
ST. JOHNS TOWN CENTER	SHOPPINGMALLNAME	ST. JOHNS TOWN CENTER
SOUTHCENTRE MALL	SHOPPINGMALLNAME	SOUTHCENTRE MALL
SOUTHCENTRE MALL	SHOPPINGMALLNAME	10
WESTLAND CENTER	SHOPPINGMALLNAME	WESTLAND SHOPPING CENTER
THE GREENE TOWN CENTER	SHOPPINGMALLNAME	GREENE TOWN CENTER
THE MALL AT PARTRIDGE CREEK	SHOPPINGMALLNAME	THE MALL AT PARTRIDGE CREEK
LAUREL PARK PLACE	SHOPPINGMALLNAME	LAUREL PARK PLACE MALL
SOUTH PLAINS MALL	SHOPPINGMALLNAME	SOUTH PLAINS MALL
ST. LAURENT CENTRE	SHOPPINGMALLNAME	ST. LAURENT CENTRE
CARLINGWOOD MALL	SHOPPINGMALLNAME	CARLINGWOOD MALL
SOUTHGATE SHOPPING CENTER	SHOPPINGMALLNAME	SOUTHGATE SHOPPING CENTER
ARTEGON MARKETPLACE	SHOPPINGMALLNAME	ARTEGON MARKETPLACE
ZONA ROSA	SHOPPINGMALLNAME	ZONA ROSA
THE MALL AT GREECE RIDGE	SHOPPINGMALLNAME	THE MALL AT GREECE RIDGE
ANCHORAGE 5TH AVENUE MALL	SHOPPINGMALLNAME	ANCHORAGE 5TH AVENUE MALL
INDOOROOPILLY SHOPPING CENTRE	SHOPPINGMALLNAME	INDOOROOPILLY SHOPPING CENTRE
MALL OF LOUISIANA	SHOPPINGMALLNAME	MALL OF LOUISIANA
THE PROMENADE SHOPS AT SAUCON VALLEY	SHOPPINGMALLNAME	THE PROMENADE SHOPS AT SAUCON VALLEY
WYOMING VALLEY MALL	SHOPPINGMALLNAME	WYOMING VALLEY MALL
LUTWYCHE CITY SHOPPING CENTRE	SHOPPINGMALLNAME	LUTWYCHE CITY SHOPPING CENTRE
GATEWAY FASHION MALL	SHOPPINGMALLNAME	GATEWAY FASHION MALL
PONDOK INDAH MALL	SHOPPINGMALLNAME	PONDOK INDAH MALL
PRINCES QUAY	SHOPPINGMALLNAME	PRINCES QUAY
LES PROMENADES GATINEAU	SHOPPINGMALLNAME	LES PROMENADES GATINEAU
MIDTOWN PLAZA	SHOPPINGMALLNAME	MIDTOWN PLAZA
HIGHLAND PARK VILLAGE	SHOPPINGMALLNAME	HIGHLAND PARK VILLAGE
ALEXIS NIHON COMPLEX	SHOPPINGMALLNAME	ALEXIS NIHON
FORUM	SHOPPINGMALLNAME	FORUM
ABU DHABI MALL	SHOPPINGMALLNAME	ABU DHABI MALL
ABU DHABI MALL	SHOPPINGMALLNAME	مركز أبو ظبي
MEDLEY CENTRE	SHOPPINGMALLNAME	MEDLEY CENTRE
THE SHOPS AT RIVERSIDE	SHOPPINGMALLNAME	THE SHOPS AT RIVERSIDE
EASTFIELD MALL	SHOPPINGMALLNAME	EASTFIELD MALL
WESTGATE ENTERTAINMENT DISTRICT	SHOPPINGMALLNAME	WESTGATE ENTERTAINMENT DISTRICT
ISO OMENA	SHOPPINGMALLNAME	ISO OMENA
VICTORIA GARDENS	SHOPPINGMALLNAME	VICTORIA GARDENS
WESTFIELD WORLD TRADE CENTER	SHOPPINGMALLNAME	WESTFIELD WORLD TRADE CENTER
STONERIDGE SHOPPING CENTER	SHOPPINGMALLNAME	STONERIDGE SHOPPING CENTER
FIESTA MALL	SHOPPINGMALLNAME	FIESTA MALL
OAKWOOD CENTER	SHOPPINGMALLNAME	OAKWOOD CENTER
WOODBURN PREMIUM OUTLETS	SHOPPINGMALLNAME	WOODBURN PREMIUM OUTLETS
SEAVIEW SQUARE MALL	SHOPPINGMALLNAME	SEAVIEW SQUARE MALL
FOOTHILLS MALL	SHOPPINGMALLNAME	FOOTHILLS MALL
PACIFIC EPPING	SHOPPINGMALLNAME	PACIFIC EPPING
WARWICK MALL	SHOPPINGMALLNAME	WARWICK MALL
RICHMOND TOWN SQUARE	SHOPPINGMALLNAME	RICHMOND TOWN SQUARE
MIDWAY MALL	SHOPPINGMALLNAME	MIDWAY MALL
AUBURN MALL	SHOPPINGMALLNAME	KING OF PRUSSIA MALL
EUCLID SQUARE MALL	SHOPPINGMALLNAME	EUCLID SQUARE MALL
THE SHOPPES AT PARMA	SHOPPINGMALLNAME	THE SHOPPES AT PARMA
ASHTABULA TOWNE SQUARE	SHOPPINGMALLNAME	ASHTABULA TOWNE SQUARE
LIBERTY TREE MALL	SHOPPINGMALLNAME	LIBERTY TREE MALL
BERKSHIRE MALL	SHOPPINGMALLNAME	BERKSHIRE MALL
THE MALL AT CHESTNUT HILL	SHOPPINGMALLNAME	THE MALL AT CHESTNUT HILL
FINGERLAKES MALL	SHOPPINGMALLNAME	FINGERLAKES MALL
TOTEM LAKE MALL	SHOPPINGMALLNAME	TOTEM LAKE MALL
RICHMOND MALL	SHOPPINGMALLNAME	RICHMOND MALL
MAYAGüEZ MALL	SHOPPINGMALLNAME	MAYAGüEZ MALL
LAKEWOOD CENTER	SHOPPINGMALLNAME	LAKEWOOD CENTER
MALL ST. MATTHEWS	SHOPPINGMALLNAME	MALL ST. MATTHEWS
WOODLAND MALL	SHOPPINGMALLNAME	WOODLAND MALL
OXMOOR CENTER	SHOPPINGMALLNAME	OXMOOR CENTER
MEADOWOOD MALL	SHOPPINGMALLNAME	MEADOWOOD MALL
WESTFIELD BROWARD	SHOPPINGMALLNAME	WESTFIELD BROWARD
COLORADO MILLS	SHOPPINGMALLNAME	COLORADO MILLS
GRAPEVINE MILLS	SHOPPINGMALLNAME	GRAPEVINE MILLS
BROOKSIDE SHOPPING CENTRE	SHOPPINGMALLNAME	BROOKSIDE SHOPPING CENTRE
BRIDGEWATER COMMONS	SHOPPINGMALLNAME	BRIDGEWATER COMMONS
DEPTFORD MALL	SHOPPINGMALLNAME	DEPTFORD MALL
CATARAQUI CENTRE	SHOPPINGMALLNAME	CATARAQUI CENTRE
MALHA MALL	SHOPPINGMALLNAME	MALHA MALL
HYDERABAD CENTRAL	SHOPPINGMALLNAME	HYDERABAD CENTRAL \Nహైదరాబాద్ సెంట్రల్
SOMERSET MALL	SHOPPINGMALLNAME	SOMERSET MALL
GURNEY PLAZA	SHOPPINGMALLNAME	GURNEY PLAZA
ÆON BUKIT TINGGI SHOPPING CENTRE	SHOPPINGMALLNAME	ÆON MALL BUKIT TINGGI, BUKIT TINGGI, KLANG
FIRST COLONY MALL	SHOPPINGMALLNAME	FIRST COLONY MALL
ARROWHEAD TOWNE CENTER	SHOPPINGMALLNAME	ARROWHEAD TOWNE CENTER
WESTFIELD MARION	SHOPPINGMALLNAME	WESTFIELD MARION
WESTFIELD NEWMARKET	SHOPPINGMALLNAME	WESTFIELD NEWMARKET
GLENFIELD MALL	SHOPPINGMALLNAME	GLENFIELD MALL
WESTFIELD ST LUKES	SHOPPINGMALLNAME	WESTFIELD ST LUKES
PLAZA INDONESIA	SHOPPINGMALLNAME	PLAZA INDONESIA
PARK PLACE	SHOPPINGMALLNAME	PARK PLACE
THE MALL AT MILL CREEK	SHOPPINGMALLNAME	THE MALL AT MILL CREEK
WESTFIELD SYDNEY	SHOPPINGMALLNAME	WESTFIELD SYDNEY
ROYAL VICTORIA PLACE	SHOPPINGMALLNAME	ROYAL VICTORIA PLACE
MYRTLE BEACH MALL	SHOPPINGMALLNAME	MYRTLE BEACH MALL
SANGERTOWN SQUARE	SHOPPINGMALLNAME	SANGERTOWN SQUARE
THE POINTE AT NORTH FAYETTE	SHOPPINGMALLNAME	THE POINTE AT NORTH FAYETTE
SERAFI MEGA MALL	SHOPPINGMALLNAME	SERAFI MEGA MALL
SERAFI MEGA MALL	SHOPPINGMALLNAME	صيرفي ميقا مول
PLAYGROUND PIER	SHOPPINGMALLNAME	PLAYGROUND PIER
THE QUARTER AT TROPICANA	SHOPPINGMALLNAME	QUARTER AT TROPICANA
LIVONIA MARKETPLACE	SHOPPINGMALLNAME	LIVONIA MARKETPLACE
CONESTOGA MALL	SHOPPINGMALLNAME	CONESTOGA MALL
FLYING HORSE WALK	SHOPPINGMALLNAME	FLYING HORSE WALK
PORT PLAZA MALL	SHOPPINGMALLNAME	PORT PLAZA MALL / WASHINGTON COMMONS
MAPLE HILL PAVILION	SHOPPINGMALLNAME	MAPLE HILL PAVILION
ROSELANDS SHOPPING CENTRE	SHOPPINGMALLNAME	ROSELANDS SHOPPING CENTRE
GRAND CENTRAL SHOPPING CENTRE	SHOPPINGMALLNAME	GRAND CENTRAL
KABUL CITY CENTER	SHOPPINGMALLNAME	KABUL CITY CENTER
WESTFIELD TEA TREE PLAZA	SHOPPINGMALLNAME	WESTFIELD TEA TREE PLAZA
FORREST CHASE	SHOPPINGMALLNAME	FORREST PLACE
SPRINGDALE MALL	SHOPPINGMALLNAME	SPRINGDALE MALL
KITSAP MALL	SHOPPINGMALLNAME	KITSAP MALL
SUNRIDGE MALL	SHOPPINGMALLNAME	SUNRIDGE MALL
WESTFIELD EASTGARDENS	SHOPPINGMALLNAME	WESTFIELD EASTGARDENS
WESTMOUNT MALL	SHOPPINGMALLNAME	WESTMOUNT MALL
PLAZA FIESTA SAN AGUSTíN	SHOPPINGMALLNAME	PLAZA FIESTA SAN AGUSTíN
MALL AT THE SOURCE	SHOPPINGMALLNAME	THE MALL AT THE SOURCE
PROMENADES SAINT-BRUNO	SHOPPINGMALLNAME	PROMENADES SAINT-BRUNO
SUPERSTITION SPRINGS CENTER	SHOPPINGMALLNAME	SUPERSTITION SPRINGS CENTER
INLAND CENTER	SHOPPINGMALLNAME	INLAND CENTER
THE MALL AT NORTHGATE	SHOPPINGMALLNAME	NORTHGATE
BIRKENHEAD POINT OUTLET CENTRE	SHOPPINGMALLNAME	BIRKENHEAD POINT OUTLET CENTRE
THE MALL OF VICTOR VALLEY	SHOPPINGMALLNAME	THE MALL OF VICTOR VALLEY
SM CITY NORTH EDSA	SHOPPINGMALLNAME	SM CITY NORTH EDSA
THE OAKS	SHOPPINGMALLNAME	THE OAKS SHOPPING CENTER
SOMERSVILLE TOWNE CENTER	SHOPPINGMALLNAME	SOMERSVILLE TOWNE CENTER
STONEWOOD CENTER	SHOPPINGMALLNAME	STONEWOOD CENTER
THE VILLAGE AT CORTE MADERA	SHOPPINGMALLNAME	THE VILLAGE AT CORTE MADERA
VINTAGE FAIRE MALL	SHOPPINGMALLNAME	VINTAGE FAIRE MALL
SOUTHWYCK MALL	SHOPPINGMALLNAME	SOUTHWYCK MALL
MARKET MALL	SHOPPINGMALLNAME	MARKET MALL
THE CENTRE	SHOPPINGMALLNAME	THE CENTRE
MESA MALL	SHOPPINGMALLNAME	MESA MALL
MIDWAY MALL	SHOPPINGMALLNAME	MIDWAY MALL
SOUTHERN HILLS MALL	SHOPPINGMALLNAME	SOUTHERN HILLS MALL
RIMROCK MALL	SHOPPINGMALLNAME	RIMROCK MALL
THE DOMAIN	SHOPPINGMALLNAME	THE DOMAIN
VALLEY RIVER CENTER	SHOPPINGMALLNAME	VALLEY RIVER CENTER
DALLAS MIDTOWN	SHOPPINGMALLNAME	DALLAS MIDTOWN
CASCADE MALL	SHOPPINGMALLNAME	CASCADE MALL
CENTRAL MALL	SHOPPINGMALLNAME	CENTRAL MALL
SERRAMONTE CENTER	SHOPPINGMALLNAME	SERRAMONTE CENTER
SANTA ROSA MALL	SHOPPINGMALLNAME	SANTA ROSA MALL
CROSSROADS CENTER	SHOPPINGMALLNAME	CROSSROADS CENTER
METRO NORTH MALL	SHOPPINGMALLNAME	METRO NORTH MALL
STOCKLAND SHELLHARBOUR	SHOPPINGMALLNAME	STOCKLAND SHELLHARBOUR
HAWTHORNE PLAZA SHOPPING CENTER	SHOPPINGMALLNAME	HAWTHORNE PLAZA SHOPPING CENTER
TANGER OUTLETS THE WALK	SHOPPINGMALLNAME	TANGER OUTLETS THE WALK
SUNGEI WANG PLAZA	SHOPPINGMALLNAME	SUNGEI WANG PLAZA
MERIDIAN MALL, DUNEDIN	SHOPPINGMALLNAME	MERIDIAN MALL
ABERCORN COMMON	SHOPPINGMALLNAME	ABERCORN COMMON
JERSEY GARDENS	SHOPPINGMALLNAME	THE MILLS AT JERSEY GARDENS
WESTGATE MALL	SHOPPINGMALLNAME	WESTGATE MALL
TOWNMALL OF WESTMINSTER	SHOPPINGMALLNAME	TOWNMALL OF WESTMINSTER
NEW SOUTH CHINA MALL	SHOPPINGMALLNAME	NEW SOUTH CHINA MALL
THE SPIRES SHOPPING CENTRE	SHOPPINGMALLNAME	THE SPIRES SHOPPING CENTRE
CHANGE ALLEY, SINGAPORE	SHOPPINGMALLNAME	CHANGE ALLEY
HICKORY RIDGE MALL	SHOPPINGMALLNAME	HICKORY RIDGE MALL
SEACON SQUARE	SHOPPINGMALLNAME	SEACON SQUARE
SUNSET MALL	SHOPPINGMALLNAME	SUNSET MALL
PEMBROKE MALL	SHOPPINGMALLNAME	PEMBROKE MALL
WENATCHEE VALLEY MALL	SHOPPINGMALLNAME	WENATCHEE VALLEY MALL
STRAWBERRY SQUARE	SHOPPINGMALLNAME	STRAWBERRY SQUARE
PLAZAMERICAS	SHOPPINGMALLNAME	PLAZAMERICAS
DAPTO MALL	SHOPPINGMALLNAME	DAPTO MALL
WESTSIDE PAVILION	SHOPPINGMALLNAME	WESTSIDE PAVILION
THE AVENUES	SHOPPINGMALLNAME	THE AVENUES MALL
GRAND CENTRAL MALL	SHOPPINGMALLNAME	GRAND CENTRAL MALL
CORDOVA MALL	SHOPPINGMALLNAME	CORDOVA MALL
NORTHFIELD SQUARE	SHOPPINGMALLNAME	NORTHFIELD SQUARE
GREENSTREET	SHOPPINGMALLNAME	GREENSTREET
THE CROSSROADS	SHOPPINGMALLNAME	THE CROSSROADS
THE SHOPS AT LA CANTERA	SHOPPINGMALLNAME	THE SHOPS AT LA CANTERA
WILLOWBROOK MALL	SHOPPINGMALLNAME	WILLOWBROOK MALL
BLOCK ARCADE, MELBOURNE	SHOPPINGMALLNAME	THE BLOCK ARCADE
CROSSIRON MILLS	SHOPPINGMALLNAME	CROSSIRON MILLS
COLTON PLAZA	SHOPPINGMALLNAME	NIKKE COLTON PLAZA
GURNEE MILLS	SHOPPINGMALLNAME	GURNEE MILLS
SUNVALLEY SHOPPING CENTER	SHOPPINGMALLNAME	SUNVALLEY SHOPPING CENTER
ALAMO QUARRY MARKET	SHOPPINGMALLNAME	ALAMO QUARRY MARKET
KINGS PLAZA	SHOPPINGMALLNAME	KINGS PLAZA SHOPPING CENTER
PARADISE VALLEY MALL	SHOPPINGMALLNAME	PARADISE VALLEY MALL
METROCENTER	SHOPPINGMALLNAME	METROCENTER
THE OUTLETS AT BERGEN TOWN CENTER	SHOPPINGMALLNAME	THE OUTLETS AT BERGEN TOWN CENTER
WILLOWBROOK MALL	SHOPPINGMALLNAME	WILLOWBROOK MALL
NEWPORT ON THE LEVEE	SHOPPINGMALLNAME	NEWPORT ON THE LEVEE
WESTFIELD LIVERPOOL	SHOPPINGMALLNAME	WESTFIELD LIVERPOOL
WESTFIELD NORTH LAKES	SHOPPINGMALLNAME	WESTFIELD NORTH LAKES
CHARTWELL SHOPPING CENTRE	SHOPPINGMALLNAME	CHARTWELL SHOPPING CENTRE
MISSION CENTER MALL	SHOPPINGMALLNAME	MISSION CENTER MALL
GEORGIAN MALL	SHOPPINGMALLNAME	RIOCAN GEORGIAN MALL
NATICK MALL	SHOPPINGMALLNAME	NATICK MALL
WESTFARMS	SHOPPINGMALLNAME	WESTFARMS
THE PEEL CENTRE, STOCKPORT	SHOPPINGMALLNAME	THE PEEL CENTRE
GREAT WORLD CITY	SHOPPINGMALLNAME	GREAT WORLD CITY
TRI-COUNTY MALL	SHOPPINGMALLNAME	TRI-COUNTY MALL
WESTFIELD WESTCITY	SHOPPINGMALLNAME	WESTFIELD WESTCITY
THE FASHION MALL AT KEYSTONE	SHOPPINGMALLNAME	FASHION MALL AT KEYSTONE
KARRINYUP SHOPPING CENTRE	SHOPPINGMALLNAME	KARRINYUP SHOPPING CENTRE
OCEAN KEYS	SHOPPINGMALLNAME	OCEAN KEYS SHOPPING CENTRE
PORT PLACE SHOPPING CENTRE	SHOPPINGMALLNAME	PORT PLACE SHOPPING CENTRE
GREENGATE CENTRE	SHOPPINGMALLNAME	GREENGATE CENTRE
GREENGATE CENTRE	SHOPPINGMALLNAME	GREENGATE MALL
RIDGEDALE CENTER	SHOPPINGMALLNAME	RIDGEDALE CENTER
THE MALL IN COLUMBIA	SHOPPINGMALLNAME	THE MALL IN COLUMBIA
FUTURE PARK RANGSIT	SHOPPINGMALLNAME	FUTURE PARK RANGSIT
CARILLON CITY	SHOPPINGMALLNAME	CARILLON CITY
PLANET M	SHOPPINGMALLNAME	PLANET M RETAIL LTD
PARAMUS PARK	SHOPPINGMALLNAME	PARAMUS PARK
INTERNATIONAL PLAZA AND BAY STREET	SHOPPINGMALLNAME	INTERNATIONAL PLAZA AND BAY STREET
WESTWOOD CROSS	SHOPPINGMALLNAME	WESTWOOD CROSS
THE GLADES	SHOPPINGMALLNAME	INTU THE GLADES
NORTHSIDE SHOPPING CENTRE	SHOPPINGMALLNAME	NORTHSIDE SHOPPING CENTRE
LAGUNEN STORSENTER	SHOPPINGMALLNAME	LAGUNEN STORSENTER
THE MALL	SHOPPINGMALLNAME	THE MALL
LEWISHAM SHOPPING CENTRE	SHOPPINGMALLNAME	LEWISHAM CENTRE
ILAC CENTRE	SHOPPINGMALLNAME	ILAC CENTRE
WESTFIELD AIRPORT WEST	SHOPPINGMALLNAME	WESTFIELD AIRPORT WEST
GREEN TREE MALL	SHOPPINGMALLNAME	GREEN TREE MALL
JEFFERSON MALL	SHOPPINGMALLNAME	JEFFERSON MALL
GREENSPOINT MALL	SHOPPINGMALLNAME	GREENSPOINT MALL
OAK PARK MALL	SHOPPINGMALLNAME	OAK PARK MALL
TRINOMA	SHOPPINGMALLNAME	TRINOMA
UNIVERSITY MALL	SHOPPINGMALLNAME	UNIVERSITY MALL
PARK CITY CENTER	SHOPPINGMALLNAME	PARK CITY CENTER
SPRINGFIELD MALL	SHOPPINGMALLNAME	SPRINGFIELD MALL
BROADWAY MALL	SHOPPINGMALLNAME	BROADWAY MALL
NORTHRIDGE FASHION CENTER	SHOPPINGMALLNAME	NORTHRIDGE FASHION CENTER
COLUMBIANA CENTRE	SHOPPINGMALLNAME	COLUMBIANA CENTRE
OSHAWA CENTRE	SHOPPINGMALLNAME	OSHAWA CENTRE
THE MALL AT SIERRA VISTA	SHOPPINGMALLNAME	THE MALL AT SIERRA VISTA
EASTGATE MALL	SHOPPINGMALLNAME	EASTGATE MALL
GALLERY AT SOUTH DEKALB	SHOPPINGMALLNAME	THE GALLERY AT SOUTH DEKALB
OAKWOOD MALL	SHOPPINGMALLNAME	OAKWOOD MALL
PLAZA FRONTENAC	SHOPPINGMALLNAME	PLAZA FRONTENAC
EASTWOOD MALL	SHOPPINGMALLNAME	EASTWOOD MALL
BRUNSWICK SQUARE	SHOPPINGMALLNAME	BRUNSWICK SQUARE
INDIAN MALL	SHOPPINGMALLNAME	INDIAN MALL
PARADISE PARK	SHOPPINGMALLNAME	PARADISE PARK
PARADISE PARK	SHOPPINGMALLNAME	200
ALBERNI MALL	SHOPPINGMALLNAME	ALBERNI MALL
UNION MALL	SHOPPINGMALLNAME	UNION MALL
SAN JACINTO MALL	SHOPPINGMALLNAME	SAN JACINTO MALL
MARKET VILLAGE	SHOPPINGMALLNAME	MARKET VILLAGE
FRENCHGATE CENTRE	SHOPPINGMALLNAME	FRENCHGATE CENTRE
TRIANGLE TOWN CENTER	SHOPPINGMALLNAME	TRIANGLE TOWN CENTER
FORD CITY MALL	SHOPPINGMALLNAME	FORD CITY MALL
BURLINGTON MALL	SHOPPINGMALLNAME	BURLINGTON MALL
COLONNADES SHOPPING CENTRE	SHOPPINGMALLNAME	COLONNADES SHOPPING CENTRE
THE COMMONS AT FEDERAL WAY	SHOPPINGMALLNAME	THE COMMONS AT FEDERAL WAY
THE ESPLANADE	SHOPPINGMALLNAME	THE ESPLANADE
CARY TOWNE CENTER	SHOPPINGMALLNAME	CARY TOWNE CENTER
SILVERBURN CENTRE	SHOPPINGMALLNAME	SILVERBURN
SOUTHLAND CENTER	SHOPPINGMALLNAME	SOUTHLAND CENTER
NORTHRIDGE MALL	SHOPPINGMALLNAME	NORTHRIDGE MALL
TYSONS GALLERIA	SHOPPINGMALLNAME	TYSONS GALLERIA
VALLEY VIEW MALL	SHOPPINGMALLNAME	VALLEY VIEW MALL
REGENCY MALL	SHOPPINGMALLNAME	REGENCY MALL
BAYSHORE TOWN CENTER	SHOPPINGMALLNAME	BAYSHORE TOWN CENTER
MALL AT GREEN HILLS	SHOPPINGMALLNAME	THE MALL AT GREEN HILLS
NORTHTOWN MALL	SHOPPINGMALLNAME	NORTHTOWN MALL
NORTHTOWN MALL	SHOPPINGMALLNAME	NORTHTOWN MALL
THE GLEN SHOPPING CENTRE	SHOPPINGMALLNAME	THE GLEN SHOPPING CENTRE
GOLDEN RESOURCES MALL	SHOPPINGMALLNAME	GOLDEN RESOURCES MALL
LAKEWOOD CROSSING	SHOPPINGMALLNAME	LAKEWOOD CROSSING MALL
EVERETT MALL	SHOPPINGMALLNAME	EVERETT MALL
ALDERWOOD MALL	SHOPPINGMALLNAME	ALDERWOOD
CORAL SQUARE	SHOPPINGMALLNAME	CORAL SQUARE
STONES RIVER MALL	SHOPPINGMALLNAME	STONES RIVER MALL
LETHBRIDGE CENTRE	SHOPPINGMALLNAME	LETHBRIDGE CENTRE
WATERGARDENS TOWN CENTRE	SHOPPINGMALLNAME	WATERGARDENS TOWN CENTRE
WESTFIELD GARDEN CITY	SHOPPINGMALLNAME	WESTFIELD GARDEN CITY
PALMS SHOPPING MALL	SHOPPINGMALLNAME	THE PALMS SHOPPING MALL
MOORESTOWN MALL	SHOPPINGMALLNAME	MOORESTOWN MALL
BELVIDERE DISCOUNT MALL	SHOPPINGMALLNAME	BELVIDERE DISCOUNT MALL
NEW SUDBURY CENTRE	SHOPPINGMALLNAME	NEW SUDBURY CENTRE
STATION MALL	SHOPPINGMALLNAME	STATION MALL
WEST OAKS MALL	SHOPPINGMALLNAME	WEST OAKS MALL
WISMA ATRIA	SHOPPINGMALLNAME	WISMA ATRIA
THE MALL AT 163RD STREET	SHOPPINGMALLNAME	THE MALL AT 163RD STREET
HOLIDAY VILLAGE MALL	SHOPPINGMALLNAME	HOLIDAY VILLAGE MALL
WEST OAKS MALL	SHOPPINGMALLNAME	WEST OAKS MALL
AMIGOLAND MALL	SHOPPINGMALLNAME	BROWNSVILLE ITEC CENTER
SHINGLE CREEK CROSSING	SHOPPINGMALLNAME	BROOKDALE CENTER
CITY CREEK CENTER	SHOPPINGMALLNAME	CITY CREEK CENTER
NORTH ROCKS SHOPPING CENTRE	SHOPPINGMALLNAME	NORTH ROCKS SHOPPING CENTRE
ALEXANDRIA MALL	SHOPPINGMALLNAME	ALEXANDRIA MALL
CHAPEL HILLS MALL	SHOPPINGMALLNAME	CHAPEL HILLS MALL
WESTFIELD RICCARTON	SHOPPINGMALLNAME	WESTFIELD RICCARTON
EASTERN SHORE CENTRE	SHOPPINGMALLNAME	EASTERN SHORE CENTRE
EASTLAND MALL	SHOPPINGMALLNAME	EASTLAND MALL
OAKLAND MALL	SHOPPINGMALLNAME	OAKLAND MALL
PALMER PARK MALL	SHOPPINGMALLNAME	PALMER PARK MALL
THE MAINE MALL	SHOPPINGMALLNAME	THE MAINE MALL
CUMBERLAND MALL	SHOPPINGMALLNAME	CUMBERLAND MALL
BURLINGTON CENTER MALL	SHOPPINGMALLNAME	BURLINGTON CENTER MALL
EASTRIDGE MALL	SHOPPINGMALLNAME	EASTRIDGE MALL
WHITEFRIARS SHOPPING CENTRE	SHOPPINGMALLNAME	WHITEFRIARS SHOPPING CENTRE
GOLDEN TRIANGLE MALL	SHOPPINGMALLNAME	GOLDEN TRIANGLE MALL
WESTWOOD MALL	SHOPPINGMALLNAME	WESTWOOD MALL
MAYFLOWER MALL	SHOPPINGMALLNAME	MAYFLOWER MALL
HARLEQUIN SHOPPING CENTRE	SHOPPINGMALLNAME	HARLEQUIN SHOPPING CENTRE
BOYNTON BEACH MALL	SHOPPINGMALLNAME	BOYNTON BEACH MALL
SUNRISE MALL	SHOPPINGMALLNAME	SUNRISE MALL
TIONG BAHRU PLAZA	SHOPPINGMALLNAME	TIONG BAHRU PLAZA
CENTURY SQUARE	SHOPPINGMALLNAME	CENTURY SQUARE
CENTURY SQUARE	SHOPPINGMALLNAME	世纪广场
WESTFIELD MANUKAU CITY	SHOPPINGMALLNAME	WESTFIELD MANUKAU CITY
LIANG COURT	SHOPPINGMALLNAME	LIANG COURT
THE MALL AT WHITNEY FIELD	SHOPPINGMALLNAME	MALL AT WHITNEY FIELD
EASTON TOWN CENTER	SHOPPINGMALLNAME	EASTON TOWN CENTER
STONEBRIAR CENTRE	SHOPPINGMALLNAME	STONEBRIAR CENTRE
MIRAMAR SHOPPING CENTRE	SHOPPINGMALLNAME	MIRA MALL
MIRAMAR SHOPPING CENTRE	SHOPPINGMALLNAME	美麗華商場
THE SHOPS AT MISSION VIEJO	SHOPPINGMALLNAME	THE SHOPS AT MISSION VIEJO
NORTH INDUSTRIAL, SASKATOON	SHOPPINGMALLNAME	RIVER CITY CENTRE MALL
THE MERCAT SHOPPING CENTRE	SHOPPINGMALLNAME	THE MERCAT SHOPPING CENTRE
GALERIA KAZIMIERZ	SHOPPINGMALLNAME	GALERIA KAZIMIERZ
WELLGATE CENTRE	SHOPPINGMALLNAME	THE WELLGATE SHOPPING CENTRE
THISTLES CENTRE	SHOPPINGMALLNAME	THE THISTLES SHOPPING CENTRE
EASTGATE SHOPPING CENTRE	SHOPPINGMALLNAME	EASTGATE SHOPPING CENTRE
THE OAKS MALL	SHOPPINGMALLNAME	OAKS MALL
NORTHCOTE SHOPPING PLAZA	SHOPPINGMALLNAME	NORTHCOTE SHOPPING PLAZA
KINGSGATE CENTRE	SHOPPINGMALLNAME	KINGSGATE SHOPPING CENTRE
GLASGOW FORT	SHOPPINGMALLNAME	GLASGOW FORT SHOPPING CENTRE
LYNNHAVEN MALL	SHOPPINGMALLNAME	LYNNHAVEN MALL
WHITE FLINT MALL	SHOPPINGMALLNAME	WHITE FLINT MALL
THE OUTLET COLLECTION AT RIVERWALK	SHOPPINGMALLNAME	THE OUTLET COLLECTION AT RIVERWALK
SENECA MALL	SHOPPINGMALLNAME	SENECA MALL
AMK HUB	SHOPPINGMALLNAME	AMK HUB
JANTZEN BEACH CENTER	SHOPPINGMALLNAME	JANTZEN BEACH CENTER
THE QUAD ST. CHARLES	SHOPPINGMALLNAME	THE QUAD ST. CHARLES
GALLERIA SHOPPING CENTRE	SHOPPINGMALLNAME	GALLERIA SHOPPING CENTRE
WESTFIELD WEST LAKES	SHOPPINGMALLNAME	WESTFIELD WEST LAKES
CONFEDERATION MALL	SHOPPINGMALLNAME	CONFEDERATION MALL
THE MALL AT LAWSON HEIGHTS	SHOPPINGMALLNAME	THE MALL AT LAWSON HEIGHTS
GOLF MILL SHOPPING CENTER	SHOPPINGMALLNAME	GOLF MILL SHOPPING CENTER
QUAIL SPRINGS MALL	SHOPPINGMALLNAME	QUAIL SPRINGS MALL
RUNCORN SHOPPING CENTRE	SHOPPINGMALLNAME	RUNCORN SHOPPING CENTRE
SORYA SHOPPING CENTER	SHOPPINGMALLNAME	SORYA SHOPPING CENTER
DIAMOND PLAZA	SHOPPINGMALLNAME	DIAMOND PLAZA
WESTFIELD MONTGOMERY	SHOPPINGMALLNAME	WESTFIELD MONTGOMERY
IRVING MALL	SHOPPINGMALLNAME	IRVING MALL
THE CROSSINGS AT NORTHWEST	SHOPPINGMALLNAME	THE CROSSINGS AT NORTHWEST
CHRISTIANA MALL	SHOPPINGMALLNAME	CHRISTIANA MALL
BAYSIDE MARKETPLACE	SHOPPINGMALLNAME	BAYSIDE MARKETPLACE
RICHLAND MALL	SHOPPINGMALLNAME	RICHLAND MALL
WESTFIELD SUNRISE	SHOPPINGMALLNAME	WESTFIELD SUNRISE
HARLEM IRVING PLAZA	SHOPPINGMALLNAME	HARLEM IRVING PLAZA
THE PEAK GALLERIA	SHOPPINGMALLNAME	THE PEAK GALLERIA
SCOTIA CENTRE	SHOPPINGMALLNAME	SCOTIA CENTRE MALL
BONANZA GIFT SHOP	SHOPPINGMALLNAME	BONANZA GIFT SHOP
LOUISIANA BOARDWALK	SHOPPINGMALLNAME	LOUISIANA BOARDWALK
FLATIRON CROSSING	SHOPPINGMALLNAME	FLATIRON CROSSING
HOUGANG MALL	SHOPPINGMALLNAME	HOUGANG MALL
THE ESPLANADE	SHOPPINGMALLNAME	THE ESPLANADE
WHITE MOUNTAIN MALL	SHOPPINGMALLNAME	WHITE MOUNTAIN MALL
ELIZABETH SHOPPING CENTRE	SHOPPINGMALLNAME	ELIZABETH
VISTA RIDGE MALL	SHOPPINGMALLNAME	VISTA RIDGE MALL
DIXIE OUTLET MALL	SHOPPINGMALLNAME	DIXIE OUTLET MALL
THE PLAZA	SHOPPINGMALLNAME	THE PLAZA
VALLCO SHOPPING MALL	SHOPPINGMALLNAME	VALLCO SHOPPING MALL
PRINCESSHAY	SHOPPINGMALLNAME	PRINCESSHAY
LAZONA KAWASAKI PLAZA	SHOPPINGMALLNAME	LAZONA KAWASAKI PLAZA
QUARTIER DIX30	SHOPPINGMALLNAME	QUARTIER DIX30
ORCHARD PARK SHOPPING CENTRE	SHOPPINGMALLNAME	ORCHARD PARK SHOPPING CENTRE
VILLAGE GREEN CENTRE	SHOPPINGMALLNAME	VILLAGE GREEN CENTRE
WEST MALL	SHOPPINGMALLNAME	WEST MALL
COTTONWOOD MALL	SHOPPINGMALLNAME	COTTONWOOD MALL
CASUARINA SQUARE	SHOPPINGMALLNAME	CASUARINA SQUARE
CAUDAN WATERFRONT	SHOPPINGMALLNAME	LE CAUDAN WATERFRONT
POLUS CITY CENTER	SHOPPINGMALLNAME	POLUS CITY CENTER
ACADIANA MALL	SHOPPINGMALLNAME	ACADIANA MALL
YUBA SUTTER MALL	SHOPPINGMALLNAME	YUBA SUTTER MALL
LAKESIDE SHOPPING CENTER	SHOPPINGMALLNAME	LAKESIDE SHOPPING CENTER
PACIFIC PLACE	SHOPPINGMALLNAME	PACIFIC PLACE
AUGUSTA MALL	SHOPPINGMALLNAME	AUGUSTA MALL
CAMBRIDGE CENTRE	SHOPPINGMALLNAME	CAMBRIDGE CENTRE
TOWN CENTER AT CORTE MADERA	SHOPPINGMALLNAME	TOWN CENTER CORTE MADERA
THE ARSENAL PROJECT OF WATERTOWN	SHOPPINGMALLNAME	THE ARSENAL PROJECT OF WATERTOWN
ANTIOCH CROSSING	SHOPPINGMALLNAME	ANTIOCH CENTER
STEPHEN'S GREEN SHOPPING CENTRE	SHOPPINGMALLNAME	STEPHEN'S GREEN SHOPPING CENTRE
LLOYD D. JACKSON SQUARE	SHOPPINGMALLNAME	LLOYD D. JACKSON SQUARE
OMNI PARK	SHOPPINGMALLNAME	OMNI PARK SHOPPING AND LEISURE
KENWOOD TOWNE CENTRE	SHOPPINGMALLNAME	KENWOOD TOWNE CENTRE
GREENWOOD PARK MALL	SHOPPINGMALLNAME	GREENWOOD PARK MALL
MALL DEL NORTE	SHOPPINGMALLNAME	MALL DEL NORTE
THE PARAGON, SINGAPORE	SHOPPINGMALLNAME	PARAGON
WEST HOLLYWOOD GATEWAY PROJECT	SHOPPINGMALLNAME	WEST HOLLYWOOD GATEWAY
PRESTON CROSSING	SHOPPINGMALLNAME	PRESTON CROSSING
ENTERPRISE SQUARE FIVE	SHOPPINGMALLNAME	MEGABOX
WESTFIELD ALBANY	SHOPPINGMALLNAME	WESTFIELD ALBANY
COLLIN CREEK MALL	SHOPPINGMALLNAME	COLLIN CREEK MALL
WEST TOWN MALL	SHOPPINGMALLNAME	WEST TOWN MALL
KINGSPORT TOWN CENTER	SHOPPINGMALLNAME	KINGSPORT TOWN CENTER
KNOXVILLE CENTER	SHOPPINGMALLNAME	KNOXVILLE CENTER
OAK RIDGE CITY CENTER	SHOPPINGMALLNAME	OAK RIDGE CITY CENTER
THE PROMENADE IN TEMECULA	SHOPPINGMALLNAME	THE PROMENADE IN TEMECULA
BAYSIDE SHOPPING CENTRE	SHOPPINGMALLNAME	BAYSIDE SHOPPING CENTRE
MEADOWS MALL	SHOPPINGMALLNAME	MEADOWS MALL
EASTLAND MALL	SHOPPINGMALLNAME	NORTH VERSAILLES' EASTLAND MALL
CHARLES TOWNE SQUARE	SHOPPINGMALLNAME	CHARLES TOWNE SQUARE
PARKWAY PLACE	SHOPPINGMALLNAME	PARKWAY PLACE
HOWARD CENTRE	SHOPPINGMALLNAME	HOWARD CENTRE
PRASADS IMAX	SHOPPINGMALLNAME	PRASADS IMAX ప్రసాద్స్ ఐమాక్స్
BAYBROOK MALL	SHOPPINGMALLNAME	BAYBROOK MALL
STONESTOWN GALLERIA	SHOPPINGMALLNAME	STONESTOWN GALLERIA
KLUUVI SHOPPING CENTRE	SHOPPINGMALLNAME	KLUUVI
THE WOODLANDS MALL	SHOPPINGMALLNAME	THE WOODLANDS MALL
BALDWIN HILLS CRENSHAW PLAZA	SHOPPINGMALLNAME	BALDWIN HILLS CRENSHAW PLAZA
WONDERLAND VILLAGE	SHOPPINGMALLNAME	WONDERLAND VILLAGE
THE STREETS OF WOODFIELD	SHOPPINGMALLNAME	THE STREETS OF WOODFIELD
NOVENA SQUARE	SHOPPINGMALLNAME	NOVENA SQUARE
WHITE SANDS SHOPPING CENTRE	SHOPPINGMALLNAME	WHITE SANDS
FORUM THE SHOPPING MALL	SHOPPINGMALLNAME	FORUM THE SHOPPING MALL
WAVERLEY GARDENS SHOPPING CENTRE	SHOPPINGMALLNAME	WAVERLEY GARDENS SHOPPING CENTRE
NORTH TOWNE SQUARE	SHOPPINGMALLNAME	NORTH TOWNE SQUARE
BIRSTALL SHOPPING PARK	SHOPPINGMALLNAME	BIRSTALL SHOPPING PARK
COURTYARD SHOPPING CENTRE	SHOPPINGMALLNAME	250
WATERSIDE SHOPS	SHOPPINGMALLNAME	WATERSIDE SHOPS
STOCKLAND TOORONGA	SHOPPINGMALLNAME	STOCKLAND TOORONGA
WALT WHITMAN SHOPS	SHOPPINGMALLNAME	WALT WHITMAN SHOPS
LEGENDS OUTLETS KANSAS CITY	SHOPPINGMALLNAME	LEGENDS OUTLETS KANSAS CITY
PARK CENTER SOFIA	SHOPPINGMALLNAME	PARK CENTER SOFIA
CHAMPLAIN MALL	SHOPPINGMALLNAME	CHAMPLAIN MALL
SM CITY BICUTAN	SHOPPINGMALLNAME	SM CITY BICUTAN
SOUTHLAKE TOWN SQUARE	SHOPPINGMALLNAME	SOUTHLAKE TOWN SQUARE
MALL AT JOHNSON CITY	SHOPPINGMALLNAME	THE MALL AT JOHNSON CITY
MILL WOODS TOWN CENTRE	SHOPPINGMALLNAME	MILL WOODS TOWN CENTRE
WASHINGTON SQUARE	SHOPPINGMALLNAME	WASHINGTON SQUARE MALL
INDEPENDENCE MALL	SHOPPINGMALLNAME	INDEPENDENCE MALL
CORONADO CENTER	SHOPPINGMALLNAME	CORONADO CENTER
SOUTHLAND MALL	SHOPPINGMALLNAME	SOUTHLAND MALL
PLACE VERTU	SHOPPINGMALLNAME	PLACE VERTU
JARDINS DORVAL	SHOPPINGMALLNAME	LES JARDINS DORVAL
LOT 10	SHOPPINGMALLNAME	LOT 10
WOODLAND HILLS MALL	SHOPPINGMALLNAME	WOODLAND HILLS MALL
PARABANKS SHOPPING CENTRE	SHOPPINGMALLNAME	PARABANKS SHOPPING CENTRE
PERIMETER MALL	SHOPPINGMALLNAME	PERIMETER MALL
MALL AT STONECREST	SHOPPINGMALLNAME	MALL AT STONECREST
SPLENDID CHINA MALL	SHOPPINGMALLNAME	SPLENDID CHINA MALL
WINDSOR PARK MALL	SHOPPINGMALLNAME	WINDSOR PARK MALL
GALERíAS PACíFICO	SHOPPINGMALLNAME	GALERíAS PACíFICO
FOOTHILLS MALL	SHOPPINGMALLNAME	FOOTHILLS MALL
WESTLAKE SHOPPING CENTER	SHOPPINGMALLNAME	WESTLAKE SHOPPING CENTER
THE MALL WOOD GREEN	SHOPPINGMALLNAME	THE MALL WOOD GREEN
THE MARKETPLACE AT STEAMTOWN	SHOPPINGMALLNAME	THE MARKETPLACE AT STEAMTOWN
VIRGINIA CENTER COMMONS	SHOPPINGMALLNAME	VIRGINIA CENTER COMMONS
NORTH SHORE SQUARE	SHOPPINGMALLNAME	NORTH SHORE SQUARE
MALL 205	SHOPPINGMALLNAME	MALL 205
PAVILION KUALA LUMPUR	SHOPPINGMALLNAME	PAVILION KL
KALčA	SHOPPINGMALLNAME	KALčA
PLYMOUTH MEETING MALL	SHOPPINGMALLNAME	PLYMOUTH MEETING MALL
PLACE GREENFIELD PARK	SHOPPINGMALLNAME	PLACE GREENFIELD PARK
HAYWOOD MALL	SHOPPINGMALLNAME	HAYWOOD MALL
PLACE LONGUEUIL	SHOPPINGMALLNAME	PLACE LONGUEUIL
HAZELDEAN MALL	SHOPPINGMALLNAME	HAZELDEAN MALL
ROUSE HILL TOWN CENTRE	SHOPPINGMALLNAME	ROUSE HILL TOWN CENTRE
ROSEDALE CENTER	SHOPPINGMALLNAME	ROSEDALE CENTER
BRUNSWICK SHOPPING CENTRE	SHOPPINGMALLNAME	BRUNSWICK SHOPPING CENTRE
MINDPRO CITIMALL	SHOPPINGMALLNAME	MINDPRO CITIMALL
HALIFAX SHOPPING CENTRE	SHOPPINGMALLNAME	HALIFAX SHOPPING CENTRE
ST STEPHEN'S HULL	SHOPPINGMALLNAME	ST STEPHEN'S
RIVER ROADS MALL	SHOPPINGMALLNAME	RIVER ROADS MALL
UPPER CANADA MALL	SHOPPINGMALLNAME	UPPER CANADA MALL
EASTLAND CENTER	SHOPPINGMALLNAME	EASTLAND CENTER
MACOMB MALL	SHOPPINGMALLNAME	MACOMB MALL
WESTGATE CENTER	SHOPPINGMALLNAME	WESTGATE CENTER
GLENDALE GALLERIA	SHOPPINGMALLNAME	GLENDALE GALLERIA
DOLPHIN MALL	SHOPPINGMALLNAME	DOLPHIN MALL
JERVIS SHOPPING CENTRE	SHOPPINGMALLNAME	JERVIS SHOPPING CENTRE
VALLEY MALL	SHOPPINGMALLNAME	VALLEY MALL
MERMAID QUAY	SHOPPINGMALLNAME	MERMAID QUAY
WESTFIELD PLENTY VALLEY	SHOPPINGMALLNAME	WESTFIELD PLENTY VALLEY
SOUTHLAKE MALL	SHOPPINGMALLNAME	SOUTHLAKE MALL
SUNWAY CARNIVAL MALL	SHOPPINGMALLNAME	SUNWAY CARNIVAL MALL
RIVER DRIVE MALL	SHOPPINGMALLNAME	RIVER DRIVE MALL
RIVER DRIVE MALL	SHOPPINGMALLNAME	THE OUTLET SHOPPES AT LAREDO
PLAZA MAYOR	SHOPPINGMALLNAME	PLAZA MAYOR AT THE CROSSROADS
50 PENN PLACE	SHOPPINGMALLNAME	50
FORT KINNAIRD	SHOPPINGMALLNAME	FORT KINNAIRD
FAYETTE MALL	SHOPPINGMALLNAME	FAYETTE MALL
TURFLAND MALL	SHOPPINGMALLNAME	TURFLAND MALL
COLLEGE MALL	SHOPPINGMALLNAME	COLLEGE MALL
GREENSBOROUGH PLAZA	SHOPPINGMALLNAME	GREENSBOROUGH PLAZA
UNI HILL FACTORY OUTLETS	SHOPPINGMALLNAME	UNI HILL FACTORY OUTLETS
GREENBRIAR MALL	SHOPPINGMALLNAME	GREENBRIAR MALL
SHERWOOD PARK MALL	SHOPPINGMALLNAME	SHERWOOD PARK MALL
BROUGHTON SHOPPING PARK	SHOPPINGMALLNAME	BROUGHTON
POST OAK MALL	SHOPPINGMALLNAME	POST OAK MALL
NORTHGATE CENTRE	SHOPPINGMALLNAME	NORTHGATE CENTRE
CAROLINA CIRCLE MALL	SHOPPINGMALLNAME	CAROLINA CIRCLE MALL
WARRAWONG PLAZA	SHOPPINGMALLNAME	WARRAWONG PLAZA
FIGTREE GROVE	SHOPPINGMALLNAME	FIGTREE GROVE
PAKURANGA PLAZA	SHOPPINGMALLNAME	PAKURANGA PLAZA
DOWNTOWN SHOPPING CENTRE	SHOPPINGMALLNAME	DOWNTOWN SHOPPING CENTRE
CONCORD MALL	SHOPPINGMALLNAME	CONCORD MALL
WAITAKERE MEGA CENTRE	SHOPPINGMALLNAME	WAITAKERE MEGA CENTRE
THE GREAT MALL OF THE GREAT PLAINS	SHOPPINGMALLNAME	THE GREAT MALL OF THE GREAT PLAINS
BRISTOL MALL	SHOPPINGMALLNAME	BRISTOL MALL
SM CITY STA. MESA	SHOPPINGMALLNAME	SM CITY STA. MESA
DREAM MALL	SHOPPINGMALLNAME	DREAM MALL
DREAM MALL	SHOPPINGMALLNAME	夢時代購物中心
RIVERGATE MALL	SHOPPINGMALLNAME	RIVERGATE MALL
CLARKE QUAY CENTRAL	SHOPPINGMALLNAME	CLARKE QUAY CENTRAL
SUNLAND PARK MALL	SHOPPINGMALLNAME	SUNLAND PARK MALL
CIELO VISTA MALL	SHOPPINGMALLNAME	CIELO VISTA MALL
SWANSEA MALL	SHOPPINGMALLNAME	SWANSEA MALL
TWELVE MILE CROSSING AT FOUNTAIN WALK	SHOPPINGMALLNAME	TWELVE MILE CROSSING AT FOUNTAIN WALK
STONE ROAD MALL	SHOPPINGMALLNAME	STONE ROAD MALL
BRIGHTON MALL	SHOPPINGMALLNAME	BRIGHTON MALL
THE VERGE	SHOPPINGMALLNAME	THE VERGE
EASTGATE MALL	SHOPPINGMALLNAME	EASTGATE MALL
VICTORIA SQUARE SHOPPING CENTRE	SHOPPINGMALLNAME	VICTORIA SQUARE
UNION STATION	SHOPPINGMALLNAME	UNION STATION MALL
SHOPPES AT KNOLLWOOD	SHOPPINGMALLNAME	SHOPPES AT KNOLLWOOD
MAPLEWOOD MALL	SHOPPINGMALLNAME	MAPLEWOOD MALL
BăNEASA SHOPPING CITY	SHOPPINGMALLNAME	BANEASA SHOPPING CITY
AFI PALACE COTROCENI	SHOPPINGMALLNAME	AFI PALACE COTROCENI
CITY MALL, ROMANIA	SHOPPINGMALLNAME	CITY MALL
MOUNDS MALL	SHOPPINGMALLNAME	MOUNDS MALL
GLENBROOK SQUARE	SHOPPINGMALLNAME	GLENBROOK SQUARE
ORLANDO INTERNATIONAL PREMIUM OUTLETS	SHOPPINGMALLNAME	ORLANDO INTERNATIONAL PREMIUM OUTLETS
SHANGRI-LA PLAZA	SHOPPINGMALLNAME	SHANGRI-LA PLAZA
OCEAN WALK SHOPPES	SHOPPINGMALLNAME	OCEAN WALK SHOPPES
SOUTHWEST PLAZA	SHOPPINGMALLNAME	SOUTHWEST PLAZA
LAKESHORE MALL	SHOPPINGMALLNAME	LAKESHORE MALL
CASTLE PLAZA	SHOPPINGMALLNAME	CASTLE PLAZA
WESTGATE MALL	SHOPPINGMALLNAME	WESTGATE MALL
BRISBANE ARCADE	SHOPPINGMALLNAME	BRISBANE ARCADE
THE SHOPS AT SUNSET PLACE	SHOPPINGMALLNAME	THE SHOPS AT SUNSET PLACE
SM CITY BAGUIO	SHOPPINGMALLNAME	SM CITY BAGUIO
CROSSROADS MALL	SHOPPINGMALLNAME	CROSSROADS MALL OMAHA
ASHTON ARCADES	SHOPPINGMALLNAME	ASHTON ARCADES
AMERICANA AT BRAND	SHOPPINGMALLNAME	THE AMERICANA AT BRAND
SM CITY SAN LAZARO	SHOPPINGMALLNAME	SM CITY SAN LAZARO
SM SOUTHMALL	SHOPPINGMALLNAME	SM SOUTHMALL
CEDAR HILLS CROSSING	SHOPPINGMALLNAME	CEDAR HILLS CROSSING
QUEENSGATE SHOPPING CENTRE, NEW ZEALAND	SHOPPINGMALLNAME	QUEENSGATE SHOPPING CENTRE
MANUKAU SUPA CENTA	SHOPPINGMALLNAME	MANUKAU SUPA CENTA
THE MALL LUTON	SHOPPINGMALLNAME	THE MALL LUTON
GREAT EASTERN TOWER	SHOPPINGMALLNAME	GREAT EASTERN MALL
SECURITY SQUARE MALL	SHOPPINGMALLNAME	SECURITY SQUARE MALL
THE ASHLEY CENTRE	SHOPPINGMALLNAME	THE ASHLEY CENTRE
OWINGS MILLS MALL	SHOPPINGMALLNAME	OWINGS MILLS MALL
FREMLIN WALK	SHOPPINGMALLNAME	FREMLIN WALK
EDEN, HIGH WYCOMBE	SHOPPINGMALLNAME	EDEN
AUGUSTA EXCHANGE	SHOPPINGMALLNAME	AUGUSTA EXCHANGE
COLLEGE SQUARE MALL	SHOPPINGMALLNAME	COLLEGE SQUARE MALL
BELLEVUE CENTER	SHOPPINGMALLNAME	BELLEVUE CENTER
CARRIAGE CROSSING	SHOPPINGMALLNAME	CARRIAGE CROSSING
WOLFCHASE GALLERIA	SHOPPINGMALLNAME	WOLFCHASE GALLERIA
SHOPS OF SADDLE CREEK	SHOPPINGMALLNAME	SHOPS OF SADDLE CREEK
SOUTHLAND MALL	SHOPPINGMALLNAME	SOUTHLAND MALL
SOUTHAVEN TOWNE CENTER	SHOPPINGMALLNAME	SOUTHAVEN TOWNE CENTER
OAK COURT MALL	SHOPPINGMALLNAME	OAK COURT MALL
LAUREL SHOPPING CENTER	SHOPPINGMALLNAME	LAUREL SHOPPING CENTER
SUN PLAZA	SHOPPINGMALLNAME	SUN PLAZA
LETTERKENNY RETAIL PARKS	SHOPPINGMALLNAME	LETTERKENNY RETAIL PARKS
THE SHOPPES AT BEL AIR	SHOPPINGMALLNAME	THE SHOPPES AT BEL AIR
PARK LANE	SHOPPINGMALLNAME	PARK LANE
BAREFOOT LANDING	SHOPPINGMALLNAME	BAREFOOT LANDING
BRIDGE STREET TOWN CENTRE	SHOPPINGMALLNAME	BRIDGE STREET TOWN CENTRE
MANZANA DE GóMEZ	SHOPPINGMALLNAME	MANZANA DE GOMEZ
EAGLES MEADOW	SHOPPINGMALLNAME	EAGLES MEADOW SHOPPING CENTRE
MARLANDS SHOPPING CENTRE	SHOPPINGMALLNAME	MARLANDS SHOPPING CENTRE
PATRIOT PLACE	SHOPPINGMALLNAME	PATRIOT PLACE
DARWIN SHOPPING CENTRE	SHOPPINGMALLNAME	DARWIN SHOPPING CENTRE
VICTORIA GATE	SHOPPINGMALLNAME	VICTORIA GATE
STAUNTON MALL	SHOPPINGMALLNAME	STAUNTON MALL
MONTEVIDEO SHOPPING	SHOPPINGMALLNAME	MONTEVIDEO SHOPPING CENTER
SAPPORO JR TOWER	SHOPPINGMALLNAME	SAPPORO JR TOWER
PATRICK HENRY MALL	SHOPPINGMALLNAME	PATRICK HENRY MALL
SKYWEST COMMONS	SHOPPINGMALLNAME	SKYWEST COMMONS
ORCHARD CENTRAL	SHOPPINGMALLNAME	ORCHARD CENTRAL
ELEMENTS, HONG KONG	SHOPPINGMALLNAME	ELEMENTS
ELEMENTS, HONG KONG	SHOPPINGMALLNAME	圓方
IULIUS MALL CLUJ	SHOPPINGMALLNAME	IULIUS MALL CLUJ
IULIUS MALL IAșI	SHOPPINGMALLNAME	IULIUS MALL IAșI
IULIUS MALL SUCEAVA	SHOPPINGMALLNAME	IULIUS MALL SUCEAVA
IULIUS MALL TIMIșOARA	SHOPPINGMALLNAME	IULIUS MALL TIMIșOARA
SAPPORO FACTORY	SHOPPINGMALLNAME	SAPPORO FACTORY
THE OASIS CENTRE	SHOPPINGMALLNAME	THE OASIS ALTERNATIVE FASHION STORE
SM CITY TARLAC	SHOPPINGMALLNAME	SM CITY TARLAC
ANTARA POLANCO	SHOPPINGMALLNAME	ANTARA FASHION HALL
PARK PLAZA MALL	SHOPPINGMALLNAME	PARK PLAZA
SM CITY PAMPANGA	SHOPPINGMALLNAME	SM CITY PAMPANGA
SELECT CITYWALK	SHOPPINGMALLNAME	SELECT CITYWALK
GALLERIA AT SUNSET	SHOPPINGMALLNAME	GALLERIA AT SUNSET
HONEY CREEK MALL	SHOPPINGMALLNAME	HONEY CREEK MALL
NAMPA GATEWAY CENTER	SHOPPINGMALLNAME	NAMPA GATEWAY CENTER
PRINCE KUHIO PLAZA	SHOPPINGMALLNAME	PRINCE KūHIō PLAZA
SANTAN VILLAGE	SHOPPINGMALLNAME	SANTAN VILLAGE
ABERCORN WALK	SHOPPINGMALLNAME	ABERCORN WALK
EUROVEA	SHOPPINGMALLNAME	EUROVEA
CROCKER PARK	SHOPPINGMALLNAME	CROCKER PARK
OAK HOLLOW MALL	SHOPPINGMALLNAME	OAK HOLLOW MALL
MARKET GATES SHOPPING CENTRE	SHOPPINGMALLNAME	MARKET GATES SHOPPING
THE COLLECTION AT CHEVY CHASE	SHOPPINGMALLNAME	THE COLLECTION AT CHEVY CHASE
DRAKE CIRCUS SHOPPING CENTRE	SHOPPINGMALLNAME	DRAKE CIRCUS SHOPPING CENTRE
MERCATO SHOPPING MALL	SHOPPINGMALLNAME	MERCATO SHOPPING MALL
HARBOR SQUARE	SHOPPINGMALLNAME	HARBOR SQUARE
TOWN SQUARE	SHOPPINGMALLNAME	TOWN SQUARE LAS VEGAS
EASTGATE METROPLEX	SHOPPINGMALLNAME	EASTGATE METROPLEX
BIRCHWOOD MALL	SHOPPINGMALLNAME	BIRCHWOOD MALL
MALL CIPUTRA	SHOPPINGMALLNAME	MALL CIPUTRA
KAWANA SHOPPINGWORLD	SHOPPINGMALLNAME	KAWANA SHOPPINGWORLD
GOVERNOR'S SQUARE	SHOPPINGMALLNAME	GOVERNOR'S SQUARE
KINGDOM SHOPPING CENTRE	SHOPPINGMALLNAME	THE KINGDOM SHOPPING CENTRE
THE VILLAGE AT RIVERWATCH	SHOPPINGMALLNAME	THE VILLAGE AT RIVERWATCH
LAKES MALL	SHOPPINGMALLNAME	LAKES MALL
VALDOSTA MALL	SHOPPINGMALLNAME	VALDOSTA MALL
COLUMBIA MALL	SHOPPINGMALLNAME	COLUMBIA MALL
MID-CITY MALL	SHOPPINGMALLNAME	MID-CITY MALL
TOWNE EAST SQUARE	SHOPPINGMALLNAME	TOWNE EAST SQUARE
CHINATOWN SQUARE	SHOPPINGMALLNAME	CHINATOWN SQUARE
FASHION MALL	SHOPPINGMALLNAME	FASHION MALL
WESTFIELD WHEATON	SHOPPINGMALLNAME	WESTFIELD WHEATON
GATEWAY MARKETPLACE	SHOPPINGMALLNAME	GATEWAY MARKETPLACE
THE CENTRE ON BARTON	SHOPPINGMALLNAME	THE CENTRE ON BARTON
LIME RIDGE MALL	SHOPPINGMALLNAME	LIME RIDGE
PILSEN PLAZA	SHOPPINGMALLNAME	PILSEN PLAZA
CENTRE OF TALLAHASSEE	SHOPPINGMALLNAME	CENTRE OF TALLAHASSEE
ELEMENTS MALL	SHOPPINGMALLNAME	ELEMENTS MALL
SOUTHLANDS	SHOPPINGMALLNAME	SOUTHLANDS LIFESTYLE CENTER
THE PALMS SHOPPING CENTRE	SHOPPINGMALLNAME	THE PALMS SHOPPING CENTRE
YORKTOWN CENTER	SHOPPINGMALLNAME	YORKTOWN CENTER
BLUE RIDGE CROSSING	SHOPPINGMALLNAME	BLUE RIDGE CROSSING
STOCKLAND ROCKHAMPTON	SHOPPINGMALLNAME	STOCKLAND ROCKHAMPTON
CASTLE TOWERS	SHOPPINGMALLNAME	CASTLE TOWERS SHOPPING CENTRE
WARD PARKWAY CENTER	SHOPPINGMALLNAME	WARD PARKWAY CENTER
TEMPE MARKETPLACE	SHOPPINGMALLNAME	TEMPE MARKETPLACE
PARK POINT AT RIT	SHOPPINGMALLNAME	PARK POINT AT RIT
THE SHOPS ON BLUE PARKWAY	SHOPPINGMALLNAME	THE SHOPS ON BLUE PARKWAY
PLACE ROSEMèRE	SHOPPINGMALLNAME	PLACE ROSEMèRE
CARREFOUR DE L'ESTRIE	SHOPPINGMALLNAME	CARREFOUR DE L'ESTRIE
NORTHWOODS MALL	SHOPPINGMALLNAME	NORTHWOODS MALL
MOUNTAIN FARMS MALL	SHOPPINGMALLNAME	MOUNTAIN FARMS MALL
LANSING MALL	SHOPPINGMALLNAME	LANSING MALL
THE LAKES MALL	SHOPPINGMALLNAME	THE LAKES MALL
PEOPLE'S PARK CENTRE	SHOPPINGMALLNAME	PEOPLE'S PARK CENTRE
ASHLEY PLAZA MALL	SHOPPINGMALLNAME	ASHLEY LANDING
FASHION VALLEY MALL	SHOPPINGMALLNAME	FASHION VALLEY MALL
LINCOLN MALL	SHOPPINGMALLNAME	LINCOLN MALL
DUTCH SQUARE	SHOPPINGMALLNAME	DUTCH SQUARE
ST. JOHN'S SHOPPING CENTRE	SHOPPINGMALLNAME	ST JOHNS SHOPPING CENTRE
FASHION SQUARE MALL	SHOPPINGMALLNAME	FASHION SQUARE MALL
CENTRAL CHIDLOM	SHOPPINGMALLNAME	CENTRAL CHIDLOM
MONDAWMIN MALL	SHOPPINGMALLNAME	MONDAWMIN MALL
MORENO VALLEY MALL	SHOPPINGMALLNAME	MORENO VALLEY MALL
LA ENCANTADA	SHOPPINGMALLNAME	LA ENCANTADA
FAR EAST PLAZA	SHOPPINGMALLNAME	FAR EAST PLAZA
VALLEY HILLS MALL	SHOPPINGMALLNAME	VALLEY HILLS MALL
MAGIC VALLEY MALL	SHOPPINGMALLNAME	MAGIC VALLEY MALL
PENINSULA TOWN CENTER	SHOPPINGMALLNAME	PENINSULA TOWN CENTER
GATEWAY MALL	SHOPPINGMALLNAME	GATEWAY MALL
CAMERON VILLAGE	SHOPPINGMALLNAME	CAMERON VILLAGE
WESTVIEW MALL	SHOPPINGMALLNAME	WESTVIEW SHOPPING CENTER
THE SHOPPES AT GATEWAY	SHOPPINGMALLNAME	THE SHOPPES AT GATEWAY
QUEENSGATE SHOPPING CENTRE, UNITED KINGDOM	SHOPPINGMALLNAME	QUEENSGATE SHOPPING CENTRE
ARBORLAND CENTER	SHOPPINGMALLNAME	ARBORLAND CENTER
FOREST LAKE SHOPPING CENTRE	SHOPPINGMALLNAME	FOREST LAKE SHOPPING CENTRE
MONTGOMERY MALL	SHOPPINGMALLNAME	MONTGOMERY MALL
WILLOW GROVE PARK MALL	SHOPPINGMALLNAME	WILLOW GROVE PARK MALL
MEGABOX	SHOPPINGMALLNAME	MEGABOX
GREENVILLE MALL	SHOPPINGMALLNAME	GREENVILLE MALL
HEARTLAND MALL	SHOPPINGMALLNAME	HEARTLAND MALL
EDGEWOOD MALL	SHOPPINGMALLNAME	EDGEWOOD MALL
CASTLECOURT	SHOPPINGMALLNAME	CASTLECOURT
ION ORCHARD	SHOPPINGMALLNAME	ION ORCHARD
NORTHLAND MALL	SHOPPINGMALLNAME	NORTHLAND MALL
ERA SQUARE	SHOPPINGMALLNAME	ERA SQUARE
THE BELFRY	SHOPPINGMALLNAME	THE BELFRY
JACKSONVILLE LANDING	SHOPPINGMALLNAME	JACKSONVILLE LANDING
INDIAN MOUND MALL	SHOPPINGMALLNAME	INDIAN MOUND MALL
MESA RIVERVIEW	SHOPPINGMALLNAME	MESA RIVERVIEW
OVIEDO MALL	SHOPPINGMALLNAME	OVIEDO MALL
ORLANDO FASHION SQUARE	SHOPPINGMALLNAME	ORLANDO FASHION SQUARE
MASHPEE COMMONS	SHOPPINGMALLNAME	MASHPEE COMMONS
MCWHIRTERS	SHOPPINGMALLNAME	MCWHIRTERS
RIOCAN CENTRE KINGSTON	SHOPPINGMALLNAME	RIOCAN CENTRE KINGSTON
REISTERSTOWN ROAD PLAZA	SHOPPINGMALLNAME	REISTERSTOWN ROAD PLAZA
MALL OF ABILENE	SHOPPINGMALLNAME	MALL OF ABILENE
CENTRALPLAZA PINKLAO	SHOPPINGMALLNAME	CENTRALPLAZA PINKLAO
CENTRALPLAZA BANGNA	SHOPPINGMALLNAME	CENTRALPLAZA BANGNA
BROADMEADOWS SHOPPING CENTRE	SHOPPINGMALLNAME	BROADMEADOWS SHOPPING CENTRE
THE PARKS AT ARLINGTON	SHOPPINGMALLNAME	THE PARKS AT ARLINGTON
PLAZA CENTRAL	SHOPPINGMALLNAME	PLAZA CENTRAL
CITY CENTRE DEIRA	SHOPPINGMALLNAME	200
PADDOCK SHOPS	SHOPPINGMALLNAME	PADDOCK SHOPS
PROMENADE	SHOPPINGMALLNAME	PROMENADE
FORUM 303 MALL	SHOPPINGMALLNAME	FORUM 303
NORTH HILLS MALL	SHOPPINGMALLNAME	NORTH HILLS MALL
RIDGMAR MALL	SHOPPINGMALLNAME	RIDGMAR MALL
CORTANA MALL	SHOPPINGMALLNAME	CORTANA MALL
WESTFIELD TRUMBULL	SHOPPINGMALLNAME	WESTFIELD TRUMBULL
MERSEYWAY SHOPPING CENTRE	SHOPPINGMALLNAME	MERSEYWAY SHOPPING CENTRE
THE SHOPPES AT RIVER CROSSING	SHOPPINGMALLNAME	THE SHOPPES AT RIVER CROSSING
FALLBROOK CENTER	SHOPPINGMALLNAME	FALLBROOK CENTER
WEST COUNTY CENTER	SHOPPINGMALLNAME	WEST COUNTY CENTER
THE BOULEVARD MALL	SHOPPINGMALLNAME	THE BOULEVARD MALL
BARRA SHOPPING	SHOPPINGMALLNAME	BARRA SHOPPING
WEST COAST PLAZA	SHOPPINGMALLNAME	WEST COAST PLAZA
RED SEA MALL	SHOPPINGMALLNAME	RED SEA MALL
RED SEA MALL	SHOPPINGMALLNAME	ردسي مول
TOP RYDE CITY	SHOPPINGMALLNAME	TOP RYDE CITY SHOPPING CENTRE
THE FORUM AT ASHLEY PARK	SHOPPINGMALLNAME	THE FORUM AT ASHLEY PARK
PICKERING TOWN CENTRE	SHOPPINGMALLNAME	PICKERING TOWN CENTRE
SOUTH ATLANTA SHOPPING CENTRE	SHOPPINGMALLNAME	SOUTH ATLANTA SHOPPING CENTRE
MONTGOMERY PLAZA	SHOPPINGMALLNAME	MONTGOMERY PLAZA
PARKDALE MALL	SHOPPINGMALLNAME	PARKDALE MALL
PLAZA SHOPPING	SHOPPINGMALLNAME	PLAZA SHOPPING
LAWRENCE SQUARE SHOPPING CENTRE	SHOPPINGMALLNAME	LAWRENCE SQUARE SHOPPING CENTRE
THE FORGE SHOPPING CENTRE	SHOPPINGMALLNAME	THE FORGE SHOPPING CENTRE
CHENNAI CITI CENTRE	SHOPPINGMALLNAME	CHENNAI CITI CENTRE
THE MERCURY MALL	SHOPPINGMALLNAME	THE MERCURY MALL
SM CITY BACOLOD	SHOPPINGMALLNAME	SM CITY BACOLOD
MEDICINE HAT MALL	SHOPPINGMALLNAME	MEDICINE HAT MALL
BOWER PLACE	SHOPPINGMALLNAME	BOWER PLACE
TACOMA MALL	SHOPPINGMALLNAME	TACOMA MALL
NORTHPARK MALL	SHOPPINGMALLNAME	NORTHPARK MALL
BENTLEY BRIDGE	SHOPPINGMALLNAME	BENTLEY BRIDGE
METRO JUNCTION MALL	SHOPPINGMALLNAME	METRO JUNCTION MALL
LAKELAND SQUARE MALL	SHOPPINGMALLNAME	LAKELAND SQUARE MALL
LAKESIDE VILLAGE	SHOPPINGMALLNAME	LAKESIDE VILLAGE
CABOT CIRCUS	SHOPPINGMALLNAME	CABOT CIRCUS
SM CITY CEBU	SHOPPINGMALLNAME	SM CITY CEBU
AYALA CENTER CEBU	SHOPPINGMALLNAME	AYALA CENTER CEBU
SANTA MARIA TOWN CENTER	SHOPPINGMALLNAME	SANTA MARIA TOWN CENTER
ST GEORGE'S SHOPPING CENTRE	SHOPPINGMALLNAME	ST GEORGE'S SHOPPING CENTRE
THE MALL BLACKBURN	SHOPPINGMALLNAME	THE MALL BLACKBURN
FISHERGATE SHOPPING CENTRE	SHOPPINGMALLNAME	FISHERGATE SHOPPING CENTRE
SANTA FE PLACE	SHOPPINGMALLNAME	SANTA FE PLACE
COPPERGATE SHOPPING CENTRE	SHOPPINGMALLNAME	COPPERGATE SHOPPING CENTRE
GRAND CANYON	SHOPPINGMALLNAME	GRAND CANYON
GRAND CANYON	SHOPPINGMALLNAME	GRAND KANYON
SWAN COURT SHOPPING ARCADE	SHOPPINGMALLNAME	SWAN COURT SHOPPING ARCADE
TRINITY WALK	SHOPPINGMALLNAME	TRINITY WALK
AL RASHID MALL	SHOPPINGMALLNAME	AL RASHED MALL
AL RASHID MALL	SHOPPINGMALLNAME	مجمع الراشد
BUGIS+	SHOPPINGMALLNAME	BUGIS+
CAPITAL CITY MALL	SHOPPINGMALLNAME	CAPITAL CITY MALL
HARRISBURG MALL	SHOPPINGMALLNAME	HARRISBURG MALL
SILVER SPRING SQUARE	SHOPPINGMALLNAME	SILVER SPRING SQUARE
CITY CENTRE PLAZA	SHOPPINGMALLNAME	CITY CENTRE PLAZA
COLONIAL PARK MALL	SHOPPINGMALLNAME	COLONIAL PARK MALL
STOCKLAND GREEN HILLS	SHOPPINGMALLNAME	STOCKLAND GREEN HILLS
CENTRO COMERCIAL SANTAFé	SHOPPINGMALLNAME	CENTRO COMERCIAL SANTAFé
FORRESTAL VILLAGE	SHOPPINGMALLNAME	FORRESTAL VILLAGE
HIGHLAND MALL	SHOPPINGMALLNAME	HIGHLAND MALL
RALEIGH SPRINGS MALL	SHOPPINGMALLNAME	RALEIGH SPRINGS MALL
THE OUTLET COLLECTION SEATTLE	SHOPPINGMALLNAME	THE OUTLET COLLECTION SEATTLE
OAK VIEW MALL	SHOPPINGMALLNAME	OAK VIEW MALL
SUNSHINE MARKETPLACE	SHOPPINGMALLNAME	SUNSHINE MARKETPLACE
SM CITY FAIRVIEW	SHOPPINGMALLNAME	SM CITY FAIRVIEW
SM CITY MANILA	SHOPPINGMALLNAME	SM CITY MANILA
DOWNTOWN SUMMERLIN	SHOPPINGMALLNAME	DOWNTOWN SUMMERLIN
THE GALLERIA, HATFIELD	SHOPPINGMALLNAME	THE GALLERIA
SPOKANE VALLEY MALL	SHOPPINGMALLNAME	SPOKANE VALLEY MALL
THE GATES SHOPPING CENTRE	SHOPPINGMALLNAME	THE GATES SHOPPING CENTRE
HILLSIDE VILLAGE	SHOPPINGMALLNAME	HILLSIDE VILLAGE
TOWN EAST MALL	SHOPPINGMALLNAME	TOWN EAST MALL
CLARENDON SQUARE SHOPPING CENTRE	SHOPPINGMALLNAME	CLARENDON SQUARE SHOPPING CENTRE
NEWPARK MALL	SHOPPINGMALLNAME	NEWPARK MALL
COVENTRY MALL	SHOPPINGMALLNAME	COVENTRY MALL
TRILLIUM CIRCLE	SHOPPINGMALLNAME	TRILLIUM CIRCLE
RIVER PARK SQUARE	SHOPPINGMALLNAME	RIVER PARK SQUARE
SM CITY DAVAO	SHOPPINGMALLNAME	SM CITY DAVAO
HADLEY CORNER	SHOPPINGMALLNAME	HADLEY CORNER
ALI MALL	SHOPPINGMALLNAME	ALI MALL
GATEWAY MALL	SHOPPINGMALLNAME	GATEWAY MALL
SM CITY SUCAT	SHOPPINGMALLNAME	SM CITY SUCAT
ROBINSONS GALLERIA	SHOPPINGMALLNAME	ROBINSONS GALLERIA
CENTRALPLAZA RAMA II	SHOPPINGMALLNAME	CENTRALPLAZA RAMA II
CENTRALPLAZA RAMA III	SHOPPINGMALLNAME	CENTRALPLAZA RAMA 3
CENTRALPLAZA RAMINDRA	SHOPPINGMALLNAME	CENTRALPLAZA RAMINDRA
SM CITY LUCENA	SHOPPINGMALLNAME	SM CITY LUCENA
TAMPINES 1	SHOPPINGMALLNAME	TAMPINES 1
THE SHOPS AT NANUET	SHOPPINGMALLNAME	THE SHOPS AT NANUET
SM CITY MARILAO	SHOPPINGMALLNAME	SM CITY MARILAO
SM CITY TAYTAY	SHOPPINGMALLNAME	SM CITY TAYTAY
PEACHTREE MALL	SHOPPINGMALLNAME	PEACHTREE MALL
CENTERPOINT MALL	SHOPPINGMALLNAME	CENTERPOINT MALL
SM CITY CLARK	SHOPPINGMALLNAME	SM CITY CLARK
THE CURVE	SHOPPINGMALLNAME	THE CURVE
THE GROVE AT SHREWSBURY	SHOPPINGMALLNAME	THE GROVE AT SHREWSBURY
ASHLAND TOWN CENTER	SHOPPINGMALLNAME	ASHLAND TOWN CENTER
BATU PAHAT MALL	SHOPPINGMALLNAME	BATU PAHAT MALL
THE CENTRE AT SALISBURY	SHOPPINGMALLNAME	THE CENTRE AT SALISBURY
MALL AVENTURA PLAZA AREQUIPA	SHOPPINGMALLNAME	MALL AVENTURA PLAZA AREQUIPA
BELLA TERRA	SHOPPINGMALLNAME	BELLA TERRA
EAST POINT MALL	SHOPPINGMALLNAME	EASTPOINT MALL
CHARLOTTESVILLE FASHION SQUARE	SHOPPINGMALLNAME	CHARLOTTESVILLE FASHION SQUARE
PASEO REFORMA	SHOPPINGMALLNAME	PASEO REFORMA
THE PODIUM	SHOPPINGMALLNAME	THE PODIUM
ROBINSONS PLACE MANILA	SHOPPINGMALLNAME	ROBINSONS PLACE MANILA
PEMBROKE LAKES MALL	SHOPPINGMALLNAME	PEMBROKE LAKES MALL
VILLAGE OF MERRICK PARK	SHOPPINGMALLNAME	SHOPS AT MERRICK PARK
SPRINGFIELD TOWN CENTER	SHOPPINGMALLNAME	SPRINGFIELD TOWN CENTER
CENTRO COMERCIAL EL PASEO TEHUACAN	SHOPPINGMALLNAME	CENTRO COMERCIAL EL PASEO TEHUACáN
BROOKFIELD SQUARE	SHOPPINGMALLNAME	BROOKFIELD SQUARE
BEIJING APM	SHOPPINGMALLNAME	BEIJING APM
SM CITY	SHOPPINGMALLNAME	SM CITY
LA PALMERA	SHOPPINGMALLNAME	LA PALMERA CORPUS CHRISTI
SM CITY ILOILO	SHOPPINGMALLNAME	SM CITY ILOILO
DEERBROOK MALL	SHOPPINGMALLNAME	DEERBROOK MALL
EASTRIDGE	SHOPPINGMALLNAME	EASTRIDGE
HEART OF HUNTSVILLE MALL	SHOPPINGMALLNAME	HEART OF HUNTSVILLE MALL
MALL AT BARNES CROSSING	SHOPPINGMALLNAME	MALL AT BARNES CROSSING
FLORENCE MALL	SHOPPINGMALLNAME	REGENCY SQUARE MALL
NORTH GRAND MALL	SHOPPINGMALLNAME	NORTH GRAND MALL
SOUTHROADS MALL	SHOPPINGMALLNAME	SOUTHROADS MALL
SM CITY BATANGAS	SHOPPINGMALLNAME	SM CITY BATANGAS
SM CITY CAGAYAN DE ORO	SHOPPINGMALLNAME	SM CITY CAGAYAN DE ORO
CENTURY MALL	SHOPPINGMALLNAME	CENTURY MALL
SM CITY DASMARIñAS	SHOPPINGMALLNAME	SM CITY DASMARIñAS
ROOSEVELT MALL	SHOPPINGMALLNAME	ROOSEVELT MALL
AMARIN PLAZA	SHOPPINGMALLNAME	AMARIN PLAZA
AMARIN PLAZA	SHOPPINGMALLNAME	อัมรินทร์พลาซ่า
COASTLAND CENTER	SHOPPINGMALLNAME	COASTLAND CENTER
CHELTENHAM SQUARE MALL	SHOPPINGMALLNAME	CHELTENHAM MALL
LINCOLNWOOD TOWN CENTER	SHOPPINGMALLNAME	LINCOLNWOOD TOWN CENTER
NORTH RIVERSIDE PARK MALL	SHOPPINGMALLNAME	NORTH RIVERSIDE PARK MALL
BELTWAY PLAZA	SHOPPINGMALLNAME	BELTWAY PLAZA
IVERSON MALL	SHOPPINGMALLNAME	IVERSON MALL
CAPITAL PLAZA MALL	SHOPPINGMALLNAME	CAPITAL PLAZA
POTTERIES SHOPPING CENTRE	SHOPPINGMALLNAME	INTU POTTERIES
ELLSWORTH PLACE	SHOPPINGMALLNAME	ELLSWORTH PLACE
SM CITY ROSALES	SHOPPINGMALLNAME	SM CITY ROSALES
THE QUENTIN COLLECTION	SHOPPINGMALLNAME	THE QUENTIN COLLECTION
BALLSTON COMMON MALL	SHOPPINGMALLNAME	BALLSTON COMMON MALL
PORT CHARLOTTE TOWN CENTER	SHOPPINGMALLNAME	PORT CHARLOTTE TOWN CENTER
SUNNYSIDE MALL	SHOPPINGMALLNAME	SUNNY SIDE MALL
THE VILLAGE AT SANDHILL	SHOPPINGMALLNAME	VILLAGE AT SANDHILL
THE ROTUNDA	SHOPPINGMALLNAME	THE ROTUNDA
THE SHOPS AT KENILWORTH	SHOPPINGMALLNAME	THE SHOPS AT KENILWORTH
THE VILLAGE AT SHIRLINGTON	SHOPPINGMALLNAME	THE VILLAGE AT SHIRLINGTON
ROCKVILLE MALL	SHOPPINGMALLNAME	ROCKVILLE MALL
ISQUARE	SHOPPINGMALLNAME	ISQUARE
BRIDGEPORT VILLAGE	SHOPPINGMALLNAME	BRIDGEPORT VILLAGE
ROBINSONS PLACE BACOLOD	SHOPPINGMALLNAME	ROBINSONS PLACE BACOLOD
INLET SQUARE MALL	SHOPPINGMALLNAME	INLET SQUARE MALL
THE SHOPS AT NATIONAL PLACE	SHOPPINGMALLNAME	THE SHOPS AT NATIONAL PLACE
CEDARBRAE MALL	SHOPPINGMALLNAME	CEDARBRAE MALL
NORTH HILL CENTRE	SHOPPINGMALLNAME	NORTH HILL CENTRE
MALIBU COUNTRY MART	SHOPPINGMALLNAME	MALIBU COUNTRY MART
CITY NORD	SHOPPINGMALLNAME	CITY NORD
SOUTHGATE, BATH	SHOPPINGMALLNAME	SOUTHGATE BATH
MALL OF ARABIA	SHOPPINGMALLNAME	MALL OF ARABIA
MALL OF ARABIA	SHOPPINGMALLNAME	مجمع العرب
SM CITY NAGA	SHOPPINGMALLNAME	SM CITY NAGA
GREENBELT	SHOPPINGMALLNAME	GREENBELT
FARMERS PLAZA	SHOPPINGMALLNAME	FARMERS PLAZA
THE MARKETPLACE MALL	SHOPPINGMALLNAME	THE MARKETPLACE MALL
MORAYFIELD SHOPPING CENTRE	SHOPPINGMALLNAME	MORAYFIELD SHOPPING CENTRE
PIERRE BOSSIER MALL	SHOPPINGMALLNAME	PIERRE BOSSIER MALL
CAPALABA PARK SHOPPING CENTRE	SHOPPINGMALLNAME	CAPALABA PARK
TAIGUM SQUARE SHOPPING CENTRE	SHOPPINGMALLNAME	TAIGUM SQUARE SHOPPING CENTRE
CAPALABA CENTRAL SHOPPING CENTRE	SHOPPINGMALLNAME	CAPALABA CENTRAL SHOPPING CENTRE
VISALIA MALL	SHOPPINGMALLNAME	VISALIA MALL
BAYINNAUNG MARKET	SHOPPINGMALLNAME	BAYINNAUNG MARKET
CHARLESTON TOWN CENTER	SHOPPINGMALLNAME	CHARLESTON TOWN CENTER
SM CITY XIAMEN	SHOPPINGMALLNAME	SM CITY XIAMEN
SM CITY JINJIANG	SHOPPINGMALLNAME	SM JINJIANG
SM CITY CHENGDU	SHOPPINGMALLNAME	SM CHENGDU
SKYLINE MALL	SHOPPINGMALLNAME	SKYLINE MALL
PENTAGON ROW	SHOPPINGMALLNAME	PENTAGON ROW
PLACE VERSAILLES	SHOPPINGMALLNAME	PLACE VERSAILLES
COURTLAND CENTER	SHOPPINGMALLNAME	COURTLAND CENTER
SM LIFESTYLE CENTER	SHOPPINGMALLNAME	SM LIFESTYLE CENTRE
AL AIN MALL	SHOPPINGMALLNAME	AL AIN MALL
FLORENCE MALL	SHOPPINGMALLNAME	FLORENCE MALL
SM AURA PREMIER	SHOPPINGMALLNAME	SM AURA PREMIER
FASHION ISLAND	SHOPPINGMALLNAME	FASHION ISLAND
ST. FRANCIS SQUARE MALL	SHOPPINGMALLNAME	ST. FRANCIS SQUARE MALL
AGANA SHOPPING CENTER	SHOPPINGMALLNAME	AGANA SHOPPING CENTER
GUAM PREMIER OUTLETS	SHOPPINGMALLNAME	GUAM PREMIER OUTLETS
ST. LAWRENCE CENTRE	SHOPPINGMALLNAME	ST. LAWRENCE CENTRE
CARREFOUR SAINT-GEORGES	SHOPPINGMALLNAME	CARREFOUR SAINT-GEORGES
KARINGAL HUB SHOPPING CENTRE	SHOPPINGMALLNAME	KARINGAL HUB SHOPPING CENTRE
KARINGAL HUB SHOPPING CENTRE	SHOPPINGMALLNAME	STAR ZONE KARINGAL
KNIGHTS PLAZA	SHOPPINGMALLNAME	KNIGHTS PLAZA
KNIGHTS PLAZA	SHOPPINGMALLNAME	AT UNIVERSITY OF CENTRAL FLORIDA
SUNRISE MALL	SHOPPINGMALLNAME	SUNRISE MALL
CHERMAS	SHOPPINGMALLNAME	CHERMA'S
CENTURY PLAZA	SHOPPINGMALLNAME	CENTURY PLAZA
JAMUNA FUTURE PARK	SHOPPINGMALLNAME	JAMUNA FUTURE PARK
REGENCY SQUARE	SHOPPINGMALLNAME	REGENCY SQUARE
REGENCY SQUARE MALL	SHOPPINGMALLNAME	REGENCY SQUARE MALL
THE BROADWAY, BRADFORD	SHOPPINGMALLNAME	THE BROADWAY
SOUTH HILL MALL	SHOPPINGMALLNAME	SOUTH HILL MALL
DIZENGOFF CENTER	SHOPPINGMALLNAME	DIZENGOFF CENTER
WOODLANDS BOULEVARD	SHOPPINGMALLNAME	WOODLANDS BOULEVARD
SM CITY BALIWAG	SHOPPINGMALLNAME	SM CITY BALIWAG
MOTHERWELL SHOPPING CENTRE	SHOPPINGMALLNAME	MOTHERWELL SHOPPING CENTRE
ALAMANCE CROSSING	SHOPPINGMALLNAME	ALAMANCE CROSSING
MARKVILLE SHOPPING CENTRE	SHOPPINGMALLNAME	CF MARKVILLE
ROBINSONS PLACE GENERAL SANTOS	SHOPPINGMALLNAME	ROBINSONS PLACE GENERAL SANTOS
KALEIDOSCOPE AT THE HUB	SHOPPINGMALLNAME	KALEIDOSCOPE AT THE HUB
SM QUIAPO	SHOPPINGMALLNAME	SM QUIAPO
PACIFIC PLACE JAKARTA	SHOPPINGMALLNAME	PACIFIC PLACE
MADRID XANADú	SHOPPINGMALLNAME	MADRID XANADú
SETTLERS RIDGE	SHOPPINGMALLNAME	SETTLERS RIDGE
NBA STORE	SHOPPINGMALLNAME	THE NBA STORE
DEMBEL CITY CENTER	SHOPPINGMALLNAME	DEMBEL CITY CENTER
GETU COMMERCIAL CENTER	SHOPPINGMALLNAME	GETU COMMERCIAL CENTER
MARKET! MARKET!	SHOPPINGMALLNAME	MARKET! MARKET!
MARKET PLACE MALL	SHOPPINGMALLNAME	MARKET PLACE MALL
WORCESTER CENTER GALLERIA	SHOPPINGMALLNAME	WORCESTER CENTER
BROADWAY SQUARE MALL	SHOPPINGMALLNAME	BROADWAY SQUARE MALL
RIVER CITY MARKETPLACE	SHOPPINGMALLNAME	RIVER CITY MARKETPLACE
GRAND ARENA SHOPPING MALL	SHOPPINGMALLNAME	GRAND ARENA
TEL-TWELVE MALL	SHOPPINGMALLNAME	TEL-TWELVE MALL
DESERT SKY MALL	SHOPPINGMALLNAME	DESERT SKY MALL
CENTRE COMMERCIAL BAB EZZOUAR	SHOPPINGMALLNAME	CENTRE COMMERCIAL BAB EZZOUAR
CENTRE COMMERCIAL AL QODS	SHOPPINGMALLNAME	CENTRE COMMERCIAL AL QODS
THE MALL NAKHON RATCHASIMA	SHOPPINGMALLNAME	THE MALL NAKHON RATCHASIMA
PEARLAND TOWN CENTER	SHOPPINGMALLNAME	PEARLAND TOWN CENTER
CHAMBERSBURG MALL	SHOPPINGMALLNAME	CHAMBERSBURG MALL
DEERBROOK MALL	SHOPPINGMALLNAME	DEERBROOK MALL
MARYVALE MALL	SHOPPINGMALLNAME	MARYVALE MALL
PRINCE OF ORANGE MALL	SHOPPINGMALLNAME	PRINCE OF ORANGE MALL
MAGNOLIA PARK TOWN CENTER	SHOPPINGMALLNAME	MAGNOLIA PARK TOWN CENTER
REGO CENTER	SHOPPINGMALLNAME	REGO CENTER
CLEVELAND CENTRE, MIDDLESBROUGH	SHOPPINGMALLNAME	CLEVELAND CENTRE, MIDDLESBROUGH
ST JOHN'S CENTRE	SHOPPINGMALLNAME	ST JOHN'S CENTRE
HAGERSTOWN PREMIUM OUTLETS	SHOPPINGMALLNAME	HAGERSTOWN PREMIUM OUTLETS
WINNIPEG SQUARE	SHOPPINGMALLNAME	SHOPS OF WINNIPEG SQUARE
HOUNDSHILL SHOPPING CENTRE	SHOPPINGMALLNAME	HOUNDSHILL SHOPPING CENTRE
KLANG PLAZA	SHOPPINGMALLNAME	KLANG PLAZA
PLACE FLEUR DE LYS	SHOPPINGMALLNAME	PLACE FLEUR DE LYS / FLEUR DE LYS CENTRE COMMERCIAL
CORTLANDT TOWN CENTER	SHOPPINGMALLNAME	CORTLANDT TOWN CENTER
UNIVERSITY MALL	SHOPPINGMALLNAME	UNIVERSITY MALL
SOUTH MALL	SHOPPINGMALLNAME	SOUTH MALL
NORTH HILLS VILLAGE SHOPPING CENTER	SHOPPINGMALLNAME	NORTH HILLS VILLAGE SHOPPING CENTER
ROBINSONS CABANATUAN	SHOPPINGMALLNAME	ROBINSONS TOWNVILLE CABANATUAN
SOUTHLAND MALL	SHOPPINGMALLNAME	SOUTHLAND MALL
ARENA PARK SHOPPING CENTRE	SHOPPINGMALLNAME	ARENA PARK SHOPPING CENTRE
JURONG POINT SHOPPING MALL	SHOPPINGMALLNAME	JURONG POINT
AUPARK	SHOPPINGMALLNAME	AUPARK BRATISLAVA
GALERIES DE LA CAPITALE	SHOPPINGMALLNAME	GALERIES DE LA CAPITALE
MANALAPAN EPICENTRE	SHOPPINGMALLNAME	MANALAPAN EPICENTER
MANALAPAN EPICENTRE	SHOPPINGMALLNAME	MANALAPAN MALL
PLACE SAINTE-FOY	SHOPPINGMALLNAME	PLACE SAINTE-FOY
THE SHOPPES AT EASTCHASE	SHOPPINGMALLNAME	THE SHOPPES AT EASTCHASE
İSTINYE PARK	SHOPPINGMALLNAME	İSTINYE PARK
COLUMBUS PARK CROSSING	SHOPPINGMALLNAME	COLUMBUS PARK CROSSING
DENNIS SHOPPING CENTER	SHOPPINGMALLNAME	DENNIS SHOPPING CENTER
MACDONALD 80 SHOPPING CENTER	SHOPPINGMALLNAME	MACDONALD 80 SHOPPING CENTER
WHITEHALL MALL	SHOPPINGMALLNAME	WHITEHALL MALL
THE VILLAGE MARKET	SHOPPINGMALLNAME	THE VILLAGE MARKET
BAY STREET EMERYVILLE	SHOPPINGMALLNAME	BAY STREET EMERYVILLE
THE MALL OF MONROE	SHOPPINGMALLNAME	THE MALL OF MONROE
MOUCHAK MARKET	SHOPPINGMALLNAME	MOUCHAK MARKET
PHILLIPSBURG MALL	SHOPPINGMALLNAME	PHILLIPSBURG MALL
WESTGATE MALL	SHOPPINGMALLNAME	WESTGATE MALL
WINROCK CENTER	SHOPPINGMALLNAME	WINROCK SHOPPING CENTER
TERMINAL 21	SHOPPINGMALLNAME	TERMINAL 21
TERMINAL 21	SHOPPINGMALLNAME	เทอร์มินัล 21
TERMINAL 21	SHOPPINGMALLNAME	200
INTERCHANGE21	SHOPPINGMALLNAME	INTERCHANGE 21
NITTANY MALL	SHOPPINGMALLNAME	NITTANY MALL
UNION SQUARE ABERDEEN	SHOPPINGMALLNAME	UNION SQUARE
RAINBOW CENTRE FACTORY OUTLET	SHOPPINGMALLNAME	RAINBOW CENTRE FACTORY OUTLET
MOHAWK MALL	SHOPPINGMALLNAME	MOHAWK MALL
HILLCREST MALL	SHOPPINGMALLNAME	HILLCREST MALL
NORTHLAND VILLAGE MALL	SHOPPINGMALLNAME	NORTHLAND VILLAGE MALL
BRAZOS MALL	SHOPPINGMALLNAME	BRAZOS MALL
SEEF MALL	SHOPPINGMALLNAME	SEEF MALL
NORTHWAY SHOPPING CENTER	SHOPPINGMALLNAME	NORTHWAY MALL
NORTHWAY SHOPPING CENTER	SHOPPINGMALLNAME	NORTHWAY SHOPPING CENTER
MALL VARNA	SHOPPINGMALLNAME	MALL VARNA
JEMBATAN MERAH PLAZA	SHOPPINGMALLNAME	JEMBATAN MERAH PLAZA
UPPER VALLEY MALL	SHOPPINGMALLNAME	UPPER VALLEY MALL
LEDGEWOOD MALL	SHOPPINGMALLNAME	LEDGEWOOD MALL
MOHAWK COMMONS	SHOPPINGMALLNAME	MOHAWK COMMONS
PENTAGON SHOPPING CENTRE	SHOPPINGMALLNAME	PENTAGON SHOPPING CENTRE
REGENT SHOPPING CENTRE	SHOPPINGMALLNAME	REGENT SHOPPING CENTRE
PARKDALE PLAZA	SHOPPINGMALLNAME	PARKDALE SHOPPING CENTER
SARATOGA MALL	SHOPPINGMALLNAME	SARATOGA MALL
HOMESTOP	SHOPPINGMALLNAME	HOMESTOP.
STUYVESANT PLAZA	SHOPPINGMALLNAME	STUYVESANT PLAZA
LOCKPORT MALL	SHOPPINGMALLNAME	LOCKPORT MALL
QUEENSWAY SHOPPING CENTRE	SHOPPINGMALLNAME	QUEENSWAY SHOPPING CENTRE
TROPICANA CITY MALL	SHOPPINGMALLNAME	TROPICANA CITY MALL
APPLE BLOSSOM MALL	SHOPPINGMALLNAME	APPLE BLOSSOM MALL
SOUTH COUNTY CENTER	SHOPPINGMALLNAME	SOUTH COUNTY CENTER
MARQUEE MALL	SHOPPINGMALLNAME	MARQUEE MALL ANGELES
SEMINOLE TOWNE CENTER	SHOPPINGMALLNAME	SEMINOLE TOWNE CENTER
COHOES COMMONS	SHOPPINGMALLNAME	COHOES COMMONS
CASTLEPOINT SHOPPING CENTRE	SHOPPINGMALLNAME	CASTLEPOINT SHOPPING PARK
POWER PLANT MALL	SHOPPINGMALLNAME	POWER PLANT MALL
CHESAPEAKE SQUARE	SHOPPINGMALLNAME	CHESAPEAKE SQUARE
SPOTSYLVANIA TOWNE CENTRE	SHOPPINGMALLNAME	SPOTSYLVANIA TOWNE CENTRE
NAN FUNG CENTRE	SHOPPINGMALLNAME	NAN FUNG CENTRE
TSUEN WAN PLAZA	SHOPPINGMALLNAME	TSUEN WAN PLAZA
SKYLINE PLAZA	SHOPPINGMALLNAME	SKYLINE PLAZA
ROBINSONS PLACE DUMAGUETE	SHOPPINGMALLNAME	ROBINSONS PLACE DUMAGUETE
OBERON MALL	SHOPPINGMALLNAME	OBERON MALL
ZEGYO MARKET	SHOPPINGMALLNAME	ZEGYO MARKET
NASHIK CITY CENTRE MALL	SHOPPINGMALLNAME	NASHIK CITY CENTRE MALL
MCFARLAND MALL	SHOPPINGMALLNAME	MCFARLAND MALL
METROPOLITAN MALL	SHOPPINGMALLNAME	METROPOLITAN MALL
GALATASARAY BEYOğLU HASNUN GALIP VOLLEYBALL ACADEMY	SHOPPINGMALLNAME	GALATASARAY BEYOGLU HASNUN GALIP VOLLEYBALL ACADEMY
LUK YEUNG GALLERIA	SHOPPINGMALLNAME	LUK YEUNG GALLERIA
DUBAI OUTLET MALL	SHOPPINGMALLNAME	DUBAI OUTLET MALL
EAST POINT CITY	SHOPPINGMALLNAME	EAST POINT CITY
METRO CITY	SHOPPINGMALLNAME	METRO CITY
PLAZA DEL CARIBE	SHOPPINGMALLNAME	PLAZA DEL CARIBE
LULU INTERNATIONAL SHOPPING MALL	SHOPPINGMALLNAME	LULU MALL
THE ACADEMY SHOPPING CENTRE	SHOPPINGMALLNAME	THE ACADEMY ABERDEEN
CITY CENTRE MIRDIF	SHOPPINGMALLNAME	FILE:MIRDIF CITY CENTER LOGO.JPG
LIBERTY CENTER MALL	SHOPPINGMALLNAME	LIBERTY CENTER MALL
HARFORD MALL	SHOPPINGMALLNAME	HARFORD MALL
VILLAGE CENTRE BATEMANS BAY	SHOPPINGMALLNAME	VILLAGE CENTRE BATEMANS BAY
THE SHOPS AT ITHACA MALL	SHOPPINGMALLNAME	THE SHOPS AT ITHACA MALL
SM CITY ROSARIO	SHOPPINGMALLNAME	SM CITY ROSARIO
STREETS OF CHESTER	SHOPPINGMALLNAME	STREETS OF CHESTER
PAVILIONS OF TROY	SHOPPINGMALLNAME	PAVILIONS OF TROY
SHAKTAN THAMPURAN PRIVATE BUS STAND	SHOPPINGMALLNAME	SAKTHAN THAMPURAN PRIVATE BUS STAND
CHIRNSIDE PARK SHOPPING CENTRE	SHOPPINGMALLNAME	CHIRNSIDE PARK SHOPPING CENTRE
ANKAMALL	SHOPPINGMALLNAME	ANKAMALL SHOPPING CENTRE
FRANDOR SHOPPING CENTER	SHOPPINGMALLNAME	FRANDOR SHOPPING CENTER
ROCKINGHAM SHOPPING CENTRE	SHOPPINGMALLNAME	ROCKINGHAM CENTRE
VALLEY PLAZA MALL	SHOPPINGMALLNAME	VALLEY PLAZA MALL
BUTLER PLAZA	SHOPPINGMALLNAME	BUTLER PLAZA
GOLD SOUK LUDHIANA	SHOPPINGMALLNAME	GOLD SOUK GRANDE, LUDHIANA
SHOPS AT DON MILLS	SHOPPINGMALLNAME	SHOPS AT DON MILLS
EASTWOOD TOWNE CENTER	SHOPPINGMALLNAME	EASTWOOD TOWNE CENTER
LAUREL MALL	SHOPPINGMALLNAME	LAUREL MALL
CAPITAL SQUARE	SHOPPINGMALLNAME	CAP SQUARE MALL
JEFFERSON POINTE	SHOPPINGMALLNAME	JEFFERSON POINTE SHOPPING CENTER
MALL OF THE MAINLAND	SHOPPINGMALLNAME	MALL OF THE MAINLAND
STAR CITY	SHOPPINGMALLNAME	STAR CITY
LOGAN VALLEY MALL	SHOPPINGMALLNAME	LOGAN VALLEY MALL
BROADWAY SHOPPING CENTRE, BEXLEYHEATH	SHOPPINGMALLNAME	BROADWAY SHOPPING CENTRE
AUBURN MALL	SHOPPINGMALLNAME	AUBURN MALL
EXCHANGE ILFORD	SHOPPINGMALLNAME	EXCHANGE ILFORD
DEERFOOT MALL	SHOPPINGMALLNAME	DEERFOOT MALL
TIAGO MALL ORADEA	SHOPPINGMALLNAME	TIAGO MALL
CITY PARK MALL	SHOPPINGMALLNAME	CITY PARK MALL
CHARLESTOWN SHOPPING CENTRE	SHOPPINGMALLNAME	CHARLESTOWN SHOPPING CENTRE
COUNTRY CLUB MALL	SHOPPINGMALLNAME	COUNTRY CLUB MALL
PARK ROAD SHOPPING CENTER	SHOPPINGMALLNAME	PARK ROAD SHOPPING CENTER
STROUD MALL	SHOPPINGMALLNAME	STROUD MALL
WASHINGTON SQUARE MALL	SHOPPINGMALLNAME	WASHINGTON SQUARE MALL
MAPLEVIEW CENTRE	SHOPPINGMALLNAME	MAPLEVIEW CENTRE
ALBANY MALL	SHOPPINGMALLNAME	ALBANY MALL
VULCANO BUONO	SHOPPINGMALLNAME	IL VULCANO BUONO
SM CENTER LAS PIñAS	SHOPPINGMALLNAME	SM CENTER LAS PIñAS
EGLINTON SQUARE SHOPPING CENTRE	SHOPPINGMALLNAME	EGLINTON SQUARE SHOPPING CENTRE
MARY BRICKELL VILLAGE	SHOPPINGMALLNAME	THE SHOPS AT MARY BRICKELL VILLAGE
CENTRO COMERCIAL ARICANDUVA	SHOPPINGMALLNAME	CENTRO COMERCIAL ARICANDUVA
THE SHOPPES AT COLLEGE HILLS	SHOPPINGMALLNAME	THE SHOPPES AT COLLEGE HILLS
EASTLAND MALL	SHOPPINGMALLNAME	EASTLAND MALL
KENTUCKY OAKS MALL	SHOPPINGMALLNAME	KENTUCKY OAKS MALL
MOUNT OMMANEY SHOPPING CENTRE	SHOPPINGMALLNAME	MT OMMANEY CENTRE
CASASHOPPING	SHOPPINGMALLNAME	CASASHOPPING
MY MALL LIMASSOL	SHOPPINGMALLNAME	MY MALL LIMASSOL
BAYSHORE MALL	SHOPPINGMALLNAME	BAYSHORE MALL
VILLAGGIO MALL	SHOPPINGMALLNAME	VILLAGGIO
ROGUE VALLEY MALL	SHOPPINGMALLNAME	ROGUE VALLEY MALL
OUTLETS AT LEGENDS	SHOPPINGMALLNAME	OUTLETS AT LEGENDS
SM DELGADO	SHOPPINGMALLNAME	SM DEPARTMENT STORE DELGADO
DC USA	SHOPPINGMALLNAME	DC USA
GAISANO CAPITAL KALIBO	SHOPPINGMALLNAME	GAISANO CAPITAL KALIBO
WESTMINSTER MALL	SHOPPINGMALLNAME	WESTMINSTER MALL
WESTMINSTER MALL	SHOPPINGMALLNAME	WESTMINSTER MALL
GREEN OAK VILLAGE PLACE	SHOPPINGMALLNAME	GREEN OAK VILLAGE PLACE
GAISANO CAPITAL PAGADIAN	SHOPPINGMALLNAME	GAISANO CAPITAL PAGADIAN
ALABANG TOWN CENTER	SHOPPINGMALLNAME	ALABANG TOWN CENTER
THE VILLAGE OF ROCHESTER HILLS	SHOPPINGMALLNAME	THE VILLAGE OF ROCHESTER HILLS
METQUARTER	SHOPPINGMALLNAME	METQUARTER
SM CITY SAN PABLO	SHOPPINGMALLNAME	SM CITY SAN PABLO
BERKSHIRE MALL	SHOPPINGMALLNAME	BERKSHIRE MALL
SOUQ SHARQ	SHOPPINGMALLNAME	SOUK SHARQ
WHITE OAKS MALL	SHOPPINGMALLNAME	WHITE OAKS MALL
CENTRALPLAZA KHON KAEN	SHOPPINGMALLNAME	CENTRALPLAZA KHON KAEN\N300PX
CENTRALPLAZA UDON THANI	SHOPPINGMALLNAME	CENTRALPLAZA UDON THANI\N300PX\N300PX
EXPRESS AVENUE	SHOPPINGMALLNAME	EXPRESS AVENUE
CASTLETOWN SHOPPINGWORLD	SHOPPINGMALLNAME	CASTLETOWN SHOPPINGWORLD
PAVILION MALL	SHOPPINGMALLNAME	PAVILION MALL
CENTRALPLAZA CHAENGWATTANA	SHOPPINGMALLNAME	CENTRALPLAZA CHAENGWATTANA
CENTRALPLAZA CHONBURI	SHOPPINGMALLNAME	CENTRALPLAZA CHONBURI
MILL CREEK TOWN CENTER	SHOPPINGMALLNAME	MILL CREEK TOWN CENTER
THE SHOPS AT CRYSTALS	SHOPPINGMALLNAME	THE SHOPS AT CRYSTALS
LAGRANGE MALL	SHOPPINGMALLNAME	LAGRANGE MALL
CAROUSEL MALL	SHOPPINGMALLNAME	CAROUSEL MALL
GADSDEN MALL	SHOPPINGMALLNAME	GADSDEN MALL
QUINTARD MALL	SHOPPINGMALLNAME	QUINTARD MALL
ÆON BUKIT INDAH SHOPPING CENTRE	SHOPPINGMALLNAME	AEON BUKIT INDAH SHOPPING CENTRE
FLORIN MALL	SHOPPINGMALLNAME	FLORIN MALL
TRI-STATE MALL	SHOPPINGMALLNAME	TRI-STATE MALL
HAMBURG PAVILION	SHOPPINGMALLNAME	HAMBURG PAVILION
THE MARKET COMMON	SHOPPINGMALLNAME	THE MARKET COMMON
ALTAMONTE MALL	SHOPPINGMALLNAME	ALTAMONTE MALL
THE KENWOOD COLLECTION	SHOPPINGMALLNAME	THE KENWOOD COLLECTION
MONTCLAIR PLAZA	SHOPPINGMALLNAME	MONTCLAIR PLACE
WESTMORELAND OUTLET WORLD	SHOPPINGMALLNAME	WESTMORELAND OUTLET WORLD
ROBINSONS PLACE TACLOBAN	SHOPPINGMALLNAME	ROBINSONS PLACE TACLOBAN
THE HIGHLANDS	SHOPPINGMALLNAME	THE HIGHLANDS
ALBERTVILLE PREMIUM OUTLETS	SHOPPINGMALLNAME	ALBERTVILLE PREMIUM OUTLETS
MAIN STREET COMPLEX	SHOPPINGMALLNAME	MAIN STREET COMPLEX
CITY SQUARE MALL	SHOPPINGMALLNAME	CITY SQUARE MALL
FU LU SHOU COMPLEX	SHOPPINGMALLNAME	FU LU SHOU COMPLEX
UNIONTOWN MALL	SHOPPINGMALLNAME	UNIONTOWN MALL
CENTRALFESTIVAL PATTAYA BEACH	SHOPPINGMALLNAME	CENTRALFESTIVAL PATTAYA
CENTRALFESTIVAL PATTAYA BEACH	SHOPPINGMALLNAME	200
MALL OF MONTENEGRO	SHOPPINGMALLNAME	MALL OF MONTENEGRO
WIREGRASS COMMONS MALL	SHOPPINGMALLNAME	WIREGRASS COMMONS MALL
WALNUT SQUARE MALL	SHOPPINGMALLNAME	WALNUT SQUARE MALL
BAYVIEW VILLAGE SHOPPING CENTRE	SHOPPINGMALLNAME	BAYVIEW VILLAGE SHOPPING CENTRE
JASPER MALL	SHOPPINGMALLNAME	JASPER MALL
CLAYTON SQUARE SHOPPING CENTRE	SHOPPINGMALLNAME	CLAYTON SQUARE SHOPPING CENTRE
FAIRGROUNDS SQUARE MALL	SHOPPINGMALLNAME	FAIRGROUNDS SQUARE MALL
MID RIVERS MALL	SHOPPINGMALLNAME	MID RIVERS MALL
CHESTERFIELD MALL	SHOPPINGMALLNAME	CHESTERFIELD MALL
LAKELINE MALL	SHOPPINGMALLNAME	LAKELINE MALL
EASTDALE MALL	SHOPPINGMALLNAME	EASTDALE MALL
MACHESNEY PARK MALL	SHOPPINGMALLNAME	MACHESNEY PARK MALL
THE PAVILIONS	SHOPPINGMALLNAME	THE PAVILIONS
SETTLERS GREEN	SHOPPINGMALLNAME	SETTLERS GREEN
GALLERIA AT TYLER	SHOPPINGMALLNAME	GALLERIA AT TYLER
THE JOHNSTOWN GALLERIA	SHOPPINGMALLNAME	THE JOHNSTOWN GALLERIA
HIGH POINT TOWN CENTER	SHOPPINGMALLNAME	HIGH POINT TOWN CENTER
BENTLEY MALL	SHOPPINGMALLNAME	BENTLEY MALL
MALLDOVA	SHOPPINGMALLNAME	SHOPPING MALLDOVA
AMARA FASHION HOUSE	SHOPPINGMALLNAME	AMARA
MANTRI SQUARE	SHOPPINGMALLNAME	MANTRI SQUARE MALL
CENTRALPLAZA LARDPRAO	SHOPPINGMALLNAME	CENTRAL PLAZA LAT PHRAO
SELMA MALL	SHOPPINGMALLNAME	SELMA MALL
HONEYDALE MALL	SHOPPINGMALLNAME	HONEYDALE MALL
CITYCENTRE	SHOPPINGMALLNAME	TOWN & COUNTRY MALL
ABREEZA	SHOPPINGMALLNAME	ABREEZA MALL
SANDUSKY MALL	SHOPPINGMALLNAME	SANDUSKY MALL
PARKWAY NEWBURY	SHOPPINGMALLNAME	PARKWAY NEWBURY
MIDLAND MALL	SHOPPINGMALLNAME	MIDLAND MALL
STEEPLEGATE MALL	SHOPPINGMALLNAME	STEEPLEGATE MALL
TOWN AND COUNTRY SHOPPING CENTER	SHOPPINGMALLNAME	TOWN AND COUNTRY SHOPPING CENTER
K IN KORTRIJK	SHOPPINGMALLNAME	K IN KORTRIJK
THE SUMMIT	SHOPPINGMALLNAME	THE SUMMIT
THE PLAZA SHOPPING CENTRE	SHOPPINGMALLNAME	THE PLAZA SHOPPING CENTRE
GARUDA MALL	SHOPPINGMALLNAME	GARUDA MALL
PRIEN LAKE MALL	SHOPPINGMALLNAME	PRIEN LAKE MALL
JOCKEY PLAZA	SHOPPINGMALLNAME	JOCKEY PLAZA
SM CENTER VALENZUELA	SHOPPINGMALLNAME	SM CENTER VALENZUELA
SM CENTER PASIG	SHOPPINGMALLNAME	SM CENTER PASIG
SM CENTER MUNTINLUPA	SHOPPINGMALLNAME	SM CENTER MUNTINLUPA
WAYFARERS ARCADE	SHOPPINGMALLNAME	WAYFARERS ARCADE
THE SUMMIT	SHOPPINGMALLNAME	THE SUMMIT
FASHION OUTLETS OF NIAGARA FALLS	SHOPPINGMALLNAME	FASHION OUTLETS NIAGARA FALLS
WESTFIELD MERIDEN	SHOPPINGMALLNAME	WESTFIELD MERIDEN
COLONIAL PROMENADE ALABASTER	SHOPPINGMALLNAME	COLONIAL PROMENADE ALABASTER
CITY COMMERCIAL CENTER	SHOPPINGMALLNAME	CITY COMMERCIAL CENTER OR C3 MALL
LANCASTER MALL	SHOPPINGMALLNAME	LANCASTER MALL
DOMAIN CENTRAL	SHOPPINGMALLNAME	DOMAIN CENTRAL
RAGHULEELA MALL, VASHI	SHOPPINGMALLNAME	RAGHULEELA MALL, VASHI
RAGHULEELA MALL, KANDIVILI	SHOPPINGMALLNAME	RAGHULEELA MALL, KANDIVALI WEST, MUMBAI
BONITA LAKES MALL	SHOPPINGMALLNAME	BONITA LAKES MALL
GRANADA CENTER	SHOPPINGMALLNAME	GRANADA CENTER
GRANADA CENTER	SHOPPINGMALLNAME	مركز غرناطة
THE CORE SHOPPING CENTRE	SHOPPINGMALLNAME	THE CORE SHOPPING CENTRE
THE PROMENADE AT COCONUT CREEK	SHOPPINGMALLNAME	THE PROMENADE AT COCONUT CREEK
THE SHOPPES AT BLACKSTONE VALLEY	SHOPPINGMALLNAME	THE SHOPPES AT BLACKSTONE VALLEY
MCALISTER SQUARE	SHOPPINGMALLNAME	MCALISTER SQUARE
OAKWAY CENTER	SHOPPINGMALLNAME	OAKWAY CENTER
NE PACIFIC MALL	SHOPPINGMALLNAME	NE PACIFIC MALL
MCCAIN MALL	SHOPPINGMALLNAME	MCCAIN MALL
THE SHOPS AT ATLAS PARK	SHOPPINGMALLNAME	THE SHOPS AT ATLAS PARK
FAHRENHEIT 88	SHOPPINGMALLNAME	FAHRENHEIT 88
FAHRENHEIT 88	SHOPPINGMALLNAME	飛輪海88
FRöLUNDA TORG	SHOPPINGMALLNAME	FRöLUNDA TORG
NORTHWEST ARKANSAS MALL	SHOPPINGMALLNAME	NORTHWEST ARKANSAS MALL
GREENWOOD MALL	SHOPPINGMALLNAME	GREENWOOD MALL
CENTRAL PARK JAKARTA	SHOPPINGMALLNAME	CENTRAL PARK
SERDIKA CENTER SOFIA	SHOPPINGMALLNAME	SERDIKA CENTER SOFIA
THE MALL	SHOPPINGMALLNAME	THE MALL
AMU PLAZA KAGOSHIMA	SHOPPINGMALLNAME	AMU PLAZA KAGOSHIMA
SUAN LUM NIGHT BAZAAR RATCHADAPHISEK	SHOPPINGMALLNAME	SUAN LUM NIGHT BAZAAR RATCHADA
THE BASE	SHOPPINGMALLNAME	THE BASE
PINNACLE AT TUTWILER FARM	SHOPPINGMALLNAME	PINNACLE AT TUTWILER FARM
CENTRO ANDINO	SHOPPINGMALLNAME	CENTRO ANDINO MALL
RICHLAND TOWN CENTRE	SHOPPINGMALLNAME	RICHLAND TOWN CENTRE
SANKO PARK	SHOPPINGMALLNAME	SANKO PARK
DECATUR MALL	SHOPPINGMALLNAME	DECATUR MALL
CAPE COD FACTORY OUTLET MALL	SHOPPINGMALLNAME	CAPE COD FACTORY OUTLET MALL
WEST VALLEY MALL	SHOPPINGMALLNAME	WEST VALLEY MALL
KANDY CITY CENTRE	SHOPPINGMALLNAME	KANDY CITY CENTRE
DADELAND STATION	SHOPPINGMALLNAME	DADELAND STATION
THE BREWERY	SHOPPINGMALLNAME	THE BREWERY
NEW CROSS SHOPPING CENTRE	SHOPPINGMALLNAME	NEW CROSS SHOPPING CENTRE
FOXCROFT TOWNE CENTER AT MARTINSBURG	SHOPPINGMALLNAME	FOXCROFT TOWNE CENTER AT MARTINSBURG
CENTRALPLAZA SURAT THANI	SHOPPINGMALLNAME	CENTRALPLAZA SURAT THANI
CENTRO MAYOR	SHOPPINGMALLNAME	CENTRO MAYOR MALL
MIDDENWAARD	SHOPPINGMALLNAME	MIDDENWAARD
TRANG TIEN PLAZA	SHOPPINGMALLNAME	TRàNG TIềN PLAZA
STRöMPILEN	SHOPPINGMALLNAME	STRöMPILEN
GRAN ESTACIóN	SHOPPINGMALLNAME	GRAN ESTACION MALL
CITYPARK ALBANIA	SHOPPINGMALLNAME	CITYPARK ALBANIA
TULSA PROMENADE	SHOPPINGMALLNAME	TULSA PROMENADE MALL
ABAD NUCLEUS MALL	SHOPPINGMALLNAME	NUCLEUS MALL
KING CROSS LEOPOLIS	SHOPPINGMALLNAME	KING CROSS LEOPOLIS
LEISURE PARK KALLANG	SHOPPINGMALLNAME	LEISURE PARK KALLANG
CENTRE PLACE	SHOPPINGMALLNAME	CENTRE PLACE
CROWNGATE SHOPPING CENTRE	SHOPPINGMALLNAME	CROWNGATE WORCESTER
KINGFISHER SHOPPING CENTRE	SHOPPINGMALLNAME	KINGFISHER SHOPPING CENTRE
ROBINSONS PLACE PANGASINAN	SHOPPINGMALLNAME	ROBINSONS PLACE PANGASINAN
CSI BAYAMBANG	SHOPPINGMALLNAME	CSI BAYAMBANG
MIDLAND GATE	SHOPPINGMALLNAME	MIDLAND GATE
BLUE HEN MALL	SHOPPINGMALLNAME	BLUE HEN MALL
EASTPOINT MALL	SHOPPINGMALLNAME	EASTPOINT MALL
ABHIRAMI MEGA MALL	SHOPPINGMALLNAME	ABIRAMI MEGA MALL
ONE NEW CHANGE	SHOPPINGMALLNAME	ONE NEW CHANGE
PELICAN PLACE AT CRAFT FARMS	SHOPPINGMALLNAME	PELICAN PLACE AT CRAFT FARMS
STARHILL GALLERY	SHOPPINGMALLNAME	STARHILL GALLERY
COTTONWOOD MALL	SHOPPINGMALLNAME	COTTONWOOD MALL
RAMAT AVIV MALL	SHOPPINGMALLNAME	RAMAT AVIV MALL
PARK BULVAR	SHOPPINGMALLNAME	PARK BULVAR
FORUM THOMSUN MALL	SHOPPINGMALLNAME	THE FORUM THOMSUN MALL
WEST MANCHESTER TOWN CENTER	SHOPPINGMALLNAME	WEST MANCHESTER TOWN CENTER
NEX	SHOPPINGMALLNAME	NEX
GEBZE CENTER	SHOPPINGMALLNAME	GEBZE CENTER
TEMPLARS SQUARE	SHOPPINGMALLNAME	TEMPLARS SQUARE
BICESTER AVENUE	SHOPPINGMALLNAME	BICESTER AVENUE HOME AND GARDEN CENTRE
GALERIA ECHO	SHOPPINGMALLNAME	GALERIA ECHO
BABILONAS	SHOPPINGMALLNAME	BABILONAS
HAWLEY LANE MALL	SHOPPINGMALLNAME	HAWLEY LANE MALL
WOODVILLE MALL	SHOPPINGMALLNAME	WOODVILLE MALL
THE SHOPS AT FALLEN TIMBERS	SHOPPINGMALLNAME	WOODVILLE MALL
OLD MILL DISTRICT	SHOPPINGMALLNAME	OLD MILL DISTRICT
BBI CENTAR	SHOPPINGMALLNAME	BBI CENTAR
BEDOK POINT	SHOPPINGMALLNAME	BEDOK POINT
SM CITY CONSOLACION	SHOPPINGMALLNAME	SM CITY CONSOLACION
MARLEY STATION	SHOPPINGMALLNAME	MARLEY STATION MALL
LAKEVIEW SQUARE MALL	SHOPPINGMALLNAME	LAKEVIEW SQUARE MALL
GRAND TRAVERSE MALL	SHOPPINGMALLNAME	GRAND TRAVERSE MALL
WESTWOOD MALL	SHOPPINGMALLNAME	WESTWOOD MALL
BAY CITY MALL	SHOPPINGMALLNAME	BAY CITY MALL
WOODGROVE CENTRE	SHOPPINGMALLNAME	WOODGROVE CENTRE
BULGARIA MALL	SHOPPINGMALLNAME	BULGARIA MALL
PAUL BUNYAN MALL	SHOPPINGMALLNAME	PAUL BUNYAN MALL
CASAS ADOBES PLAZA	SHOPPINGMALLNAME	CASAS ADOBES PLAZA
WILDWOOD CENTRE	SHOPPINGMALLNAME	WILDWOOD CENTRE
MIRACLE MARKETPLACE	SHOPPINGMALLNAME	MIRACLE MARKETPLACE
EDISON MALL	SHOPPINGMALLNAME	EDISON MALL
TEWKSBURY MILLS	SHOPPINGMALLNAME	TEWKSBURY MILLS
PACIFIC EAST MALL	SHOPPINGMALLNAME	PACIFIC EAST MALL
PACIFIC EAST MALL	SHOPPINGMALLNAME	太平洋东马尔
PACIFIC EAST MALL	SHOPPINGMALLNAME	TàIPíNGYáNG DōNG MǎěR
JAMESTOWN MALL	SHOPPINGMALLNAME	JAMESTOWN MALL
CRESTWOOD COURT	SHOPPINGMALLNAME	CRESTWOOD COURT
GREENBRIER MALL	SHOPPINGMALLNAME	GREENBRIER MALL
JACKSON CROSSING	SHOPPINGMALLNAME	JACKSON CROSSING
CANELAND CENTRAL	SHOPPINGMALLNAME	CANELAND CENTRAL
ST. CHARLES TOWNE CENTER	SHOPPINGMALLNAME	ST. CHARLES TOWNE CENTER
PACIFIC VIEW MALL	SHOPPINGMALLNAME	PACIFIC VIEW MALL
TELFORD SHOPPING CENTRE	SHOPPINGMALLNAME	TELFORD SHOPPING CENTRE
ERODE CENTRAL BUS TERMINUS	SHOPPINGMALLNAME	CENTRAL BUS TERMINAL COMPLEX
TOWN CENTER AT AURORA	SHOPPINGMALLNAME	TOWN CENTER AT AURORA
PALLADIUM WORLD	SHOPPINGMALLNAME	PALLADIUM SQUARE
PALLADIUM WORLD	SHOPPINGMALLNAME	พัลลาเดียม สแควร์
CENTRIO	SHOPPINGMALLNAME	CENTRIO AYALA MALL
THE FORT SHOPPING PARK	SHOPPINGMALLNAME	THE FORT SHOPPING PARK
CRYSTAL MALL	SHOPPINGMALLNAME	CRYSTAL MALL
TORP KöPCENTRUM	SHOPPINGMALLNAME	TORP KöPCENTRUM
BRADLEY SQUARE MALL	SHOPPINGMALLNAME	BRADLEY SQUARE MALL
EMPIRE SUBANG	SHOPPINGMALLNAME	EMPIRE SUBANG
MYER CENTREPOINT	SHOPPINGMALLNAME	MYER CENTREPOINT
LAVINGTON SQUARE SHOPPING CENTRE	SHOPPINGMALLNAME	LAVINGTON SQUARE SHOPPING CENTRE
FIGAT7TH	SHOPPINGMALLNAME	FIGAT7TH
KEJETIA, KUMASI, GHANA	SHOPPINGMALLNAME	KUMASI CENTRAL MARKET
WINDWARD MALL	SHOPPINGMALLNAME	WINDWARD MALL
SUNSET ESPLANADE	SHOPPINGMALLNAME	THE SUNSET ESPLANADE
ROBINSONS PLACE PALAWAN	SHOPPINGMALLNAME	ROBINSONS PLACE PALAWAN
HARRISON PLAZA	SHOPPINGMALLNAME	HARRISON PLAZA
CITY CENTRE BAHRAIN	SHOPPINGMALLNAME	CITY CENTRE BAHRAIN
BAKERY SQUARE	SHOPPINGMALLNAME	BAKERY SQUARE
OUTLET SHOPPES AT OKLAHOMA CITY	SHOPPINGMALLNAME	OUTLET SHOPPES AT OKLAHOMA CITY
AGINCOURT MALL	SHOPPINGMALLNAME	AGINCOURT MALL
CENTRAL MARKET, PHNOM PENH	SHOPPINGMALLNAME	CENTRAL MARKET
VIVA HOME	SHOPPINGMALLNAME	VIVA HOME
CLEMENTI MALL	SHOPPINGMALLNAME	THE CLEMENTI MALL
SPINDERIET	SHOPPINGMALLNAME	SPINDERIET
SM SEASIDE CITY CEBU	SHOPPINGMALLNAME	SM SEASIDE CITY CEBU
GANDHI MARKET	SHOPPINGMALLNAME	GANDHI MARKET
ISFAHAN CITY CENTER	SHOPPINGMALLNAME	ISFAHAN CITY CENTER
DFO MOORABBIN	SHOPPINGMALLNAME	DFO MOORABBIN
THE PARKSHOPPING	SHOPPINGMALLNAME	PARKSHOPPING
SERENDRA	SHOPPINGMALLNAME	SERENDRA
OUTLETS AT ANTHEM	SHOPPINGMALLNAME	OUTLETS AT ANTHEM
WOODBINE CENTRE	SHOPPINGMALLNAME	WOODBINE CENTRE
ASAFO MARKET	SHOPPINGMALLNAME	ASAFO MARKET
ADRIAN MALL	SHOPPINGMALLNAME	ADRIAN MALL
NEPTUNE MAGNET MALL	SHOPPINGMALLNAME	NEPTUNE MAGNET MALL
THE PARADE SHOPPING CENTRE	SHOPPINGMALLNAME	THE PARADE SHOPPING CENTRE
ILLINOIS STAR CENTRE	SHOPPINGMALLNAME	ILLINOIS STAR CENTRE
PERSIAN GULF COMPLEX	SHOPPINGMALLNAME	PERSIAN GULF COMPLEX
PARKMORE SHOPPING CENTRE	SHOPPINGMALLNAME	PARKMORE SHOPPING CENTRE
GALLERIA EDINA	SHOPPINGMALLNAME	THE GALLERIA
KUKUI GROVE CENTER	SHOPPINGMALLNAME	KUKUI GROVE CENTER
ROCK HILL GALLERIA	SHOPPINGMALLNAME	ROCK HILL GALLERIA
DANDENONG PLAZA	SHOPPINGMALLNAME	DANDENONG PLAZA
SAMBIL PARAGUANá	SHOPPINGMALLNAME	SAMBIL PARAGUANá
BRONX TERMINAL MARKET	SHOPPINGMALLNAME	BRONX TERMINAL MARKET
SOUTHTOWN CENTER	SHOPPINGMALLNAME	SOUTHTOWN CENTER
RIVERDALE VILLAGE	SHOPPINGMALLNAME	RIVERDALE VILLAGE
OLD QUEBEC STREET MALL	SHOPPINGMALLNAME	OLD QUEBEC STREET MALL
SM CITY MARIKINA	SHOPPINGMALLNAME	SM CITY MARIKINA
ABENO CUES TOWN	SHOPPINGMALLNAME	ABENO CUES TOWN
CHESTERFIELD TOWNE CENTER	SHOPPINGMALLNAME	CHESTERFIELD TOWNE CENTER
LAYTON HILLS MALL	SHOPPINGMALLNAME	LAYTON HILLS MALL
KATONG SHOPPING CENTRE	SHOPPINGMALLNAME	KATONG SHOPPING CENTRE
THE MALL AT LEXINGTON GREEN	SHOPPINGMALLNAME	THE MALL AT LEXINGTON GREEN
ORANGE PARK MALL	SHOPPINGMALLNAME	ORANGE PARK MALL
SCHUYLKILL MALL	SHOPPINGMALLNAME	SCHUYLKILL MALL
MEADOWBROOK MALL	SHOPPINGMALLNAME	MEADOWBROOK MALL
ARNOT MALL	SHOPPINGMALLNAME	ARNOT MALL
RAMOT MALL	SHOPPINGMALLNAME	RAMOT MALL
FESTIVAL ALABANG	SHOPPINGMALLNAME	FESTIVAL ALABANG
LA FIESTA MALL	SHOPPINGMALLNAME	LA FIESTA SHOPPING CENTER
JUBILEE SQUARE	SHOPPINGMALLNAME	JUBILEE SQUARE
CARBON PLAZA MALL	SHOPPINGMALLNAME	CARBON PLAZA MALL
BURWOOD ONE	SHOPPINGMALLNAME	BURWOOD ONE
SM CITY SAN FERNANDO	SHOPPINGMALLNAME	SM CITY SAN FERNANDO
ENG WAH GLOBAL	SHOPPINGMALLNAME	JUBILEE SQUARE
ENG WAH GLOBAL	SHOPPINGMALLNAME	321
MID VALLEY SHOPPING CENTRE	SHOPPINGMALLNAME	MID VALLEY SHOPPING CENTRE
ERA CENTRE	SHOPPINGMALLNAME	ERA CENTRE
GALERíAS INSURGENTES	SHOPPINGMALLNAME	GALERíAS INSURGENTES
HYSAN PLACE	SHOPPINGMALLNAME	HYSAN PLACE
STOCKLAND TRARALGON	SHOPPINGMALLNAME	STOCKLAND TRARALGON
BROOKEFIELDS MALL	SHOPPINGMALLNAME	BROOKEFIELDS
GOLD SOUK GRANDE MALL CHENNAI	SHOPPINGMALLNAME	GOLD SOUK GRANDE, CHENNAI
UNIVERSITY PLACE	SHOPPINGMALLNAME	UNIVERSITY PLACE
PROZONE MALL AURANGABAD	SHOPPINGMALLNAME	PROZONE MALL, AURANGABAD
SM CITY SUZHOU	SHOPPINGMALLNAME	SM SUZHOU
THE WALK	SHOPPINGMALLNAME	THE WALK
PORTANOVA	SHOPPINGMALLNAME	PORTANOVA
COOPER'S SQUARE	SHOPPINGMALLNAME	COOPERS SQUARE
CITY CENTRE PATNA	SHOPPINGMALLNAME	CITY CENTRE PATNA
THE OUTLETS AT SANDS BETHLEHEM	SHOPPINGMALLNAME	THE OUTLETS AT SANDS BETHLEHEM
THE CHIMES, UXBRIDGE	SHOPPINGMALLNAME	THE CHIMES
LYCOMING MALL	SHOPPINGMALLNAME	LYCOMING MALL
ENFIELD SQUARE	SHOPPINGMALLNAME	ENFIELD SQUARE MALL
LIMKETKAI MALL	SHOPPINGMALLNAME	LIMKETKAI CENTER
FUBONN SHOPPING CENTER	SHOPPINGMALLNAME	FUBONN SHOPPING CENTER
VIEWMONT MALL	SHOPPINGMALLNAME	VIEWMONT MALL
MAYBERRY MALL	SHOPPINGMALLNAME	MAYBERRY MALL
MOROCCO MALL	SHOPPINGMALLNAME	MOROCCO MALL
YORK GALLERIA	SHOPPINGMALLNAME	YORK GALLERIA MALL
NCCC MALL TAGUM	SHOPPINGMALLNAME	NCCC MALL TAGUM
COLONNADE AT STATE COLLEGE	SHOPPINGMALLNAME	COLONNADE AT STATE COLLEGE
SM CITY OLONGAPO	SHOPPINGMALLNAME	SM CITY OLONGAPO
CITY SENTRAL	SHOPPINGMALLNAME	CITY SENTRAL
HARBOR POINT	SHOPPINGMALLNAME	HARBOR POINT
BASS PRO COMPLEX	SHOPPINGMALLNAME	BASS PRO COMPLEX
GALERIES DE GRANBY	SHOPPINGMALLNAME	GALERIES DE GRANBY
SUSQUEHANNA VALLEY MALL	SHOPPINGMALLNAME	SUSQUEHANNA VALLEY MALL
SOBHA CITY MALL	SHOPPINGMALLNAME	SOBHA CITY MALL
SALEM CENTER	SHOPPINGMALLNAME	SALEM CENTER
CENTRE AT GLEN BURNIE	SHOPPINGMALLNAME	CENTRE AT GLEN BURNIE
MANI SQUARE	SHOPPINGMALLNAME	MANI SQUARE
SHOPS AT UNIVERSITY SQUARE	SHOPPINGMALLNAME	THE SHOPS AT UNIVERSITY SQUARE
SOUTH CITY MALL	SHOPPINGMALLNAME	SOUTH CITY MALL
BAY PRIDE MALL	SHOPPINGMALLNAME	BAY PRIDE MALL
MILITARY CIRCLE MALL	SHOPPINGMALLNAME	MILITARY CIRCLE MALL
FLORIN TOWNE CENTRE	SHOPPINGMALLNAME	FLORIN TOWNE CENTRE
MOUNT PLEASANT TOWNE CENTRE	SHOPPINGMALLNAME	MOUNT PLEASANT TOWNE CENTRE
MALL OF LAHORE	SHOPPINGMALLNAME	MALL OF LAHORE
PACE SHOPPING MALL	SHOPPINGMALLNAME	PACE SHOPPING MALLS
CARREFOUR DU NORD	SHOPPINGMALLNAME	CARREFOUR DU NORD
LES GALERIES CHAGNON	SHOPPINGMALLNAME	LES GALERIES CHAGNON
HILITE MALL	SHOPPINGMALLNAME	HILITE MALL
SOUTHGATE MALL	SHOPPINGMALLNAME	SOUTHGATE MALL
QUICENTRO SUR SHOPPING	SHOPPINGMALLNAME	QUICENTRO SUR
BRAMPTON MALL	SHOPPINGMALLNAME	BRAMPTON MALL
HIGH STREET PHOENIX	SHOPPINGMALLNAME	HIGH STREET PHOENIX
GVK ONE	SHOPPINGMALLNAME	GVK ONE
BANGOR MALL	SHOPPINGMALLNAME	BANGOR MALL
CITY CENTRE, MANGALORE	SHOPPINGMALLNAME	CITY CENTRE
MALL OF MYSORE	SHOPPINGMALLNAME	MALL OF MYSORE
BM HABITAT MALL	SHOPPINGMALLNAME	BM HABITAT MALL
BRENTWOOD COUNTRY MART	SHOPPINGMALLNAME	BRENTWOOD COUNTRY MART
JCUBE	SHOPPINGMALLNAME	JCUBE
NEW SQUARE, WEST BROMWICH	SHOPPINGMALLNAME	NEW SQUARE
MERCER VILLAGE	SHOPPINGMALLNAME	MERCER VILLAGE
VISHAAL DE MAL	SHOPPINGMALLNAME	VISHAAL DE MAL
SOUTH POINT	SHOPPINGMALLNAME	SOUTH POINT MALL
IMM	SHOPPINGMALLNAME	IMM
NAAZ LIFESTYLE MALL	SHOPPINGMALLNAME	NAAZ LIFESTYLE SHOPPING MALL
INTERNATIONAL MARKET WORLD	SHOPPINGMALLNAME	INTERNATIONAL MARKET WORLD
KENANGA WHOLESALE CITY	SHOPPINGMALLNAME	KENANGA WHOLESALE CITY
HENRY TOWN CENTER	SHOPPINGMALLNAME	HENRY TOWN CENTER
CROSS COUNTY MALL	SHOPPINGMALLNAME	CROSS COUNTY MALL
CROSS COUNTY MALL	SHOPPINGMALLNAME	CROSS COUNTY PLAZA
SHUTE PARK PLAZA	SHOPPINGMALLNAME	SHUTE PARK PLAZA
PRESCOTT GATEWAY	SHOPPINGMALLNAME	PRESCOTT GATEWAY
VICTORIA MALL	SHOPPINGMALLNAME	VICTORIA MALL
CENTRALPLAZA GRAND RAMA IX	SHOPPINGMALLNAME	CENTRAL PLAZA GRAND RAMA 9
CENTRALPLAZA RATTANATHIBET	SHOPPINGMALLNAME	CENTRALPLAZA RATTANATHIBET
CENTRALPLAZA PATTAYA	SHOPPINGMALLNAME	CENTRALPLAZA PATTAYA
CENTRALPLAZA PHITSANULOK	SHOPPINGMALLNAME	CENTRALPLAZA PHITSANULOK
CENTRALPLAZA CHIANG MAI AIRPORT	SHOPPINGMALLNAME	CENTRALPLAZA CHIANGMAI AIRPORT
CENTRALPLAZA CHIANG RAI	SHOPPINGMALLNAME	CENTRALPLAZA CHIANG RAI
RIVER HILLS MALL	SHOPPINGMALLNAME	RIVER HILLS MALL
112 KATONG	SHOPPINGMALLNAME	I12 KATONG
FASHION PLACE	SHOPPINGMALLNAME	FASHION PLACE
FX SUDIRMAN	SHOPPINGMALLNAME	FX SUDIRMAN
MERRIMACK PREMIUM OUTLETS	SHOPPINGMALLNAME	MERRIMACK PREMIUM OUTLETS
PHILADELPHIA PREMIUM OUTLETS	SHOPPINGMALLNAME	PHILADELPHIA PREMIUM OUTLETS
ALGO CENTRE MALL	SHOPPINGMALLNAME	ALGO CENTRE MALL
OAKWOOD PLAZA	SHOPPINGMALLNAME	OAKWOOD PLAZA
BLUE MOUNTAIN MALL	SHOPPINGMALLNAME	BLUE MOUNTAIN MALL
R CITY MALL	SHOPPINGMALLNAME	R CITY MALL
EASTPORT PLAZA	SHOPPINGMALLNAME	EASTPORT PLAZA
INDIAN HILL MALL	SHOPPINGMALLNAME	INDIAN HILL MALL
WHITTWOOD TOWN CENTER	SHOPPINGMALLNAME	WHITTWOOD TOWN CENTER
BELL CANYON CENTER	SHOPPINGMALLNAME	BELL CANYON CENTER
EAST GATE SQUARE	SHOPPINGMALLNAME	EAST GATE SQUARE
NORTHLAND MALL	SHOPPINGMALLNAME	NORTHLAND MALL
FAIRLANE VILLAGE MALL	SHOPPINGMALLNAME	FAIRLANE VILLAGE MALL
TOWSON SQUARE	SHOPPINGMALLNAME	TOWSON SQUARE
ROBINSONS MAGNOLIA	SHOPPINGMALLNAME	ROBINSONS MAGNOLIA
IKEJA CITY MALL	SHOPPINGMALLNAME	IKEJA CITY MALL
DESOTO SQUARE	SHOPPINGMALLNAME	DESOTO SQUARE
SM LANANG PREMIER	SHOPPINGMALLNAME	SM LANANG PREMIER
CONESTOGA MALL	SHOPPINGMALLNAME	CONESTOGA MALL
THE VILLAGE SHOPPING CENTER	SHOPPINGMALLNAME	THE VILLAGE SHOPPING CENTER
THAMRIN CITY	SHOPPINGMALLNAME	THAMRIN CITY
PARQUESUR	SHOPPINGMALLNAME	PARQUESUR
GAISANO CAPITAL SURIGAO	SHOPPINGMALLNAME	GAISANO CAPITAL MALL SURIGAO
SIKES SENTER	SHOPPINGMALLNAME	SIKES SENTER
JOHOR PREMIUM OUTLETS	SHOPPINGMALLNAME	JOHOR PREMIUM OUTLETS
THE QUAD AT WHITTIER	SHOPPINGMALLNAME	THE QUAD AT WHITTIER
SUPER BRAND MALL	SHOPPINGMALLNAME	SUPER BRAND MALL
NORTHGATE MALL	SHOPPINGMALLNAME	NORTHGATE MALL
OHIO VALLEY MALL	SHOPPINGMALLNAME	OHIO VALLEY MALL
GOVERNOR'S SQUARE MALL	SHOPPINGMALLNAME	GOVERNOR'S SQUARE MALL
CONCORD MALL	SHOPPINGMALLNAME	CONCORD MALL
PARADISE CENTER	SHOPPINGMALLNAME	PARADISE CENTER
PACIFIC WERRIBEE	SHOPPINGMALLNAME	PACIFIC WERRIBEE
WESTLAND MALL	SHOPPINGMALLNAME	WESTLAND MALL
FRANCIS SCOTT KEY MALL	SHOPPINGMALLNAME	FRANCIS SCOTT KEY MALL
CLOVERDALE MALL	SHOPPINGMALLNAME	CLOVERDALE MALL
THE COMMONS AT CALABASAS	SHOPPINGMALLNAME	THE COMMONS AT CALABASAS
PAPAMOA PLAZA	SHOPPINGMALLNAME	PAPAMOA PLAZA
BAYFAIR SHOPPING CENTRE	SHOPPINGMALLNAME	BAYFAIR SHOPPING MALL
AL AALI SHOPPING COMPLEX	SHOPPINGMALLNAME	AL AALI SHOPPING COMPLEX
THE BAHRAIN MALL	SHOPPINGMALLNAME	THE BAHRAIN MALL
AL ENMA MALL	SHOPPINGMALLNAME	AL ENMA MALL
CORNMILL SHOPPING CENTRE	SHOPPINGMALLNAME	CORNMILL SHOPPING CENTRE
CENTRE SQUARE MALL	SHOPPINGMALLNAME	CENTRE SQUARE MALL
BLVD PLACE	SHOPPINGMALLNAME	BLVD PLACE
LIST OF SMALL SHOPPING CENTRES IN MONTREAL	SHOPPINGMALLNAME	CARREFOUR DE LA POINTE
LIST OF SMALL SHOPPING CENTRES IN MONTREAL	SHOPPINGMALLNAME	CARREFOUR LANGELIER
LIST OF SMALL SHOPPING CENTRES IN MONTREAL	SHOPPINGMALLNAME	PLACE LASALLE
LIST OF SMALL SHOPPING CENTRES IN MONTREAL	SHOPPINGMALLNAME	COMPLEXE POINTE CLAIRE
MONROE CROSSING	SHOPPINGMALLNAME	MONROE CROSSING MALL
PLACE NEWMAN	SHOPPINGMALLNAME	PLACE NEWMAN
DORT MALL	SHOPPINGMALLNAME	DORT MALL
LEBANON VALLEY MALL	SHOPPINGMALLNAME	LEBANON VALLEY MALL
CHANGI CITY POINT	SHOPPINGMALLNAME	CHANGI CITY POINT
CHERRY LANE SHOPPING CENTRE	SHOPPINGMALLNAME	CHERRY LANE SHOPPING CENTRE
LANSING CITY MARKET	SHOPPINGMALLNAME	LANSING CITY MARKET
NORTH HANOVER MALL	SHOPPINGMALLNAME	NORTH HANOVER MALL
NORTHWOODS MALL	SHOPPINGMALLNAME	NORTHWOODS MALL
LAKESHORE MALL	SHOPPINGMALLNAME	LAKESHORE MALL
OMACHE SHOPPING CENTER	SHOPPINGMALLNAME	OMACHE SHOPPING CENTER
BASSETT PLACE	SHOPPINGMALLNAME	BASSETT PLACE
MESILLA VALLEY MALL	SHOPPINGMALLNAME	MESILLA VALLEY MALL
SOONER MALL	SHOPPINGMALLNAME	SOONER MALL
NORTHPARK MALL	SHOPPINGMALLNAME	THE SHOPPES AT NORTHPARK
SHAWNEE MALL	SHOPPINGMALLNAME	SHAWNEE MALL
KILLEEN MALL	SHOPPINGMALLNAME	KILLEEN MALL
TEMPLE MALL	SHOPPINGMALLNAME	TEMPLE MALL
RICHLAND MALL	SHOPPINGMALLNAME	RICHLAND MALL
WILLIAMSBURG PREMIUM OUTLETS	SHOPPINGMALLNAME	WILLIAMSBURG PREMIUM OUTLETS
LA PLAZA MALL	SHOPPINGMALLNAME	LA PLAZA MALL
VALLE VISTA MALL	SHOPPINGMALLNAME	VALLE VISTA MALL
SQUARE 2	SHOPPINGMALLNAME	SQUARE 2
THE SHOPS AT WESTSHORE	SHOPPINGMALLNAME	THE SHOPS AT WESTSHORE
PEARSON PLAZA	SHOPPINGMALLNAME	PEARSON PLAZA
WASHINGTON PARK MALL	SHOPPINGMALLNAME	WASHINGTON PARK MALL
ARROWHEAD MALL	SHOPPINGMALLNAME	ARROWHEAD MALL
SM CITY CAUAYAN	SHOPPINGMALLNAME	SM CITY CAUAYAN
FOREST MALL	SHOPPINGMALLNAME	FOREST MALL
EAST YORK TOWN CENTRE	SHOPPINGMALLNAME	EAST YORK TOWN CENTRE
LIMA MALL	SHOPPINGMALLNAME	LIMA MALL
WEST PARK MALL	SHOPPINGMALLNAME	WEST PARK MALL
ALDERLAND CENTRE	SHOPPINGMALLNAME	ALDERLAND CENTRE
AROOSTOOK CENTRE MALL	SHOPPINGMALLNAME	AROOSTOOK CENTRE MALL
MAGNOLIA MALL	SHOPPINGMALLNAME	MAGNOLIA MALL
REMINGTON CENTRE	SHOPPINGMALLNAME	REMINGTON CENTRE MALL
WRENTHAM VILLAGE PREMIUM OUTLETS	SHOPPINGMALLNAME	WRENTHAM VILLAGE PREMIUM OUTLETS
MONTGOMERY MALL	SHOPPINGMALLNAME	MONTGOMERY MALL
POLO PARK MALL	SHOPPINGMALLNAME	POLO PARK MALL
BRIDLEWOOD MALL	SHOPPINGMALLNAME	BRIDLEWOOD MALL
DALMA GARDEN MALL	SHOPPINGMALLNAME	DALMA GARDEN MALL
MOBILE FESTIVAL CENTRE	SHOPPINGMALLNAME	MOBILE FESTIVAL CENTRE
FRIARS SQUARE	SHOPPINGMALLNAME	FRIARS SQUARE
WESTFIELD SOUTHGATE	SHOPPINGMALLNAME	WESTFIELD SOUTHGATE
SANTA ROSA PLAZA	SHOPPINGMALLNAME	SANTA ROSA PLAZA
CODDINGTOWN MALL	SHOPPINGMALLNAME	CODDINGTOWN MALL
SANTA ROSA MALL	SHOPPINGMALLNAME	SANTA ROSA MALL
PLAZA RIO HONDO	SHOPPINGMALLNAME	PLAZA RIO HONDO
THE ORCHARDS MALL	SHOPPINGMALLNAME	THE ORCHARDS MALL
CHAUTAUQUA MALL	SHOPPINGMALLNAME	CHAUTAUQUA MALL
MUNCIE MALL	SHOPPINGMALLNAME	MUNCIE MALL
TIPPECANOE MALL	SHOPPINGMALLNAME	TIPPECANOE MALL
SOUTHTOWN MALL	SHOPPINGMALLNAME	SOUTHTOWN MALL
MARKLAND MALL	SHOPPINGMALLNAME	MARKLAND MALL
WEST RIDGE MALL	SHOPPINGMALLNAME	WEST RIDGE MALL
JEFFERSON VALLEY MALL	SHOPPINGMALLNAME	JEFFERSON VALLEY MALL
GULF VIEW SQUARE	SHOPPINGMALLNAME	GULF VIEW SQUARE
INDIAN RIVER MALL	SHOPPINGMALLNAME	INDIAN RIVER MALL
LONGVIEW MALL	SHOPPINGMALLNAME	LONGVIEW MALL
MELBOURNE SQUARE	SHOPPINGMALLNAME	MELBOURNE SQUARE
PADDOCK MALL	SHOPPINGMALLNAME	PADDOCK MALL
PIER PARK	SHOPPINGMALLNAME	PIER PARK
TYRONE SQUARE MALL	SHOPPINGMALLNAME	TYRONE SQUARE MALL
UNIVERSITY TOWN PLAZA	SHOPPINGMALLNAME	UNIVERSITY TOWN PLAZA
MIDLAND PARK MALL	SHOPPINGMALLNAME	MIDLAND PARK MALL
CLAY TERRACE	SHOPPINGMALLNAME	CLAY TERRACE
HAMILTON TOWN CENTER	SHOPPINGMALLNAME	HAMILTON TOWN CENTER
EASTLAND MALL	SHOPPINGMALLNAME	EASTLAND MALL
CRYSTAL RIVER MALL	SHOPPINGMALLNAME	CRYSTAL RIVER MALL
VIAPORT FLORIDA	SHOPPINGMALLNAME	VIAPORT FLORIDA
TURTLE CREEK MALL	SHOPPINGMALLNAME	TURTLE CREEK MALL
THE MALL AT SOUTH UNIONVILLE SQUARE	SHOPPINGMALLNAME	THE MALL AT LANGHAM SQUARE
CHERRYLAND CENTER	SHOPPINGMALLNAME	CHERRYLAND CENTER
SEAWAY MALL	SHOPPINGMALLNAME	SEAWAY MALL
OLD HICKORY MALL	SHOPPINGMALLNAME	OLD HICKORY MALL
MAJURA PARK SHOPPING CENTRE	SHOPPINGMALLNAME	MAJURA PARK SHOPPING CENTRE
MANASSAS MALL	SHOPPINGMALLNAME	MANASSAS MALL
HYLAN PLAZA	SHOPPINGMALLNAME	HYLAN PLAZA
PALMERSTON SHOPPING CENTRE	SHOPPINGMALLNAME	PALMERSTON SHOPPING CENTRE
SHAHBA MALL	SHOPPINGMALLNAME	SHAHBA MALL
EAST HILLS MALL	SHOPPINGMALLNAME	EAST HILLS MALL
EAST HILLS SHOPPING CENTER	SHOPPINGMALLNAME	EAST HILLS SHOPPING CENTER
PARKWAY CENTER MALL	SHOPPINGMALLNAME	PARKWAY CENTER MALL
PROVO TOWNE CENTRE	SHOPPINGMALLNAME	PROVO TOWNE CENTRE
WESTLAND MALL	SHOPPINGMALLNAME	WESTLAND MALL
HICKORY POINT MALL	SHOPPINGMALLNAME	HICKORY POINT MALL
ST. CLAIR SQUARE	SHOPPINGMALLNAME	ST. CLAIR SQUARE
GULF COAST TOWN CENTER	SHOPPINGMALLNAME	GULF COAST TOWN CENTER
IMPERIAL VALLEY MALL	SHOPPINGMALLNAME	IMPERIAL VALLEY MALL
WAUSAU CENTER	SHOPPINGMALLNAME	WAUSAU CENTER
PANAMA CITY MALL	SHOPPINGMALLNAME	PANAMA CITY MALL
RANDOLPH MALL	SHOPPINGMALLNAME	RANDOLPH MALL
RIVER RIDGE MALL	SHOPPINGMALLNAME	RIVER RIDGE MALL
PARK MEADOWS	SHOPPINGMALLNAME	PARK MEADOWS
HERITAGE MALL	SHOPPINGMALLNAME	HERITAGE MALL
GRAND CENTRAL PLAZA	SHOPPINGMALLNAME	GRAND CENTRAL PLAZA
GRAND CENTURY PLACE	SHOPPINGMALLNAME	MOKO
NEW ROCHELLE MALL	SHOPPINGMALLNAME	NEW ROCHELLE MALL
AMBARRUKMO PLAZA	SHOPPINGMALLNAME	AMBARRUKMO PLAZA YOGYAKARTA
PASEO INTERLOMAS	SHOPPINGMALLNAME	PASEO INTERLOMAS
NORTHLINE MALL	SHOPPINGMALLNAME	NORTHLINE MALL
EAGLE RIDGE MALL	SHOPPINGMALLNAME	EAGLE RIDGE MALL
SOUTHGATE MALL	SHOPPINGMALLNAME	SOUTHGATE MALL
CANBERRA OUTLET CENTRE	SHOPPINGMALLNAME	CANBERRA OUTLET CENTRE
COLONY SQUARE MALL	SHOPPINGMALLNAME	COLONY SQUARE MALL
JEM	SHOPPINGMALLNAME	JEM
ROBINSONS METRO EAST	SHOPPINGMALLNAME	ROBINSONS METRO EAST
MIDDLESBORO MALL	SHOPPINGMALLNAME	MIDDLESBORO MALL
ROCCA AL MARE SHOPPING CENTRE	SHOPPINGMALLNAME	ROCCA AL MARE
THE MALL AT WESTLAKE	SHOPPINGMALLNAME	THE MALL AT WESTLAKE
WATERWAY POINT	SHOPPINGMALLNAME	WATERWAY POINT
WATERWAY POINT	SHOPPINGMALLNAME	170
FOORUM	SHOPPINGMALLNAME	FOORUM
JäRVE CENTRE	SHOPPINGMALLNAME	JäRVE KESKUS
KRISTIINE CENTRE	SHOPPINGMALLNAME	KRISTIINE KESKUS
KUNINGAN CITY	SHOPPINGMALLNAME	KUNINGAN CITY
SLAVYANSKIY MIR	SHOPPINGMALLNAME	SLAVYANSKIY MIR
DRESS SMART	SHOPPINGMALLNAME	DRESS SMART
NORTHERN LIGHTS SHOPPING CENTER	SHOPPINGMALLNAME	NORTHERN LIGHTS SHOPPING CENTER
GOTEMBA PREMIUM OUTLETS	SHOPPINGMALLNAME	GOTEMBA PREMIUM OUTLETS
360 MALL	SHOPPINGMALLNAME	360
THE CENTRE AT FORESTVILLE	SHOPPINGMALLNAME	THE CENTRE AT FORESTVILLE
BARKERS OF KENSINGTON	SHOPPINGMALLNAME	BARKERS OF KENSINGTON
TORONTO PREMIUM OUTLETS	SHOPPINGMALLNAME	TORONTO PREMIUM OUTLETS
GATEWAY TOWN CENTER	SHOPPINGMALLNAME	GATEWAY TOWN CENTER
PLAZA INTER	SHOPPINGMALLNAME	PLAZA INTER
SM CITY SAN MATEO	SHOPPINGMALLNAME	SM CITY SAN MATEO
SM CENTER ANGONO	SHOPPINGMALLNAME	SM CENTER ANGONO
SOUTH SIDE MALL	SHOPPINGMALLNAME	SOUTH SIDE MALL
SOFIA RING MALL	SHOPPINGMALLNAME	SOFIA RING MALL
HIGHFIELD SQUARE	SHOPPINGMALLNAME	HIGHFIELD SQUARE
KINGSDALE SHOPPING CENTER	SHOPPINGMALLNAME	KINGSDALE SHOPPING CENTER
WESTGATE, NAIROBI	SHOPPINGMALLNAME	WESTGATE SHOPPING MALL
QUEST MALL	SHOPPINGMALLNAME	QUEST
MUSKEGON MALL	SHOPPINGMALLNAME	MUSKEGON MALL
TOWSON PLACE	SHOPPINGMALLNAME	TOWSON PLACE
DANA MALL	SHOPPINGMALLNAME	DANA MALL
MIAMI VALLEY CENTRE MALL	SHOPPINGMALLNAME	MIAMI VALLEY ENTRE MALL
FASHION OUTLETS OF CHICAGO	SHOPPINGMALLNAME	FASHION OUTLETS OF CHICAGO
DANVILLE MALL	SHOPPINGMALLNAME	DANVILLE MALL
CAROLINA MALL	SHOPPINGMALLNAME	CAROLINA MALL
VILLAGE OF MARTINSVILLE	SHOPPINGMALLNAME	VILLAGE OF MARTINSVILLE
VILLAGE MALL	SHOPPINGMALLNAME	VILLAGE MALL
MARINE POINT	SHOPPINGMALLNAME	MARINE POINT
GAISANO MALL OF DAVAO	SHOPPINGMALLNAME	GAISANO MALL OF DAVAO
SOUTHSIDE MALL	SHOPPINGMALLNAME	SOUTHSIDE MALL
KENSINGTON ARCADE	SHOPPINGMALLNAME	KENSINGTON ARCADE
FISKETORVET	SHOPPINGMALLNAME	FISKETORVET
FISHER MALL	SHOPPINGMALLNAME	FISHER MALL
CITY CENTRE FUJAIRAH	SHOPPINGMALLNAME	CITY CENTRE FUJAIRAH
EUGENE MALL	SHOPPINGMALLNAME	EUGENE MALL
JAUDE CENTRE	SHOPPINGMALLNAME	JAUDE CENTRE
PINNACLE HILLS PROMENADE	SHOPPINGMALLNAME	PINNACLE HILLS PROMENADE
CENTRAL MALL	SHOPPINGMALLNAME	CENTRAL MALL
SOUTHBAY PAVILION	SHOPPINGMALLNAME	SOUTHBAY PAVILION
CHULA VISTA CENTER	SHOPPINGMALLNAME	CHULA VISTA CENTER
BELLIS FAIR MALL	SHOPPINGMALLNAME	BELLIS FAIR
PALLADIUM	SHOPPINGMALLNAME	PALLADIUM
SEACON BANGKAE	SHOPPINGMALLNAME	SEACON BANGKAE
GROSSMONT CENTER	SHOPPINGMALLNAME	GROSSMONT CENTER
NEWGATE MALL	SHOPPINGMALLNAME	NEWGATE MALL
EDGEWATER MALL	SHOPPINGMALLNAME	EDGEWATER MALL
SM CITY BF PARAñAQUE	SHOPPINGMALLNAME	SM CITY BF PARAñAQUE
THE DISTRICT	SHOPPINGMALLNAME	THE DISTRICT - DASMARIñAS
THE DISTRICT	SHOPPINGMALLNAME	THE DISTRICT- IMUS
LCC MALL	SHOPPINGMALLNAME	LCC  CENTRAL MALL
BIRCH RUN PREMIUM OUTLETS	SHOPPINGMALLNAME	BIRCH RUN PREMIUM OUTLETS
WESTGATE	SHOPPINGMALLNAME	WESTGATE
BEDOK MALL	SHOPPINGMALLNAME	BEDOK MALL
NOVý SMíCHOV	SHOPPINGMALLNAME	NOVý SMíCHOV
BERKELEY MALL	SHOPPINGMALLNAME	BERKELEY MALL
SM CITY GENERAL SANTOS	SHOPPINGMALLNAME	SM CITY GENERAL SANTOS
COLUMBIA MALL	SHOPPINGMALLNAME	COLUMBIA MALL
GOLDEN EAST CROSSING	SHOPPINGMALLNAME	GOLDEN EAST CROSSING
ROBINSONS PLACE BUTUAN	SHOPPINGMALLNAME	ROBINSONS PLACE BUTUAN
SALFORD SHOPPING CENTRE	SHOPPINGMALLNAME	SALFORD SHOPPING CENTRE
MCCANDLESS CROSSING	SHOPPINGMALLNAME	MCCANDLESS CROSSING
THE STREET CHESTNUT HILL	SHOPPINGMALLNAME	THE STREET CHESTNUT HILL
BENTALL CENTRE, KINGSTON	SHOPPINGMALLNAME	THE BENTALL CENTRE, KINGSTON
WEBERSTOWN MALL	SHOPPINGMALLNAME	WEBERSTOWN MALL
SHERWOOD MALL	SHOPPINGMALLNAME	SHERWOOD MALL
WEST 7TH FORT WORTH	SHOPPINGMALLNAME	WEST 7TH
PRESCOT SHOPPING CENTRE	SHOPPINGMALLNAME	PRESCOT SHOPPING CENTRE
ROBINSONS PLACE SANTIAGO	SHOPPINGMALLNAME	ROBINSONS PLACE SANTIAGO
KING SQUARE SHOPPING MALL	SHOPPINGMALLNAME	KING SQUARE SHOPPING MALL
PROVIDENCE TOWN CENTER	SHOPPINGMALLNAME	PROVIDENCE TOWN CENTER
DOLPHIN SHOPPING CENTRE	SHOPPINGMALLNAME	DOLPHIN SHOPPING CENTRE
FINDLAY VILLAGE MALL	SHOPPINGMALLNAME	FINDLAY VILLAGE MALL
ISETANN CINERAMA RECTO	SHOPPINGMALLNAME	ISETANN CINERAMA RECTO
TANGER OUTLETS PITTSBURGH	SHOPPINGMALLNAME	TANGER OUTLETS PITTSBURGH
THE VILLAGE SUBWAY	SHOPPINGMALLNAME	THE VILLAGE SUBWAY
GOLDEN ROCK SHANDY	SHOPPINGMALLNAME	GOLDEN ROCK SHANDY
PROTEA GLEN MALL	SHOPPINGMALLNAME	PROTEA GLEN MALL
ORION MALL	SHOPPINGMALLNAME	ORION MALL
THE FORUM VIJAYA	SHOPPINGMALLNAME	FORUM VIJAYA MALL
THE FORUM VALUE	SHOPPINGMALLNAME	THE FORUM VALUE
PHOENIX MARKET CITY	SHOPPINGMALLNAME	PHOENIX MARKETCITY
ROBINSONS PLACE ROXAS	SHOPPINGMALLNAME	ROBINSONS PLACE ROXAS
THE PULSE	SHOPPINGMALLNAME	THE PULSE
MAJESTIC CITY	SHOPPINGMALLNAME	MAJESTIC CITY
GALLATIN VALLEY MALL	SHOPPINGMALLNAME	GALLATIN VALLEY MALL
CAPITAL MALL	SHOPPINGMALLNAME	CAPITAL MALL
DONETSK CITY	SHOPPINGMALLNAME	DONETSK CITY
DONETSK CITY	SHOPPINGMALLNAME	Донецьк-Сіті
CARGILLS SQUARE	SHOPPINGMALLNAME	CARGILLS SQUARE
PLAZA DEL CARMEN MALL	SHOPPINGMALLNAME	PLAZA DEL CARMEN MALL
BARKLY SQUARE	SHOPPINGMALLNAME	BARKLY SQUARE
CITY CENTRE MALL, SHIMOGA	SHOPPINGMALLNAME	CITY CENTRE MALL
PHOENIX MARKET CITY	SHOPPINGMALLNAME	PHOENIX MARKETCITY CHENNAI..
MALL OF JOY, THRISSUR	SHOPPINGMALLNAME	MALL OF JOY
NAGALAND E-MALL	SHOPPINGMALLNAME	NAGALAND E-MALL
GRAND TETON MALL	SHOPPINGMALLNAME	GRAND TETON MALL
YEREVAN MALL	SHOPPINGMALLNAME	YEREVAN MALL
SALMON RUN MALL	SHOPPINGMALLNAME	SALMON RUN MALL
ARENA PLAZA	SHOPPINGMALLNAME	ARENA PLAZA
FAIRVIEW TERRACES	SHOPPINGMALLNAME	FAIRVIEW TERRACES
FIVE POINTS MALL	SHOPPINGMALLNAME	FIVE POINTS MALL
LANDMARK MALL DOHA	SHOPPINGMALLNAME	LANDMARK
NORTH TOWN CENTRE	SHOPPINGMALLNAME	NORTH TOWN CENTRE
LAS AMERICAS PREMIUM OUTLETS	SHOPPINGMALLNAME	LAS AMERICAS PREMIUM OUTLETS
FORUM ROBINSONS	SHOPPINGMALLNAME	FORUM ROBINSONS
FORUM ROBINSONS	SHOPPINGMALLNAME	( ROBINSONS PLACE PIONEER )
SURREY QUAYS SHOPPING CENTRE	SHOPPINGMALLNAME	SURREY QUAYS SHOPPING CENTRE
OUTLET SHOPPES OF THE BLUEGRASS	SHOPPINGMALLNAME	OUTLET SHOPPES OF THE BLUEGRASS
STONY BROOK VILLAGE CENTER	SHOPPINGMALLNAME	STONY BROOK VILLAGE CENTER
PHOENIX MARKET CITY MUMBAI	SHOPPINGMALLNAME	PHOENIX MARKET CITY
RUA 24 HORAS	SHOPPINGMALLNAME	RUA 24 HORAS
ELANTE MALL	SHOPPINGMALLNAME	ELANTE MALL
SELETAR MALL	SHOPPINGMALLNAME	THE SELETAR MALL
ORCHARD GATEWAY	SHOPPINGMALLNAME	ORCHARD GATEWAY
CHINATOWN POINT	SHOPPINGMALLNAME	CHINATOWN POINT
THOMSON PLAZA	SHOPPINGMALLNAME	THOMSON PLAZA
KCC MALL DE ZAMBOANGA	SHOPPINGMALLNAME	KCC MALL DE ZAMBOANGA
EDGEWOOD TOWNE CENTRE	SHOPPINGMALLNAME	EDGEWOOD TOWNE CENTRE
DECARIE SQUARE	SHOPPINGMALLNAME	DECARIE SQUARE
THE BRIDGES AT MINT HILL	SHOPPINGMALLNAME	THE BRIDGES AT MINT HILL
ROBINSONS NOVALICHES	SHOPPINGMALLNAME	ROBINSONS NOVALICHES
ROGERS PLAZA	SHOPPINGMALLNAME	ROGERS PLAZA
OUTLET COLLECTION AT NIAGARA	SHOPPINGMALLNAME	OUTLET COLLECTION AT NIAGARA
WOODSIDE SQUARE	SHOPPINGMALLNAME	WOODSIDE SQUARE
RP MALL, KOLLAM	SHOPPINGMALLNAME	RP MALL
STRATHFIELD PLAZA	SHOPPINGMALLNAME	STRATHFIELD PLAZA
SHIMANTO SQUARE	SHOPPINGMALLNAME	SHIMANTO SQUARE
TIKAHTNU COMMONS	SHOPPINGMALLNAME	TIKAHTNU COMMONS
DERBY STREET SHOPPES	SHOPPINGMALLNAME	DERBY STREET SHOPPES
ROBINSONS PLACE ANTIPOLO	SHOPPINGMALLNAME	ROBINSONS ANTIPOLO
GLENN SQUARE	SHOPPINGMALLNAME	GLENN SQUARE
RIVERGATE	SHOPPINGMALLNAME	RIVERGATE
URBAN OASIS MALL	SHOPPINGMALLNAME	URBAN OASIS MALL
OLD DUTCH HOSPITAL, GALLE	SHOPPINGMALLNAME	OLD DUTCH HOSPITAL, GALLE
CENTER CITY MALL	SHOPPINGMALLNAME	CENTER CITY MALL
WEST HILLS MALL	SHOPPINGMALLNAME	WEST HILLS
OUTLETS OF MISSISSIPPI	SHOPPINGMALLNAME	OUTLETS OF MISSISSIPPI
LOTUS MALL	SHOPPINGMALLNAME	LOTUS SHOPPING MALL
VILLAGE AT LEESBURG	SHOPPINGMALLNAME	VILLAGE AT LEESBURG
MAK MALL	SHOPPINGMALLNAME	MAK MALL
SUN PLAZA	SHOPPINGMALLNAME	SUN PLAZA
ABQ UPTOWN	SHOPPINGMALLNAME	ABQ UPTOWN
MONTGOMERY VILLAGE SHOPPING CENTER	SHOPPINGMALLNAME	MONTGOMERY VILLAGE
NEBRASKA CROSSING OUTLETS	SHOPPINGMALLNAME	NEBRASKA CROSSING OUTLETS
PALAS IAșI	SHOPPINGMALLNAME	PALAS IAșI
CITYMALL ARNALDO-ROXAS	SHOPPINGMALLNAME	CITYMALL ARNALDO-ROXAS
RO'S TORV	SHOPPINGMALLNAME	RO'S TORV
LINCOLN PARK SHOPPING CENTER	SHOPPINGMALLNAME	LINCOLN PARK SHOPPING CENTER
FORTRESS SQUARE	SHOPPINGMALLNAME	FORTRESS SQUARE
LAS CATALINAS MALL	SHOPPINGMALLNAME	LAS CATALINAS MALL
ROBINSONS PLACE LAS PIñAS	SHOPPINGMALLNAME	ROBINSONS PLACE LAS PIñAS
LUCKY CHINATOWN	SHOPPINGMALLNAME	LUCKY CHINATOWN
OXFORD STREET MALL	SHOPPINGMALLNAME	OXFORD STREET
FISHERMAN'S VILLAGE	SHOPPINGMALLNAME	FISHERMAN'S VILLAGE
KOMTAR JBCC	SHOPPINGMALLNAME	KOMTAR JBCC
THE MALL OF SAN JUAN	SHOPPINGMALLNAME	THE MALL OF SAN JUAN
KOTVA DEPARTMENT STORE	SHOPPINGMALLNAME	KOTVA DEPARTMENT STORE
OBCHODNí CENTRUM LETňANY	SHOPPINGMALLNAME	OC LETňANY
NORTH PIER	SHOPPINGMALLNAME	NORTH PIER
MALL AT UNIVERSITY TOWN CENTER	SHOPPINGMALLNAME	THE MALL AT UNIVERSITY TOWN CENTER
THE QUAYS NEWRY	SHOPPINGMALLNAME	THE QUAYS NEWRY
SM MEGACENTER CABANATUAN	SHOPPINGMALLNAME	SM MEGACENTER CABANATUAN
SM CITY CABANATUAN	SHOPPINGMALLNAME	SM CITY CABANATUAN
SILVERBIRD GALLERIA	SHOPPINGMALLNAME	SILVERBIRD GALLERIA
ROBINSONS TOWN MALL MALABON	SHOPPINGMALLNAME	ROBINSONS TOWN MALL MALABON
TOWNE CENTRE AT LAUREL	SHOPPINGMALLNAME	TOWNE CENTRE AT LAUREL
BROADWAY PLAZA	SHOPPINGMALLNAME	BROADWAY PLAZA
FLAGSTAFF MALL	SHOPPINGMALLNAME	FLAGSTAFF MALL
1800 N. CLYBOURN	SHOPPINGMALLNAME	CLYBOURN SQUARE
MARINA MALL ACCRA	SHOPPINGMALLNAME	MARINA MALL
JUNCTION MALL ACCRA	SHOPPINGMALLNAME	JUNCTION MALL
ANAHEIM GARDENWALK	SHOPPINGMALLNAME	ANAHEIM GARDENWALK
CONJUNTO NACIONAL	SHOPPINGMALLNAME	CONJUNTO NACIONAL
TEMA CENTRAL MALL	SHOPPINGMALLNAME	TEMA CENTRAL MALL
ARCADE INDEPENDENCE SQUARE	SHOPPINGMALLNAME	ARCADE - INDEPENDENCE SQUARE
WORLD TRADE PARK, JAIPUR	SHOPPINGMALLNAME	WORLD TRADE PARK
SHOWCASE MALL	SHOPPINGMALLNAME	SHOWCASE MALL
PARKHURST TOWN CENTRE	SHOPPINGMALLNAME	PARKHURST TOWN CENTRE
EAST RIVER PLAZA	SHOPPINGMALLNAME	EAST RIVER PLAZA
SM CENTER SANGANDAAN	SHOPPINGMALLNAME	SM CENTER SANGANDAAN
ABDALI MALL	SHOPPINGMALLNAME	ABDALI MALL
CENTRALPLAZA WESTGATE	SHOPPINGMALLNAME	CENTRALPLAZA WESTGATE
TSAWWASSEN MILLS	SHOPPINGMALLNAME	TSAWWASSEN MILLS
LANGHAM SQUARE	SHOPPINGMALLNAME	LANGHAM SQUARE
NORTHWEST SHOPPING CENTRE	SHOPPINGMALLNAME	NORTHWEST MALL
CITYMALL TETUAN-ZAMBOANGA	SHOPPINGMALLNAME	CITYMALL TETUAN-ZAMBOANGA
WESTFIELD PALM DESERT	SHOPPINGMALLNAME	WESTFIELD PALM DESERT
BISHOP JEROME NAGAR	SHOPPINGMALLNAME	BISHOP JEROME NAGAR
STOCKLAND HERVEY BAY	SHOPPINGMALLNAME	STOCKLAND HERVEY BAY
SETAPAK CENTRAL	SHOPPINGMALLNAME	SETAPAK CENTRAL
FAIRLANE GREEN	SHOPPINGMALLNAME	FAIRLANE GREEN
H&J MALL	SHOPPINGMALLNAME	H&J MALL
U.P. TOWN CENTER	SHOPPINGMALLNAME	U.P. TOWN CENTER
CENTURY CITY MALL	SHOPPINGMALLNAME	CENTURY CITY MALL
DOMAIN	SHOPPINGMALLNAME	DOMAIN
FORUM LVIV	SHOPPINGMALLNAME	FORUM LVIV
FREDERICK TOWNE MALL	SHOPPINGMALLNAME	FREDERICK TOWNE MALL
BELMAR	SHOPPINGMALLNAME	BELMAR
PUNGGOL PLAZA	SHOPPINGMALLNAME	PUNGGOL PLAZA
SM CITY SAN JOSE DEL MONTE	SHOPPINGMALLNAME	SM CITY SAN JOSE DEL MONTE
SM CITY TRECE MARTIRES	SHOPPINGMALLNAME	SM CITY TRECE MARTIRES
LA CUMBRE PLAZA	SHOPPINGMALLNAME	LA CUMBRE PLAZA
ACHIMOTA RETAIL CENTRE	SHOPPINGMALLNAME	ACHIMOTA RETAIL CENTRE
K-ZONE JA-ELA	SHOPPINGMALLNAME	K-ZONE JA-ELA
RøDOVRE CENTRUM	SHOPPINGMALLNAME	RøDOVRE CENTRUM
RIVER OAKS DISTRICT	SHOPPINGMALLNAME	RIVER OAKS DISTRICT
WAYZATA BAY CENTER	SHOPPINGMALLNAME	WAYZATA BAY CENTER
TRAVERSE CITY PREMIUM OUTLETS	SHOPPINGMALLNAME	TRAVERSE CITY PREMIUM OUTLETS, HORIZON OUTLETS
THE GROVE	SHOPPINGMALLNAME	THE GROVE
FOUR SEASONS MALL	SHOPPINGMALLNAME	FOUR SEASONS MALL
SLOTSARKADERNE	SHOPPINGMALLNAME	SLOTSARKADERNE
PUTNEY EXCHANGE	SHOPPINGMALLNAME	PUTNEY EXCHANGE
ST IVES SHOPPING VILLAGE	SHOPPINGMALLNAME	ST IVES SHOPPING VILLAGE
ROSSIA MALL	SHOPPINGMALLNAME	ROSSIA MALL
EMPORIUM MALL	SHOPPINGMALLNAME	EMPORIUM MALL
TIBA OUTLET MALL	SHOPPINGMALLNAME	TIBA OUTLET MALL
SHOPPING CITY TIMIșOARA	SHOPPINGMALLNAME	SHOPPING CITY TIMIșOARA
DEE WHY GRAND SHOPPING CENTRE	SHOPPINGMALLNAME	DEE WHY GRAND
THE PINES, ELANORA	SHOPPINGMALLNAME	THE PINES,ELANORA
JUFFAIR MALL	SHOPPINGMALLNAME	JUFFAIR MALL
MCGOWIN PARK	SHOPPINGMALLNAME	MCGOWIN PARK
WARRIEWOOD SQUARE	SHOPPINGMALLNAME	WARRIEWOOD SQUARE
VR BENGALURU	SHOPPINGMALLNAME	VR BENGALURU
ALBROOK MALL	SHOPPINGMALLNAME	ALBROOK MALL
SAFA GOLD MALL	SHOPPINGMALLNAME	SAFA GOLD MALL
Z SQUARE MALL, KANPUR	SHOPPINGMALLNAME	Z SQUARE MALL
MALL DE GOA	SHOPPINGMALLNAME	MALL DE GOA
KO OLINA STATION AND CENTER	SHOPPINGMALLNAME	KO OLINA STATION AND CENTER
EASTGATE BONDI JUNCTION	SHOPPINGMALLNAME	EASTGATE BONDI JUNCTION
GOLD SOUK GRANDE, KOCHI	SHOPPINGMALLNAME	GOLD SOUK GRANDE, KOCHI
CENTRE CITY MALL, DUNEDIN	SHOPPINGMALLNAME	CENTRE CITY MALL
Q1 MALL	SHOPPINGMALLNAME	Q1 MALL
A&C MALL	SHOPPINGMALLNAME	A&C MALL
DOCK STREET MARKET	SHOPPINGMALLNAME	DOCK STREET MARKET
BASS HILL PLAZA	SHOPPINGMALLNAME	BASS HILL PLAZA
BRANDON SHOPPERS MALL	SHOPPINGMALLNAME	BRANDON SHOPPERS MALL
LIDCOMBE SHOPPING CENTRE	SHOPPINGMALLNAME	LIDCOMBE SHOPPING CENTRE
CASULA MALL	SHOPPINGMALLNAME	CASULA MALL
BURWOOD PLAZA	SHOPPINGMALLNAME	BURWOOD PLAZA
ROCKDALE PLAZA	SHOPPINGMALLNAME	ROCKDALE PLAZA
ASHFIELD MALL	SHOPPINGMALLNAME	ASHFIELD MALL
GRAND GALAXY PARK	SHOPPINGMALLNAME	GRAND GALAXY PARK
ROBINSONS PLACE JARO	SHOPPINGMALLNAME	ROBINSONS PLACE JARO
MIDTOWN SQUARE MALL	SHOPPINGMALLNAME	MIDTOWN SQUARE MALL
DLF MALL OF INDIA	SHOPPINGMALLNAME	DLF MALL OF INDIA
AVION SHOPPING PARK	SHOPPINGMALLNAME	AVION SHOPPING PARK
CHATSWOOD INTERCHANGE	SHOPPINGMALLNAME	CHATSWOOD INTERCHANGE
MANDARIN CENTRE	SHOPPINGMALLNAME	MANDARIN CENTRE
NEW MARKET SQUARE	SHOPPINGMALLNAME	NEW MARKET SQUARE
GORDON CENTRE	SHOPPINGMALLNAME	GORDON CENTRE
HILITE BUSINESS PARK	SHOPPINGMALLNAME	HILITE BUSINESS PARK
