ABRAHAM LINCOLN	SIGNATURE	ABRAHAM LINCOLN 1862 SIGNATURE.SVG
ALBERT SPEER	SIGNATURE	ALBERT SPEER SIGNATURE.SVG
ALEXANDER MACKENZIE	SIGNATURE	ALEXANDER MACKENZIE SIGNATURE-RT.SVG
ANDREW JOHNSON	SIGNATURE	ANDREW JOHNSON SIGNATURE.SVG
ANDREW JACKSON	SIGNATURE	ANDREW JACKSON SIGNATURE-.SVG
ARNOLD SCHWARZENEGGER	SIGNATURE	ARNOLD SCHWARZENEGGER SIGNATURE.SVG
ARTHUR ST. CLAIR	SIGNATURE	ARTHUR ST CLAIR SIGNATURE.SVG
AUNG SAN SUU KYI	SIGNATURE	AUNG SAN SUU KYI SIGNATURE 2013.SVG
BENJAMIN FRANKLIN	SIGNATURE	BENJAMIN FRANKLIN SIGNATURE.SVG
BARRY GOLDWATER	SIGNATURE	BARRYGOLDWATERSIG.PNG
BOHDAN KHMELNYTSKY	SIGNATURE	XM AVT2.JPG
CHRISTOPHER COLUMBUS	SIGNATURE	COLUMBUS SIGNATURE.SVG
CHARLES TUPPER	SIGNATURE	CHARLES TUPPER SIGNATURE.SVG
CALVIN COOLIDGE	SIGNATURE	C COOLIDGE SIGNATURE.SVG
COLIN POWELL	SIGNATURE	COLIN LUTHER POWELL SIGNATURE.SVG
CHARLES EVANS HUGHES	SIGNATURE	CHARLES EVANS HUGHES SIGNATURE.SVG
DWIGHT D. EISENHOWER	SIGNATURE	DWIGHT EISENHOWER SIGNATURE.SVG
ARTHUR WELLESLEY, 1ST DUKE OF WELLINGTON	SIGNATURE	ARTHUR WELLESLEY, 1ST DUKE OF WELLINGTON SIGNATURE.SVG
DONALD RUMSFELD	SIGNATURE	DONALD RUMSFELD SIGNATURE.SVG
ERNEST RUTHERFORD	SIGNATURE	ERNEST RUTHERFORD SIG.JPG
ELIAS BOUDINOT	SIGNATURE	ELIAS BOUDINOT SIGNATURE.SVG
ELBRIDGE GERRY	SIGNATURE	ELBRIDGE GERRY SIGNATURE.SVG
FRANKLIN D. ROOSEVELT	SIGNATURE	FRANKLIN ROOSEVELT SIGNATURE.SVG
FIORELLO H. LA GUARDIA	SIGNATURE	FIORELLO LAGUARDIA SIGNATURE.SVG
FRANCISCO FRANCO	SIGNATURE	FRANCISCO FRANCO SIGNATURE.SVG
F. W. DE KLERK	SIGNATURE	FW DEKLERK SIGN.PNG
GEORGE WASHINGTON	SIGNATURE	GEORGE WASHINGTON SIGNATURE.SVG
GEORGE H. W. BUSH	SIGNATURE	GEORGE HW BUSH SIGNATURE.SVG
GOUGH WHITLAM	SIGNATURE	GOUGH WHITLAM SIGNATURE.SVG
GROVER CLEVELAND	SIGNATURE	GROVERCLEVELAND SIGNATURE.PNG
GEORGE HAMILTON-GORDON, 4TH EARL OF ABERDEEN	SIGNATURE	GEORGE HAMILTON-GORDON, 4TH EARL OF ABERDEEN SIGNATURE.SVG
GORDON BROWN	SIGNATURE	SIGNATURE OF GORDON BROWN.PNG
GRO HARLEM BRUNDTLAND	SIGNATURE	GRO HARLEM BRUNDTLAND SIGNATURE.SVG
HEINRICH HIMMLER	SIGNATURE	HIMMLER SIGNATURE 2.SVG
HERMANN GöRING	SIGNATURE	HERMANN GöRING SIGNATURE.SVG
HANS-DIETRICH GENSCHER	SIGNATURE	SIGNATURE1 ZWEI PLUS VIER VERTRAG.JPG
HERBERT HOOVER	SIGNATURE	HERBERT CLARK HOOVER SIGNATURE.SVG
HENRY KISSINGER	SIGNATURE	HENRY KISSINGER SIGNATURE 2.SVG
HAROLD HOLT	SIGNATURE	HAROLD HOLT SIGNATURE.JPG
HANNIBAL HAMLIN	SIGNATURE	HANNIBAL HAMLIN SIGNATURE.SVG
HERNáN CORTéS	SIGNATURE	HERNAN CORTES SIGNATURE.SVG
INDIRA GANDHI	SIGNATURE	INDIRA-GANDHI-SIGNATURE-TRANSPARENT.PNG
JOSEPH STALIN	SIGNATURE	STALIN SIGNATURE.SVG
JOHN QUINCY ADAMS	SIGNATURE	JOHN QUINCY ADAMS SIGNATURE.SVG
JOSEPH GOEBBELS	SIGNATURE	JOSEPH GOEBBELS SIGNATURE.SVG
JOHN LYNCH	SIGNATURE	JOHN LYNCH SIGNATURE.SVG
JOHN SPARROW DAVID THOMPSON	SIGNATURE	JSDTSIGNATURE.SVG
JOHN MAJOR	SIGNATURE	SIGNATURE OF JOHN MAJOR.PNG
JOHN A. MACDONALD	SIGNATURE	JOHN A MACDONALD SIGNATURE.SVG
DAN QUAYLE	SIGNATURE	DAN QUAYLE SIGNATURE 2.SVG
JAMES MADISON	SIGNATURE	JAMES MADISON SIG.SVG
JAMES MONROE	SIGNATURE	JAMES MONROE'S SIG.SVG
JAMES K. POLK	SIGNATURE	JAMES K POLK SIGNATURE.SVG
JIMMY CARTER	SIGNATURE	JIMMY CARTER SIGNATURE-2.SVG
J. EDGAR HOOVER	SIGNATURE	J EDGAR HOOVER SIGNATURE.SVG
JEFFERSON DAVIS	SIGNATURE	JEFFERSON DAVIS SIGNATURE.SVG
JAMES G. BLAINE	SIGNATURE	APPLETONS' BLAINE JAMES GILLESPIE SIGNATURE.JPG
JAWAHARLAL NEHRU	SIGNATURE	JAWAHARLAL NEHRU SIGNATURE.SVG
JOSEPH MCCARTHY	SIGNATURE	JOE MCCARTHY SIGNATURE.SVG
JOHN HANSON	SIGNATURE	JOHN HANSON SIGNATURE.SVG
JOHN HAY	SIGNATURE	JOHN HAY SIGNATURE.SVG
JOSIP BROZ TITO	SIGNATURE	TITO SIGNATURE.SVG
JOACHIM VON RIBBENTROP	SIGNATURE	JOACHIM VON RIBBENTROP SIGNATURE.SVG
JOSEPH LISTER, 1ST BARON LISTER	SIGNATURE	JOSEPH LISTER SIGNATURE.PNG
KONRAD ADENAUER	SIGNATURE	KONRAD ADENAUER SIGNATURE TRANSPARENT.PNG
KENESAW MOUNTAIN LANDIS	SIGNATURE	KENESAW MOUNTAIN LANDIS SIGNATURE.SVG
KOFI ANNAN	SIGNATURE	KOFI ANNAN SIGNATURE.SVG
KURT WALDHEIM	SIGNATURE	KURT WALDHEIM SIGNATURE.SVG
KONSTANTIN CHERNENKO	SIGNATURE	CHERNENKO SIGNATURE.SVG
TOSHIKI KAIFU	SIGNATURE	KAIFUT KAO.PNG
LAURA BUSH	SIGNATURE	LAURA BUSH SIGNATURE.SVG
KURT GEORG KIESINGER	SIGNATURE	KIESINGER SIGNATURE.JPG
LEON TROTSKY	SIGNATURE	LEON TROTSKY SIGNATURE.SVG
LAVRENTIY BERIA	SIGNATURE	LAVRENTIY BERIA SIGNATURE.SVG
MAO ZEDONG	SIGNATURE	MAO ZEDONG SIGNATURE.SVG
MACKENZIE BOWELL	SIGNATURE	SIR MACKENZIE BOWELL SIGNATURE.SVG
MARTIN VAN BUREN	SIGNATURE	MARTIN VAN BUREN SIGNATURE2.SVG
MARGARET THATCHER	SIGNATURE	SIGNATURE OF MARGARET THATCHER.SVG
MARY ROBINSON	SIGNATURE	MARYROBINSONSIGNATURE.JPG
MENACHEM BEGIN	SIGNATURE	MENACHEM BEGIN SIGNATURE.SVG
MIKHAIL GORBACHEV	SIGNATURE	GORBACHEV SIGNATURE.SVG
NANCY REAGAN	SIGNATURE	NREAGANSIGNATURE.JPG
OLIVER CROMWELL	SIGNATURE	SIGNATURE OF OLIVER CROMWELL .PNG
OTTO VON BISMARCK	SIGNATURE	OTTO VONBISMARCK SIGNATURE.SVG
PIERRE TRUDEAU	SIGNATURE	PIERRE TRUDEAU SIGNATURE 2.SVG
PETER STUYVESANT	SIGNATURE	PIETER STUYVESANT SIGNATURE.SVG
ROBERT BYRD	SIGNATURE	ROBERT C. BYRD SIGNATURE.SVG
RICHARD NIXON	SIGNATURE	RICHARD NIXON SIGNATURE.SVG
ROBERT BORDEN	SIGNATURE	RL BORDEN SIGNATURE.SVG
REINHARD HEYDRICH	SIGNATURE	REINHARD HEYDRICH SIGNATURES.SVG
RUDY GIULIANI	SIGNATURE	RUDY GIULIANI SIGNATURE.SVG
RICHARD HENRY LEE	SIGNATURE	RICHARD HENRY LEE SIGNATURE2.SVG
SILVIO BERLUSCONI	SIGNATURE	SILVIO BERLUSCONI SIGNATURE.SVG
SOONG MEI-LING	SIGNATURE	MAY-LING SOONG CHIANG SIGNATURE.SVG
SADDAM HUSSEIN	SIGNATURE	SADDAM HUSSEIN SIGNATURE.SVG
THOMAS JEFFERSON	SIGNATURE	THOMAS JEFFERSON SIGNATURE.SVG
THOMAS MORE	SIGNATURE	THOMAS MORE SIGNATURE.SVG
THEODORE ROOSEVELT	SIGNATURE	THEODORE ROOSEVELT SIGNATURE-2.SVG
TARJA HALONEN	SIGNATURE	TARJA HALONEN SIGNATURE.SVG
THOMAS MIFFLIN	SIGNATURE	THOMAS MIFFLIN SIGNATURE2.SVG
THOMAS MCKEAN	SIGNATURE	THOMAS MCKEAN SIGNATURE.SVG
THABO MBEKI	SIGNATURE	THABO MBEKI SIGNATURE.SVG
THOMAS R. MARSHALL	SIGNATURE	THOMAS R MARSHALL SIGNATURE.SVG
ULYSSES S. GRANT	SIGNATURE	ULYSSESSGRANTSIGNATURE.SVG
VIDKUN QUISLING	SIGNATURE	QUISLING SIGNATURE.PNG
VLADIMIR PUTIN	SIGNATURE	PUTIN SIGNATURE.SVG
WILLIAM THOMSON, 1ST BARON KELVIN	SIGNATURE	LORD KELVIN SIGNATURE.SVG
WILLIAM HENRY HARRISON	SIGNATURE	WILLIAM HENRY HARRISON SIGNATURE-FULL.SVG
WILFRID LAURIER	SIGNATURE	WILFRID LAURIER SIGNATURE2.SVG
WILLIAM LYON MACKENZIE KING	SIGNATURE	WILLIAM LYON MACKENZIE KING SIGNATURE.SVG
WILLIAM HOWARD TAFT	SIGNATURE	WILLIAM HOWARD TAFT SIGNATURE2.SVG
WILLIAM MCKINLEY	SIGNATURE	WILLIAM MCKINLEY SIGNATURE-FULL.SVG
WILLIAM RANDOLPH HEARST	SIGNATURE	WILLIAM RANDOLPH HEARST SIGNATURE.SVG
WOODROW WILSON	SIGNATURE	WOODROW WILSON SIGNATURE 2.SVG
WIM KOK	SIGNATURE	SIGNATURE OF WIM KOK.PNG
WILLIAM EWART GLADSTONE	SIGNATURE	WILLIAM EWART GLADSTONE SIGNATURE 2.SVG
GEORGE MARSHALL	SIGNATURE	GEORGE C MARSHALL SIGNATURE.SVG
FRANçOIS MITTERRAND	SIGNATURE	FRANçOIS MITTERRAND SIGNATURE.SVG
FIDEL CASTRO	SIGNATURE	FIDEL CASTRO SIGNATURE.SVG
GEORGY ZHUKOV	SIGNATURE	GEORGI ZHUKOV SIGNATURE.SVG
SPIRO AGNEW	SIGNATURE	SPIRO T AGNEW SIGNATURE.SVG
ROGER WILLIAMS	SIGNATURE	ROGER WILLIAMS SIGNATURE.SVG
JACQUES CHIRAC	SIGNATURE	JACQUES CHIRAC SIGNATURE.SVG
RICHARD M. DALEY	SIGNATURE	RMDALEYSIG.SVG
JAMES A. GARFIELD	SIGNATURE	JAMES ABRAM GARFIELD SIGNATURE.SVG
PAUL VON HINDENBURG	SIGNATURE	PAUL VON HINDENBURG SIGNATURE.SVG
WILLIAM JENNINGS BRYAN	SIGNATURE	WILLIAM JENNINGS BRYAN SIGNATURE 2.SVG
ALEXANDER HAMILTON	SIGNATURE	ALEXANDER HAMILTON SIGNATURERT.SVG
LUDWIG ERHARD	SIGNATURE	LUDWIG ERHARD SIGNATURE.JPG
HELMUT KOHL	SIGNATURE	HELMUT KOHL SIGNATURE.SVG
HELMUT SCHMIDT	SIGNATURE	HELMUT SCHMIDT SIGNATURE.SVG
WALTER MONDALE	SIGNATURE	WALTER MONDALE SIGNATURE.SVG
ÉAMON DE VALERA	SIGNATURE	ÉAMON DE VALERA SIGNATURE 2.SVG
NIKITA KHRUSHCHEV	SIGNATURE	NIKITA KHRUSHCHEV SIGNATURE2.SVG
SANDRA DAY O'CONNOR	SIGNATURE	SANDRA DAY O'CONNOR .PNG
HUBERT HUMPHREY	SIGNATURE	HUBERT H HUMPHREY SIGNATURE.SVG
THOMAS F. BAYARD	SIGNATURE	THOMAS F BAYARD SIGNATURE.SVG
STROM THURMOND	SIGNATURE	STROM THUMOND SIGNATURE.SVG
FREDERICK THEODORE FRELINGHUYSEN	SIGNATURE	FREDERICK THEODORE FRELINGHUYSEN SIGNATURE.SVG
THOMAS E. DEWEY	SIGNATURE	THOMAS DEWEY SIGNATURE.SVG
RAMSAY MACDONALD	SIGNATURE	RAMSAY MACDONALD SIGNATURE.SVG
ERNEST HOLLINGS	SIGNATURE	ERNEST F HOLLINGS SIGNATURE.SVG
GABRIELE D'ANNUNZIO	SIGNATURE	FIRMADANNUNZIO.PNG
HENRY CLAY	SIGNATURE	HENRY CLAY SIGNATURE-.SVG
CHARLES MAURICE DE TALLEYRAND-PéRIGORD	SIGNATURE	CHARLES MAURICE DE TALLEYRAND-PéRIGORD SIGNATURE.SVG
HUGO CHáVEZ	SIGNATURE	HUGO CHAVEZ SIGNATURE.SVG
JOSé RAMOS-HORTA	SIGNATURE	ASSINATURA_DE_JOSé_RAMOS-HORTA.JPG
WILLY BRANDT	SIGNATURE	WILLY BRANDT SIGNATURE.SVG
ANWAR SADAT	SIGNATURE	ANWAR EL SADAT SIGNATURE.SVG
KATSURA TARō	SIGNATURE	KATSURAT KAO.PNG
NICOLAE CEAUșESCU	SIGNATURE	NICOLAE CEAUşESCU SIGNATURE.SVG
ITō HIROBUMI	SIGNATURE	ITO HIROBUMI KAO.PNG
ALFRED ROSENBERG	SIGNATURE	ALFRED ROSENBERG SIGNATURE.SVG
YURI ANDROPOV	SIGNATURE	YURI ANDROPOV SIGNATURE 2.SVG
LEONID BREZHNEV	SIGNATURE	LEONID BREZHNEV SIGNATURE.SVG
EUGENE V. DEBS	SIGNATURE	EUGENE V. DEBS SIGNATURE.PNG
ZHOU ENLAI	SIGNATURE	ZHOU ENLAI SIGNATURE.SVG
WOJCIECH JARUZELSKI	SIGNATURE	WOJCIECH JARUZELSKI SIGNATURE.SVG
CHARLES DE GAULLE	SIGNATURE	CHARLES DE GAULLE SIGNATURE 2.SVG
SALVADOR ALLENDE	SIGNATURE	SALVADOR ALLENDE SIGNATURE.SVG
DANIEL WEBSTER	SIGNATURE	DANIEL WEBSTER SIGNATURE.SVG
HOSNI MUBARAK	SIGNATURE	HOSNI MUBARAK SIGNATURE.SVG
GAMAL ABDEL NASSER	SIGNATURE	NASSER.JPG
JOHN C. CALHOUN	SIGNATURE	JOHN C CALHOUN SIGNATURE.SVG
EDWARD HEATH	SIGNATURE	SIGNATURE OF EDWARD HEATH.PNG
HAROLD WILSON	SIGNATURE	WILSON HAROLD SIGNATURE.PNG
JAMES CALLAGHAN	SIGNATURE	SIGNATURE OF JAMES CALLAGHAN.PNG
CARL BILDT	SIGNATURE	CARL BILDT SIGNATURE.SVG
MUAMMAR GADDAFI	SIGNATURE	MUAMMAR AL-GADDAFI SIGNATURE.SVG
OLOF PALME	SIGNATURE	OLOF PALME SIGNATURE.SVG
LYNDON B. JOHNSON	SIGNATURE	LYNDON B. JOHNSON - SIGNATURE.SVG
BOB DOLE	SIGNATURE	BOB DOLE SIGNATURE2.SVG
SIMóN BOLíVAR	SIGNATURE	SIMóN BOLíVAR SIGNATURE.SVG
XANANA GUSMãO	SIGNATURE	XANANA GUSMãO SIGNATURE.SVG
BENJAMIN NETANYAHU	SIGNATURE	BENJAMIN NETANYAHU SIGNATURE.SVG
AARON BURR	SIGNATURE	AARON BURR SIGNATURE2.SVG
NURSULTAN NAZARBAYEV	SIGNATURE	SIGNATURE OF NURSULTAN NAZARBAYEV.PNG
YUAN SHIKAI	SIGNATURE	YUAN SHIKAI SIGN.PNG
NANCY ASTOR, VISCOUNTESS ASTOR	SIGNATURE	SIGNATURE NANCY ASTOR.PNG
JEFFERY AMHERST, 1ST BARON AMHERST	SIGNATURE	JEFFREYAMHERST.SVG
SAM HOUSTON	SIGNATURE	SAM HOUSTON SIGNATURE.SVG
A. P. J. ABDUL KALAM	SIGNATURE	ABDUL_KALAM_AUTOGRAPH.JPG
JAN PETER BALKENENDE	SIGNATURE	JAN PETER BALKENENDE SIGNATURE.PNG
VáCLAV HAVEL	SIGNATURE	VACLAV HAVEL SIGNATURE.SVG
JOHN TURNER	SIGNATURE	JOHN TURNER SIGNATURE.SVG
JACQUELINE KENNEDY ONASSIS	SIGNATURE	JACQUELINE KENNEDY SIGNATURE.SVG
Võ NGUYêN GIáP	SIGNATURE	GENERAL GIáP SIGNATURE.SVG
GOLDA MEIR	SIGNATURE	GOLDA MEIR SIGNATURE.SVG
JóZEF PIłSUDSKI	SIGNATURE	JóZEF PIłSUDSKI SIGNATURE.SVG
HO CHI MINH	SIGNATURE	HO CHI MINH SIGNATURE.SVG
DAVID BEN-GURION	SIGNATURE	DAVID BEN-GURION SIGNATURE.SVG
LUCY HAYES	SIGNATURE	LUCY HAYES SIGNATURE.SVG
VYACHESLAV MOLOTOV	SIGNATURE	VYACHESLAV MOLOTOV SIGNATURE 1944.PNG
ANGELA MERKEL	SIGNATURE	ANGELA MERKEL SIGNATURE.SVG
JOE LIEBERMAN	SIGNATURE	JOE LIEBERMAN SIGNATURE.SVG
MICHAEL DUKAKIS	SIGNATURE	M DUKAKIS SIGNATURE.SVG
JEAN CHRéTIEN	SIGNATURE	JEAN CHRETIEN SIGNATURE 2.SVG
VALéRY GISCARD D'ESTAING	SIGNATURE	VALéRY GISCARD D'ESTAING SIGNATURE.SVG
ROBERT MCNAMARA	SIGNATURE	ROBERT S MCNAMARA SIGNATURE.SVG
DEAN RUSK	SIGNATURE	DEAN RUSK SIGNATURE.SVG
ALEXANDER HAIG	SIGNATURE	ALEXANDER HAIG SIGNATURE 2.SVG
JOHN FOSTER DULLES	SIGNATURE	STAATSVERTRAGSUNTERSCHRIFTEN JOHN FOSTER DULLES.JPG
WILLIAM H. SEWARD	SIGNATURE	WILLIAM HENRY SEWARD SIGNATURE.SVG
FERNANDO HENRIQUE CARDOSO	SIGNATURE	ASSINATURA DE FERNANDO HENRIQUE CARDOSO - VERSãO 3.SVG
WIM DUISENBERG	SIGNATURE	WIM DUISENBERG SIGNATURE.SVG
H. H. ASQUITH	SIGNATURE	HH ASQUITH SIGNATURE.SVG
JOSEPH CHAMBERLAIN	SIGNATURE	JOSEPH CHAMBERLAIN SIGNATURE.SVG
SUN YAT-SEN	SIGNATURE	SUN YAT SEN SIGNATURE.PNG
DANIEL D. TOMPKINS	SIGNATURE	DANIEL D TOMPKINS SIGNATURE 2.SVG
GEORGE M. DALLAS	SIGNATURE	GEORGE M DALLAS-2SIGNATURE.SVG
RICHARD MENTOR JOHNSON	SIGNATURE	RICHARD MENTOR JOHNSON SIGNATURE.SVG
GARRET HOBART	SIGNATURE	GARRET HOBART SIGNATURE 2.SVG
SCHUYLER COLFAX	SIGNATURE	SCHUYLER COLFAX JR SIGNATURE.SVG
WILLIAM R. KING	SIGNATURE	WILLIAM R KING SIGNATURE.SVG
LEVI P. MORTON	SIGNATURE	LEVI P MORTON-2 SIGNATURE.SVG
JOHN C. BRECKINRIDGE	SIGNATURE	BRECKINRIDGESIGNATURE.SVG
WILLIAM A. WHEELER	SIGNATURE	WILLIAM ALMON WHEELER SIGNATURE.SVG
HENRY WILSON	SIGNATURE	HENRY WILSON SIGNATURE2.SVG
THOMAS A. HENDRICKS	SIGNATURE	THOMAS ANDREWS HENDRICKS SIGNATURE.SVG
ALBEN W. BARKLEY	SIGNATURE	ALBEN W BARKLEY SIGNATURE2.SVG
CHARLES CURTIS	SIGNATURE	CHARLES CURTIS SIGNATURE.SVG
CHARLES G. DAWES	SIGNATURE	CHARLES G DAWES SIGNATURE.SVG
HENRY A. WALLACE	SIGNATURE	HENRY A WALLACE SIGNATURE.SVG
JOHN NANCE GARNER	SIGNATURE	JOHN NANCE GARNER SIGNATURE2.SVG
JAMES S. SHERMAN	SIGNATURE	JAMES SCHOOLCRAFT SHERMAN SIGNATURE.SVG
ADLAI STEVENSON I	SIGNATURE	ADLAI EWING STEVENSON I SIGNATURE.SVG
CHARLES W. FAIRBANKS	SIGNATURE	CHARLES WARREN FAIRBANKS SIGNATURE.SVG
MICHAEL COLLINS	SIGNATURE	MICHAEL COLLINS SIGNATURE.PNG
RUUD LUBBERS	SIGNATURE	RUUD LUBBERS SIG.PNG
DRIES VAN AGT	SIGNATURE	DRIES VAN AGT SIGNATURE.JPG
JOOP DEN UYL	SIGNATURE	JOOP DEN UYL SIGNATURE.JPG
WILLEM DREES	SIGNATURE	SIGNATURE WILLEM DREES.PNG
JOHN ABBOTT	SIGNATURE	SIR JOHN JC ABBOTT SIGNATURE.SVG
GRAY DAVIS	SIGNATURE	GRAY DAVIS SIGNATURE.SVG
ISAAC BROCK	SIGNATURE	ISAAC BROCK SIGNATURE.SVG
LUIZ INáCIO LULA DA SILVA	SIGNATURE	SIGNATURE OF LUIZ INáCIO LULA DA SILVA.SVG
TOM VILSACK	SIGNATURE	TOM VILSACK SIGNATURE.SVG
K. R. NARAYANAN	SIGNATURE	K_R_NARAYANAN_AUTOGRAPH.JPG
ATAL BIHARI VAJPAYEE	SIGNATURE	ATAL_BIHARI_VAJPAYEE'S_AUTOGRAPH_IN_HINDI.JPG
DOLLEY MADISON	SIGNATURE	DOLLEY TODD MADISON SIGNATURE.SVG
HUEY LONG	SIGNATURE	HUEY LONG SIGNATURE.SVG
BENITO JUáREZ	SIGNATURE	FIRMA DE BENITO JUáREZ.PNG
GEORGE B. MCCLELLAN	SIGNATURE	GEORGE MCCLELLAN SIGNATURE.SVG
EZRA STILES	SIGNATURE	EZRA STILES SIGNATURE.SVG
NATHANIEL GORHAM	SIGNATURE	NATHANIEL GORHAM SIGNATURE.SVG
MADELEINE ALBRIGHT	SIGNATURE	MADELEINE ALBRIGHT SIGNATURE.SVG
PAUL KRUGER	SIGNATURE	PAUL KRUGER'S SIGNATURE.PNG
THOMAS D'ARCY MCGEE	SIGNATURE	THOMAS D'ARCY MCGEE SIGNATURE.SVG
JOHN CHURCHILL, 1ST DUKE OF MARLBOROUGH	SIGNATURE	JOHN CHURCHILL, 1ST DUKE OF MARLBOROUGH SIGNATURE.SVG
FERDINAND MARCOS	SIGNATURE	MARCOS SIG.SVG
JUAN PONCE DE LEóN	SIGNATURE	JUAN PONCE DE LEóN SIGNATURE.SVG
EMILIO AGUINALDO	SIGNATURE	AGUINALDO SIG.PNG
ROBERT BALDWIN	SIGNATURE	ROBERT BALDWIN SIGNATURE.SVG
JOE BIDEN	SIGNATURE	JOE BIDEN SIGNATURE.SVG
GUY VERHOFSTADT	SIGNATURE	SIGNATURE OF GUY VERHOFSTADT.PNG
ARTHUR BALFOUR	SIGNATURE	ARTHUR BALFOUR SIGNATURE.SVG
MARY MCALEESE	SIGNATURE	MARY MCALEESE SIGNATURE.SVG
NANCY PELOSI	SIGNATURE	NANCY PELOSI SIGNATURE.SVG
GEORGE CLINTON	SIGNATURE	GEORGE CLINTON SIGNATURE-RT.SVG
NATHANIEL P. BANKS	SIGNATURE	NATHANIEL P. BANKS SIGNATURE.PNG
ALEKSANDER KWAśNIEWSKI	SIGNATURE	ALEKSANDER KWAśNIEWSKI SIGNATURE.SVG
ROBERT STEWART, VISCOUNT CASTLEREAGH	SIGNATURE	CASTLEREAGH SIGNATURE.JPG
BERTRAND BARèRE	SIGNATURE	BARèRE DE VIEUZACSIGNATURE.JPG
SITTING BULL	SIGNATURE	SITTING BULL SIGNATURE.SVG
KIM DAE-JUNG	SIGNATURE	SIGNATURE OF KIM DAE-JUNG.SVG
KIM JONG-IL	SIGNATURE	KIM JONG-IL SIGNATURE.PNG
GEORGES DANTON	SIGNATURE	GEORGESDANTONSIGNATURE.JPG
ALFRED MOISIU	SIGNATURE	ALFRED MOISIU SIGNATURE.SVG
CONDOLEEZZA RICE	SIGNATURE	CONDOLEEZZA RICE SIGNATURE 2.SVG
THOMAS BABINGTON MACAULAY	SIGNATURE	THOMAS BABINGTON MACAULAY, 1ST BARON MACAULAY .SVG
P. T. BARNUM	SIGNATURE	PT BARNUM SIGNATURE.SVG
CHARLES WILLIAM ELIOT	SIGNATURE	CHARLES WILLIAM ELIOT SIGNATURE.SVG
MANUEL L. QUEZON	SIGNATURE	MANUEL QUEZON SIGNATURE.SVG
DOUGLAS HYDE	SIGNATURE	DOUGLAS HYDE SIGNATURE.SVG
WILLIAM HAGUE	SIGNATURE	WILLIAM-HAGUE-SIGNATURE.SVG
MARTHA WASHINGTON	SIGNATURE	MARTHA WASHINGTONS SIGNATURE.SVG
MARK HANNA	SIGNATURE	MARK HANNA SIGNATURE.SVG
ÓLAFUR RAGNAR GRíMSSON	SIGNATURE	SIGNATURE OF ÓLAFUR RAGNAR GRíMSSON.PNG
DANIEL ARAP MOI	SIGNATURE	ARAP MOI SIGNATURE.SVG
BARBARA BUSH	SIGNATURE	BARBARA BUSH SIGNATURE.SVG
JOHN WINTHROP	SIGNATURE	JOHN WINTHROP SIGNATURE.SVG
ANDREW DICKSON WHITE	SIGNATURE	AD WHITE SIGNATURE.JPG
MARTTI AHTISAARI	SIGNATURE	AHTISAARIMARTTISIGNATURE.PNG
CARL GUSTAF EMIL MANNERHEIM	SIGNATURE	CGE MANNERHEIM AUTOGRAPH.SVG
CYRUS VANCE	SIGNATURE	CYRUS VANCE SIGNATURE.SVG
OMAR BRADLEY	SIGNATURE	OMAR N BRADLEY SIGNATURE.SVG
FRANJO TUđMAN	SIGNATURE	SIGNATURE OF FRANJO TUđMAN.PNG
DANIEL O'CONNELL	SIGNATURE	DANIEL O'CONNELL SIGNATURE C1835.JPG
GORDON CAMPBELL	SIGNATURE	GORDON CAMPBELL SIGNATURE.SVG
RON PAUL	SIGNATURE	RON PAUL SIGNATURE.SVG
C. DOUGLAS DILLON	SIGNATURE	C DOUGLAS DILLON SIG.JPG
ORRIN HATCH	SIGNATURE	ORRIN HATCH SIGNATURE.SVG
SONIA GANDHI	SIGNATURE	SIGNATURE OF SONIA GANDHI.SVG
JACOBO ÁRBENZ	SIGNATURE	FIRMAARBENZ.JPG
HORACE GREELEY	SIGNATURE	HORACE GREELEY SIGNATURE.SVG
LéOPOLD SéDAR SENGHOR	SIGNATURE	SENGHORSIG.JPG
HENRY VANE THE YOUNGER	SIGNATURE	HENRY VANE THE YOUNGER SIGNATURE.SVG
KURODA KIYOTAKA	SIGNATURE	KURODAK KAO.PNG
HARA TAKASHI	SIGNATURE	HARAT KAO.PNG
ŌKUMA SHIGENOBU	SIGNATURE	OKUMAS KAO.PNG
YAMAMOTO GONNOHYōE	SIGNATURE	YAMAMOTOG KAO.PNG
OSACHI HAMAGUCHI	SIGNATURE	HAMAGUCHIO KAO.PNG
KATō TOMOSABURō	SIGNATURE	KATOTO KAO.PNG
TERAUCHI MASATAKE	SIGNATURE	TERAUCHIM KAO.PNG
TAKAHASHI KOREKIYO	SIGNATURE	TAKAHASHIK KAO.PNG
KAKUEI TANAKA	SIGNATURE	TANAKAK KAO.PNG
SōSUKE UNO	SIGNATURE	UNOS KAO.PNG
EISAKU SATō	SIGNATURE	SATōE KAO.PNG
JACK LAYTON	SIGNATURE	JACK LAYTON SIGNATURE 2.SVG
JERRY BROWN	SIGNATURE	SIGNATURE OF CALIFORNIA EDMUND G.  BROWN.PNG
HORACE MANN	SIGNATURE	APPLETONS' MANN HORACE SIGNATURE.JPG
JOHN BRECKINRIDGE	SIGNATURE	JOHN BRECKINRIDGE SIGNATURE.SVG
NEWT GINGRICH	SIGNATURE	NEWT GINGRICH SIGNATURE.SVG
JOSé SARNEY	SIGNATURE	PRESIDENTE JOSé SARNEY ASSINATURA.JPG
MICHAEL JOSEPH SAVAGE	SIGNATURE	MICHAEL JOSEPH SAVAGE SIGNATURE.JPG
TED STEVENS	SIGNATURE	TED STEVENS SIGNATURE.SVG
DAVID SOUTER	SIGNATURE	SOUTER SIGNATURE.PNG
TED KENNEDY	SIGNATURE	TED KENNEDY SIGNATURE 2.SVG
ROBIN COOK	SIGNATURE	NICE TREATY FA THE UNITED KINGDOM.PNG
JOHN PAUL STEVENS	SIGNATURE	JOHN PAUL STEVENS SIGNATURE.SVG
MARY LANDRIEU	SIGNATURE	MARY LANDRIEU SIGNATURE.GIF
JEB BUSH	SIGNATURE	JEB BUSH SIGNATURE.SVG
ION ILIESCU	SIGNATURE	SIGNATURE OF ION ILIESCU.PNG
CHRISTIAN HERTER	SIGNATURE	CHRISTIAN HERTER SIGNATURE.SVG
GLORIA MACAPAGAL ARROYO	SIGNATURE	ARROYO SIGNATURE.SVG
HORST KöHLER	SIGNATURE	HORST KöHLER SIGNATURE.SVG
JOHN LAMBTON, 1ST EARL OF DURHAM	SIGNATURE	JOHN LAMBTON, 1ST EARL OF DURHAM SIGNATURE.SVG
LOUIS-HIPPOLYTE LAFONTAINE	SIGNATURE	LOUIS-HIPPOLYTE LAFONTAINE SIGNATURE.SVG
GEORGE-ÉTIENNE CARTIER	SIGNATURE	GEORGE-ETIENNE CARTIER SIGNATURE.SVG
ADOLPHE THIERS	SIGNATURE	ADOLPHE_THIERS_AUTOGRAPH.SVG
JENS STOLTENBERG	SIGNATURE	JENS STOLTENBERG SIGNATURE.SVG
THORBJøRN JAGLAND	SIGNATURE	THORBJORN JAGLAND SIGNATURE.SVG
MOHAMMAD KHATAMI	SIGNATURE	MOHAMMAD KHATAMI SIGNATURE.SVG
BENAZIR BHUTTO	SIGNATURE	BENAZIR BHUTTO SIGNATURE.SVG
ED RENDELL	SIGNATURE	ED RENDELL SIGNATURE.SVG
MARCOS PéREZ JIMéNEZ	SIGNATURE	MARCOS PéREZ JIMéNEZ SIGNATURE.SVG
KONSTANTIN VON NEURATH	SIGNATURE	KONSTANTIN VON NEURATH SIGNATURE.SVG
EDWARD LIVINGSTON	SIGNATURE	EDWARD LIVINGSTON SIGNATURE.SVG
B. R. AMBEDKAR	SIGNATURE	DR.AMBEDKAR SIGNATURE.JPG
JOSé MARíA AZNAR	SIGNATURE	JOSé MARíA AZNAR SIGNATURE 2.SVG
KIICHI MIYAZAWA	SIGNATURE	MIYAZAWAK KAO.PNG
FRANçOIS TOMBALBAYE	SIGNATURE	FRANçOIS TOMBALBAYE .PNG
CHRIS PATTEN	SIGNATURE	CHRIS PATTEN SIGNATURE.SVG
HILMI ÖZKöK	SIGNATURE	HILMI ÖZKöK SIGNATURE.PNG
PLAEK PHIBUNSONGKHRAM	SIGNATURE	SIGNATURE OF PLEK PIBULSONGKRAM.SVG
GEORGE PATAKI	SIGNATURE	GEORGE PATAKI SIGNATURE.SVG
FREDERICK MUHLENBERG	SIGNATURE	FREDERICK MUHLENBERG SIGNATURE.SVG
LAWRENCE SUMMERS	SIGNATURE	LAWRENCE H SUMMERS SIG.JPG
CORNELIUS COLE	SIGNATURE	CORNELIUS COLE SIGNATURE 2.SVG
WILLIAM E. SIMON	SIGNATURE	WILLIAM E SIMON SIG.JPG
BOUTROS BOUTROS-GHALI	SIGNATURE	SIGNATURE OF BOUTROS BOUTROS-GHALI.SVG
RICHARD LUGAR	SIGNATURE	SIGNATURE OF RICHARD LUGAR.SVG
ELIZABETH DOLE	SIGNATURE	ELIZABETH DOLE SIGNATURE.SVG
JAMES BAKER	SIGNATURE	JAMES ADDISON BAKER, III SIGNATURE.SVG
TOMMY DOUGLAS	SIGNATURE	TOMMY DOUGLAS SIGNATURE.SVG
LADY BIRD JOHNSON	SIGNATURE	LADY BIRD JOHNSON SIGNATURE.SVG
JUDAH P. BENJAMIN	SIGNATURE	JUDAH BENJAMIN SIGNATURE.SVG
JüRGEN TRITTIN	SIGNATURE	SIGNATURE J. TRITTIN.GIF
HALEY BARBOUR	SIGNATURE	HALEY BARBOUR SIGNATURE.SVG
CARL SCHURZ	SIGNATURE	CARL SCHURZ SIGNATURE.SVG
JOSé MANUEL RESTREPO VéLEZ	SIGNATURE	JOSé MANUEL RESTREPO SIGNATURE.PNG
MARK PRYOR	SIGNATURE	MARK PRYOR SIGNATURE.SVG
FREDERICK NORTH, LORD NORTH	SIGNATURE	FREDERICK NORTH, LORD NORTH SIGNATURE.SVG
JOSé CECILIO DEL VALLE	SIGNATURE	FIRMA DE JOSE CECILIO DEL VALLE.JPG
JAMES FORRESTAL	SIGNATURE	JAMES FORRESTAL SIGNATURE.SVG
JOHN W. SNOW	SIGNATURE	JOHN W SNOW SIG.JPG
THOMAS GAGE	SIGNATURE	THOMAS GAGE SIGNATURE.SVG
GEORGE TENET	SIGNATURE	GEORGE TENET SIGNATURE.SVG
DUFFERIN ROBLIN	SIGNATURE	DUFFERIN ROBLIN SIGNATURE.SVG
PETER LOUGHEED	SIGNATURE	PETER LOUGHEED SIGNATURE.SVG
PETER MUHLENBERG	SIGNATURE	APPLETONS' MUHLENBERG JOHN PETER GABRIEL SIGNATURE.PNG
ANTONIO JOSé DE SUCRE	SIGNATURE	ANTONIO JOSé DE SUCRE SIGNATURE.SVG
DADABHAI NAOROJI	SIGNATURE	DADABHAI NAORAJI SIGNATURE.SVG
ELIO DI RUPO	SIGNATURE	ACCESSION TREATY 2011 ELIO DI RUPO SIGNATURE.SVG
ROBERT MORRIS	SIGNATURE	ROBERT MORRIS SIGNATURE.PNG
GERALDINE FERRARO	SIGNATURE	GERALDINE A. FERRARO SIGNATURE.SVG
HENRY KNOX	SIGNATURE	HENRY KNOX SIGNATURE2.SVG
ERNEST MANNING	SIGNATURE	ERNEST MANNING SIGNATURE.SVG
ALEXANDER CAMERON RUTHERFORD	SIGNATURE	ALEXANDER CAMERON RUTHERFORD SIGNATURE.SVG
DON GETTY	SIGNATURE	DONALD ROSS GETTY SIGNATURE.SVG
ARTHUR SIFTON	SIGNATURE	ARTHUR SIFTON SIGNATURE.SVG
C. RAJAGOPALACHARI	SIGNATURE	RAJAGOPALACHARI SIGN.JPG
SARGENT SHRIVER	SIGNATURE	SARGENT SHRIVER SIGNATURE.SVG
JOHN A. QUITMAN	SIGNATURE	JOHN A QUITMAN SIGNATURE.SVG
DAG HAMMARSKJöLD	SIGNATURE	SIGN DAG HAMMARSKJOLD.PNG
PAUL H. O'NEILL	SIGNATURE	PAUL H O'NEILL SIG.JPG
TIM PAWLENTY	SIGNATURE	TIM PAWLENTY SIGNATURE.SVG
MEGAWATI SUKARNOPUTRI	SIGNATURE	SIGNATURE OF MEGAWATI SOEKARNOPUTRI.SVG
GEORGE BROWN	SIGNATURE	GEORGE BROWN SIGNATURE.SVG
ALEXANDER CAMPBELL	SIGNATURE	ALEXANDER CAMPBELL SIGNATURE.SVG
JOSEPH DEISS	SIGNATURE	SIGNATURE OF JOSEPH DEISS.PNG
HENRY DEARBORN	SIGNATURE	HENRY DEARBORN SIGNATURE.SVG
TRYGVE LIE	SIGNATURE	TRYGVE LIE SIGNATURE.SVG
ROSALYNN CARTER	SIGNATURE	ROSALYNN CARTER SIGNATURE.SVG
STEPHEN HARPER	SIGNATURE	STEPHEN HARPER SIGNATURE-RT.SVG
LEO VON CAPRIVI	SIGNATURE	CAPRIVI SIGNATURE.SVG
BENJAMIN CHEW	SIGNATURE	BENJAMIN-CHEW-SIGNATURE.GIF
DONALD REGAN	SIGNATURE	DONALD T REGAN SIG.JPG
KLAUS WOWEREIT	SIGNATURE	SIGNATURE OF KLAUS WOWEREIT.GIF
ED KOCH	SIGNATURE	ED KOCH SIGNATURE.PNG
FRANK B. KELLOGG	SIGNATURE	FRANK B KELLOGG SIGNATURE.SVG
AL FRANKEN	SIGNATURE	AL FRANKEN SIGNATURE.SVG
MATTI VANHANEN	SIGNATURE	MATTI VANHANEN SIGNATURE 2.SVG
GILLES DUCEPPE	SIGNATURE	GILLES DUCEPPE SIGNATURE.SVG
MARGARET CHASE SMITH	SIGNATURE	MARGARET CHASE SMITH SIGNATURE.PNG
ROBERT M. LA FOLLETTE SR.	SIGNATURE	SIGNATURE OF ROBERT LA FOLLETTE.SVG
MAHATHIR MOHAMAD	SIGNATURE	MAHATHIR MOHAMAD SIGNATURE.SVG
YANG SHANGKUN	SIGNATURE	杨尚昆签名.JPG
GEORGE WALLACE	SIGNATURE	GEORGE WALLACE SIGNATURE.SVG
WILLIAM ELLERY	SIGNATURE	WILLIAM ELLERY SIGNATURE.PNG
BUTTON GWINNETT	SIGNATURE	BUTTON GWINNETT SIGNATURE.SVG
ROGER SHERMAN	SIGNATURE	ROGER SHERMAN SIGNATURE.PNG
ENDA KENNY	SIGNATURE	ACCESSION TREATY 2011 ENDA KENNY SIGNATURE.SVG
CAESAR RODNEY	SIGNATURE	C RODNEY SIGNATURE.SVG
GEORGE READ	SIGNATURE	GEORGE READ SIGNATURE.SVG
LEWIS CASS	SIGNATURE	LEWIS CASS SIGNATURE2.SVG
LOUIS DE BUADE DE FRONTENAC	SIGNATURE	FRONTENAC SIGNATURE.SVG
FRANCIS BOND HEAD	SIGNATURE	FRANCIS BOND HEAD SIGNATURE.SVG
JAMES BRYCE, 1ST VISCOUNT BRYCE	SIGNATURE	SIGNATURE OF JAMES BRYCE, 1ST VISCOUNT BRYCE.JPG
FRANZ JOSEF STRAUSS	SIGNATURE	STRAUSSFRANZJOSEFSIGNATURE02 MONO 25P TRANSP.PNG
ALASTAIR CAMPBELL	SIGNATURE	ALASTAIRCAMPBELLSIGNATURE.GIF
EDMUND RANDOLPH	SIGNATURE	EDMUND RANDOLPH SIGNATURE.SVG
SALI BERISHA	SIGNATURE	SALI BERISHA SIGNATURE.SVG
CORDELL HULL	SIGNATURE	CORDELL HULL SIGNATURE2.SVG
THOMAS HART BENTON	SIGNATURE	APPLETONS' BENTON THOMAS HART SIGNATURE.PNG
JOSé MARíA REINA BARRIOS	SIGNATURE	FIRMAREINABARRIOS.JPG
JORGE UBICO	SIGNATURE	FIRMAUBICO.JPG
FELIPE GONZáLEZ	SIGNATURE	SIGNATURE OF FELIPE GONZáLEZ.PNG
HENRY WHEATON	SIGNATURE	APPLETONS' WHEATON HENRY SIGNATURE.PNG
ALBERT GALLATIN	SIGNATURE	ALBERT GALLATIN SIGNATURE.SVG
V. V. GIRI	SIGNATURE	VARAHAGIRI VENKATAGIRI SIGNATURE.JPG
MARIO CUOMO	SIGNATURE	MARIO CUOMO SIGNATURE.SVG
BENIGNO AQUINO III	SIGNATURE	NONOY AQUINO SIGNATURE.SVG
CORAZON AQUINO	SIGNATURE	AQUINO SIG.SVG
JAMES BRUCE, 8TH EARL OF ELGIN	SIGNATURE	JAMES BRUCE, 8TH EARL OF ELGIN AND 12TH EARL OF KINCARDINE SIGNATURE.SVG
EVO MORALES	SIGNATURE	EVO MORALES SIGNATURE.SVG
LAWRENCE EAGLEBURGER	SIGNATURE	LAWRENCE EAGLEBURGER SIGNATURE.SVG
GOH CHOK TONG	SIGNATURE	GOH CHOK TONG SIGNATURE.PNG
BRIAN COWEN	SIGNATURE	BRIAN COWEN SIGNATURE.SVG
FREDERICK HAMILTON-TEMPLE-BLACKWOOD, 1ST MARQUESS OF DUFFERIN AND AVA	SIGNATURE	LORD DUFFERIN SIGNATURE.SVG
FREDERICK STANLEY, 16TH EARL OF DERBY	SIGNATURE	LORD STANLEY SIGNATURE.SVG
ELIHU ROOT	SIGNATURE	ELIHU ROOT SIGNATURE.SVG
GIDEON WELLES	SIGNATURE	GIDEON WELLES SIGNATURE.SVG
JOHN HOEVEN	SIGNATURE	JOHN HOEVEN SIGNATURE.SVG
BETTY FORD	SIGNATURE	BETTY FORD SIGNATURE.SVG
JOSEPH P. KENNEDY SR.	SIGNATURE	JOSEPH P KENNEDY SIGNATURE.SVG
MIKE GRAVEL	SIGNATURE	MIKE GRAVEL SIGNATURE.SVG
NICHOLAS BIDDLE	SIGNATURE	APPLETONS' BIDDLE NICHOLAS FINANCIER SIGNATURE.PNG
JEAN-LUC DEHAENE	SIGNATURE	SIGNATURE OF JEAN-LUC DEHAENE.PNG
DARRELL ISSA	SIGNATURE	DARRELL EDWARD ISSA SIGNATURE.SVG
GüNTER SCHABOWSKI	SIGNATURE	GüNTER SCHABOWSKI SIG.SVG
ERNESTO ZEDILLO	SIGNATURE	SIGNATURE OF ERNESTO ZEDILLO PONCE DE LEON.SVG
DANIEL AKAKA	SIGNATURE	DANIEL AKAKA SIGNATURE.SVG
LI LANQING	SIGNATURE	LI LANQING SIGN.JPG
WALTER SCHEEL	SIGNATURE	SIGNATUR WALTER SCHEEL.JPG
ROMAN HERZOG	SIGNATURE	ROMAN HERZOG SIGNATURE.SVG
JOHN CONNALLY	SIGNATURE	JOHN B CONNALLY SIG.JPG
MIKE HUCKABEE	SIGNATURE	MIKE HUCKABEE SIGNATURE.SVG
VáCLAV KLAUS	SIGNATURE	VACLAV KLAUS SIGNATURE.SVG
RAHUL GANDHI	SIGNATURE	SIGNATURE_OF_RAHUL_GANDHI.SVG
ELEFTHERIOS VENIZELOS	SIGNATURE	ELEFTHERIOS-VENIZELOS-SIGNATURE.SVG
CHANDRIKA KUMARATUNGA	SIGNATURE	SIGNATURE OF CHANDRIKA KUMARATUNGA.SVG
EDMUND MUSKIE	SIGNATURE	EDMUND MUSKIE SIGNATURE.SVG
ALEXANDER H. STEPHENS	SIGNATURE	ALEXANDER STEPHENS SIGNATURE.SVG
JORGE RAFAEL VIDELA	SIGNATURE	FIRMA VIDELA.SVG
BETTINO CRAXI	SIGNATURE	BETTINO CRAXI SIGNATURE.JPG
VAZGEN SARGSYAN	SIGNATURE	VAZGEN SARGSYAN SIGNATURE.SVG
SIMON BOLIVAR BUCKNER	SIGNATURE	SIMON BOLIVAR BUCKNER SIGNATURE.SVG
DALTON MCGUINTY	SIGNATURE	DALTON MCGUINTY SIGNATURE.SVG
SAIONJI KINMOCHI	SIGNATURE	SAIONJIK KAO.PNG
CARLOS PRATS	SIGNATURE	FIRMA CARLOS PRATS.PNG
MANUEL FRAGA IRIBARNE	SIGNATURE	FRAGA SIGNATURE.JPG
MACHADO DE ASSIS	SIGNATURE	ASSINATURA DE MACHADO DE ASSIS.GIF
VAIRA VīķE-FREIBERGA	SIGNATURE	VAIRA VIKE FREIBERGA SIGNATURE.SVG
U THANT	SIGNATURE	U THANT SIGNATURE.SVG
JOHN WARNER	SIGNATURE	JOHN WARNER SIGNATURE.SVG
WILLIAM GANNAWAY BROWNLOW	SIGNATURE	WILLIAM-BROWNLOW-SIGNATURE1.JPG
MOHAMMAD BEHESHTI	SIGNATURE	MOHAMMAD BEHESHTI SIGNATURE.PNG
FRANK LAUTENBERG	SIGNATURE	FRANK LAUTENBERG SIGNATURE.SVG
ELIZA MCCARDLE JOHNSON	SIGNATURE	ELIZA JOHNSON SIGNATURE.SVG
STJEPAN MESIć	SIGNATURE	SIGNATURE OF STJEPAN MESIć.PNG
WALLY HICKEL	SIGNATURE	WALTER J. HICKEL SIGNATURE.JPG
ANTE PAVELIć	SIGNATURE	ANTE PAVELIC'S SIGNATURE.SVG
ROSE MOFFORD	SIGNATURE	ROSE MOFFORD SIGNATURE.PNG
MORARJI DESAI	SIGNATURE	MORARJI DESAI SIGNATURE.SVG
BLANCHE LINCOLN	SIGNATURE	BLANCHE LINCOLN SIGNATURE.SVG
ALAN GARCíA	SIGNATURE	FIRMAALANGARCIA.JPG
CARL LEVIN	SIGNATURE	CARL LEVIN SIGNATURE.SVG
ROBERT TODD LINCOLN	SIGNATURE	ROBERT LINCOLN SIGNATURE.SVG
JAY ROCKEFELLER	SIGNATURE	JAY ROCKEFELLER SIGNATURE.SVG
JEAN-LAMBERT TALLIEN	SIGNATURE	JEAN-LAMBERT TALLIENSIGNATURE.JPG
ARTURO UMBERTO ILLIA	SIGNATURE	FIRMA DE ARTURO ILLIA.SVG
JIM DOYLE	SIGNATURE	JIM DOYLE SIGNATURE.SVG
SONNY PERDUE	SIGNATURE	SONNY PERDUE SIGNATURE.SVG
ARNOLD RüüTEL	SIGNATURE	SIGNATURE OF ARNOLD RüüTEL.PNG
PETE WILSON	SIGNATURE	PETE WILSON SIGNATURE.PNG
GEORGE DEUKMEJIAN	SIGNATURE	GEORGE DEUKMEJIAN SIGNATURE.PNG
MARY TODD LINCOLN	SIGNATURE	APPLETONS' LINCOLN ABRAHAM - MARY SIGNATURE.PNG
EZRA CORNELL	SIGNATURE	EZRA CORNELL SIGNATURE.SVG
WILLIAM WALKER	SIGNATURE	APPLETONS' WALKER WILLIAM SIGNATURE.PNG
KONSTANTINOS STEPHANOPOULOS	SIGNATURE	SIGNATURE OF KONSTANTINOS STEPHANOPOULOS.PNG
PIERRE-JOSEPH-OLIVIER CHAUVEAU	SIGNATURE	PIERRE-JOSEPH-OLIVIER CHAUVEAU SIGNATURE.SVG
MITCH MCCONNELL	SIGNATURE	MITCH MCCONNELL SIGNATURE.SVG
THERESA MAY	SIGNATURE	SIGNATURE OF THERESA MAY.SVG
BEN CAYETANO	SIGNATURE	BENJAMIN J. CAYETANO 1997 SIGNATURE.SVG
SEBASTIãO JOSé DE CARVALHO E MELO, 1ST MARQUIS OF POMBAL	SIGNATURE	ASSINATURA MARQUêS DE POMBAL.PNG
EDUARD SHEVARDNADZE	SIGNATURE	EDUARD SHEVARDNADZE SIGNATURE.SVG
WłADYSłAW SIKORSKI	SIGNATURE	WłADYSłAW SIKORSKI SIGNATURE.SVG
JOSé MANUEL BARROSO	SIGNATURE	BARROSO SIGNATURE.SVG
TOMIICHI MURAYAMA	SIGNATURE	SIGNATURE OF TOMIICHI MURAYAMA.SVG
JIM ANDERTON	SIGNATURE	JIM ANDERTON SIGNATURE.SVG
MáRIO SOARES	SIGNATURE	ASSINATURAMáRIOSOARES.SVG
LOU HENRY HOOVER	SIGNATURE	LOU HENRY HOOVER SIGNATURE.SVG
MAKARIOS III	SIGNATURE	ARCHIBISHOP-MAKARIOS-III-SIGNATURE.SVG
JOSé MARíA MORELOS	SIGNATURE	FIRMA DE MORELOS.PNG
JEAN-CLAUDE TRICHET	SIGNATURE	TRICHET SIGNATURE.SVG
LINDA LINGLE	SIGNATURE	LINDA LINGLE SIGNATURE.SVG
JOSé DE SAN MARTíN	SIGNATURE	FIRMA JOSé DE SAN MARTíN.SVG
THAKSIN SHINAWATRA	SIGNATURE	THAI-PM-THAKSIN SIGNATURE.PNG
BERNIE SANDERS	SIGNATURE	BERNIE SANDERS SIGNATURE.SVG
LEE HSIEN LOONG	SIGNATURE	LEE HSIEN LOONG SIGNATURE.PNG
MARGOT WALLSTRöM	SIGNATURE	MARGOT WALLSTRöM SIGNATURE.SVG
ITAMAR FRANCO	SIGNATURE	AUTóGRAFO DE ITAMAR FRANCO.JPG
THADDEUS STEVENS	SIGNATURE	T STEVENS SIGNATURE.SVG
WILLIAM PEARCE HOWLAND	SIGNATURE	WILLIAM PEARCE HOWLAND SIGNATURE.SVG
JAMES TALLMADGE, JR.	SIGNATURE	JAMES TALLMADGE SIGNATURE.JPG
PATRICK LEAHY	SIGNATURE	PAT LEAHY SIGNATURE.SVG
SAM BROWNBACK	SIGNATURE	SAM BROWNBACK SIGNATURE.SVG
LISA MURKOWSKI	SIGNATURE	LISAMURKOWSKISIGNATURE.PNG
ARLEN SPECTER	SIGNATURE	ARLEN SPECTER SIGNATURE.SVG
HARRY REID	SIGNATURE	HARRY REID SIGNATURE.SVG
ZELMAN COWEN	SIGNATURE	ZELMAN COWEN SIGNATURE GG.JPG
BARBARA MIKULSKI	SIGNATURE	SIGNATURE OF BARBARA MIKULSKI.JPG
H. D. DEVE GOWDA	SIGNATURE	DEVEGOWDA AUTOGRAPH.JPG
V. P. SINGH	SIGNATURE	VISHWANATH PRATAP SINGH SIGNATURE.SVG
EDWIN STANTON	SIGNATURE	EDWIN MCMASTERS STANTON SIGNATURE.SVG
SIMON CAMERON	SIGNATURE	SIMON CAMERON SIGNATURE.SVG
RICHARD SHELBY	SIGNATURE	RICHARD SHELBY SIGNATURE.SVG
OLYMPIA SNOWE	SIGNATURE	OLYMPIA SNOWE SIGNATURE.SVG
TABARé VáZQUEZ	SIGNATURE	FIRMATABARE.JPG
RECEP TAYYIP ERDOğAN	SIGNATURE	RECEP TAYYIP ERDOğAN SIGNATURE.PNG
WILLIAM DOWDESWELL	SIGNATURE	WILLIAM DOWDESWELL  .JPG
MIKHEIL SAAKASHVILI	SIGNATURE	MIKHEIL SAAKASHVILI SIGNATURE.SVG
FREDRIK REINFELDT	SIGNATURE	FREDRIK REINFELDT SIGNATURERT.SVG
KENT CONRAD	SIGNATURE	KENT CONRAD SIGNATURE.SVG
KEVIN RUDD	SIGNATURE	KEVIN RUDD SIGNATURE 2.SVG
DANIEL INOUYE	SIGNATURE	DANIEL K. INOUYE SIGNATURE.SVG
LAJOS KOSSUTH	SIGNATURE	KOSSUTH LAJOS ALáíRáSA.JPG
LEONID KUCHMA	SIGNATURE	LEONID KUCHMA SIGNATURE 1996.PNG
HAMILTON FISH	SIGNATURE	HAMILTON FISH SIGNATURE.SVG
DANIEL COIT GILMAN	SIGNATURE	DANIEL COIT GILMAN SIGNATURE.SVG
AHMET NECDET SEZER	SIGNATURE	A. NECDET SEZER SIGNATURE.PNG
ALI KHAMENEI	SIGNATURE	KHAMENEI SIGNATURE.PNG
JOHN DINGELL	SIGNATURE	JOHN DINGELL SIGNATURE.SVG
RAMON MAGSAYSAY	SIGNATURE	RMAGSAYSAYSIGNATURE.JPEG
HABIB BOURGUIBA	SIGNATURE	SIGNATURE_HABIB_BOURGUIBA.SVG
LOUIS BOTHA	SIGNATURE	LOUIS BOTHA SIGN.PNG
GEORGI PARVANOV	SIGNATURE	SIGNATURE OF GEORGI PARVANOV.PNG
ISAIAS AFWERKI	SIGNATURE	ISAIAS AFWERKI'S SIGNATURE.SVG
VLADIMIR ZHIRINOVSKY	SIGNATURE	SIGNATURE OF VLADIMIR ZHIRINOVSKY.PNG
AZALI ASSOUMANI	SIGNATURE	ASSOUMANISIGNATURE.JPG
HUN SEN	SIGNATURE	HUN SEN SIG.PNG
VLADIMíR ŠPIDLA	SIGNATURE	VLADIMIR SPIDLA SIGNATURE.SVG
VIKTOR YANUKOVYCH	SIGNATURE	VIKTOR YANUKOVYCH SIGNATURE.SVG
JEAN-CLAUDE JUNCKER	SIGNATURE	JEAN-CLAUDE JUNCKER SIGNATURE.SVG
EDWARD BLAKE	SIGNATURE	EDWARD BLAKE SIGNATURE.SVG
GOH KUN	SIGNATURE	GOH KUN SIGNATURE.SVG
EDDIE FENECH ADAMI	SIGNATURE	SIGNATURE OF EDWARD FENECH ADAMI.PNG
SYMON PETLIURA	SIGNATURE	SYMON PETLURA SIGNATURE 1920.PNG
AZIE TAYLOR MORTON	SIGNATURE	AZIE TAYLOR MORTON SIG.JPG
JAMES WILKINSON	SIGNATURE	JAMES WILKINSON SIGNATURE.SVG
BENJAMIN LINCOLN	SIGNATURE	BENJAMIN LINCOLN SIGNATURE.SVG
AKBAR HASHEMI RAFSANJANI	SIGNATURE	SIGNATURE OF AKBAR HASHEMI RAFSANJANI.SVG
HEYDAR ALIYEV	SIGNATURE	SIGNATURE OF HEYDAR ALIYEV.PNG
LAZAR KAGANOVICH	SIGNATURE	LAZAR KAGANOVICH SIGNATURE.PNG
PAT NIXON	SIGNATURE	PATNIXON SIGNATURE 2.SVG
JULIA GRANT	SIGNATURE	JULIA GRANT SIGNATURE.SVG
WILLIAM P. ROGERS	SIGNATURE	WILLIAM P. ROGERS SIGNATURE.SVG
MURLI MANOHAR JOSHI	SIGNATURE	MURLIMANOHARJOSHI.JPG
ADOLFO SUáREZ	SIGNATURE	FIRMADEADOLFOSUAREZ.PNG
SADEGH KHALKHALI	SIGNATURE	SADEGH KHALKHALI SIGNATURE.PNG
MIKE ROSS	SIGNATURE	REPRESENTATIVE MIKE ROSS SIGNATURE.PNG
JOHN BOOZMAN	SIGNATURE	JOHN BOOZMAN SIGNATURE.SVG
PAUL RYAN	SIGNATURE	PAUL RYAN SIGNATURE.SVG
MARK UDALL	SIGNATURE	MARK UDALL SIGNATURE.SVG
BILL YOUNG	SIGNATURE	CW BILL YOUNG SIGNATURE.SVG
JOHNNY ISAKSON	SIGNATURE	JOHNNYISAKSONSIGNATURE.JPG
NATHAN DEAL	SIGNATURE	SIGNATURE OF NATHAN DEAL.SVG
BUTCH OTTER	SIGNATURE	BUTCH OTTER SIGNATURE.SVG
LUIS GUTIéRREZ	SIGNATURE	LUIS V GUTIERREZ SIGNATURE.PNG
RAHM EMANUEL	SIGNATURE	RAHM EMANUEL SIGNATURE.SVG
AVERY BRUNDAGE	SIGNATURE	AVERY BRUNDAGE SIGNATURE.SVG
JIM MORAN	SIGNATURE	JIM MORAN SIGNATURE.PNG
DAVID VITTER	SIGNATURE	DAVID VITTER SIGNATURE.SVG
ELIJAH CUMMINGS	SIGNATURE	ELIJAH EUGENE CUMMINGS SIGNATURE.SVG
CHRIS VAN HOLLEN	SIGNATURE	CHRIS VAN HOLLEN SIGNATURE.SVG
HENRY POTTINGER	SIGNATURE	HENRY POTTINGER SIGNATURE.PNG
HELEN HERRON TAFT	SIGNATURE	HELEN TAFT SIGNATURE.SVG
FRANCES FOLSOM CLEVELAND PRESTON	SIGNATURE	FRANCES CLEVELAND SIGNATURE.SVG
MAMIE EISENHOWER	SIGNATURE	MAMIE EISENHOWER SIGNATURE.SVG
FLORENCE HARDING	SIGNATURE	FLORENCE HARDING SIGNATURE.SVG
BESS TRUMAN	SIGNATURE	BESS TRUMAN SIGNATURE.SVG
EDITH WILSON	SIGNATURE	EDITH BOLLING GALT WILSON SIGNATURE.SVG
ELLEN AXSON WILSON	SIGNATURE	ELLEN WILSON SIGNATURE.SVG
IDA SAXTON MCKINLEY	SIGNATURE	IDA MCKINLEY SIGNATURE.SVG
EDITH ROOSEVELT	SIGNATURE	EDITH ROOSEVELT SIGNATURE.SVG
LOUISA ADAMS	SIGNATURE	LOUISA C ADAMS SIGNATURE.SVG
CAROLINE HARRISON	SIGNATURE	CAROLINE HARRISON SIGNATURE.SVG
LUCRETIA GARFIELD	SIGNATURE	LUCRETIA GARFIELD SIGNATURE.SVG
ANNA HARRISON	SIGNATURE	ANNA HARRISON SIGNATURE.SVG
SARAH CHILDRESS POLK	SIGNATURE	SARAH POLK SIGNATURE.SVG
JULIA GARDINER TYLER	SIGNATURE	JULIA TYLER SIGNATURE.SVG
JANE PIERCE	SIGNATURE	JANE PIERCE SIGNATURE.SVG
HARRIET LANE	SIGNATURE	HARRIET R LANE SIGNATURE.SVG
ABIGAIL FILLMORE	SIGNATURE	ABIGAIL FILLMORE SIGNATURE.SVG
KENNY GUINN	SIGNATURE	KENNY GUINN SIGNATURE.GIF
ROD BLAGOJEVICH	SIGNATURE	ROD BLAGOJEVICH SIGNATURE.SVG
GAVIN NEWSOM	SIGNATURE	GAVIN NEWSOM SIGNATURE.SVG
DAVID CAMERON	SIGNATURE	ACCESSION TREATY 2011 DAVID CAMERON SIGNATURE.SVG
ERNIE FLETCHER	SIGNATURE	ERNIE FLETCHER SIGNATURE.GIF
JOE HOEFFEL	SIGNATURE	JOE HOEFFEL SIGNATURE.SVG
VOJISLAV KOšTUNICA	SIGNATURE	SIGNATURE OF VOJISLAV KOšTUNICA.PNG
ANGELICA SINGLETON VAN BUREN	SIGNATURE	PRESIDENTS ANGELICA VAN BUREN SIGNATURE.JPG
MARY ARTHUR MCELROY	SIGNATURE	PRESIDENTS MARY A MCELROY SIGNATURE.PNG
JOHN BALDACCI	SIGNATURE	JOHN BALDACCI SIGNATURE.SVG
MITT ROMNEY	SIGNATURE	MITT ROMNEY SIGNATURE.SVG
C. D. HOWE	SIGNATURE	CD HOWE SIGNATURE.SVG
NOE ZHORDANIA	SIGNATURE	NOE ZHORDANIA SIGNATURE.SVG
JOHN WENTWORTH	SIGNATURE	LT. COL. JOHN WENTWORTH'S SIGNATURE.PNG
CHLODWIG, PRINCE OF HOHENLOHE-SCHILLINGSFüRST	SIGNATURE	UNTERSCHRIFT CHLODWIG ZU HOHENLOHE-SCHILLINGSFüRST.SVG
NGUYễN CAO Kỳ	SIGNATURE	NGUYEN CAO KY  - AUTOGRAPH SENTIMENT SIGNED.PNG
WARREN CHRISTOPHER	SIGNATURE	WARREN CHRISTOPHER SIGNATURE.SVG
PHILANDER C. KNOX	SIGNATURE	PHILANDER C KNOX SIGNATURE.SVG
TONY KNOWLES	SIGNATURE	TONY KNOWLES SIGNATURE.JPG
JOSEPH HODGES CHOATE	SIGNATURE	JOSEPH H. CHOATE SIGNATURE.PNG
SIMON SNYDER	SIGNATURE	SIMON SNYDER SIGNATURE.SVG
JOHN W. GEARY	SIGNATURE	JOHN W GEARY SIGNATURE.SVG
GEORGES ERNEST BOULANGER	SIGNATURE	GEORGES BOULANGER - SIGNATURE.PNG
NARENDRA MODI	SIGNATURE	SIGNATURE OF NARENDRA MODI.SVG
MARY ELLEN WITHROW	SIGNATURE	MARY ELLEN WITHROW SIG.JPG
VENKAIAH NAIDU	SIGNATURE	SIGNATURE OF VENKAIAH NAIDU.SVG
JOSEPH HOWE	SIGNATURE	JOSEPH HOWE SIGNATURE.SVG
ELPIDIO QUIRINO	SIGNATURE	QUIRINO SIG.PNG
RICK LEVIN	SIGNATURE	RICK LEVIN SIGNATURE.SVG
MARK SANFORD	SIGNATURE	MARK SANFORD SIGNATURE.SVG
TIMOTHY PICKERING	SIGNATURE	TIMOTHY PICKERING SIGNATURE.SVG
JOHN LANGDON	SIGNATURE	JOHN LANGDON SIGNATURE.SVG
PHIL GOFF	SIGNATURE	PHIL GOFF SIGNATURE.SVG
ANTóNIO GUTERRES	SIGNATURE	ANTONIO GUTERRES ASSINATURA.JPG
GENNADY ZYUGANOV	SIGNATURE	SIGNATURE OF GENNADY ZYUGANOV.PNG
KARUNANIDHI	SIGNATURE	KARUNANIDHI SIGNATURE.SVG
GEORGE FERNANDES	SIGNATURE	GEORGE FERNANDES AUTOGRAPH.JPG
JOHN G. CARLISLE	SIGNATURE	APPLETONS' CARLISLE JOHN GRIFFIN SIGNATURE.JPG
WILLIAM HULL	SIGNATURE	WILLIAM HULL SIGNATURE.SVG
FRANCIS BIDDLE	SIGNATURE	FRANCIS BIDDLE SIGNATURE.JPG
LOUIS MCLANE	SIGNATURE	LOUIS MCLANE SIGNATURE.SVG
AZEM HAJDARI	SIGNATURE	AZEM HAJDARI SIGNATURE.SVG
JUAN MANUEL DE ROSAS	SIGNATURE	FIRMA DEL BRIGADIER GENERAL DON JUAN MANUEL DE ROSAS-.PNG
ELIZABETH MONROE	SIGNATURE	ELIZABETH MONROE SIGNATURE.SVG
JOSEPH YAM	SIGNATURE	JOSEPH YAM CHI KWONG SIGNATURE.PNG
KāRLIS ULMANIS	SIGNATURE	KāRLIS ULMANIS SIGNATURE.SVG
NIKOLAI YEZHOV	SIGNATURE	NIKOLAI YEZHOV SIGNATURE 1938.PNG
GUNTIS ULMANIS	SIGNATURE	SIGNATURE OF GUNTIS ULMANIS.PNG
JOHN CONYERS	SIGNATURE	JOHN CONYERS SIGNATURE.PNG
MICHAEL STEELE	SIGNATURE	MICHAEL STEELE SIGNATURE.SVG
SERGIO OSMEñA	SIGNATURE	OSMENA SIG.PNG
ROBERT SMITH	SIGNATURE	ROBERT SMITH SIGNATURE.SVG
ROBERT CHARLES WINTHROP	SIGNATURE	APPLETONS' WINTHROP JOHN - ROBERT CHARLES SIGNATURE.PNG
DANILO MEDINA	SIGNATURE	FIRMA-DANILO-MEDINA.SVG
MARIANO RAJOY	SIGNATURE	FIRMA DE MARIANO RAJOY.SVG
ENVER PASHA	SIGNATURE	ENVER PAşA IMZASı.PNG
JOSé P. LAUREL	SIGNATURE	LAUREL SIG.SVG
W. AVERELL HARRIMAN	SIGNATURE	WILLIAM AVERELL HARRIMAN SIGNATURE.SVG
GALUSHA A. GROW	SIGNATURE	APPLETONS' GROW GALUSHA AARON SIGNATURE.PNG
JULIA GILLARD	SIGNATURE	JULIA GILLARD SIGNATURE.SVG
WILLIAM S. CLARK	SIGNATURE	WILLIAMSCLARK.SVG
GORDON THIESSEN	SIGNATURE	--02-25
DAVID A. DODGE	SIGNATURE	--02-28
HUGH JOHN MACDONALD	SIGNATURE	HUGH JOHN MACDONALD SIGNATURE.SVG
CHARLES AVERY DUNNING	SIGNATURE	CHARLES A DUNNING SIGNATURE.SVG
LOUIS-MARIE STANISLAS FRéRON	SIGNATURE	LOUIS FRéRONSIGNATURE.JPG
JóZEF HALLER	SIGNATURE	J.HALLER SIGNATURE.JPG
ALI LARIJANI	SIGNATURE	ALI LARIJANI SIGNATURE.SVG
JOHN J. CRITTENDEN	SIGNATURE	JOHN JORDAN CRITTENDEN SIGNATURE.SVG
CARL VINSON	SIGNATURE	CARL VINSON SIGNATURE.SVG
JOHN SEVIER	SIGNATURE	JOHN SEVIER SIGNATURE.SVG
IBRAHIM RUGOVA	SIGNATURE	IBRAHIM RUGOVA SIGNATURE.SVG
PATRICIO AYLWIN	SIGNATURE	FIRMA PATRICIO AYLWIN.PNG
SERGEY LAVROV	SIGNATURE	SIGNATURE OF SERGEY LAVROV.PNG
SANDER LEVIN	SIGNATURE	SANDER LEVIN SIGNATURE.SVG
EUGENE WHELAN	SIGNATURE	WHELAN-SIG.PNG
JOHN SHERMAN COOPER	SIGNATURE	JOHN-SHERMAN-COOPER-SIG.JPG
BORIS TADIć	SIGNATURE	BORIS TADIC SIGNATURE.GIF
RICK PERRY	SIGNATURE	RICK PERRY SIGNATURE.SVG
JAMES MCHENRY	SIGNATURE	JAMES MCHENRY SIGNATURE.SVG
MARIO MONTI	SIGNATURE	MARIO MONTI SIGNATURE.PNG
THOMAS CORWIN	SIGNATURE	THOMAS CORWIN SIGNATURE.PNG
VITALI KLITSCHKO	SIGNATURE	VITALI KLITSCHKO SIGNATURE.PNG
NICOLAS SARKOZY	SIGNATURE	NICOLAS SARKOZY SIGNATURE.SVG
ALEXANDER KEITH	SIGNATURE	ALEXANDERKEITHSIGNATURE.SVG
SéGOLèNE ROYAL	SIGNATURE	SEGOLENE ROYAL SIGNATURE..JPG
FRANçOIS HOLLANDE	SIGNATURE	FRANçOIS HOLLANDE SIGNATURE.SVG
LAWRENCE GONZI	SIGNATURE	LAWRENCE_GONZI_SIGNATURE_2.SVG
UHURU KENYATTA	SIGNATURE	UHURU KENYATTA SIGNATURE.PNG
NICHOLAS MURRAY BUTLER	SIGNATURE	NICHOLAS MURRAY BUTLER SIGNATURE.SVG
ALPHONSO TAFT	SIGNATURE	APPLETONS' TAFT ALPHONSO SIGNATURE.PNG
IVAN GAšPAROVIč	SIGNATURE	SIGNATURE OF IVAN GAšPAROVIč.PNG
JOãO HAVELANGE	SIGNATURE	JOãO HAVELANGE FIFA PRESIDENT SIGNATURE..JPG
MLAđAN DINKIć	SIGNATURE	SIGNATURE MLADJAN DINKIC.PNG
HENRY MORGENTHAU JR.	SIGNATURE	HENRY MORGENTHAU JR SIG.JPG
MICHEL DEBRé	SIGNATURE	SIGNATURE MICHEL DEBRé.JPG
DIXY LEE RAY	SIGNATURE	DIXY LEE RAY SIGNATURE.PNG
JUAN PRIM, 1ST MARQUIS OF LOS CASTILLEJOS	SIGNATURE	FIRMA PRIM.PNG
YEGOR GAIDAR	SIGNATURE	SIGNATURE OF YEGOR GAIDAR.PNG
WANG JIN-PYNG	SIGNATURE	SIGNATURE OF WANG JIN-PYNG.SVG
MANMOHAN SINGH	SIGNATURE	MANMOHAN SINGH SIGNATURES.SVG
NIKOLAI PODGORNY	SIGNATURE	NIKOLAI PODGORNY SIGNATURE 1967.PNG
CHARLES REED BISHOP	SIGNATURE	CHAS R BISHOP 1848 SIGNATURE.SVG
RAFAEL CARRERA	SIGNATURE	FIRMA DE RAFAEL CARRERA. MUSEO NACIONAL DE HISTORIA.JPG
ROBERT RUBIN	SIGNATURE	ROBERT E RUBIN SIG.JPG
ALEXANDER J. DALLAS	SIGNATURE	ALEXANDER J DALLAS SIGNATURE.SVG
WILLIAM P. FESSENDEN	SIGNATURE	APPLETONS' FESSENDEN SAMUEL - WILLIAM PITT SIGNATURE.JPG
SHEIKH HASINA	SIGNATURE	SHEIKH HASINA SIGNATURE.PNG
VLADIMíR REMEK	SIGNATURE	VLADIMíR REMEK - PODPIS.JPG
JOHN M. CLAYTON	SIGNATURE	JOHN M. CLAYTON SIGNATURE.PNG
WILLIAM R. DAY	SIGNATURE	WILLIAM RUFUS DAY SIGNATURE.JPG
ZACHARIAH CHANDLER	SIGNATURE	ZACHARIAH CHANDLER SIGNATURE.SVG
ARTUR MAS	SIGNATURE	SIGNATURA ARTUR MAS.SVG
THEODORE HESBURGH	SIGNATURE	THEODORE HESBURGH SIGNATURE.SVG
ABDULLAH GüL	SIGNATURE	ABDULLAH GüL'S SIGNATURE.PNG
BERNARDINO MACHADO	SIGNATURE	ASSINATURABERNARDINOMACHADO.SVG
ENOS T. THROOP	SIGNATURE	ENOS THOMSON THROOP SIGNATURE.SVG
JAROSłAW KACZYńSKI	SIGNATURE	JAROSłAW KACZYńSKI SIGNATURE.SVG
LECH KACZYńSKI	SIGNATURE	LECH KACZYńSKI SIGNATURE.SVG
HERBERT H. LEHMAN	SIGNATURE	HERBERT HENRY LEHMAN SIGNATURE.SVG
IGNACY MOśCICKI	SIGNATURE	IGNACY MOSCICKI SIGNATURE.JPG
GLEN MURRAY	SIGNATURE	GLEN MURRAY SIGNATURE.SVG
JOHN KASICH	SIGNATURE	JOHN-KASICH-SIGNATURE.PNG
DONALD TUSK	SIGNATURE	DONALD TUSK SIGNATURE 2.SVG
PAT TOOMEY	SIGNATURE	PAT TOOMEY SIGNATURE.SVG
LEONEL FERNáNDEZ	SIGNATURE	FIRMALF.JPG
JAMES A. BAYARD	SIGNATURE	APPLETONS' BAYARD JAMES ASHETON SIGNATURE.JPG
RICHARD RUSH	SIGNATURE	RICHARD RUSH SIGNATURE.PNG
SOMNATH CHATTERJEE	SIGNATURE	SIGNATURE OF SOMNATH CHATTERJEE.SVG
MANUEL DE ARRIAGA	SIGNATURE	ASSINATURA MANUEL DE ARRIAGA.SVG
MILOš ZEMAN	SIGNATURE	MILOš ZEMAN SIGNATURE BLACK.PNG
ABUL KALAM AZAD	SIGNATURE	AUTOGRAPH_OF_MAULANA_ABUL_KALAM_AZAD.JPG
WILLIAM WIRT	SIGNATURE	APPLETONS' WIRT WILLIAM SIGNATURE.JPG
CALEB CUSHING	SIGNATURE	APPLETONS' CUSHING CALEB SIGNATURE.JPG
BOB MENENDEZ	SIGNATURE	BOB MENENDEZ SIGNATURE.SVG
JUDSON HARMON	SIGNATURE	JUDSON HARMON SIGNATURE.PNG
PETER DEFAZIO	SIGNATURE	PETER DEFAZIO SIGNATURE.GIF
DAVID WU	SIGNATURE	DAVID WU SIGNATURE.JPG
ASA S. BUSHNELL	SIGNATURE	ASA S. BUSHNELL  SIGNATURE.JPG
GEORGE HOADLY	SIGNATURE	GEORGE HOADLY SIGNATURE.JPG
GEORGE K. NASH	SIGNATURE	GEORGE K. NASH SIGNATURE.JPG
JOSEPH B. FORAKER	SIGNATURE	JOSEPH B. FORAKER SIGNATURE.PNG
DUNCAN MCARTHUR	SIGNATURE	APPLETONS' MCARTHUR DUNCAN SIGNATURE.JPG
EDWARD TIFFIN	SIGNATURE	EDWARD TIFFIN SIGNATURE.PNG
ROB PORTMAN	SIGNATURE	ROBERT JONES PORTMAN OFFICIAL SIGNATURE.JPG
JAMES WOLFENSOHN	SIGNATURE	SIGNATURE OF JAMES D. WOLFENSOHN.SVG
SAMUEL DEXTER	SIGNATURE	SAMUEL DEXTER SIGNATURE.SVG
HENRY B. PAYNE	SIGNATURE	SIGNATURE OF HENRY B. PAYNE.SVG
THOMAS EWING	SIGNATURE	THOMAS EWING SIGNATURE.PNG
PEDRO PABLO RAMíREZ	SIGNATURE	FIR-RAMIREZ.GIF
TOMISLAV NIKOLIć	SIGNATURE	SIGNATURE TOMISLAV NIKOLIC.PNG
IVICA DAčIć	SIGNATURE	IVICA DACIC SIGNATURE.PNG
SERGEI BAGAPSH	SIGNATURE	SERGEI BAGAPSH SIGNATURE.SVG
W. MICHAEL BLUMENTHAL	SIGNATURE	W M BLUMENTHAL SIG.JPG
JOHN BELL	SIGNATURE	JOHN-BELL-TN-SIGNATURE-.JPG
JUSTIN SMITH MORRILL	SIGNATURE	JUSTINSMITHMORRILL.SVG
LUIS ALBERTO LACALLE	SIGNATURE	LACALLE SIGNATURE.SVG
THOMAS WILSON DORR	SIGNATURE	THOMAS WILSON DORR SIGNATURE.JPG
CHARLES WOODRUFF YOST	SIGNATURE	CWY SIGNATURE.PNG
QIAN QICHEN	SIGNATURE	QIAN QICHEN SIGN.JPG
RAMóN FREIRE	SIGNATURE	FIRMA RAMóN FREIRE.SVG
FELIX GRUNDY	SIGNATURE	FELIX GRUNDY SIGNATURE.SVG
CURT WELDON	SIGNATURE	CURT WELDON SIGNATURE.SVG
BENJAMIN FRANKLIN BUTLER	SIGNATURE	BENJAMIN FRANKLIN BUTLER  SIGNATURE.SVG
JERZY BUZEK	SIGNATURE	JERZY BUZEK SIGNATURE.SVG
BOB MILLER	SIGNATURE	BOB MILLER SIGNATURE.JPG
RALPH IZARD	SIGNATURE	RALPH IZARD SIGNATURE.SVG
BENEDETTO CROCE	SIGNATURE	FIRMABCROCE.PNG
MANUEL ROXAS	SIGNATURE	ROXAS SIG.PNG
WILLIAM RUSSELL	SIGNATURE	WILLIAMERUSSELLSIGNATURE.PNG
EDWARD WINSLOW	SIGNATURE	EDWARDWINSLOWSIGNATURE.PNG
WILLIAM H. WOODIN	SIGNATURE	W H WOODIN SIG.JPG
VIKTOR ORBáN	SIGNATURE	ACCESSION TREATY 2011 VIKTOR ORBáN SIGNATURE.SVG
OGDEN L. MILLS	SIGNATURE	OGDEN L MILLS SIG.JPG
WALTER BEDELL SMITH	SIGNATURE	W. B. SMITH SIGNATURE.PNG
R. VENKATARAMAN	SIGNATURE	RAMASWAMY VENKATARAMAN'S AUTOGRAPH.JPG
TANSU ÇILLER	SIGNATURE	SIGNATURE OF TANSU CILLER.SVG
LEON PANETTA	SIGNATURE	LEON PANETTA SIG.SVG
MANUEL ORIBE	SIGNATURE	MANUEL ORIBE SIGNATURE.SVG
STANISLAV GROSS	SIGNATURE	STANISLAV GROSS SIGNATURE.SVG
TED STRICKLAND	SIGNATURE	TED STRICKLAND SIGNATURE.SVG
JOHN BOEHNER	SIGNATURE	JOHN BOEHNER SIGNATURE.SVG
ROBERT B. ANDERSON	SIGNATURE	ROBERT B ANDERSON SIG.JPG
HENRY B. ANTHONY	SIGNATURE	APPLETONS' ANTHONY HENRY BOWEN SIGNATURE.PNG
REUBIN ASKEW	SIGNATURE	REUBIN ASKEW'S SIGNATURE.PNG
JAMES GUTHRIE	SIGNATURE	JAMES-GUTHRIE-SIG.JPG
SUSILO BAMBANG YUDHOYONO	SIGNATURE	SUSILO BAMBANG YUDHOYONO SIGNATURE.SVG
MARSHALL JEWELL	SIGNATURE	MARSHALL JEWELL .JPG
ANTóNIO RAMALHO EANES	SIGNATURE	ASSINATURARAMALHOEANES.SVG
WILLIAM A. EGAN	SIGNATURE	WILLIAM ALLEN EGAN SIGNATURE.JPG
COLUMBUS DELANO	SIGNATURE	COLUMBUS DELANO SIGNATURE.SVG
BETTINO RICASOLI	SIGNATURE	BETTINO RICASOLI SIGNATURE.SVG
URBANO RATTAZZI	SIGNATURE	URBANO RATTAZZI SIGNATURE.SVG
HENRY STANBERY	SIGNATURE	HENRY STANBERY SIGNATURE.PNG
VOJISLAV ŠEšELJ	SIGNATURE	VOJISLAV SESELJ SIGNATURE.PNG
ARCHIBALD SCOTT CLEGHORN	SIGNATURE	ARCHIBALD SCOTT CLEGHORN 1879 SIGNATURE.SVG
CURTIS P. IAUKEA	SIGNATURE	IAUKEA 1896 SIGNATURE.SVG
WILLIAM BERKELEY	SIGNATURE	MAKERS OF VIRGINIA HISTORY - GOV WILLIAM BERKELEY SIGNATURE.JPG
SIDóNIO PAIS	SIGNATURE	ASSINATURASIDóNIOPAIS.SVG
CEVDET SUNAY	SIGNATURE	CEVDET SUNAY IMZA.PNG
HENRY H. FOWLER	SIGNATURE	HENRY H FOWLER SIG.JPG
ABBOTT LAWRENCE	SIGNATURE	APPLETONS' APPLETON LAWRENCE AMOS - ABBOTT SIGNATURE.JPG
JAN SYROVý	SIGNATURE	JAN SYROVý - PODPIS.GIF
BENJAMIN MOORE	SIGNATURE	SIGNATURE OF BISHOP BENJAMIN MOORE.PNG
ARTHUR ERNEST MORGAN	SIGNATURE	ARTHUR_ERNEST_MORGAN_SIGNATURE.JPG
IGOR SMIRNOV	SIGNATURE	SMIRNOV AUTOGRAPH.PNG
CARTER GLASS	SIGNATURE	CARTER GLASS SIG.JPG
GEORGE HENRY WILLIAMS	SIGNATURE	GEORGE HENRY WILLIAMS SIGNATURE.SVG
ROBERT GATES	SIGNATURE	ROBERT GATES SIGNATURE 2.SVG
RICHARD BURR	SIGNATURE	RICHARD BURR SIGNATURE.SVG
DAVID M. KENNEDY	SIGNATURE	DAVID M KENNEDY SIG.JPG
CHRISTIAN WULFF	SIGNATURE	CHRISTIAN WULFF SIGNATURE.SVG
SIGMAR GABRIEL	SIGNATURE	SIGNATURE SIGMAR GABRIEL.PNG
ANTóNIO COSTA	SIGNATURE	ASSINATURAANTóNIOCOSTA.SVG
JOSEPH W. BARR	SIGNATURE	JOSEPH W BARR SIG.JPG
JOHN WESLEY SNYDER	SIGNATURE	JOHN W SNYDER SIG.JPG
GEORGE M. HUMPHREY	SIGNATURE	G M HUMPHREY SIG.JPG
SERGEY SHOYGU	SIGNATURE	SIGNATURE OF SERGEY SHOYGU.PNG
JAMES BARBOUR	SIGNATURE	JAMES BARBOUR SIGNATURE.SVG
NIKOLA PAšIć	SIGNATURE	SIGNATURENIKOLAPASIC.PNG
ALEXANDER YAKOVLEV	SIGNATURE	SIGNATURE OF ALEXANDER NIKOLAEVICH YAKOVLEV.PNG
LEVON TER-PETROSYAN	SIGNATURE	LEVON TER-PETROSYAN SIGNATURE.PNG
EDWARD H. EAST	SIGNATURE	EDWARD-HAZZARD-EAST-SIGNATURE.JPG
MARTIN O'MALLEY	SIGNATURE	MARTIN O'MALLEY SIGNATURE.SVG
JOHN ADAMS DIX	SIGNATURE	JOHN ADAMS DIX SIGNATURE.SVG
FRANKLIN KNIGHT LANE	SIGNATURE	FRANKLIN K LANE SIGNATURE.SVG
PAULO PORTAS	SIGNATURE	ASSINATURA PAULO PORTAS.SVG
KEN SALAZAR	SIGNATURE	KEN SALAZAR SIGNATURE.SVG
GEORGE PERKINS MARSH	SIGNATURE	APPLETONS' MARSH CHARLES - GEORGE PERKINS SIGNATURE.PNG
JAMES D. PORTER	SIGNATURE	JAMES-PORTER-SIGNATURE.PNG
ALBERT S. MARKS	SIGNATURE	MARKS-ALBERT-SMITH-SIGNATURE.JPG
ROBERT LOVE TAYLOR	SIGNATURE	TAYLOR-ROBERT-LOVE-SIGNATURE.PNG
FAHRI KORUTüRK	SIGNATURE	FAHRI KORUTüRK IMZASı.PNG
CARLOS P. GARCIA	SIGNATURE	GARCIA SIG.PNG
HENRY TAZEWELL	SIGNATURE	HENRY TAZEWELL SIGNATURE.SVG
TSAKHIAGIIN ELBEGDORJ	SIGNATURE	SIGNATURE OF TSAKHIAGIIN ELBEGDORJ.SVG
GEORGE VON LENGERKE MEYER	SIGNATURE	GEORGE VON LENGERKE MEYER SIGNATURE.JPG
GEORGE H. V. BULYEA	SIGNATURE	GEORGE HEDLEY VICARS BULYEA SIGNATURE.SVG
DICK HUBBARD	SIGNATURE	DICK HUBBARD SIGNATURE.SVG
HERMES DA FONSECA	SIGNATURE	ASSINATURA HERES OK VALENDO.JPG
JúLIO PRESTES	SIGNATURE	JúLIO PRESTES 1930SIGNATURE.JPG
BRIAN SANDOVAL	SIGNATURE	BRIAN SANDOVAL SIG.SVG
RICHARD BLUMENTHAL	SIGNATURE	RICHARD BLUMENTHAL SIGNATURE.SVG
BILL SHUSTER	SIGNATURE	BILL SHUSTER SIGNATURE.SVG
JIM GERLACH	SIGNATURE	JIM GERLACH SIGNATURE.PNG
PHIL ENGLISH	SIGNATURE	PHIL ENGLISH SIGNATURE.SVG
JOHN M. MCHUGH	SIGNATURE	JOHN M. MCHUGH SIGNATURE.SVG
KONSTANTIN RODZAEVSKY	SIGNATURE	KONSTANTIN RODZAEVSKY SIGNATURE.SVG
JOHN DAVIS	SIGNATURE	GOVJOHNDAVISSIGNATURE.PNG
JORGE ALESSANDRI	SIGNATURE	FIRMA JORGE ALESSANDRI.PNG
CALEB BLOOD SMITH	SIGNATURE	CALEB BLOOD SMITH SIGNATURE.SVG
MICHELLE BACHELET	SIGNATURE	FIRMA DE MICHELLE BACHELET.SVG
ROSCOE CONKLING	SIGNATURE	ROSCOE CONKLING SIGNATURE.SVG
SHANKAR DAYAL SHARMA	SIGNATURE	SIGNATURE OF SHANKER DAYAL SHARMA.SVG
JYOTI BASU	SIGNATURE	JYOTI BASU SIGNATURE.JPG
ANDREI GRECHKO	SIGNATURE	ANDREI GRECHKO SIGNATURE 1949.PNG
JOSé SóCRATES	SIGNATURE	JOSE SOCRATES SIGNATURE.SVG
DONALD SMITH, 1ST BARON STRATHCONA AND MOUNT ROYAL	SIGNATURE	DONALD SMITH, 1ST BARON STRATHCONA AND MOUNT ROYAL SIGNATURE.SVG
BHAIRON SINGH SHEKHAWAT	SIGNATURE	SIGNATURE OF BHAIRON SINGH SHEKHAWAT.SVG
JYRKI KATAINEN	SIGNATURE	ACCESSION TREATY 2011 JYRKI KATAINEN SIGNATURE.SVG
E. GORDON GEE	SIGNATURE	GORDON GEE SIGNATURE.SVG
HANS VAN MIERLO	SIGNATURE	AMSTERDAM TREATY FA THE NETHERLANDS.PNG
MOHAMMAD REZA AREF	SIGNATURE	MOHAMMAD REZA AREF SIGNATURE.SVG
JOHN KEY	SIGNATURE	JOHN KEY SIG.SVG
KAZIMIERZ ŚWITALSKI	SIGNATURE	KAZIMIERZ ŚWITALSKI - SIGNATURE.PNG
OSCAR LUIGI SCALFARO	SIGNATURE	SIGNATURE OF OSCAR LUIGI SCALFARO.PNG
BRIEN MCMAHON	SIGNATURE	BRIEN MCMAHON SIGNATURE.JPG
MARTHA JEFFERSON RANDOLPH	SIGNATURE	MARTHA JEFFERSON SIGNATURE.SVG
KATHERINE D. ORTEGA	SIGNATURE	KATHERINE DAVALOS ORTEGA SIG.JPG
ISAAC SHELBY	SIGNATURE	ISAAC SHELBY SIGNATURE.SVG
TRAIAN BăSESCU	SIGNATURE	SIGNATURE OF TRAIAN BăSESCU.PNG
WILLIAM TORREY HARRIS	SIGNATURE	WILLIAM TORREY HARRIS SIGNATURE.SVG
VIKTOR YUSHCHENKO	SIGNATURE	VIKTOR YUSHCHENKO'S SIGNATURE.SVG
BISHWESHWAR PRASAD KOIRALA	SIGNATURE	SIGNATURE OF BP KOIRALA.PNG
LINN BOYD	SIGNATURE	LINN BOYD SIGNATURE.SVG
SAMUEL J. RANDALL	SIGNATURE	SAMUEL J. RANDALL SIGNATURE.TIF
SANTIAGO DE LINIERS, 1ST COUNT OF BUENOS AIRES	SIGNATURE	FIRMADESANTIAGODELINIERS.JPG
MITCH DANIELS	SIGNATURE	MITCH DANIELS SIGNATURE.SVG
BOBBY JINDAL	SIGNATURE	BOBBY JINDAL SIGNATURE.SVG
OMAR MUKHTAR	SIGNATURE	OMAR AL-MUKHTAR'S SIGNATURE2.PNG
SOLOMON P. SHARP	SIGNATURE	SOLOMON-SHARP-SIG.JPG
STANLEY FISCHER	SIGNATURE	STANLEY FISCHER  SIGNATURE 2010.PNG
WILLIAM FITZHUGH	SIGNATURE	FITZHUGH SIGNATURE.PNG
APOLINARIO MABINI	SIGNATURE	APOLINARIO MABINI SIGNATURE.PNG
DEBBIE WASSERMAN SCHULTZ	SIGNATURE	DEBBIE WASSERMAN SCHULTZ SIGNATURE.JPG
LUKE P. BLACKBURN	SIGNATURE	LUKE P BLACKBURN SIGNATURE.SVG
ROBERT WILLIAMS	SIGNATURE	ROBT WILLIAMS AMPOLIT SIG.JPG
TOOMAS HENDRIK ILVES	SIGNATURE	TOOMAS HENDRIK ILVES SIGNATURE.SVG
SAMUEL ALITO	SIGNATURE	SAMUEL ALITO SIGNATURE.SVG
CHARLES A. WICKLIFFE	SIGNATURE	CHARLES ANDERSON WICKLIFFE SIGNATURE.SVG
CHARLIE CRIST	SIGNATURE	CHARLIE CRIST SIGNATURE.SVG
DAVID SWANN	SIGNATURE	DAVID SWANN SIGNATURE 2.SVG
MAREK JUREK	SIGNATURE	PODPIS MJ.GIF
JOE MANCHIN	SIGNATURE	JOE MANCHIN SIGNATURE.SVG
ANDRIS PIEBALGS	SIGNATURE	ANDRIS PIEBALGS SIGNATURE.SVG
JADRANKA KOSOR	SIGNATURE	ACCESSION TREATY 2011 JADRANKA KOSOR SIGNATURE.SVG
ALEXANDER GORCHAKOV	SIGNATURE	SIGNATUREALEXANDERGORCHAKOV.JPG
GEORGE TUCKER	SIGNATURE	SIGNATURE OF GEORGE TUCKER.JPEG
KAROLOS PAPOULIAS	SIGNATURE	KAROLOS PAPOULIAS SIGNATURE.SVG
ANTóNIO JOSé DE ALMEIDA	SIGNATURE	ASSINATURA ANTóNIO JOSé DE ALMEIDA.SVG
PERRY BELMONT	SIGNATURE	CAB 1918 BELMONT PERRY SIGNATURE.PNG
JOSé SERRA	SIGNATURE	SIGNATURE OF JOSé SERRA.JPG
JON HUNTSMAN JR.	SIGNATURE	JON M HUNTSMAN JR SIGNATURE.SVG
NIKOLAOS PLASTIRAS	SIGNATURE	NIKOLAOS-PLASTIRAS-SIGNATURE.SVG
MIKE COX	SIGNATURE	MICHAELCOXSIGNATURE.PNG
ALEXANDER GRIBOYEDOV	SIGNATURE	GRIBOYEDOV_SIGNATURE.JPG
ABDUL HARIS NASUTION	SIGNATURE	SIGNATURE OF ABDUL HARIS NASUTION.SVG
CHARLES O'CONOR	SIGNATURE	APPLETONS' O'CONOR, THOMAS - CHARLES SIGNATURE.PNG
NECMETTIN ERBAKAN	SIGNATURE	NECMETTIN ERBAKAN SIGNATURE.PNG
MUSTAFA KEMAL ATATüRK	SIGNATURE	SIGNATURE OF MUSTAFA KEMAL ATATüRK.SVG
SAMUEL SMITH	SIGNATURE	SAMUEL SMITH  .JPG
SCOTT WALKER	SIGNATURE	SCOTT-WALKER-SIGNATURE.PNG
JOSEPH REED INGERSOLL	SIGNATURE	APPLETONS' INGERSOLL JARED - JOSEPH REED SIGNATURE.PNG
MANUEL BLANCO ENCALADA	SIGNATURE	FIRMA BLANCO ENCALADA.SVG
ANTóNIO DE SPíNOLA	SIGNATURE	ASSINATURAANTóNIOSPíNOLA.SVG
AMéRICO TOMáS	SIGNATURE	ASSINATURAAMERICOTHOMAZ.SVG
PAVEL BéM	SIGNATURE	PAVEL BéM - PODPIS.PNG
NORMAN KWONG	SIGNATURE	NORMAN KWONG SIGNATURE.SVG
JOHN COTTON SMITH	SIGNATURE	JOHN COTTON SMITH SIGNATURE.SVG
LEVI LINCOLN JR.	SIGNATURE	LEVILINCOLNJRSIGNATURE.PNG
MOHAMMAD BAGHER GHALIBAF	SIGNATURE	MOHAMMAD BAGHER GHALIBAF SIGNATURE.SVG
NAVIN RAMGOOLAM	SIGNATURE	NAVIN RAMGOOLAM SIGNATURE.SVG
TERRY CAVANAGH	SIGNATURE	TERRY CAVANAGH SIGNATURE.SVG
ADAM MALIK	SIGNATURE	SIGN ADAM MALIK.PNG
LAURENCE DECORE	SIGNATURE	LAURENCE DECORE SIGNATURE.SVG
AMIR ABDULLAH KHAN NIAZI	SIGNATURE	A. A. K. NIAZI SIGNATURE.SVG
TIM KAINE	SIGNATURE	TIM KAINE SIGNATURE.SVG
ROB NICHOLSON	SIGNATURE	ROB NICHOLSON SIGNATURE.JPG
CECILIA MALMSTRöM	SIGNATURE	CECILIA MALMSTRöM SIGNATURE.SVG
SAM RAINSY	SIGNATURE	SAM RAINSY SIGNATURE.PNG
GREG ABBOTT	SIGNATURE	ABBOTTSIGNATURE.JPG
SOLOMON VAN RENSSELAER	SIGNATURE	APPLETONS' VAN RENSSELAER KILLIAN - SOLOMON SIGNATURE.PNG
ALEXANDER ANKVAB	SIGNATURE	ALEXANDER ANKVAB SIGNATURE.SVG
SHEVAH WEISS	SIGNATURE	S.WEISS SIGNATURE.JPG
JIM WEBB	SIGNATURE	WEBB SIGNATURE.PNG
BILL WHITE	SIGNATURE	BILL WHITE SIGNATURE.SVG
PHILIP KERR, 11TH MARQUESS OF LOTHIAN	SIGNATURE	PHILIP KERR, 11TH MARQUESS OF LOTHIAN SIGNATURE.JPG
ZHOU XIAOCHUAN	SIGNATURE	ZHOU XIAO CHUAN SIGNATURE.PNG
CHARLES J. COLGAN	SIGNATURE	CHARLES COLGAN SIGNATURE.PNG
JOHN ADAIR	SIGNATURE	JOHN ADAIR SIGNATURE.SVG
FEVZI ÇAKMAK	SIGNATURE	FEVZI ÇAKMAK IMZASı.PNG
WILLIAM HENRY CUSHING	SIGNATURE	WILLIAM HENRY CUSHING SIGNATURE.SVG
GEORGE L. HARRISON	SIGNATURE	GEORGE L HARRISON SIGNATURE.JPG
PAT QUINN	SIGNATURE	PAT QUINN SIGNATURE.SVG
CRISTINA FERNáNDEZ DE KIRCHNER	SIGNATURE	CF SIGNATURE.SVG
JAMES MOLINARO	SIGNATURE	JAMES MOLINARO SIGNATURE.PNG
REGINALD WINGATE	SIGNATURE	REGINALDWINGATE-SIGNATURE CLEANED.SVG
LEWIS STEVENSON	SIGNATURE	LEWIS GREEN STEVENSON SIGNATURE.PNG
MARCELO REBELO DE SOUSA	SIGNATURE	SIGNATURE MARCELO REBELO DE SOUSA.SVG
DOMINIQUE STRAUSS-KAHN	SIGNATURE	DOMINIQUE STRAUSS-KAHN SIGNATURE.JPG
GRANT MACEWAN	SIGNATURE	GRANT MACEWAN SIGNATURE.SVG
ANDREW JACKSON DONELSON	SIGNATURE	APPLETONS' DONELSON ANDREW JACKSON SIGNATURE.SVG
HENRY PAULSON	SIGNATURE	HENRY M PAULSON JR SIG.SVG
HELLE THORNING-SCHMIDT	SIGNATURE	ACCESSION TREATY 2011 HELLE THORNING-SCHMIDT SIGNATURE.SVG
URMAS PAET	SIGNATURE	URMAS PAET SIGNATURE.PNG
KAMAL NATH	SIGNATURE	SIGNATURE OF KAMAL NATH.SVG
ANTONI MACIEREWICZ	SIGNATURE	ANTONI MACIEREWICZ SIGNATURE.JPG
EZRA MEEKER	SIGNATURE	EZRA MEEKER SIGNATURE.SVG
THOMAS J. MURPHY, JR.	SIGNATURE	TOM MURPHY SIGNATURE.SVG
JOHN KER, 3RD DUKE OF ROXBURGHE	SIGNATURE	ROXBURGHE SIGNATURE.JPG
HERMAN GREF	SIGNATURE	SIGNATURE OF GERMAN GREF.PNG
MARTIN SCHULZ	SIGNATURE	MARTIN SCHULZ UNTERSCHRIFT.SVG
PIERRE NKURUNZIZA	SIGNATURE	PIERRE NKURUNZIZA SIGNATURE.PNG
MARK R. HAMILTON	SIGNATURE	MARK A. HAMILTON SIGNATURE.PNG
JIří PAROUBEK	SIGNATURE	JIří PAROUBEK SIGNATURE.SVG
PáL SCHMITT	SIGNATURE	SIGNATURE OF PáL SCHMITT.PNG
JOHN AARON RAWLINS	SIGNATURE	JOHN AARON RAWLINS SIGNATURE.SVG
JOHN ATTA MILLS	SIGNATURE	JOHN E ATTA MILLS SIGNATURE.JPG
HENRY CLAY PAYNE	SIGNATURE	HCPAYNESIGNATURE.PNG
SEBASTIáN PIñERA	SIGNATURE	FIRMA SEBASTIáN PIñERA.PNG
WILLIAM LAWRENCE	SIGNATURE	WILLIAM LAWRENCE  SIGNATURE.JPG
BUDDHADEB BHATTACHARJEE	SIGNATURE	BUDDHADEB BHATTACHARJEE SIGNATURE.JPG
JOHN ROBERTS	SIGNATURE	JOHN ROBERTS SIGNATURE.SVG
PEER STEINBRüCK	SIGNATURE	SIGNATURE P. STEINBRüCK.GIF
BAY BUCHANAN	SIGNATURE	ANGELA M BUCHANAN SIG.JPG
FELIPE CALDERóN	SIGNATURE	FELIPE CALDERóN SIGNATURE.SVG
ELMER ERNEST ROPER	SIGNATURE	ELMER ERNEST ROPER SIGNATURE.SVG
FRANCISCO ANTONIO PINTO	SIGNATURE	FIRMA FRANCISCO ANTONIO PINTO.SVG
HARRY AINLAY	SIGNATURE	HARRY AINLAY SIGNATURE.SVG
KRISHAN KANT	SIGNATURE	KRISHNA KANT.JPG
HENRY MARSHALL TORY	SIGNATURE	HM TORY SIGNATURE.SVG
A. C. GRAYLING	SIGNATURE	ANTHONY CLIFFORD GRAYLING SIGNATURE.SVG
MIKE DUFFY	SIGNATURE	DUFFY-SIGNATURE.JPG
OREN BURBANK CHENEY	SIGNATURE	ORENBCHENEYSIGNATURE.PNG
J. PROCTOR KNOTT	SIGNATURE	J.-PROCTOR-KNOTT-SIG.JPG
JOSEPH REED	SIGNATURE	JOSEPH REED SIGNATURE.SVG
VIRBHADRA SINGH	SIGNATURE	VIRBHADRA_SINGH_SIGNATURE.SVG
DEVAL PATRICK	SIGNATURE	DEVAL PATRICK SIGNATURE.SVG
HAMENGKUBUWONO IX	SIGNATURE	SIGN HBIX.PNG
JOSEPH DUFFEY	SIGNATURE	JOSEPHDUFFEY.SVG
CORY BOOKER	SIGNATURE	CORY BOOKER SIGNATURE .PNG
RUSLAN ABDULGANI	SIGNATURE	SIGNATURE OF ROESLAN ABDULGANI.SVG
AHMAD JANNATI	SIGNATURE	AHMAD JANNATI SIGNATURE.PNG
CHARLES SCOTT	SIGNATURE	GOVERNOR CHARLES SCOTT SIGNATURE.SVG
MICHELLE OBAMA	SIGNATURE	MICHELLE OBAMA SIGNATURE.SVG
VLADISLAV SURKOV	SIGNATURE	SIGNATURE OF VLADISLAV SURKOV.PNG
ELEAZAR LóPEZ CONTRERAS	SIGNATURE	LóPEZ CONTRERAS FIRMA.JPG
JIM RISCH	SIGNATURE	JIM RISCH SIGNATURE.PNG
LEóN FEBRES CORDERO	SIGNATURE	FIRMA DE LEóN FEBRES-CORDERO RIBADENEYRA.JPG
KAPIL SIBAL	SIGNATURE	SIGNATURE OF KAPIL SIBAL.SVG
STANISLAV KOSIOR	SIGNATURE	STANISLAV KOSIOR SIGNATURE 1934.PNG
C. P. RAMASWAMI IYER	SIGNATURE	CP SIGN.JPG
ABEL MALDONADO	SIGNATURE	ABEL MALDONADO SIGNATURE.JPG
WILLIAM HAWRELAK	SIGNATURE	WILLIAM HAWRELAK SIGNATURE.SVG
WILLIAM SHORT	SIGNATURE	WILLIAM SHORT SIGNATURE-.SVG
WILLIAM ANTROBUS GRIESBACH	SIGNATURE	WILLIAM A GRIESBACH SIGNATURE.SVG
JACK WARNER	SIGNATURE	JACK-WARNER-SIGNATURE.JPG
JANUSZ KORWIN-MIKKE	SIGNATURE	JANUSZ KORWIN-MIKKE SIGNATURE.SVG
WILLIAM F. GALVIN	SIGNATURE	WFGALVIN.SVG
PARK GEUN-HYE	SIGNATURE	PARK GEUN-HYE SIGNATURE.PNG
ROGER WOLCOTT	SIGNATURE	ROGER WOLCOTT SIG.PNG
EDWIN D. MCGUINNESS	SIGNATURE	EDWIN D. MCGUINNESS MAYOR OF PROVIDENCE SIGNATURE.JPG
JACK MARKELL	SIGNATURE	JACK MARKELL SIGNATURE.SVG
MARK EVERSON	SIGNATURE	MARK EVERSON SIGNATURE.PNG
LORRAINE HUNT	SIGNATURE	LORRAINE HUNT SIGNATURE.GIF
PEDRO PABLO KUCZYNSKI	SIGNATURE	PEDRO PABLO KUCZYNSKI SIGNATURE.SVG
JAMES ODDO	SIGNATURE	JAMES ODDO SIGNATURE.PNG
TED CRUZ	SIGNATURE	TEDCRUZSIG.SVG
RASHID NURGALIYEV	SIGNATURE	SIGNATURE OF RASHID NURGALIYEV.PNG
BRONISłAW KOMOROWSKI	SIGNATURE	BRONISłAW KOMOROWSKI SIGNATURE.SVG
CATALINA VASQUEZ VILLALPANDO	SIGNATURE	CATALINA V VILLALPANDO SIG.JPG
JOZIAS VAN AARTSEN	SIGNATURE	SIGNATURE OF JOZIAS VAN AARTSEN .PNG
GLENN HUBBARD	SIGNATURE	ROBERT GLENN HUBARD SIGNATURE.JPG
TEóFILO BRAGA	SIGNATURE	ASSINATURA TEóFILO BRAGA.SVG
JOãO DO CANTO E CASTRO	SIGNATURE	ASSINATURACANTOECASTRO.SVG
MANUEL DE OLIVEIRA GOMES DA COSTA	SIGNATURE	ASSINATURAGOMESDACOSTA.SVG
JOSé MENDES CABEçADAS	SIGNATURE	ASSINATURAMENDESCABEçADAS.SVG
AFONSO COSTA	SIGNATURE	ASSINATURA AFONSO COSTA.SVG
ADRIAN FENTY	SIGNATURE	ADRIAN FENTY SIGNATURE.SVG
RAJ BABBAR	SIGNATURE	SIGNATURE OF RAJ BABBAR.SVG
MARTINE AUBRY	SIGNATURE	MARTINE AUBRY SIGNATURE.JPG
CORNELIO SAAVEDRA	SIGNATURE	FIRMA DE CORNELIO SAAVEDRA.JPG
MARIANO MORENO	SIGNATURE	FIRMA DE MARIANO MORENO.JPG
ALEXEI KUDRIN	SIGNATURE	SIGNATURE OF ALEXEI KUDRIN.PNG
SEVERIN LøVENSKIOLD	SIGNATURE	SEVERIN LøVENSKIOLD SIGNATURE.PNG
KAREN DEMIRCHYAN	SIGNATURE	KAREN DEMIRCHYAN SIGNATURE.JPG
ENRIQUE PEñA NIETO	SIGNATURE	EPN FIRMA.PNG
JOHN MCKINLY	SIGNATURE	JOHN MCKINLY SIGNATURE.SVG
ADOLF HITLER	SIGNATURE	HITLER SIGNATURE2.SVG
BRINDA KARAT	SIGNATURE	SIGNATURE OF BRINDA KARAT.SVG
DAVID COBB	SIGNATURE	DAVID COBB SIGNATURE.PNG
VASILY BOCHKARYOV	SIGNATURE	BOCHKARYOV SIGNATURE.PNG
SERGEY SOBYANIN	SIGNATURE	SIGNATURE OF SERGEY SOBYANIN.PNG
MUSALIA MUDAVADI	SIGNATURE	MUSALIA MUDAVADI SIGNATURE.PNG
JAMES BLAIR	SIGNATURE	JAMES BLAIR SIGNATURE.SVG
VLADIMIR SHAMANOV	SIGNATURE	SIGNATURE OF VLADIMIR SHAMANOV.PNG
JOSé MUJICA	SIGNATURE	FIRMAMUJICA VEC.SVG
JOACHIM ERWIN	SIGNATURE	UNTERSCHRIFT JOACHIM ERWIN 2008.PNG
ABHISIT VEJJAJIVA	SIGNATURE	THAI-PM-ABHISIT SIGNATURE.PNG
ANASTASY VONSYATSKY	SIGNATURE	ANASTASY VONSYATSKY SIGNATURE.SVG
FRANK-WALTER STEINMEIER	SIGNATURE	SIGNATURE F.-W. STEINMEIER.GIF
JOSHUA REED GIDDINGS	SIGNATURE	APPLETONS' GIDDINGS JOSHUA REED SIGNATURE.JPG
VOLODYMYR SHCHERBYTSKY	SIGNATURE	VOLODYMYR SHCHERBYTSKY SIGNATURE 1978.PNG
JOHN ROWAN	SIGNATURE	JOHN ROWAN SIG.JPG
HORST SEEHOFER	SIGNATURE	SIGNATURE OF HORST SEEHOFER.PNG
NORBERT LAMMERT	SIGNATURE	NORBERT LAMMERT SIGNATURE.PNG
SARAH PALIN	SIGNATURE	SARAH PALIN SIGNATURE.SVG
M. M. LOGAN	SIGNATURE	M.-M.-LOGAN-SIG.JPG
WILLIAM H. WEST	SIGNATURE	WILLIAM H. WEST - SIGNATURE.JPG
FRANCIS NICHOLSON	SIGNATURE	FRANCISNICHOLSONSIGNATURE.PNG
JOHN W. STEVENSON	SIGNATURE	JOHN-W.-STEVENSON-SIG.JPG
AUGUSTUS OWSLEY STANLEY	SIGNATURE	AUGUSTUS OWSLEY STANLEY SIGNATURE.SVG
ROBERTO MARONI	SIGNATURE	FIRMA ROBERTO MARONI.JPG
GIORGIO NAPOLITANO	SIGNATURE	GIORGIO NAPOLITANO SIGNATURE.SVG
DAVID PATERSON	SIGNATURE	DAVID A PATERSON SIGNATURE.JPG
SERRANUS CLINTON HASTINGS	SIGNATURE	SERRANUS_HASTINGS_SIGNATURE.PNG
ALEXANDER PAPAGOS	SIGNATURE	ALEXANDROS-PAPAGOS-SIGNATURE.SVG
JAMES KENNEDY PATTERSON	SIGNATURE	JAMES-K-PATTERSON-SIG.JPG
RICHARD BLAND LEE	SIGNATURE	RICHARD BLAND LEE SIGNATURE.SVG
BILL RITTER	SIGNATURE	BILL RITTER SIGNATURE.SVG
ALI BONGO ONDIMBA	SIGNATURE	ALI BONGO'S SIGNATURE.PNG
PETRO POROSHENKO	SIGNATURE	PETRO POROSHENKO SIGNATURE 2014.PNG
BILL BOLLING	SIGNATURE	BILL BOLLING SIGNATURE.JPG
DMITRY MEDVEDEV	SIGNATURE	SIGNATURE OF DMITRY MEDVEDEV.SVG
ANDRéS ELOY BLANCO	SIGNATURE	ANDRéS ELOY BLANCO SIGNATURE.JPG
WILLIAM B. CASTLE	SIGNATURE	WILLIAM B. CASTLE - SIGNATURE.JPG
RADOSłAW SIKORSKI	SIGNATURE	RADOSLAW SIKORSKI - SIGNATURE.SVG
PAUL ST. PIERRE	SIGNATURE	PAUL ST PIERE CANADA.PNG
PETER LAI	SIGNATURE	SIGNATURE_OF_PETER_LAI.SVG
TONY BLAIR	SIGNATURE	SIGNATURE OF TONY BLAIR.PNG
JOHN L. HELM	SIGNATURE	JOHN LARUE HELM SIGNATURE.SVG
AHMET DAVUTOğLU	SIGNATURE	AHMET DAVUTOğLU SIGNATURE.PNG
HARRY S. TRUMAN	SIGNATURE	HARRY S TRUMAN SIGNATURE.SVG
IVOR DENT	SIGNATURE	IVOR DENT SIGNATURE.SVG
JERRY VOORHIS	SIGNATURE	JERRY VOORHIS SIGNATURE.SVG
ARCHIBALD DIXON	SIGNATURE	ARCHIBALD DIXON SIG.JPG
EUGEN KVATERNIK	SIGNATURE	EUGEN KVATERNIK'S SIGNATURE.JPG
ADAM BENJAMIN JR.	SIGNATURE	ADAM BENJAMIN SIGNATURE.JPG
JOHN CUTT	SIGNATURE	JOHN_CUTT_SIGNATURE_CROP.JPG
MARIO DRAGHI	SIGNATURE	MARIO DRAGHI SIGNATURE.SVG
MAURICIO MACRI	SIGNATURE	MACRISIGNATURE.PNG
CHARLES MARLEY ANDERSON	SIGNATURE	CHARLES MARLEY ANDERSON SIGNATURE.JPG
DEMETRIS CHRISTOFIAS	SIGNATURE	ACCESSION TREATY 2011 DIMITRIS CHRISTOFIAS SIGNATURE.SVG
ANTHONY G. BROWN	SIGNATURE	ANTHONY G BROWN SIGNATURE.GIF
CHARLES W. STEGER	SIGNATURE	CHARLES STEGER SIGNATURE.PNG
JOHNSON N. CAMDEN JR.	SIGNATURE	JOHNSON-CAMDEN-JR.-SIG.JPG
IVY BAKER PRIEST	SIGNATURE	IVY B PRIEST SIG.JPG
HENRY CORNELIUS BURNETT	SIGNATURE	HENRY C. BURNETT SIG.JPG
ANTóNIO MARIA DA SILVA	SIGNATURE	ASSINATURA ANTóNIO MARIA DA SILVA.SVG
CHARLES LANDON KNIGHT	SIGNATURE	CHARLES LANDON KNIGHT SIGNATURE.JPG
BERTIE AHERN	SIGNATURE	BERTIE AHERN SIGNATURE.JPG
WILLIAM JOSEPH DEBOE	SIGNATURE	WILLIAM-DEBOE-SIG.JPG
KEM SOKHA	SIGNATURE	KEM SOKHA SIGNATURE.PNG
WILLIAM ALEXANDER JULIAN	SIGNATURE	WILLIAM A JULIAN SIG.JPG
ELBERT L. LAMPSON	SIGNATURE	ELBERT L. LAMPSON SIGNATURE.JPG
LEE MYUNG-BAK	SIGNATURE	LEE MYUNGBAK SIGNATURE.PNG
LENA HJELM-WALLéN	SIGNATURE	AMSTERDAM TREATY FA SWEDEN.PNG
JAIME GAMA	SIGNATURE	AMSTERDAM TREATY FA PORTUGAL.PNG
JOAQUIM PIMENTA DE CASTRO	SIGNATURE	ASSINATURAJOAQUIMPIMENTADECASTRO.SVG
JOSé RELVAS	SIGNATURE	ASSINATURAJOSéRELVAS.SVG
LOUIS-HECTOR DE CALLIèRE	SIGNATURE	GRANDE_PAIX_DE_MONTRéAL_01_SIGNATURE_DU_CHEVALIER_DE_CALLIèRES.SVG
U RAZAK	SIGNATURE	U RAZAT SIGNATURE.SVG
WILLIAM LINDSAY	SIGNATURE	WILLIAM LINDSAY SIG.JPG
DENNIS DAUGAARD	SIGNATURE	DENNIS DAUGAARD SIGNATURE.SVG
DANNEL MALLOY	SIGNATURE	DANNELPMALLOYSIGNTURE.JPG
THARMAN SHANMUGARATNAM	SIGNATURE	THARMAN SHANMUGARATNAM SIGNATURE.PNG
JOHN DRAMANI MAHAMA	SIGNATURE	JOHN D MAHAMA SIGNATURE.JPG
TSAI ING-WEN	SIGNATURE	蔡英文SIGNATURE-2016.PNG
ROBERT FICO	SIGNATURE	ROBERT FICO SIGNATURE.JPG
MOHAMMAD REZA RAHIMI	SIGNATURE	SIGNATURE OF MOHAMMAD REZA RAHIMI.SVG
JOAQUíN CASTRO	SIGNATURE	JOAQUIN_CASTRO_SIG.GIF
HENRY E. COOPER	SIGNATURE	HENRY COOPER 1898 SIGNATURE.JPG
LISA BOSCOLA	SIGNATURE	LISA BOSCOLA SIGNATURE.SVG
RICK SCOTT	SIGNATURE	SCOTT_SIG.PNG
MARK RUTTE	SIGNATURE	ACCESSION TREATY 2011 MARK RUTTE SIGNATURE.SVG
JOHN PERCY PAGE	SIGNATURE	J PERCY PAGE SIGNATURE.SVG
FRANK OLIVER	SIGNATURE	FRANK OLIVER SIGNATURE.SVG
JACK DALRYMPLE	SIGNATURE	JACK DALYRYMPLE SIG.SVG
JOHN BURTON THOMPSON	SIGNATURE	JOHN-B.-THOMPSON-SIG.JPG
MOHAMMAD JAVAD ZARIF	SIGNATURE	SIGNATURE OF MOHAMMAD JAVAD ZARIF.SVG
HAN MYEONG-SOOK	SIGNATURE	HAN MYONG-SUK SIGNATURE.PNG
MIREK TOPOLáNEK	SIGNATURE	MIREK TOPOLáNEK SIGNATURE.SVG
ED STELMACH	SIGNATURE	ED STELMACH SIGNATURE2.SVG
HARRY MARSHALL ERSKINE EVANS	SIGNATURE	HARRY MARSHALL ERSKINE EVANS SIGNATURE.SVG
ANDREW LANZA	SIGNATURE	ANDREW LANZA SIGNATURE.PNG
CHEN DING-NAN	SIGNATURE	CHEN DING-NAN SIGN.GIF
JOHN HOWARD	SIGNATURE	JOHN HOWARD SIGNATURE.SVG
KAMRAN BAGHERI LANKARANI	SIGNATURE	KAMRAN BAGHERI LANKARANI SIGNATURE.SVG
DAVID A. BOWERS	SIGNATURE	DAVID BOWERS SIGNATURE.PNG
ALEXANDER BULLOCK	SIGNATURE	ALEXANDERBULLOCKSIGNATURE.PNG
P. SUBBARAYAN	SIGNATURE	SUBBARAYAN SIGN.JPG
BENJAMIN BATES II	SIGNATURE	BENJAMIN_BATES SIGNATURE FOUNDER OF BATES COLLEGE.JPG
MUSTAFA SARıGüL	SIGNATURE	MUSTAFA SARıGüL SIGNATURE.PNG
SERZH SARGSYAN	SIGNATURE	SERZH SARGSYAN SIGNATURE.PNG
RICK SNYDER	SIGNATURE	RICK-SNYDER-SIGSVG.PNG
EDWIN P. MORROW	SIGNATURE	EDWIN PORCH MORROW SIGNATURE.SVG
PAUL FEARING	SIGNATURE	PAUL FEARING SIGNATURE.JPG
GERALD FORD	SIGNATURE	GERALD FORD SIGNATURE.SVG
SELDEN P. SPENCER	SIGNATURE	SELDEN PALMER SPENCER SIGNATURE.JPG
HOWARD DEAN	SIGNATURE	HOWARD DEAN SIGNATURE.SVG
DICK CHENEY	SIGNATURE	DICK CHENEY SIGNATURE.SVG
HENRY LIPPITT	SIGNATURE	HENRY LIPPITT GOVERNOR OF RHODE ISLAND-SIGNATURE.JPG
OLLANTA HUMALA	SIGNATURE	FIRMAHUMALA.PNG
HAU LUNG-PIN	SIGNATURE	郝.JPG
JOHN F. KENNEDY	SIGNATURE	JOHN F KENNEDY SIGNATURE 2.SVG
JOHN KERRY	SIGNATURE	JOHN KERRY SIGNATURE2.SVG
WILLIAM HAWKINS POLK	SIGNATURE	WILLIAM-HAWKINS-POLK-SIGNATURE.JPG
GEORGE SYLVESTER TAYLOR	SIGNATURE	GEORGE SYLVESTER TAYLOR SIGNATURE.JPG
RODERICK R. BUTLER	SIGNATURE	RODERICK-RANDUM-BUTLER-SIGNATURE.JPG
KATHRYN E. GRANAHAN	SIGNATURE	KATHRYN GRANAHAN SIG.JPG
WILLIAM K. SUTER	SIGNATURE	SUTER SIGNATURE.PNG
WANG LEQUAN	SIGNATURE	WANG LEQUAN SIGN.JPG
JOSEPH CLARKE	SIGNATURE	JOSEPH A CLARKE SIGNATURE.SVG
ARAM MANUKIAN	SIGNATURE	ARAM MANUKIAN SIGNATURE.JPG
DAVID MILWYN DUGGAN	SIGNATURE	DAVID MILWYN DUGGAN SIGNATURE.SVG
RODOLFO NIN NOVOA	SIGNATURE	FIRMANIN.JPG
GABRIELLE GIFFORDS	SIGNATURE	GABRIELLE GIFFORDS SIGNATURE 2009.PNG
RASUL GULIYEV	SIGNATURE	SIGNATURE RASUL GULIYEV.JPG
ISA GAMBAR	SIGNATURE	ISA GAMBAR - SIGNATURE.PNG
KENNY BLATCHFORD	SIGNATURE	KENNY BLATCHFORD SIGNATURE.SVG
MOHAMMAD MEHDI ZAHEDI	SIGNATURE	SIGNATURE OF MOHAMMAD MEHDI ZAHEDI.SVG
WILLIAM GRAY	SIGNATURE	WILLIAM GRAY SIGNATURE.PNG
DIANE SAVINO	SIGNATURE	DIANE SAVINO SIGNATURE.PNG
EDUARD PLESKE	SIGNATURE	PLESKE EDUARD DMITRIEVICH SIGNATURE.JPG
LEV MEKHLIS	SIGNATURE	LEV MEHLIS SIGNATURE 1937.PNG
ADAM LIPIńSKI	SIGNATURE	ADAM LIPIńSKI SIGNATURE.PNG
RAINER BRüDERLE	SIGNATURE	SIGNATURE RAINER-BRUEDERLE.PNG
CHRIS CHRISTIE	SIGNATURE	CHRIS CHRISTIE SIGNATURE.SVG
JOHN LOUIS TAYLOR	SIGNATURE	JOHN LOUIS TAYLOR SIG.JPG
CHARLES STUART	SIGNATURE	CHARLES STUART SIGNATURE.SVG
JULIO COBOS	SIGNATURE	FIRMA COBOS.JPG
KIM JONG-UN	SIGNATURE	KIMJONGUNSIGN.PNG
JOSEPH ROYAL	SIGNATURE	JOSEPH ROYAL SIGNATURE.SVG
JUAN JOSé CASTELLI	SIGNATURE	FIRMA DE CASTELLI.JPG
PREM KUMAR DHUMAL	SIGNATURE	SIGNATURE_OF_PREM_KUMAR_DHUMAL.SVG
BüLENT ARıNç	SIGNATURE	BüLENT ARıNç SIGNATURE.PNG
FRANçOIS FILLON	SIGNATURE	FRANçOIS FILLON SIGNATURE.SVG
DAVID R. CRAIG	SIGNATURE	DRC SIGNATURE.GIF
JOE ARPAIO	SIGNATURE	JOE ARPAIO SIGNATURE.JPG
KARIYA MUNDA	SIGNATURE	SIGNATURE OF KARIA MUNDA.SVG
RADOVAN JELAšIć	SIGNATURE	SIGNATURE RADOVAN JELASIC.PNG
BRIAN MORAN	SIGNATURE	BRIAN MORAN SIGNATURE.PNG
MICHAEL IGNATIEFF	SIGNATURE	MICHAEL IGNATIEFF SIGNATURE.SVG
JACK WAGNER	SIGNATURE	JACKWAGNERSIGNATURE.SVG
RUSH D. HOLT JR.	SIGNATURE	RUSH HOLT SIGNATURE.PNG
KAZIMIRA PRUNSKIENė	SIGNATURE	SIGNATURE OF KAZIMIRA PRUNSKIENė.PNG
JAMES D. BLACK	SIGNATURE	JAMES DIXON BLACK SIGNATURE.SVG
AUGUSTUS E. WILLSON	SIGNATURE	AUGUSTUS EVERETT WILLSON SIGNATURE.SVG
THOMAS E. BRAMLETTE	SIGNATURE	THOMAS-E-BRAMLETTE-SIG.JPG
RAFAEL BUENAVENTURA	SIGNATURE	BUENAVENTURASIGNATURE.JPG
VINCENT J. GENTILE	SIGNATURE	VINCENT GENTILE SIGNATURE.PNG
BILL DE BLASIO	SIGNATURE	BILL DE BLASIO SIGNATURE.PNG
MARTIN GOLDEN	SIGNATURE	MARTY GOLDEN SIGNATURE.PNG
HENRY W. CUSHMAN	SIGNATURE	HENRY W. CUSHMAN SIGNATURE.PNG
KIRSTEN GILLIBRAND	SIGNATURE	KIRSTEN GILLIBRAND SIGNATURE.SVG
TOM CORBETT	SIGNATURE	TOM CORBETT SIGNATURE.SVG
HENRIQUE CAPRILES RADONSKI	SIGNATURE	FIRMA AUTéNTICA DE HENRIQUE CAPRILES RADONSKI.PNG
TREY GRAYSON	SIGNATURE	TREY GRAYSON SHORT SIGNATURE.JPG
SONTHI BOONYARATGLIN	SIGNATURE	SIGNATURE OF SONDHI BOONYARATGLIN.SVG
PAVEL POSTYSHEV	SIGNATURE	PAVEL POSTYSHEV SIGNATURE 1937.PNG
PRASANNA KUMAR PATASANI	SIGNATURE	PRASANNA PATASANI SIGN.PNG
SURAYUD CHULANONT	SIGNATURE	THAI-PM-SURAYUT SIGNATURE.SVG
NICOLáS MADURO	SIGNATURE	NICOLáS MADURO SIGNATURE.SVG
ANDREI FURSENKO	SIGNATURE	SIGNATURE OF ANDREI FURSENKO.PNG
MALCOLM SMITH	SIGNATURE	MALCSMITHSIG.JPG
JAMES WILLIAM BRYAN	SIGNATURE	JAMES W. BRYAN SIG.JPG
RODRIGO DUTERTE	SIGNATURE	RODRIGO DUTERTE SIGNATURE.PNG
KARIM SANJABI	SIGNATURE	SANJABI SIGNITURE.PNG
KARAN SINGH	SIGNATURE	KARAN SINGH AUTOGRAPH.JPG
GEORGE A. HIBBARD	SIGNATURE	GEORGE_A_HIBBARD_SIGNATURE.PNG
HERMAN VAN ROMPUY	SIGNATURE	HERMAN VAN ROMPUY SIGNATURE.SVG
DENNIS RICHARDSON	SIGNATURE	DENNIS RICHARDSON SIGNATURE.PNG
BENJAMIN HARRISON	SIGNATURE	BENJAMIN HARRISON SIGNATURE-2.SVG
JOSé LUIS MACHINEA	SIGNATURE	FIRMA MACHINEA.JPG
SHERROD BROWN	SIGNATURE	SHERROD BROWN .PNG
JOHN APPLETON	SIGNATURE	JOHNAPPLETONSIGNATURE.PNG
MAHMOUD AHMADINEJAD	SIGNATURE	MAHMOUD AHMADINEJAD SIGNATURE.SVG
DILMA ROUSSEFF	SIGNATURE	SIGNATURE OF DILMA ROUSSEFF.SVG
SHAHKUR ULLAH DURRANI	SIGNATURE	S.U._DURRANI_SIGNATURE_AS_GOVERNOR_OF_THE_STATE_BANK_OF_PAKISTAN.PNG
WALTER M. GIBSON	SIGNATURE	WALTER M GIBSON 1886 SIGNATURE.SVG
ROQUE FERNáNDEZ	SIGNATURE	FIRMA_ROQUE_FERNáNDEZ.JPG
THOMAS N. HART	SIGNATURE	THOMAS NORTON HART SIGNATURE.PNG
MICHAEL CUSICK	SIGNATURE	MICHAEL CUSICK SIGNATURE.PNG
MARTIN JENKINS CRAWFORD	SIGNATURE	MARTIN J. CRAWFORD SIGNATURE.PNG
MICHAEL VILLINES	SIGNATURE	MIKE VILLINES .PNG
NIKOLA ŠPIRIć	SIGNATURE	NIKOLA_SPIRIC_SIGNATURE_2008.PNG
KEN CUCCINELLI	SIGNATURE	KEN CUCCINELLI SIGNATURE.JPG
JANELE HYER-SPENCER	SIGNATURE	JANELE HYER-SPENCER SIGNATURE.PNG
MICHAEL LAMB	SIGNATURE	MICHAEL LAMB SIGNATURE.SVG
AUGUSTINE HERMAN	SIGNATURE	APPLETONS' HERRMAN AUGUSTINE SIGNATURE.PNG
EDWARD M. LEWIS	SIGNATURE	EDWARDMLEWIS.SVG
TAUR MATAN RUAK	SIGNATURE	TAUR MATAN RUAK SIGNATURE.JPG
SEAN PARNELL	SIGNATURE	SEAN PARNELL SIGNATURE.SVG
CHOU HSI-WEI	SIGNATURE	周錫瑋簽名.JPG
KAREL SCHWARZENBERG	SIGNATURE	KAREL SCHWARZENBERG SIGNATURE.PNG
CHRISTINE LAGARDE	SIGNATURE	CHRISTINE LAGARDE SIGNATURE.JPG
DANILO ASTORI	SIGNATURE	DANILO ASTORI SIGNATURE.SVG
FERNANDO LUGO	SIGNATURE	FIRMA DE FERNANDO LUGO.PNG
JACQUES ROY	SIGNATURE	JACQUES_M_ROY_SIGNATURE.JPG
VIKTOR CHEBRIKOV	SIGNATURE	VIKTOR CHEBRIKOV SIGNATURE.JPG
PAUL A. CHADBOURNE	SIGNATURE	PAULACHADBOURNE.SVG
ANATOLIY SERDYUKOV	SIGNATURE	SIGNATURE OF ANATOLY SERDYUKOV.PNG
BRIAN KROLICKI	SIGNATURE	BRIAN KROLICKI SIGNATURE.JPG
NANCY WYMAN	SIGNATURE	NANCY WYMAN SIGNATURE.GIF
JAN BREWER	SIGNATURE	JAN BREWER SIGNATURE.SVG
LEVI STOCKBRIDGE	SIGNATURE	LEVISTOCKBRIDGE.SVG
EDUARDO BLANCO	SIGNATURE	EDUARDO BLANCO SIGNATURE.JPG
VIKTOR ZUBKOV	SIGNATURE	SIGNATURE OF VIKTOR ZUBKOV.PNG
JASON HOLSMAN	SIGNATURE	HOLSMANSIG.PNG
JUAN MANUEL SANTOS	SIGNATURE	JUAN MANUEL SANTOS SIGNATURE.SVG
BINALI YıLDıRıM	SIGNATURE	BINALI YıLDıRıM IMZASı.PNG
KENYON L. BUTTERFIELD	SIGNATURE	KENYONLEECHBUTTERFIELD.SVG
EDGARDO SOGNO	SIGNATURE	EDGARDO SOGNO SIGNATURE.JPG
MIGUEL DE AZCUéNAGA	SIGNATURE	FIRMA DE AZCUéNAGA.JPG
JOHN JAY	SIGNATURE	APPLETONS' JAY JOHN - JOHN SIGNATURE.PNG
RAFAEL CASANOVA	SIGNATURE	RAFAEL-CASANOVA-CONSELLER-EN-CAP-CORONEL-GOBERNADOR.JPG
JUAN PABLO PéREZ ALFONZO	SIGNATURE	JUAN PABLO PéREZ ALFONZO SIGNATURE.JPG
ABDULLAH ENSOUR	SIGNATURE	ABDULLAH NSOUR SIGNATURE.SVG
LOWELL THOMAS JR.	SIGNATURE	LOWELL THOMAS, JR. SIGNATURE 76GEN.JPG
SHERLOCK JAMES ANDREWS	SIGNATURE	SHERLOCK JAMES ANDREWS SIGNATURE.PNG
ARSENIY YATSENYUK	SIGNATURE	ARSENIY YATSENYUK SIGNATURE 2014.PNG
SOKRAT JINJOLIA	SIGNATURE	SOKRAT_DJINDJOLIA_SIGNATURE.SVG
JOHN ADAMS	SIGNATURE	JOHN ADAMS SIG 2.SVG
THOMAS PEREZ	SIGNATURE	THOMASPEREZ-SIG-.PNG
ALBERT G. TALBOTT	SIGNATURE	ALBERT-G.-TALBOTT-SIG.JPG
ŞüKRü KAYA	SIGNATURE	ŞüKRü KAYA IMZASı.PNG
YANG JIECHI	SIGNATURE	YANG JIECHI SIGN.JPG
JOZEFINA TOPALLI	SIGNATURE	JOZEFINA TOPALLI SIGNATURE.JPG
FRANCINE IRVING NEFF	SIGNATURE	FRANCINE I NEFF SIG.JPG
OCTAVIO LEPAGE	SIGNATURE	OCTAVIO LEPAGE SIGNATURE.JPG
SAMUEL S. COX	SIGNATURE	SAMUEL S. COX SIGNATURE 35TH CONGRESS 1859.JPG
ČEDOMILJ MIJATOVIć	SIGNATURE	FIRMADECEDOMILJEMIJATOVICAROYALTRAGEDY.PNG
LOUIS TOBACCO	SIGNATURE	TOBACCO SIGNATURE.PNG
HORATIO WASHINGTON BRUCE	SIGNATURE	HORATIO BRUCE SIG.JPG
MIRKO CVETKOVIć	SIGNATURE	MIRKO CVETKOVIC SIGNATURE.PNG
DRAGAN ĐILAS	SIGNATURE	DRAGAN ĐILAS SIGNATURE.PNG
STEVE KENT	SIGNATURE	STEVE KENT SIGNATURE LARGE.JPG
GRIGORY PETROVSKY	SIGNATURE	GRIGORIY PETROVSKIY SIGNATURE 1936.PNG
VALDIS ZATLERS	SIGNATURE	VALDIS ZATLERS SIGNATURE.SVG
JOSHUA JEWETT	SIGNATURE	JOSHUA-H.-JEWETT-SIG.JPG
CHARLES K. WHEELER	SIGNATURE	SIGNATURE OF CHARLES K. WHEELER.SVG
DON C. EDWARDS	SIGNATURE	DON-CALVIN-EDWARDS-SIG.JPG
FRANCIS A. HOPKINS	SIGNATURE	FRANCIS-A.-HOPKINS-SIG.JPG
GEORGE G. GILBERT	SIGNATURE	GEORGE-G.-GILBERT-SIG.JPG
GEORGE M. DAVISON	SIGNATURE	GEORGE M. DAVISON SIG.JPG
HARVEY SAMUEL IRWIN	SIGNATURE	HARVEY-S.-IRWIN-SIG.JPG
JAMES M. RICHARDSON	SIGNATURE	JAMES-M.-RICHARDSON-SIG.JPG
JOHN TELEMACHUS JOHNSON	SIGNATURE	JOHN-TELEMACHUS-JOHNSON-SIG.JPG
JOHN CALVIN MASON	SIGNATURE	JOHN-C.-MASON-SIG.JPG
ZORAN MILANOVIć	SIGNATURE	MILANOVIC POTPIS.GIF
BENJAMIN LE FEVRE	SIGNATURE	BENJAMIN LE FEVRE SIGNATURE.JPG
LABAN T. MOORE	SIGNATURE	LABAN T. MOORE SIG.JPG
MILTON J. DURHAM	SIGNATURE	MILTON DURHAM SIG.JPG
POLK LAFFOON	SIGNATURE	POLK-LAFFOON-SIG.JPG
WARNER UNDERWOOD	SIGNATURE	WARNER-L.-UNDERWOOD-SIG.JPG
WILLIAM EVANS ARTHUR	SIGNATURE	WILLIAM-E.-ARTHUR-SIG.JPG
WILLIAM H. RANDALL	SIGNATURE	WILLIAM-H.-RANDALL-SIG.JPG
VINCENT BOREING	SIGNATURE	VINCENT-BOREING-SIG.JPG
WILLIAM H. WADSWORTH	SIGNATURE	WILLIAM H. WADSWORTH SIG.JPG
LEWIS W. ROSS	SIGNATURE	SIGNATURE OF HON LEWIS W ROSS.SVG
FRANCIS E. SPINNER	SIGNATURE	FRANCIS E. SPINNER SIGNATURE.PNG
ARTHUR W. OVERMYER	SIGNATURE	ARTHUR W. OVERMYER - SIGNATURE.JPG
CHARLES D. COFFIN	SIGNATURE	CHARLES DUSTIN COFFIN SIGNATURE.JPG
COOPER K. WATSON	SIGNATURE	COOPER K. WATSON - SIGNATURE.JPG
CHARLES H. GROSVENOR	SIGNATURE	CHARLES H. GROSVENOR SIGNATURE.JPG
DANIEL DUNCAN	SIGNATURE	DANIEL DUNCAN  SIGNATURE.JPG
EBENEZER B. FINLEY	SIGNATURE	EBENEZER B. FINLEY SIGNATURE.JPG
EPHRAIM R. ECKLEY	SIGNATURE	EPHRAIM R. ECKLEY SIGNATURE.JPG
FRANK H. HURD	SIGNATURE	FRANK H. HURD SIGNATURE.JPG
JAMES M. GAYLORD	SIGNATURE	JAMES M. GAYLORD SIGNATURE.JPG
LAWRENCE W. HALL	SIGNATURE	LAWRENCE W. HALL SIGNATURE 35TH CONGRESS 1859.JPG
MATTHEW DENVER	SIGNATURE	MATTHEW DENVER SIGNATURE.JPG
MICHAEL D. HARTER	SIGNATURE	MICHAEL D. HARTER SIGNATURE.JPG
PERLEY B. JOHNSON	SIGNATURE	PERLEY B. JOHNSON SIGNATURE.JPG
ROBERT P. KENNEDY	SIGNATURE	ROBERT P. KENNEDY SIGNATURE.JPG
SAMUEL T. WORCESTER	SIGNATURE	SAMUEL T. WORCESTER SIGNATURE.GIF
SEWARD H. WILLIAMS	SIGNATURE	SEWARD H. WILLIAMS SIGNATURE.JPG
WILLIAM R. WARNOCK	SIGNATURE	WILLIAM R. WARNOCK SIGNATURE.JPG
WILLIAM E. HAYNES	SIGNATURE	WILLIAM E. HAYNES SIGNATURE.JPG
WILLIAM A. WHITTLESEY	SIGNATURE	WILLIAM A. WHITTLESEY SIGNATURE.JPG
W. AUBREY THOMAS	SIGNATURE	W. AUBREY THOMAS SIGNATURE.JPG
JOHN CROWELL	SIGNATURE	JOHN CROWELL  SIGNATURE.JPG
JOHN B. RICE	SIGNATURE	JOHN B. RICE SIGNATURE.JPG
BENJAMIN HARDIN	SIGNATURE	BENJAMIN HARDIN SIG.JPG
JOSEPH HORACE LEWIS	SIGNATURE	JOSEPH-HORACE-LEWIS-SIG.JPG
GEORGE ROBERTSON	SIGNATURE	GEORGE ROBERTSON SIG.JPG
TOM LEPPERT	SIGNATURE	TOM LEPPERT SIGNATURE.GIF
COLIN STRANG	SIGNATURE	COLIN STRANG SIGNATURE.SVG
SABINE LEUTHEUSSER-SCHNARRENBERGER	SIGNATURE	SIGNATURE S. LEUTHEUSSER SCHNARRENBERGER.GIF
JAMES GOODRIDGE	SIGNATURE	JAMES GOODRIDGE SIGNATURE.SVG
JOHN CAMERON	SIGNATURE	JOHN CAMERON SIGNATURE.SVG
JOHN ALEXANDER MCDOUGALL	SIGNATURE	JOHN ALEXANDER MCDOUGALL SIGNATURE.SVG
GEORGE PRINGLE SANDERSON	SIGNATURE	GEORGE P SANDERSON SIGNATURE.SVG
JOHN KELLY	SIGNATURE	JOHN KELLY SIGNATURE.SVG
JAMES ROSS	SIGNATURE	JAMES ROSS SIGNATURE.SVG
RAND PAUL	SIGNATURE	RAND SIG.GIF
THOMAS BELLAMY	SIGNATURE	THOMAS BELLAMY SIGNATURE.SVG
ROSS MILLER	SIGNATURE	ROSS MILLER SIGNATURE.JPG
KENNETH MCLEOD	SIGNATURE	KENNETH MCLEOD SIGNATURE.SVG
CORNELIUS GALLAGHER	SIGNATURE	CORNELIUS GALLAGHER SIGNATURE.SVG
JOSEPH HENRI PICARD	SIGNATURE	JOSEPH HENRI PICARD SIGNATURE.SVG
WILLIAM S. EDMISTON	SIGNATURE	WILLIAM S EDMISTON SIGNATURE.SVG
ISAAC COWIE	SIGNATURE	ISAAC COWIE SIGNATURE.SVG
KIM CAMPBELL	SIGNATURE	KIM CAMPBELL SIGNATURE.SVG
JOSEPH GARIéPY	SIGNATURE	JOSEPH GARIEPY SIGNATURE.SVG
JOSEPH ADAIR	SIGNATURE	JOSEPH WOODS ADAIR SIGNATURE.SVG
CHARLES MAY	SIGNATURE	CHARLES MAY SIGNATURE.SVG
TERRY MILLER	SIGNATURE	SIGNATURE OF TERRY MILLER.SVG
ROBERT LEE	SIGNATURE	ROBERT LEE SIGNATURE.SVG
WILLIAM J. MCNAMARA	SIGNATURE	WILLIAM J MCNAMARA SIGNATURE.SVG
GEORGE S. ARMSTRONG	SIGNATURE	GEORGE SEALE ARMSTRONG SIGNATURE.SVG
WILLIAM THOMAS HENRY	SIGNATURE	WILLIAM THOMAS HENRY SIGNATURE.SVG
MYRON H. MCCORD	SIGNATURE	MCCORDSIGNATURE.PNG
WILLIAM HOPKINSON COX	SIGNATURE	WILLIAM-H.-COX-SIG.JPG
EDWARD J. MCDERMOTT	SIGNATURE	EDWARD-J.-MCDERMOTT-SIG.JPG
H. A. BOUCHER	SIGNATURE	RED BOUCHER SIGNATURE.JPG
AMBROSE BURY	SIGNATURE	AMBROSE BURY SIGNATURE.SVG
JAMES MCCRIE DOUGLAS	SIGNATURE	JAMES MCCRIE DOUGLAS SIGNATURE.SVG
PRESIDENCY OF VLADIMIR PUTIN	SIGNATURE	PUTIN SIGNATURE.SVG
GEORGE GREENE	SIGNATURE	GEORGE GREENE SIGNATURE.JPG
ABHISHEK SINGHVI	SIGNATURE	SIGNATURE OF ABHISHEK MANU SINGHVI.SVG
DAN KNOTT	SIGNATURE	DANIEL KENNEDY KNOTT SIGNATURE.SVG
JOHN WESLEY FRY	SIGNATURE	JOHN WESLEY FRY SIGNATURE.SVG
CHARLES WELLS	SIGNATURE	CHARLES WELLS  SIGNATURE.PNG
JOSEPH WIGHTMAN	SIGNATURE	WIGHTMAN SIGNATURE.PNG
JUAN GERMáN ROSCIO	SIGNATURE	JUAN GERMáN ROSCIO SIGNATURE.JPG
BLANCA RODRíGUEZ	SIGNATURE	FIRMA BLANCA DE PEREZ.JPG
RICHARD SECORD	SIGNATURE	RICHARD SECORD SIGNATURE.SVG
HENRY GOODRIDGE	SIGNATURE	HENRY GOODRIDGE SIGNATURE.SVG
JAMES BLOWEY	SIGNATURE	JAMES T BLOWEY SIGNATURE.SVG
ARTHUR CUSHING	SIGNATURE	ARTHUR CUSHING SIGNATURE.SVG
WILLIAM HAROLD CLARK	SIGNATURE	WILLIAM HAROLD CLARK SIGNATURE - FULL.SVG
SARAH WILSON	SIGNATURE	SARAH WILSON SIG.JPG
BEşIR ATALAY	SIGNATURE	ABDULLAH GüL'S SIGNATURE.PNG
HüSEYIN ÇELIK	SIGNATURE	HüSEYIN ÇELIK SIGNATURE.PNG
RHYU SI-MIN	SIGNATURE	RYU SI-MIN SIGNATURE.PNG
MARK WARNER	SIGNATURE	MARK WARNER SIGNATURE.SVG
NATHAN CUTLER	SIGNATURE	NATHAN CUTLER SIGNATURE.SVG
ALEKSANDAR VUčIć	SIGNATURE	SIGNATURE ALEKSANDAR VUCIC.PNG
TATYANA GOLIKOVA	SIGNATURE	SIGNATURE OF TATYANA GOLIKOVA.PNG
JUAN LARREA	SIGNATURE	FIRMA DE LARREA.PNG
MARK CARNEY	SIGNATURE	--02-29
HE GUOQIANG	SIGNATURE	HE GUOQIANG SIGN.JPG
DON IVESON	SIGNATURE	DON IVESON .PNG
SAEED JALILI	SIGNATURE	SAEED JALILI SIGNATURE.SVG
GEORGE BARKER	SIGNATURE	GEORGE SIGNATURE.JPG
JACQUES DIOUF	SIGNATURE	SIGNATURE OF JACQUES DIOUF.SVG
FREDERICK O. PRINCE	SIGNATURE	FREDERICK O. PRINCE SIGNATURE.PNG
FREDERICK CORNWALLIS, 1ST BARON CORNWALLIS	SIGNATURE	SIGNATURE OF SIR FREDERICK CORNWALLIS, 1ST BARON CORNWALLIS OF EYE.JPG
GERMáN VARGAS LLERAS	SIGNATURE	GERMAN VARGAS LLERAS SIGNATURE.SVG
ARTHUR MEIGHEN	SIGNATURE	ARTHUR MEIGHEN SIGNATURE 2.SVG
BENJAMIN F. GUE	SIGNATURE	BENJAMIN F. GUE SIGNATURE.JPG
JOHN WEISS FORNEY	SIGNATURE	JOHN W. FORNEY SIGNATURE.JPG
ANNE HOLTON	SIGNATURE	ANNE HOLTON SIGNATURE.PNG
SAMAK SUNDARAVEJ	SIGNATURE	THAI-PM-SAMAK SIGNATURE.PNG
LULZIM BASHA	SIGNATURE	LULZIM BASHA SIGNATURE.SVG
DAYLIN LEACH	SIGNATURE	DAYLIN LEACH SIGNATURE.SVG
BO HMU AUNG	SIGNATURE	BO MHU AUNG SIGN.SVG
EDWARD ECHOLS	SIGNATURE	EDWARD ECHOLS .PNG
VOLODYMYR STELMAKH	SIGNATURE	SIGNATURE VOLODYMYR STELMAKH.JPG
ELISHA DYER JR.	SIGNATURE	ELISHA DYER JR. SIGNATURE.JPG
LEONARD R. CUTTER	SIGNATURE	LEONARD RICHARDSON CUTTER SIGNATURE.PNG
ALEXIS TSIPRAS	SIGNATURE	ALEXIS TSIPRAS SIGNATURE .PNG
JAMES EAST	SIGNATURE	JAMES EAST SIGNATURE.SVG
ALISON REDFORD	SIGNATURE	ALISON REDFORD SIGNATURE.SVG
SCOTT KAWASAKI	SIGNATURE	SCOTT KAWASAKI SIGNATURE.JPG
VICE PRESIDENCY OF AL GORE	SIGNATURE	AL GORE SIGNATURE.SVG
WAYNE D. FONTANA	SIGNATURE	WAYNE S. FONTANA SIGNATURE.SVG
WILLIAM LYTTELTON, 3RD BARON LYTTELTON	SIGNATURE	SIGNATURE OF WILLIAM LYTTELTON, 3RD BARON LYTTELTON - 20141022.JPG
ARMAND DUKA	SIGNATURE	ARMAND DUKA SIGNATURE.PNG
ALAN BATES	SIGNATURE	ALAN BATES SIGNATURE.JPG
MARY NOLAN	SIGNATURE	MARY NOLAN SIG.GIF
ILLINOIS SENATE CAREER OF BARACK OBAMA	SIGNATURE	BARACK OBAMA SIGNATURE.SVG
SAMUEL CHARLES BLACK	SIGNATURE	SAMUEL CHARLES BLACK SIG.PNG
MASAAKI SHIRAKAWA	SIGNATURE	MASAAKI SHIRAKAWA  SIGNATURE 2012.PNG
KURT SCHRADER	SIGNATURE	KURTSCHRADER_SIGNATURE.JPG
JOSEPH WANTON	SIGNATURE	JOSEPHWANTON.SIGNATURE.JPG
ROBERT MUGABE	SIGNATURE	SIGNATURE OF ROBERT MUGABE CLEAR.SVG
ALFREDO SFEIR	SIGNATURE	FIRMA DE ALFREDO SFEIR.PNG
PAT VANCE	SIGNATURE	PAT VANCE SIGNATURE.SVG
JAMES J. RHOADES	SIGNATURE	JAMESJRHOADESSIGNATURE-2.SVG
ROB WONDERLING	SIGNATURE	ROB WONDERLING SIGATURE.SVG
LISA BAKER	SIGNATURE	LISA BAKER SIGNATURE.SVG
SRI MULYANI INDRAWATI	SIGNATURE	SIGN SRI MULYANI.PNG
GUSTAV KOERNER	SIGNATURE	GUSTAV KOERNER SIGNATUR.SVG
ASA W. JONES	SIGNATURE	ASAHEL WELLINGTON JONES SIGNATURE.PNG
REES G. RICHARDS	SIGNATURE	REES G. RICHARDS - SIGNATURE.JPG
JOSé PARANHOS, VISCOUNT OF RIO BRANCO	SIGNATURE	JOSé PARANHOS SIGNATURE.SVG
TERRY MCAULIFFE	SIGNATURE	TERRY MCAULIFFE SIGNATURE.PNG
NIKOL PASHINYAN	SIGNATURE	NIKOL PASHINYAN SIGNATURE.PNG
EVAN BAYH	SIGNATURE	EVAN BAYH SIGNATURE.SVG
OLEKSANDR TURCHYNOV	SIGNATURE	OLEKSANDR TURCHYNOV SIGNATURE 2014.PNG
WANG YI	SIGNATURE	WANG YI  SIGNATURE.PNG
A. SESHAYYA SASTRI	SIGNATURE	SESHAYYASASTRISIGN.JPG
JAIME BERMúDEZ	SIGNATURE	JAIME BERMUDEZ MERIZALDE SIGNATURE.SVG
ZETI AKHTAR AZIZ	SIGNATURE	--03-11
PETR NEčAS	SIGNATURE	PETR NEčAS SIGNATURE.SVG
WERNER FAYMANN	SIGNATURE	ACCESSION TREATY 2011 WERNER FAYMANN SIGNATURE.SVG
LAURA CHINCHILLA	SIGNATURE	PRESIDENTA LAURA CHINCHILLA FIRMA.JPG
KANURI LAKSHMANA RAO	SIGNATURE	KLRAO_AUTOGRAPH.JPG
WU DEN-YIH	SIGNATURE	WU DEN-YIH SIGNATURE 20131130.JPG
LIU PANG-YU	SIGNATURE	劉邦友.JPG
AUGUSTO PINOCHET	SIGNATURE	SIGNATURE OF AUGUSTO PINOCHET.SVG
RICK BOUCHER	SIGNATURE	RICK BOUCHER SIGNATURE.PNG
WILLIAM REHNQUIST	SIGNATURE	WILLIAM H. REHNQUIST SIGNATURE.SVG
JILL BIDEN	SIGNATURE	JILL BIDEN SIGNATURE.SVG
WILLIAM POLK	SIGNATURE	WILLIAM POLK COL SIG.JPG
MARIO CIVERA	SIGNATURE	MARIO CIVERA SIGNATURE.SVG
SOMCHAI WONGSAWAT	SIGNATURE	THAI-PM-SOMCHAI SIGNATURE.PNG
ELEANOR ROOSEVELT	SIGNATURE	ELEANOR ROOSEVELT SIGNATURE-.SVG
NELSON ROCKEFELLER	SIGNATURE	NELSON A ROCKEFELLER SIGNATURE.SVG
BENITO MUSSOLINI	SIGNATURE	BENITO MUSSOLINI SIGNATURE.SVG
RAFAEL ÁNGEL CALDERóN GUARDIA	SIGNATURE	FIRMA RAFAEL ANGEL CALDERON GUARDIA.JPG
CALEB STETSON	SIGNATURE	CALEB STETSON SIGNATURE.PNG
NATHANIEL WALES	SIGNATURE	NATHANIEL WALES SIGNATURE.PNG
ELISHA CAPEN MONK	SIGNATURE	ELISHA CAPEN MONK SIGNATURE.PNG
WALDO COLBURN	SIGNATURE	WALDO COLBURN SIGNATURE.PNG
ANíBAL CAVACO SILVA	SIGNATURE	SIGNATURE ANíBAL CAVACO SILVA-EDIT.SVG
JOSé LUIS RODRíGUEZ ZAPATERO	SIGNATURE	JOSé LUIS RODRíGUEZ ZAPATERO SIGNATURE.SVG
HOWARD BROAD	SIGNATURE	SIGNATURE_HOWARD_BROAD.PNG
EVELYN MATTHEI	SIGNATURE	FIRMA DE EVELYN MATTHEI.PNG
KIM IL-SUNG	SIGNATURE	KIM IL SUNG SIGNATURE.SVG
RUTHERFORD B. HAYES	SIGNATURE	RUTHERFORD BIRCHARD HAYES SIGNATURE.SVG
FRANKLIN PIERCE	SIGNATURE	FRANKLIN PIERCE SIGNATURE2.SVG
MILLARD FILLMORE	SIGNATURE	MILLARD FILLMORE SIGNATURE-2.SVG
ZACHARY TAYLOR	SIGNATURE	ZACHARY TAYLOR SIGNATURE-2.SVG
JOHN TYLER	SIGNATURE	JOHN TYLER SIGNATURE 2.SVG
JAMES BUCHANAN	SIGNATURE	JAMES BUCHANAN SIGNATURE2.SVG
ELIHU B. HAYES	SIGNATURE	ELIHU B. HAYES SIGNATURE.PNG
E. KNOWLTON FOGG	SIGNATURE	E. KNOWLTON FOGG SIGNATURE.PNG
K. KAMARAJ	SIGNATURE	SIGNATURE OF K. KAMRAJ.SVG
LEE WARE	SIGNATURE	LEE WARE SIGNATURE.PNG
JOHN O'BANNON	SIGNATURE	JOHN OBANNON SIGNATURE.PNG
O. V. ALAGESAN	SIGNATURE	ALAGESAN SIGN.JPG
THEOPHILUS W. SMITH	SIGNATURE	THEOPHILUSSMITHSIGNATURE.JPG
PEYTON SHORT	SIGNATURE	PEYTON SHORT SIG.JPG
ZDENěK TůMA	SIGNATURE	ZDENěK TůMA - PODPIS 2009.JPG
BIDZINA IVANISHVILI	SIGNATURE	IVANISHVILI SIGNATURE .PNG
STEPHEN N. GIFFORD	SIGNATURE	SIGNATURE OF STEPHEN NYE GIFFORD.PNG
ROBERT F. KENNEDY	SIGNATURE	ROBERT KENNEDY SIGNATURE.SVG
CHARLES L. FLINT	SIGNATURE	CHARLESLFLINT.SVG
CHAIRUL TANJUNG	SIGNATURE	SIGN CHAIRUL TANJUNG.PNG
TIMOTHY GEITHNER	SIGNATURE	TIM GEITHNER SIG.JPG
G. ALVIN MASSENBURG	SIGNATURE	G ALVIN MASSENBURG SIGNATURE.PNG
ANTONIO VILLARAIGOSA	SIGNATURE	ANTONIO VILLARAIGOSA SIGNATURE.SVG
ELIOT SPITZER	SIGNATURE	ELIOT SPITZER SIGNATURE.SVG
VAUGHN WALKER	SIGNATURE	VAUGHN R WALKER SIGNATURE.PNG
FERMíN TORO	SIGNATURE	SIGNATURE OF FERMíN TORO.JPG
ALDO FERRER	SIGNATURE	ALDOFERRERFIRMA.JPG
KARL-THEODOR ZU GUTTENBERG	SIGNATURE	KARL-THEODOR ZU GUTTENBERG - UNTERSCHRIFT 2010.PNG
GIUSEPPE GARIBALDI	SIGNATURE	APPLETONS' GARIBALDI GIUSEPPE SIGNATURE.PNG
CHESTER A. ARTHUR	SIGNATURE	CHESTER ALAN ARTHUR SIGNATURE.SVG
MORGAN TSVANGIRAI	SIGNATURE	MORGANSIGN.SVG
GJORGE IVANOV	SIGNATURE	GJORGE IVANOV SIGNATURE.SVG
OMAR ABDIRASHID ALI SHARMARKE	SIGNATURE	OMAR ABDIRASHID ALI SHARMARKE SIGNATURE.SVG
BERNARD DEVLIN	SIGNATURE	SIGNATURE OF IRISH-CANADIAN LAWYER BERNARD DEVLIN, QC, KC, MP.JPG
RODRIGO AUGUSTO DA SILVA	SIGNATURE	SIGNATURE OF RODRIGO SILVA.PNG
JOHN WATSON BARR	SIGNATURE	JOHN WATSON BARR SIG.JPG
ANDREW MCCONNELL JANUARY COCHRAN	SIGNATURE	ANDREW-COCHRAN-SIG.JPG
DAVID DAVIS	SIGNATURE	DAVID DAVIS, JUSTICE OF THE UNITED STATES SUPREME COURT .JPG
CYRUS GRIFFIN	SIGNATURE	CYRUS GRIFFIN .SVG
JOHN JAY	SIGNATURE	JOHN JAY SIGNATURE2.SVG
JOHN MARSHALL	SIGNATURE	JOHN MARSHALL SIGNATURE.SVG
JOHN RUTLEDGE	SIGNATURE	JOHN RUTLEDGE SIG.SVG
ROGER B. TANEY	SIGNATURE	ROGER B TANEY SIGNATURE.SVG
OLIVER WOLCOTT JR.	SIGNATURE	O WOLCOTTSIG.SVG
LEVI WOODBURY	SIGNATURE	LEVI WOODBURY SIGNATURE.SVG
FRANCISCO DOMíNGUEZ BRITO	SIGNATURE	FIRMAFDB.JPG
SALVADOR SáNCHEZ CERéN	SIGNATURE	SALVADOR SáNCHEZ CERéN SIGNATURE.SVG
ANBUMANI RAMADOSS	SIGNATURE	DRANBUMANIRAMADOSS.JPG
DAVID SHEPARD	SIGNATURE	DAVID SHEPARD SIGNATURE.SVG
MICHEL TEMER	SIGNATURE	ASSINATURA TEMER OK.JPG
ALFONSO PRAT-GAY	SIGNATURE	ALFONSO PRAT-GAY SIGNATURE.PNG
JACINTA PAREJO	SIGNATURE	JACINTA PAREJO SIGNATURE.JPG
WILLIAM HYDE RICE	SIGNATURE	WILLIAM HYDE RICE SIGNATURE.SVG
TED HARHAI	SIGNATURE	TED HARHAI SIGNATURE.GIF
BABETTE JOSEPHS	SIGNATURE	BABETTE JOSEPHS .SVG
IRINA BOKOVA	SIGNATURE	IRINA BOKOVASIGNATURE.PNG
MATTHEW BRADFORD	SIGNATURE	MATTHEW BRADFORD SIGNATURE.GIF
LLOYD SMUCKER	SIGNATURE	LLOYD SMUCKER SIGNATURE.GIF
ALBERT BELAN	SIGNATURE	ALBERT BELAN SIGNATURE.SVG
STEPHEN A. DOUGLAS	SIGNATURE	STEPHEN A DOUGLAS SIGNATURE.SVG
IVO JOSIPOVIć	SIGNATURE	ACCESSION TREATY 2011 IVO JOSIPOVIć SIGNATURE.SVG
ILDIKó LENDVAI	SIGNATURE	LENDVAI NéV.JPG
ILHAM ALIYEV	SIGNATURE	SIGNATURE OF ILHAM ALIYEV.SVG
BOB BLUMENFIELD	SIGNATURE	BB CITY SIGNATURE.PNG
HELEN CLARK	SIGNATURE	SIGNATURE HELEN CLARK.JPG
MARCO ENRíQUEZ-OMINAMI	SIGNATURE	FIRMA DE MARCO ENRíQUEZ-OMINAMI.PNG
DALIA GRYBAUSKAITė	SIGNATURE	DALIA GRYBAUSKAITė.SIGNATURE.SVG
GEORGE P. SHULTZ	SIGNATURE	GEORGE PRATT SHULTZ SIGNATURE.SVG
HONóRIO HERMETO CARNEIRO LEãO, MARQUIS OF PARANá	SIGNATURE	MARQUIS OF PARANA SIGNATURE.PNG
GERHARD SCHRöDER	SIGNATURE	GERHARD SCHRöDER SIGNATURE.SVG
VICTOR PONTA	SIGNATURE	SIGNATURE OF VICTOR PONTA.SVG
CHARLES CORNWALLIS, 1ST MARQUESS CORNWALLIS	SIGNATURE	CORNWALLIS SIGNATURE.SVG
MATTEO RENZI	SIGNATURE	MATTEO RENZI FIRMA.SVG
DMYTRO ANTONOVYCH	SIGNATURE	DMYTRO ANTONOVYCH SIGNATURE 1919.PNG
MAITHRIPALA SIRISENA	SIGNATURE	SIGNATURE OF MAITHRIPALA SIRISENA.SVG
HUGO MOYANO	SIGNATURE	FIRMA HUGO A. MOYANO.JPG
GIORGIO DE STEFANI	SIGNATURE	GIORGIO DE STEFANI SIGNATURE.JPG
AMADO BOUDOU	SIGNATURE	FIRMA AMADO BOUDOU.SVG
ESFANDIAR RAHIM MASHAEI	SIGNATURE	ESFANDIAR-E RAHIM MASHAEI SIGNATURE.PNG
JOHAN RUDOLPH THORBECKE	SIGNATURE	THORBECKE SIGNATURE.SVG
NORMAN CHAN	SIGNATURE	NORMAN CHAN TAK-LAM SIGNATURE.PNG
MAXIMILIEN ROBESPIERRE	SIGNATURE	SIGNATURE DE MAXIMILIEN DE ROBESPIERRE.JPG
SILAS PEIRCE	SIGNATURE	SILAS PEIRCE SIGNATURE.PNG
CHANDRA SHEKHAR	SIGNATURE	CHANDRASHEKHAR-PRIME-MINISTER.JPG
WILLIAM P. BROOKS	SIGNATURE	WILLIAMPBROOKS.SVG
ABUL MAAL ABDUL MUHITH	SIGNATURE	AMA MUHITH SIGNATURE.JPG
ALI JANNATI	SIGNATURE	ALI JANNATI SIGNATURE.SVG
FRANCISCO GONZáLEZ GUINáN	SIGNATURE	FRANCISCO GONZáLEZ GUINáN SIGNATURE.JPG
ESTEBAN GIL BORGES	SIGNATURE	ESTEBAN GIL BORGES SIGNATURE.JPG
MANUEL DíAZ RODRíGUEZ	SIGNATURE	MANUEL DíAZ RODRíGUEZ SIGNATURE.JPG
STEVE BULLOCK	SIGNATURE	BULLOCK_SIG.PNG
ANTONIO LóPEZ DE SANTA ANNA	SIGNATURE	ANTONIO LóPEZ DE SANTA ANNA SIGNATURE.SVG
MARZIEH VAHID-DASTJERDI	SIGNATURE	SIGNATURE OF MARZIEH VAHID-DASTJERDI.SVG
ĐORđE VAJFERT	SIGNATURE	SIGNATURE DJORDJE VAJFERT.PNG
KAMRAN DANESHJOO	SIGNATURE	SIGNATURE OF KAMRAN DANESHJOO.SVG
SIMóN ALBERTO CONSALVI	SIGNATURE	FIRMA CONSALVI.JPG
JóVITO VILLALBA	SIGNATURE	SIGNATURE OF JóVITO VILLALBA.JPG
JIM GREER	SIGNATURE	JIM GREER SIGNATURE.SVG
MANUEL ALBERTI	SIGNATURE	FIRMA DE ALBERTI.JPG
BIRGIT SCHNIEBER-JASTRAM	SIGNATURE	BIRGIT SCHNIEBER-JASTRAM.SVG
VERNOR SMITH	SIGNATURE	VERNOR SMITH SIGNATURE.SVG
DOMINGO MATHEU	SIGNATURE	FIRMA DE MATHEU.JPG
RALF BRAUKSIEPE	SIGNATURE	RALF BRAUKSIEPE SIGNATURE.GIF
MARCELLUS BOSS	SIGNATURE	MARCELLUS BOSS SIGNATURE.JPG
VIJAY MALLYA	SIGNATURE	SIGNATURE OF VIJAY MALLYA.SVG
MARTíN REDRADO	SIGNATURE	FIRMA REDRADO.SVG
PEDRO ITRIAGO CHACíN	SIGNATURE	PEDRO ITRIAGO CHACíN SIGNATURE.JPG
TOM WOLF	SIGNATURE	TOM WOLF SIGNATURE.SVG
VLADIMíR DLOUHý	SIGNATURE	VLADIMíR DLOUHý SIGNATURE.SVG
RISE OF NEVILLE CHAMBERLAIN	SIGNATURE	NEVILLE CHAMBERLAIN SIGNATURE 2.SVG
KIM PIZZINGRILLI	SIGNATURE	KIM PIZZINGRILLI SIG.PNG
GEORGE C. HIGGINS	SIGNATURE	GEORGE C. HIGGINS SIGNATURE.PNG
GEORGE D. HART	SIGNATURE	GEORGE D. HART SIGNATURE.PNG
SAMUEL M. BUBIER	SIGNATURE	SAMUEL MANSFIELD BUBIER SIGNATURE.PNG
ASA T. NEWHALL	SIGNATURE	ASA T. NEWHALL SIGNATURE.PNG
GEORGE HOOD	SIGNATURE	GEORGE HOOD  SIGNATURE.PNG
ANDREWS BREED	SIGNATURE	ANDREWS BREED SIGNATURE.PNG
PETER M. NEAL	SIGNATURE	PETER MORRELL NEAL SIGNATURE.PNG
GEORGE PLAISTED SANDERSON	SIGNATURE	GEORGE PLAISTED SANDERSON SIGNATURE.PNG
EZRA W. MUDGE	SIGNATURE	EZRA WARREN MUDGE SIGNATURE.PNG
HIRAM N. BREED	SIGNATURE	HIRAM N. BREED SIGNATURE.PNG
EDWARD S. DAVIS	SIGNATURE	EDWARD S. DAVIS SIGNATURE.PNG
JAMES N. BUFFUM	SIGNATURE	JAMES N. BUFFUM SIGNATURE.PNG
EDWIN WALDEN	SIGNATURE	EDWIN WALDEN SIGNATURE.PNG
JAMES DANA	SIGNATURE	JAMES DANA  SIGNATURE.PNG
TIMOTHY T. SAWYER	SIGNATURE	TTSAWYERSIGNATURE.PNG
FERENC DUSCHEK	SIGNATURE	DUSCHEK FERENC SIGNATURE.JPG
MARIO BLEJER	SIGNATURE	FIRMA BLEJER.JPG
ALVIN F. SORTWELL	SIGNATURE	ALVIN F. SORTWELL SIGNATURE.PNG
PRESIDENCY OF FIDEL RAMOS	SIGNATURE	FIDEL V. RAMOS SIGNATURE.SVG
PRESIDENCY OF CORAZON AQUINO	SIGNATURE	AQUINO SIG.SVG
J. WARREN MERRILL	SIGNATURE	J. WARREN MERRILL SIGNATURE.PNG
JOAN BALLWEG	SIGNATURE	JOANBALLWEGSIG.GIF
JAMES AUGUSTUS FOX	SIGNATURE	JAMES AUGUSTUS FOX SIGNATURE.PNG
AUGUSTO MIJARES	SIGNATURE	AUGUSTO MIJARES SIGNATURE.JPG
JOACHIM GAUCK	SIGNATURE	JOACHIM GAUCKS SIGNATURE.SVG
PHùNG QUANG THANH	SIGNATURE	PHUNG QUANG THANH SIGNATURE.JPG
ROBERT CRICHTON WYLLIE	SIGNATURE	R. C. WYLLIE 1850 SIGNATURE.SVG
MERCEDES MARCó DEL PONT	SIGNATURE	FIRMA MARCóDELPONT.JPG
GOVERNMENT OF MAHMOUD AHMADINEJAD	SIGNATURE	AHMADINAJD SIGNATURE.JPG
HUGH P. BAKER	SIGNATURE	HUGHPBAKER.SVG
ANTóNIO DE OLIVEIRA SALAZAR	SIGNATURE	ANTONIO SALAZAR SIGNATURE.JPG
YUN CHI-YOUNG	SIGNATURE	SIGNATURE OF YUN CHI-YOUNG.SVG
HENRY K. BRALEY	SIGNATURE	HENRY KING BRALEY SIGNATURE.PNG
HERB KOHL	SIGNATURE	HERB KOHL SIGNATURE.SVG
TED WHEELER	SIGNATURE	TED WHEELER SIGNATURE.PNG
JáNOS ZICHY	SIGNATURE	ZICHY JáNOS ALáíRáSA.JPG
MYKOLA AZAROV	SIGNATURE	NIKOLAY AZAROV SIGNATURE.JPG
CHARLES DE VARIGNY	SIGNATURE	CHARLES DE VARIGNY SIGNATURE.SVG
EDGAR J. SHERMAN	SIGNATURE	EDGAR J. SHERMAN SIGNATURE.PNG
CHESTER I. REED	SIGNATURE	CHESTER I. REED SIGNATURE.PNG
RICK SANTORUM	SIGNATURE	RICK SANTORUM SIGNATURE.PNG
PEDRO PASSOS COELHO	SIGNATURE	ACCESSION TREATY 2011 PEDRO PASSOS COELHO SIGNATURE.SVG
IVAN SAMYLOVSKY	SIGNATURE	SIGNATURE IVAN SAMYLOVSKY.PNG
OLIVER ELLSWORTH	SIGNATURE	O ELLSWORTH SIGNATURE.SVG
LEWIS J. POWERS	SIGNATURE	LEWIS J. POWERS SIGNATURE.PNG
LECH WAłęSA	SIGNATURE	LECH WALESA SIGNATURE.SVG
CALEB RICE	SIGNATURE	CALEB RICE SIGNATURE.PNG
BHARATSINH MADHAVSINH SOLANKI	SIGNATURE	SIGNATURE OF BHARATSINH SOLANKI.SVG
HANNELORE KRAFT	SIGNATURE	HANNELORE KRAFT SIGNATURE.PNG
JOHN AVERY, JR.	SIGNATURE	JOHN AVERY SIGNATURE.PNG
DAN DONOVAN	SIGNATURE	DANIEL DONOVAN SIGNATURE.PNG
SUSANA MARTINEZ	SIGNATURE	SIGNATURE OF SUSANA MARTINEZ.PNG
BOHUSLAV SOBOTKA	SIGNATURE	BOHUSLAV SOBOTKA SIGNATURE.SVG
RICHARD WALDRON	SIGNATURE	RICHARD_WALDERNE.PNG
JUAN CARLOS ECHEVERRY	SIGNATURE	JUAN CARLOS ECHEVERRY SIGNATURE.SVG
HENRY A. P. CARTER	SIGNATURE	HENRY A P CARTER 1881 SIGNATURE.SVG
WILLIAM O'CONNELL BRADLEY	SIGNATURE	WILLIAM O. BRADLEY SIGNATURE.SVG
VOLTAIRE GAZMIN	SIGNATURE	VOLTAIRE GAZMIN SIGNATURE.PNG
SAMUEL GARDNER WILDER	SIGNATURE	SAMUEL G WILDER 1880 SIGNATURE.SVG
WILLIAM LUTHER MOEHONUA	SIGNATURE	WILLIAM L. MOEHONUA 1875 SIGNATURE.JPG
YELENA SKRYNNIK	SIGNATURE	SIGNATURE OF YELENA SKRYNNIK.PNG
SAMUEL MILLS DAMON	SIGNATURE	SAMUEL MILLS DAMON 1884 SIGNATURE.SVG
CLARENCE THOMAS	SIGNATURE	CLARENCE THOMAS%27 SIGNATURE.SVG
MARíA ÁNGELA HOLGUíN	SIGNATURE	MARíA ÁNGELA HOLGUíN SIGNATURE.SVG
VITALY MUTKO	SIGNATURE	SIGNATURE OF VITALIY MUTKO.PNG
GABRIEL SILVA LUJáN	SIGNATURE	GABRIEL SILVA LUJAN SIGNATURE.SVG
SIMON BERMAN	SIGNATURE	HANDTEKENING_SIMON_BERMAN_1889.JPG
MATTHEW MCCAULEY	SIGNATURE	MATTHEW MCCAULEY SIGNATURE2.SVG
EUGENIU STăTESCU	SIGNATURE	EUGENIU STATESCU - SIGNATURE.PNG
JAMES DAVIDSON	SIGNATURE	JAMES-DAVIDSON-SIG.JPG
STEVE MUNISTERI	SIGNATURE	STEVE_MUNISTERI_SIGNATURE.JPEG
ALBERT C. HOUGHTON	SIGNATURE	ALBERT CHARLES HOUGHTON SIGNATURE.JPG
JOHN E. BUSH	SIGNATURE	JOHN E. BUSH 1883 SIGNATURE.JPG
KATHERINE CHIDLEY	SIGNATURE	KATHERINE CHIDLEY SIGNATURE.JPG
WENDY DAVIS	SIGNATURE	WENDY RUSSELL DAVIS SIGNATURE.SVG
MILAN MOGUš	SIGNATURE	POTPIS MILANA MOGUšA.SVG
RODRIGO RIVERA SALAZAR	SIGNATURE	RODRIGO RIVERA SALAZAR SIGNATURE.SVG
EDGAR ROBB	SIGNATURE	EDGAR S ROBB SIGNATURE.PNG
ANDRéS FELIPE ARIAS LEIVA	SIGNATURE	ANDRéS FELIPE ARIAS LEIVA'S SIGNATURE.JPG
JOKO WIDODO	SIGNATURE	SIGNATURE OF JOKO WIDODO.SVG
GIORGOS KAMINIS	SIGNATURE	GIORGOS KAMINIS SIGNATURE.PNG
FRANCIS BATES POND	SIGNATURE	FRANCIS BATES POND SIGNATURE.JPG
NALLARI KIRAN KUMAR REDDY	SIGNATURE	SIGNATURE_OF_KIRAN_KUMAR_REDDY.PNG
DELFIM MODESTO BRANDãO	SIGNATURE	DELFIM MODESTO BRANDãO .JPG
OGTAY ASADOV	SIGNATURE	SIGNATURE OF OQTAY ƏSəDOV.GIF
FERDINAND XHAFERRAJ	SIGNATURE	FERDINAND XHAFERAJ SIGNATURE.JPG
EARLY LIFE AND CAREER OF THOMAS JEFFERSON	SIGNATURE	THOMAS JEFFERSON SIGNATURE.SVG
LYMAN R. CRITCHFIELD	SIGNATURE	LYMAN R. CRITCHFIELD SIGNATURE.PNG
RUFUS P. RANNEY	SIGNATURE	RUFUS P. RANNEY SIGNATURE.JPG
LUTHER DAY	SIGNATURE	LUTHER DAY SIGNATURE.PNG
THADDEUS A. MINSHALL	SIGNATURE	THADDEUS A. MINSHALL SIGNATURE.JPG
AUGUSTUS N. SUMMERS	SIGNATURE	AUGUSTUS N. SUMMERS SIGNATURE.PNG
CALVIN PEASE	SIGNATURE	CALVIN PEASE SIGNATURE.PNG
SUDIP BANDYOPADHYAY	SIGNATURE	SIGNATURE OF SUDEEP BANDHOPADHYAY.SVG
JOHN H. DOYLE	SIGNATURE	JOHN H. DOYLE SIGNATURE.PNG
ELMER B. STAATS	SIGNATURE	ELMER B. STAATS SIGNATURE.JPG
WILLIAM S. MCKINNON	SIGNATURE	WILLIAM S. MCKINNON SIGNATURE.JPG
CARMI THOMPSON	SIGNATURE	CARMI ALDERMAN THOMPSON .JPG
ENKELEJD ALIBEAJ	SIGNATURE	ENKELEJD ALIBEAJ SIGNATURE.PNG
TOSHIHIKO FUKUI	SIGNATURE	TOSHIHIKO FUKUI  SIGNATURE 2007.PNG
JOãO CARLOS DE SALDANHA OLIVEIRA E DAUN, 1ST DUKE OF SALDANHA	SIGNATURE	ASSINATURASALDANHA.SVG
MIKHAIL FRUNZE	SIGNATURE	MIKHAIL FRUNZE SIGNATURE.SVG
LORETTA LYNCH	SIGNATURE	LORETTA LYNCH SIGNATURE.PNG
PANAS LYUBCHENKO	SIGNATURE	PANAS LIUBCHENKO SIGNATURE 1927.PNG
DEMYAN KOROTCHENKO	SIGNATURE	DEMYAN KOROTCHENKO SIGNATURE 1954.PNG
LEONID KORNIYETS	SIGNATURE	LEONID KORNIYETS SIGNATURE 1944.PNG
RICHARD EVELYN BYRD SR.	SIGNATURE	RE BYRD SR SIGNATURE.PNG
RICHARD WARD	SIGNATURE	APPLETONS' WARD RICHARD SIGNATURE.PNG
JUD MCMILLIN	SIGNATURE	JUDSIGN.PNG
PASQUAL ENRILE Y ALCEDO	SIGNATURE	PASQUAL ENRILE SIGNATURE.JPG
YINGLUCK SHINAWATRA	SIGNATURE	YINGLUCK SHINAWATRA'S HAND.JPG
HERMANN RASTER	SIGNATURE	HERMANN RASTER SIGNATURE SVG.SVG
JAVIER GONZáLEZ FRAGA	SIGNATURE	FIRMA GONZáLEZ FRAGA.PNG
JóZSEF TORGYáN	SIGNATURE	SIGNATURE OF TORGYáN JóZSEF.JPG
MUSTAFA BALBAY	SIGNATURE	MUSTAFABALBAYIMZA.PNG
CHRISTIAN L. POORMAN	SIGNATURE	CHRISTIAN L. POORMAN SIGNATURE.JPG
MOHAMED MORSI	SIGNATURE	MUHAMMED MORSI SIGNATURE.PNG
LEVI S. GOULD	SIGNATURE	LEVI S. GOULD SIGNATURE.PNG
MIGUEL CUADERNO SR.	SIGNATURE	CUADERNO SIGNATURE.JPG
PERRY D. THOMPSON	SIGNATURE	PERRY D. THOMPSON SIGNATURE.PNG
ANDRES CASTILLO	SIGNATURE	PH-137D.JPG
JORGE CARLOS FONSECA	SIGNATURE	ASSI JORGE CARLOS FONSECA OK.JPG
RICARDO COUTINHO	SIGNATURE	GOVERNADOR RICARDO COUTINHO SIGNATURE.JPG
JUAN CARLOS PINZóN	SIGNATURE	JUAN CARLOS PINZóN SIGNATURE.SVG
ANTHONY HOWELLS	SIGNATURE	ANTHONY HOWELLS SIGNATURE.JPG
ZVONKO KUSIć	SIGNATURE	POTPIS ZVONKA KUSIćA.SVG
GEORGE E. ROYCE	SIGNATURE	GEORGEEROYCE-SIGNATURE.JPG
BIBLIOGRAPHY OF THOMAS JEFFERSON	SIGNATURE	THOMAS JEFFERSON SIGNATURE.SVG
WILLIAM TREVITT	SIGNATURE	WILLIAM TREVITT SIGNATURE.JPG
AURELIANO COUTINHO, VISCOUNT OF SEPETIBA	SIGNATURE	AURELIANO COUTINHO VISCONDE DE SEPETIBA SIGNATURE.PNG
MOON JAE-IN	SIGNATURE	MOON JAE IN SIGNATURE.PNG
ABDELILAH BENKIRANE	SIGNATURE	توقيع عبد الإله بنكيران.JPG
ALBERT F. RICHARDSON	SIGNATURE	ALBERT FREDERICK RICHARDSON SIGNATURE.PNG
DEJAN ŠOšKIć	SIGNATURE	SIGNATURE DEJAN SOSKIC.PNG
MARIA CAVACO SILVA	SIGNATURE	SIGNATUREMARIACAVACOSILVA.PNG
SU CHIA-CHYUAN	SIGNATURE	蘇嘉全SIGNATURE.PNG
RANO KARNO	SIGNATURE	SIGNATURE OF RANO KARNO.SVG
STACY ERWIN OAKES	SIGNATURE	STACY ERWIN OAKES.PNG
FREDERICK HINDE ZIMMERMAN	SIGNATURE	FRED ZIMMERMAN SIGNATURE 1906.JPG
HARUHIKO KURODA	SIGNATURE	HARUHIKO KURODA  SIGNATURE IN ENGLISH 2014.PNG
VERONICA CARSTENS	SIGNATURE	SIGNATURVERONICACARSTENS.SVG
STEFAN LöFVEN	SIGNATURE	STEFAN LöFVEN AUTOGRAPH.PNG
JAMES C. GREENOUGH	SIGNATURE	JCGREENOUGH.SVG
MICHAEL SHONROCK	SIGNATURE	MICHAEL SHONROCK SIGNATURE.SVG
JAY PANDA	SIGNATURE	JAY PANDA SIGNATURE.JPG
PRAYUT CHAN-O-CHA	SIGNATURE	SIGNATURE OF PRAYUT CHAN-O-CHA.SVG
VALENTYN NALYVAICHENKO	SIGNATURE	VALENTYN NALYVAICHENKO SIGNATURE 2014.PNG
SCOTT HOWELL	SIGNATURE	SCOTT HOWELL .PNG
JACOB ZIMMERMAN	SIGNATURE	JACOB_ZIMMERMAN_SIGNATURE.JPG
CHARLES H. CONSTABLE	SIGNATURE	JUDGE CONSTABLE SIGNATURE.JPG
KIM YOUNG-SAM	SIGNATURE	KIM YOUNG-SAM SIGNATURE.SVG
JORGOVANKA TABAKOVIć	SIGNATURE	SIGNATURE JORGOVANKA TABAKOVIC.PNG
FRANKIE SUE DEL PAPA	SIGNATURE	FRANKIE SUE DEL PAPA SIGNATURE.JPG
ABBAS AHMAD AKHOUNDI	SIGNATURE	ABBAS AHMAD AKHOUNDI SIGNATURE.JPG
PRESIDENCY OF DMITRY MEDVEDEV	SIGNATURE	SIGNATURE OF DMITRY MEDVEDEV.SVG
SACHCHIDANANDA SINHA	SIGNATURE	SACHCHIDANANDA SINHA SIGNATURE.JPG
FERENC KOSSUTH	SIGNATURE	KOSSUTH FERENC SIGNATURE.JPG
MYKHAILO BURMYSTENKO	SIGNATURE	MYKHAILO BURMYSTENKO SIGNATURE 1941.PNG
BARTOLOMé BACA	SIGNATURE	FIG9-25.GIF
ANTONIO NARBONA	SIGNATURE	FIG9-26.GIF
JOHANNES CHRISTOFFEL KROGH	SIGNATURE	SIGNATURE OF JOHANNES CHRISTOFFEL KROGH.JPG
HASSAN SHEIKH MOHAMUD	SIGNATURE	HASSAN SHEIKH MOHAMUD SIGNATURE.SVG
OLIVER BOSBYSHELL	SIGNATURE	OC BOSBYSHELL SIG.SVG
VIKTOR BALOHA	SIGNATURE	BVI-SIGNATURE1.PNG
JIří DIENSTBIER JR.	SIGNATURE	JIRI DIENSTBIER JR PODPIS.SVG
TOBY TIANGCO	SIGNATURE	TOBY TIANGCO SIGNATURE.JPG
MUHAMMAD ALI JINNAH	SIGNATURE	JINNAH SIGN.GIF
LOLO MATALASI MOLIGA	SIGNATURE	LOLO MOLIGA SIGNATURE.PNG
ANDY BARR	SIGNATURE	ANDY BARR SIGNATURE.PNG
JUSTIN BUTTERFIELD	SIGNATURE	JUSTIN BUTTERFIELD SIGNATURE.JPG
WILLIAM JOHNSTON	SIGNATURE	WILLIAM JOHNSTON  SIGNATURE.PNG
LUíS DA CUNHA	SIGNATURE	ASSINATURA D. LUíS DA CUNHA.PNG
IRAKLI GARIBASHVILI	SIGNATURE	GHARIBASHVILI SIGNATURE.SVG
ARCHELAUS D. MARSH	SIGNATURE	ARCHELAUS D. MARSH SIGNATURE.JPG
SERHIY ARBUZOV	SIGNATURE	SERHII ARBUZOV SIGNATURE 2011.PNG
DAVID LIN	SIGNATURE	DAVID LIN YUNG-LO SIGNATURE.PNG
OLEKSANDR VIKTOROVYCH KLYMENKO	SIGNATURE	KLIMENKO.O.SIGNATURE.JPG
OLEKSANDR VILKUL	SIGNATURE	Вилкул подпись.JPG
ANDREW G. PIERCE	SIGNATURE	ANDREW G. PIERCE SIGNATURE.PNG
HASSAN ROUHANI	SIGNATURE	ROUHANI SIGNATURE.PNG
VOLODYMYR GROYSMAN	SIGNATURE	VOLODYMYR GROYSMAN SIGNATURE 2014.PNG
THOMAS J. SERRA	SIGNATURE	SERRATHOMAS.JPEG
WILLIAM FOUSHEE	SIGNATURE	FOUSHEE SIGNATURE.PNG
HIDEKI TOJO	SIGNATURE	HIDEKI TOJO SIGNATURE.SVG
CIHANGIR AKşIT	SIGNATURE	CIHANGIR AKSIT SIGNATURE.SVG
FRANCO DEBONO	SIGNATURE	FRANCOSIG.PNG
GIORGI MARGVELASHVILI	SIGNATURE	MARGVELASHVILI SIGNATURE.SVG
STEPHEN POLOZ	SIGNATURE	STEPHEN S. POLOZ , SIGNATURE , 2015.PNG
PERNG FAI-NAN	SIGNATURE	FAI-NAN PERNG SIGNATURE.PNG
HELEN CHANG	SIGNATURE	張花冠.JPG
MARCEL CLAUDE	SIGNATURE	FIRMA DE MARCEL CLAUDE.PNG
FRANCO PARISI	SIGNATURE	FIRMA DE FRANCO PARISI.PNG
IHOR SORKIN	SIGNATURE	IHOR SORKIN SIGNATURE 2013.PNG
KARAPET RUBINYAN	SIGNATURE	KARAPET_RUBINYAN_SIGNATURE.PNG
ALEXEI RYKOV	SIGNATURE	ALEXEI RYKOV SIGNATURE.SVG
BENJAMIN F. RANDOLPH	SIGNATURE	B F RANDOLPH SIGNATURE.PNG
ADLY MANSOUR	SIGNATURE	ADLY MANSOUR SIGNATURE.PNG
YEVGENY URLASHOV	SIGNATURE	URLASHOVSIGNATURE.PNG
SCOTT S. HARRIS	SIGNATURE	SCOTT S HARRIS SIGNATURE.PNG
ANDY HALSALL	SIGNATURE	ANDY HALSALL UNTERSCHRIFT.PNG
ABDOLREZA RAHMANI FAZLI	SIGNATURE	SIGNATURE OF ABDOLREZA RAHMANI FAZLI.PNG
MAHMOUD ALAVI	SIGNATURE	MAHMOUD ALAVI SIGNATURE.SVG
HOSSEIN DEHGHAN	SIGNATURE	SIGNATURE OF HOSSEIN DEHGHAN.SVG
ALI TAYEBNIA	SIGNATURE	ALI TAYEBNIA SIGNATURE.PNG
CHARLES H. BURNS	SIGNATURE	CHARLES H. BURNS SIGNATURE.PNG
ANSON S. MARSHALL	SIGNATURE	ANSON S. MARSHALL SIGNATURE.PNG
JOHN SHERMAN	SIGNATURE	APPLETONS' SHERMAN WILLIAM TECUMSEH - JOHN SIGNATURE.PNG
GEORGE MERRILL WRIGHT	SIGNATURE	GEORGE MERRILL WRIGHT SIGNATURE.PNG
HENRY T. WICKHAM	SIGNATURE	HENRY T WICKHAM SIGNATURE.PNG
JOHN HOWARD RAYMOND	SIGNATURE	JOHN RAYMOND SIGNATURE.PNG
HAMID MIRZADEH	SIGNATURE	HAMID MIRZADEH SIGNATURE.JPG
PEARCE ROBINSON	SIGNATURE	PEARCE ROBINSON SIGNATURE.JPG
ROB MANFRED	SIGNATURE	ROB_MANFRED_SIG.PNG
PAUL DEMARCO	SIGNATURE	DEMARCOSIGNATURE.PNG
ROXANA MIRANDA	SIGNATURE	FIRMA DE ROXANA MIRANDA.PNG
TOMáS JOCELYN-HOLT	SIGNATURE	FIRMA DE TOMáS JOCELYN-HOLT.PNG
RICARDO ISRAEL	SIGNATURE	FIRMA DE RICARDO ISRAEL.PNG
SANNIE OVERLY	SIGNATURE	SANNIE OVERLY SIGNATURE.PNG
JUAN MIGUEL DE ESPARZA	SIGNATURE	JUAN M DE ESPARZA FIRMA.JPG
FRANCIS OTTLEY	SIGNATURE	FRANCIS OTTLEY SIGNATURE.JPG
BENJAMIN D. DWINNELL	SIGNATURE	BENJAMIN D. DWINNEL SIGNATURE.PNG
FRANKLIN PEALE	SIGNATURE	FRANKLIN PEALE SIG.SVG
MARCUS SIMON	SIGNATURE	MARCUS SIMON SIGNATURE.PNG
JOHN BAKER WHITE	SIGNATURE	JOHN_BAKER_WHITE_SIGNATURE.JPG
JUAN CARLOS FáBREGA	SIGNATURE	WP 20141106 16 55 53 PRO.JPG
LEVI C. WADE	SIGNATURE	LEVI CLIFFORD WADE SIGNATURE.PNG
WILLIAM J. HOWELL	SIGNATURE	BILL HOWELL SIGNATURE.PNG
REBECA COFRé	SIGNATURE	FIRMA DE REBECA COFRé.PNG
KHEM VEASNA	SIGNATURE	KHEM VEASNA SIGNATURE.PNG
HENRY H. EVANS	SIGNATURE	HENRY H. EVANS SIGNATURE.PNG
ALFRED M. JONES	SIGNATURE	ALFRED M. JONES SIGNATURE.PNG
GEORGE BRUCE UPTON	SIGNATURE	GEORGE_BRUCE_UPTON_SIGNATURE.PNG
BOYKO BORISSOV	SIGNATURE	ACCESSION TREATY 2011 BOïKO BORISSOV SIGNATURE.SVG
BIBLIOGRAPHY OF ULYSSES S. GRANT	SIGNATURE	ULYSSESSGRANTSIGNATURE.SVG
SOUMYA RANJAN PATNAIK	SIGNATURE	AUTOGRAPH_SOUMYARANJAN_PATNAIK.PNG
DENIS PUSHILIN	SIGNATURE	SIGNATURE OF DENIS PUSHILIN.SVG
HARRIS C. HARTWELL	SIGNATURE	HARRIS C. HARTWELL SIGNATURE.PNG
MARSHALL PINCKNEY WILDER	SIGNATURE	MARSHALL PINCKNEY WILDER  SIGNATURE.PNG
EDWARD SWIFT ISHAM	SIGNATURE	EDWARD SWIFT ISHAM SIGNATURE.PNG
SHERMAN LELAND	SIGNATURE	SHERMAN LELAND MASSACHUSETTS SENATE PRESIDENT SIGNATURE.PNG
JOSé MáRIO VAZ	SIGNATURE	JOSé MáRIO VAZ ASSINATURA DE PRESIDENTE DA GUINé-BISSAU.JPG
PHINEAS W. LELAND	SIGNATURE	PHINEAS W. LELAND SIGNATURE.PNG
VALERY BOLOTOV	SIGNATURE	SIGNATURE OF VALERYI BOLOTOV.JPG
STANLEY F. BATTLE	SIGNATURE	STANLEY F. BATTLE SIGNATURE.PNG
MIRO CERAR	SIGNATURE	MIRO CERAR SIGNATURE.PNG
CAMILLO BENSO, COUNT OF CAVOUR	SIGNATURE	CAMILLO BENSO, CONTE DI CAVOUR SIGNATURE.SVG
REZA FARAJIDANA	SIGNATURE	REZA FARAJI EMZA.JPG
LAMAR STERNAD	SIGNATURE	JUSTIN LAMAR STERNAD SIGNATURE.JPG
PEDRO SáNCHEZ	SIGNATURE	FIRMA PEDRO SáNCHEZ.PNG
SAMUEL SNOWDEN HAYES	SIGNATURE	SAMUEL SNOWDEN HAYES SIGNATURE.PNG
WILLIAM C. GOUDY	SIGNATURE	WILLIAM C. GOUDY SIGNATURE.PNG
JAMES W. ROBISON	SIGNATURE	JAMES W. ROBISON SIGNATURE.PNG
MYKHAILO HRECHUKHA	SIGNATURE	MYKHAILO HRECHUKHA SIGNATURE 1944.PNG
ALEXANDER ZAKHARCHENKO	SIGNATURE	SIGNATURE OF ALEKSANDR ZAKHARCHENKO.JPG
RUFUS KING	SIGNATURE	RUFUS KING  SIGNATURE.PNG
IGOR PLOTNITSKY	SIGNATURE	SIGNATURE OF IHOR PLOTNYTSKIY.JPG
RAPHAEL WIDEN	SIGNATURE	RAPHAEL WIDEN SIGNATURE.PNG
WILLARD WOODARD	SIGNATURE	WILLARD WOODARD SIGNATURE.PNG
LYMAN BEECHER RAY	SIGNATURE	LYMAN BEECHER RAY SIGNATURE.PNG
ALEJANDRO VANOLI	SIGNATURE	FIRMA VANOLI.JPG
FRANCISCO ESPEJO	SIGNATURE	FRANCISCO ESPEJO SIGNATURE.JPG
HASSAN GHAZIZADEH HASHEMI	SIGNATURE	HASSAN GHAZIZADEH HASHEMI SIGNATURE.SVG
JOAQUíN VELáZQUEZ DE LEóN	SIGNATURE	JOAQUIN VELAZQUEZ DE LEON SIGNATURE.PNG
JOHN JAMES ESQ	SIGNATURE	JOHN JAMES SIGNATURE.PNG
LEVAR STONEY	SIGNATURE	LEVAR STONEY SIGNATURE.PNG
WILLIAM BLACKSTONE HUBBARD	SIGNATURE	WILLIAM BLACKSTONE HUBBARD SIGNATURE.JPG
SAMUEL FURMAN HUNT	SIGNATURE	SAMUEL FURMAN HUNT SIGNATURE.JPG
THOMAS J. GODFREY	SIGNATURE	THOMAS J. GODFREY SIGNATURE.JPG
ORLANDO J. HODGE	SIGNATURE	ORLANDO J. HODGE SIGNATURE.JPG
LIN YU-CHANG	SIGNATURE	LIN YU-CHANG'S SIGNATURE 2015-02.JPG
ROBERT BOAL	SIGNATURE	ROBERT BOAL SIGNATURE.PNG
GEORGE HENRY CHAMBERLAIN	SIGNATURE	GEORGE HENRY CHAMBERLAIN SIGNATURE.JPG
ÁNGEL CANAVERIS	SIGNATURE	ÁNGEL CANAVERIS FIRMA.JPG
TOMáS CANAVERY	SIGNATURE	TOMáS CANAVERI SIGNATURE.JPG
TIMELINE OF THE PRESIDENCY OF MAITHRIPALA SIRISENA	SIGNATURE	SIGNATURE OF MAITHRIPALA SIRISENA.SVG
EUCLID TSAKALOTOS	SIGNATURE	EUCLID TSAKALOTOS SIGNATURE.JPG
ANDRZEJ DUDA	SIGNATURE	ANDRZEJ DUDA SIGNATURE 02.SVG
FRANCISCO DE MERLO	SIGNATURE	FRANCISCO DE MERLO FIRMA.JPG
KAY SCHALLENKAMP	SIGNATURE	KAY SCHALLENKAMP SIGNATURE.SVG
JAMES HOWELL	SIGNATURE	JAMES HOWELL BROOKLYN MAYOR SIGNATURE.PNG
JACQUELINE VIETTI	SIGNATURE	JACKIE VIETTI SIGNATURE.SVG
EDWIN MAXWELL	SIGNATURE	EDWIN MAXWELL AUTOGRAPH 1903.JPG
RAFAEL SPINOLA	SIGNATURE	FIRMASPINOLA.JPG
FRANKLIN THOMAS BACKUS	SIGNATURE	FRANKLIN T. BACKUS SIGNATURE.PNG
JANET VESTAL KELLY	SIGNATURE	JANET VESTAL KELLY SIGNATURE.PNG
CARME FORCADELL	SIGNATURE	SIGNATURA_FORCADELL.PNG
HASSANAL BOLKIAH	SIGNATURE	SIGNATURE OF HASSANAL BOLKIAH.SVG
PERRY A. ARMSTRONG	SIGNATURE	PERRY_ARMSTRONG_SIGNATURE.PNG
ALLISON GARRETT	SIGNATURE	ALLISON GARRETT SIGNATURE.SVG
CHEN CHIEN-JEN	SIGNATURE	陳建仁SIGNATURE.PNG
NICO MARQUARDT	SIGNATURE	SIGNATURE_OF_NICO_MARQUARDT.PNG
KATARINA BARLEY	SIGNATURE	KATARINA BARLEY SIGNATURE.PNG
JOSé ANTONIO DURáN	SIGNATURE	JOSé ANTONIO DURAN.JPG
NGUYễN VăN BìNH	SIGNATURE	NGUYễN VăN BìNH , NGUYEN VAN BINH SIGNATURE.PNG
SAMUEL CHIDLEY	SIGNATURE	SAMUEL CHIDLEY SIGNATURE.JPG
JAMES COATES	SIGNATURE	SIGNATURE_OF_JAMES_COATES_FROM_TREATY_OF_WAITANGI_1840.JPG
CECIL BROWN	SIGNATURE	US-NBN-HI-HONOLULU-5550-1882BB-10-1-B .JPG
ALI-ASGHAR FANI	SIGNATURE	ALI ASGHAR FANI SIGNATURE.SVG
VICTOR MONTAGLIANI	SIGNATURE	VICTOR MONTAGLIANI SIGNATURE.PNG
JOHN MCKIBBIN	SIGNATURE	JOHN MCKIBBIN SIGNATURE.PNG
SINFOROSO CANAVERY	SIGNATURE	SINFOROSO CANAVERI FIRMA.JPG
LIAO PEN-YEN	SIGNATURE	LIAO BEN-IAN SIGNATURE.JPG
MATěJ STROPNICKý	SIGNATURE	MATEJ STROPNICKY PODPIS.SVG
STEVEN A. SCOTT	SIGNATURE	STEVE A. SCOTT SIGNATURE.SVG
GHOLAMREZA TAJGARDOON	SIGNATURE	GHOLAMREZA TAJGARDOON SIGNATURE.SVG
PRESIDENCY OF RODRIGO DUTERTE	SIGNATURE	RODRIGO DUTERTE SIGNATURE.PNG
JERRY FARLEY	SIGNATURE	JERRY FARLEY SIGNATURE.SVG
ABRAHAM GYULKHANDANYAN	SIGNATURE	ABRAHAM GYULKHANDANYAN SIGNATURE.JPG
JOSé VICTORINO LASTARRIA	SIGNATURE	FIRMA DE J.V LASTARRIA.PNG
GIUSEPPE CROTTO	SIGNATURE	JOSE CROTO FIRMA.JPG
