HARVARD CRIMSON	SOCCERSTADIUM	SOLDIERS FIELD SOCCER STADIUM
HARVARD CRIMSON	SOCCERSTADIUM	OHIRI FIELD
MEDAILLE COLLEGE	SOCCERSTADIUM	ALL-HIGH STADIUM
MINNESOTA GOLDEN GOPHERS	SOCCERSTADIUM	ELIZABETH LYLE ROBBIE STADIUM
FLORIDA STATE SEMINOLES	SOCCERSTADIUM	SEMINOLE SOCCER COMPLEX
LOUISVILLE CARDINALS	SOCCERSTADIUM	DR. MARK & CINDY LYNN STADIUM
SIMON FRASER CLAN	SOCCERSTADIUM	TERRY FOX FIELD
ALABAMA CRIMSON TIDE	SOCCERSTADIUM	ALABAMA SOCCER STADIUM
MEMPHIS TIGERS	SOCCERSTADIUM	MIKE ROSE SOCCER COMPLEX
PITTSBURGH PANTHERS	SOCCERSTADIUM	AMBROSE URBANIC FIELD
KANSAS STATE WILDCATS	SOCCERSTADIUM	MEMORIAL STADIUM
VIRGINIA CAVALIERS	SOCCERSTADIUM	KLöCKNER STADIUM
TEXAS TECH RED RAIDERS AND LADY RAIDERS	SOCCERSTADIUM	JOHN WALKER SOCCER COMPLEX
CREIGHTON BLUEJAYS	SOCCERSTADIUM	MORRISON STADIUM
OREGON STATE BEAVERS	SOCCERSTADIUM	PAUL LORENZ FIELD AT PATRICK WAYNE VALLEY STADIUM
CALIFORNIA GOLDEN BEARS	SOCCERSTADIUM	EDWARDS STADIUM
UC IRVINE ANTEATERS	SOCCERSTADIUM	ANTEATER STADIUM
CLEVELAND STATE VIKINGS	SOCCERSTADIUM	KRENZLER FIELD
GEORGE MASON PATRIOTS	SOCCERSTADIUM	GEORGE MASON STADIUM
YALE BULLDOGS	SOCCERSTADIUM	REESE STADIUM
MONTANA GRIZZLIES AND LADY GRIZ	SOCCERSTADIUM	MONTANA GRIZZLIES
PENN STATE NITTANY LIONS	SOCCERSTADIUM	JEFFREY FIELD
NORTHWESTERN WILDCATS	SOCCERSTADIUM	TOYOTA PARK
TEXAS A&M AGGIES	SOCCERSTADIUM	ELLIS FIELD
FAIRFIELD STAGS	SOCCERSTADIUM	LESSING FIELD
MARYLAND TERRAPINS	SOCCERSTADIUM	LUDWIG FIELD
COLUMBIA LIONS	SOCCERSTADIUM	ROCCO B. COMMISSO SOCCER STADIUM
CONNECTICUT HUSKIES	SOCCERSTADIUM	MORRONE STADIUM
UAB BLAZERS	SOCCERSTADIUM	BBVA COMPASS FIELD
MCNEESE STATE COWBOYS AND COWGIRLS	SOCCERSTADIUM	COWGIRL FIELD
RUTGERS SCARLET KNIGHTS	SOCCERSTADIUM	YURCAK FIELD
WESTERN MICHIGAN BRONCOS	SOCCERSTADIUM	WMU SOCCER COMPLEX
MARSHALL THUNDERING HERD	SOCCERSTADIUM	VETERANS MEMORIAL SOCCER COMPLEX
MIAMI HURRICANES	SOCCERSTADIUM	COBB STADIUM
CAMPBELL FIGHTING CAMELS AND LADY CAMELS	SOCCERSTADIUM	EAKES ATHLETICS COMPLEX
SOUTH FLORIDA BULLS	SOCCERSTADIUM	CORBETT SOCCER STADIUM
SETON HALL PIRATES	SOCCERSTADIUM	OWEN T. CARROLL FIELD
SMU MUSTANGS	SOCCERSTADIUM	WESTCOTT FIELD
SAN FRANCISCO DONS	SOCCERSTADIUM	NEGOESCO STADIUM
NORTHEASTERN HUSKIES	SOCCERSTADIUM	PARSONS FIELD
WESTERN ILLINOIS LEATHERNECKS	SOCCERSTADIUM	MACKENZIE ALUMNI FIELD
NYU VIOLETS	SOCCERSTADIUM	HOME GAMES USUALLY PLAYED AT GAELIC PARK
UCF KNIGHTS	SOCCERSTADIUM	UCF SOCCER AND TRACK STADIUM
APPALACHIAN STATE MOUNTAINEERS	SOCCERSTADIUM	ASU SOCCER STADIUM
UC SANTA BARBARA GAUCHOS	SOCCERSTADIUM	HARDER STADIUM
VCU RAMS	SOCCERSTADIUM	SPORTS BACKERS STADIUM
CHARLOTTE 49ERS	SOCCERSTADIUM	TRANSAMERICA FIELD
SAINT LOUIS BILLIKENS	SOCCERSTADIUM	HERMANN STADIUM
NEW MEXICO STATE AGGIES	SOCCERSTADIUM	SOCCER ATHLETIC COMPLEX
OMAHA MAVERICKS	SOCCERSTADIUM	AL F. CANIGLIA FIELD
WRIGHT STATE RAIDERS	SOCCERSTADIUM	ALUMNI FIELD
NJIT HIGHLANDERS	SOCCERSTADIUM	J. MALCOLM SIMON STADIUM
NORTHERN COLORADO BEARS	SOCCERSTADIUM	JACKSON STADIUM
ALBANY GREAT DANES	SOCCERSTADIUM	BOB FORD FIELD
DENVER PIONEERS	SOCCERSTADIUM	CIBER FIELD AT THE UNIVERSITY OF DENVER SOCCER STADIUM
FURMAN PALADINS	SOCCERSTADIUM	EUGENE E. STONE III STADIUM
UNC GREENSBORO SPARTANS	SOCCERSTADIUM	UNCG SOCCER STADIUM
WILLIAM & MARY TRIBE	SOCCERSTADIUM	ALBERT–DALY FIELD
GREEN BAY PHOENIX	SOCCERSTADIUM	ALDO SANTAGA STADIUM
LAMAR CARDINALS AND LADY CARDINALS	SOCCERSTADIUM	LAMAR SOCCER COMPLEX
PRINCETON TIGERS	SOCCERSTADIUM	ROBERTS STADIUM
SAM HOUSTON STATE BEARKATS	SOCCERSTADIUM	PRITCHETT FIELD
UMKC KANGAROOS	SOCCERSTADIUM	DURWOOD SOCCER STADIUM
NORTHWESTERN STATE DEMONS AND LADY DEMONS	SOCCERSTADIUM	LADY DEMON SOCCER COMPLEX
UC SAN DIEGO TRITONS	SOCCERSTADIUM	TRITON SOCCER STADIUM
PORTLAND PILOTS	SOCCERSTADIUM	MERLO FIELD
NEVADA WOLF PACK	SOCCERSTADIUM	MACKAY STADIUM
ST. FRANCIS BROOKLYN TERRIERS	SOCCERSTADIUM	BROOKLYN BRIDGE PARK
WEBER STATE WILDCATS	SOCCERSTADIUM	P.E. PLAYFIELD
SOUTHERN UTAH THUNDERBIRDS	SOCCERSTADIUM	THUNDERBIRD PARK COMPLEX
LE MOYNE DOLPHINS	SOCCERSTADIUM	TED GRANT FIELD
JACKSONVILLE DOLPHINS	SOCCERSTADIUM	SOUTHERN OAK STADIUM
CAL STATE FULLERTON TITANS	SOCCERSTADIUM	TITAN STADIUM
WASHINGTON AND LEE GENERALS	SOCCERSTADIUM	ALSTON PARKER WATT FIELD
GARDNER–WEBB RUNNIN' BULLDOGS	SOCCERSTADIUM	GREENE–HARBISON STADIUM
WASHINGTON & JEFFERSON PRESIDENTS	SOCCERSTADIUM	ROSS MEMORIAL PARK AND ALEXANDRE STADIUM
STEPHEN F. AUSTIN LUMBERJACKS AND LADYJACKS	SOCCERSTADIUM	SFA SOCCER FIELD
NORTHERN ARIZONA LUMBERJACKS	SOCCERSTADIUM	LUMBERJACK STADIUM
NICHOLLS STATE COLONELS	SOCCERSTADIUM	NICHOLLS SOCCER COMPLEX
HOLY CROSS CRUSADERS	SOCCERSTADIUM	LINDA JOHNSON SMITH SOCCER STADIUM
RADFORD HIGHLANDERS	SOCCERSTADIUM	PATRICK D. CUPP STADIUM
NORTH FLORIDA OSPREYS	SOCCERSTADIUM	HODGES STADIUM
VERMONT CATAMOUNTS	SOCCERSTADIUM	VIRTUE FIELD
SANTA CLARA BRONCOS	SOCCERSTADIUM	BUCK SHAW STADIUM
WINTHROP EAGLES	SOCCERSTADIUM	EAGLE FIELD
KANSAS WESLEYAN COYOTES	SOCCERSTADIUM	GENE BISSELL FIELD AT THE GRAVES FAMILY SPORTS COMPLEX
SIU EDWARDSVILLE COUGARS	SOCCERSTADIUM	RALPH KORTE STADIUM
UNC WILMINGTON SEAHAWKS	SOCCERSTADIUM	UNCW SOCCER STADIUM
CONCORDIA GOLDEN BEARS	SOCCERSTADIUM	SEA FOAM STADIUM
MARY MARAUDERS	SOCCERSTADIUM	MDU RESOURCES BOWL
NORTHERN STATE WOLVES	SOCCERSTADIUM	JERDE FIELD
BAKERSFIELD RENEGADES	SOCCERSTADIUM	MEMORIAL STADIUM
GRAND CANYON ANTELOPES	SOCCERSTADIUM	GCU SOCCER STADIUM
NORTHERN KENTUCKY NORSE	SOCCERSTADIUM	NKU SOCCER STADIUM
UPPER IOWA PEACOCKS	SOCCERSTADIUM	PATTISON FIELD
ST. BONAVENTURE BONNIES	SOCCERSTADIUM	TOM AND MICHELLE MARRA ATHLETICS FIELD COMPLEX
CAL STATE EAST BAY PIONEERS	SOCCERSTADIUM	PIONEER STADIUM
LONGWOOD LANCERS	SOCCERSTADIUM	LONGWOOD UNIVERSITY ATHLETICS COMPLEX
VMI KEYDETS	SOCCERSTADIUM	PATCHIN FIELD
MILWAUKEE PANTHERS	SOCCERSTADIUM	ENGELMANN FIELD
BELMONT BRUINS	SOCCERSTADIUM	E.S. ROSE PARK
TEXAS–PAN AMERICAN BRONCS	SOCCERSTADIUM	FUTURE UTRGV VAQUEROS SOCCER STADIUM
DALLAS BAPTIST PATRIOTS	SOCCERSTADIUM	PATRIOT SOCCER FIELD
TEXAS A&M–CORPUS CHRISTI ISLANDERS	SOCCERSTADIUM	DR. JACK DUGAN FAMILY SOCCER & TRACK STADIUM
CAL STATE DOMINGUEZ HILLS TOROS	SOCCERSTADIUM	TORO STADIUM
CAL STATE LOS ANGELES GOLDEN EAGLES	SOCCERSTADIUM	JESSE OWENS TRACK
BATES BOBCATS	SOCCERSTADIUM	CAMPUS OF BATES COLLEGE
SOUTH DAKOTA SCHOOL OF MINES HARDROCKERS	SOCCERSTADIUM	SIOUX PARK FIELD
MOUNT OLIVE TROJANS	SOCCERSTADIUM	AMON FIELD
SOUTHEASTERN LOUISIANA LIONS AND LADY LIONS	SOCCERSTADIUM	SOUTHEASTERN SOCCER COMPLEX
DELTA STATE STATESMEN AND LADY STATESMEN	SOCCERSTADIUM	DELTA FIELD
TROY TROJANS	SOCCERSTADIUM	SOCCER COMPLEX
UWI BLACKBIRDS	SOCCERSTADIUM	USAIN BOLT SPORTS COMPLEX
