DETROIT RIVER	SOURCENAME	LAKE ST. CLAIR
GANGES	SOURCENAME	GANGOTRI GLACIER, SATOPANTH GLACIER, KHATLING GLACIER, AND WATERS FROM MELTED SNOW FROM SUCH PEAKS AS NANDA DEVI, TRISUL, KEDARNATH, NANDA KOT, AND KAMET.
MISSISSIPPI RIVER	SOURCENAME	LAKE ITASCA
MURRAY RIVER	SOURCENAME	COWOMBAT FLAT
NEVA RIVER	SOURCENAME	LAKE LADOGA
NIEUWE WATERWEG	SOURCENAME	NIEUWE MAAS
OHIO RIVER	SOURCENAME	ALLEGHENY RIVER
RIVER CLYDE	SOURCENAME	LOWTHER HILLS IN SOUTH LANARKSHIRE
SNAKE RIVER	SOURCENAME	ROCKY MOUNTAINS
HUDSON RIVER	SOURCENAME	NEAR OR AT LAKE TEAR OF THE CLOUDS OR NEAR OR AT HENDERSON LAKE
ELBE	SOURCENAME	BíLé LABE
DELAWARE RIVER	SOURCENAME	WEST BRANCH DELAWARE RIVER
YENISEI RIVER	SOURCENAME	KA-HEM
WAAL	SOURCENAME	RIVER RHINE
BRISBANE RIVER	SOURCENAME	MOUNT STANLEY
YAKIMA RIVER	SOURCENAME	KEECHELUS LAKE
RIVER PARRETT	SOURCENAME	CHEDINGTON
POTOMAC RIVER	SOURCENAME	FAIRFAX STONE
VEDEA	SOURCENAME	DăDULEșTI HILL
TAGUS	SOURCENAME	FRíAS DE ALBARRACíN
IJSSEL	SOURCENAME	NEDERRIJN
DOURO	SOURCENAME	PICOS DE URBIóN
RIVER SHANNON	SOURCENAME	SHANNON POT
CHARLES RIVER	SOURCENAME	ECHO LAKE
RIVER AVON	SOURCENAME	ACTON TURVILLE
RIVER DERWENT, CUMBRIA	SOURCENAME	STYHEAD TARN
RIVER DERWENT	SOURCENAME	LAKE ST CLAIR
CHAO PHRAYA RIVER	SOURCENAME	CONFLUENCE OF PING RIVER AND NAN RIVER
RIVER TAY	SOURCENAME	ALLT COIRE LAOIGH
MERRIMACK RIVER	SOURCENAME	PEMIGEWASSET RIVER-WINNIPESAUKEE RIVER JUNCTURE
KAVERI	SOURCENAME	TALAKAVERI
KAVERI	SOURCENAME	KODAGU
KAVERI	SOURCENAME	WESTERN GHATS
KAVERI	SOURCENAME	KARNATAKA
ORANGE RIVER	SOURCENAME	THABA PUTSOA
SAGUENAY RIVER	SOURCENAME	LAC SAINT-JEAN
FRASER RIVER	SOURCENAME	FRASER PASS
MONONGAHELA RIVER	SOURCENAME	TYGART VALLEY RIVER
AFGEDAMDE MAAS	SOURCENAME	MEUSE
NORTH SEA CANAL	SOURCENAME	IJ
MUSKEGON RIVER	SOURCENAME	HOUGHTON LAKE
DUWAMISH RIVER	SOURCENAME	GREEN RIVER
SUSQUEHANNA RIVER	SOURCENAME	OTSEGO LAKE
RARITAN RIVER	SOURCENAME	SOUTH BRANCH RARITAN RIVER AND
RARITAN RIVER	SOURCENAME	NORTH BRANCH RARITAN RIVER
LEK	SOURCENAME	NEDERRIJN
SAVANNAH RIVER	SOURCENAME	LAKE HARTWELL
RIVER MEDWAY	SOURCENAME	TURNERS HILL
CONNECTICUT RIVER	SOURCENAME	FOURTH CONNECTICUT LAKE
MINNESOTA RIVER	SOURCENAME	BIG STONE LAKE
PASIG RIVER	SOURCENAME	LAGUNA DE BAY
ST. MARYS RIVER	SOURCENAME	WHITEFISH BAY
SANTIAM RIVER	SOURCENAME	CONFLUENCE OF NORTH SANTIAM AND SOUTH SANTIAM RIVERS
RIVER TAMAR	SOURCENAME	WOOLLEY MOOR, MORWENSTOW PARISH
RIVER DART	SOURCENAME	WEST DART
RIVER TONE	SOURCENAME	BRENDON HILLS
RIVER PIDDLE	SOURCENAME	ALTON PANCRAS
WHITE RIVER	SOURCENAME	BOSTON MOUNTAINS
MURRUMBIDGEE RIVER	SOURCENAME	PEPPERCORN HILL
DARLING RIVER	SOURCENAME	CONFLUENCE OF BARWON AND CULGOA RIVERS
DON RIVER	SOURCENAME	OAK RIDGES MORAINE
BIG SANDY RIVER	SOURCENAME	TUG FORK
RIVER FORTH	SOURCENAME	LOCH ARD
RIVER TEME	SOURCENAME	DOLFOR
YAMUNA	SOURCENAME	YAMUNOTRI
RIVER RAVENSBOURNE	SOURCENAME	KESTON
PASłęKA	SOURCENAME	OLSZTYN LAKE AREA
RIVER STOUR, DORSET	SOURCENAME	STOURHEAD
RIVER LUGG	SOURCENAME	LLANGYNLLO
BAGMATI RIVER	SOURCENAME	BAGDWAR
MOLALLA RIVER	SOURCENAME	TABLE ROCK WILDERNESS AREA
HUANGPU RIVER	SOURCENAME	DIANSHAN LAKE
QUINNIPIAC RIVER	SOURCENAME	DEADWOOD SWAMP
SUWANNEE RIVER	SOURCENAME	OKEFENOKEE NATIONAL WILDLIFE REFUGE
ROGUE RIVER	SOURCENAME	LARGE MUCK FIELDS NEAR GRANT, MI
KLAMATH RIVER	SOURCENAME	UPPER KLAMATH LAKE
ROGUE RIVER	SOURCENAME	BOUNDARY SPRINGS IN CRATER LAKE NATIONAL PARK
GREEN RIVER	SOURCENAME	CASCADE RANGE
GREEN RIVER	SOURCENAME	WIND RIVER MOUNTAINS
TUALATIN RIVER	SOURCENAME	NORTHERN OREGON COAST RANGE
MUREș	SOURCENAME	CARPATHIAN MOUNTAINS
HOOSIC RIVER	SOURCENAME	CHESHIRE RESERVOIR
PISCATAQUA RIVER	SOURCENAME	COCHECHO AND SALMON FALLS RIVERS
GUNNISON RIVER	SOURCENAME	EAST RIVER CONFLUENCE WITH THE TAYLOR RIVER
NEW RIVER	SOURCENAME	SOUTH FORK NEW RIVER
YAMPA RIVER	SOURCENAME	ROCKY MOUNTAINS
GALLATIN RIVER	SOURCENAME	GALLATIN RANGE
BOULDER RIVER	SOURCENAME	CONTINENTAL DIVIDE
BRONX RIVER	SOURCENAME	KENSICO RESERVOIR
CEDAR RIVER	SOURCENAME	CASCADE RANGE
KISHON RIVER	SOURCENAME	GILBOA MOUNTAINS
KANAWHA RIVER	SOURCENAME	NEW RIVER
WHITE RIVER	SOURCENAME	MOUNT RAINIER
SAMMAMISH RIVER	SOURCENAME	LAKE SAMMAMISH
LEHIGH RIVER	SOURCENAME	POCONO PEAK LAKE
SHETUCKET RIVER	SOURCENAME	CONFLUENCE OF WILLIMANTIC RIVER AND NATCHAUG RIVER
BEAVER RIVER	SOURCENAME	MAHONING RIVER
JUNIATA RIVER	SOURCENAME	FRANKSTOWN BRANCH JUNIATA RIVER
SALMON RIVER	SOURCENAME	SAWTOOTH RANGE
PUYALLUP RIVER	SOURCENAME	MOUNT RAINIER
CURRENT RIVER	SOURCENAME	PIGEON CREEK, MISSOURI
BRANDYWINE CREEK	SOURCENAME	WEST BRANCH BRANDYWINE CREEK
ST. JONES RIVER	SOURCENAME	SILVER LAKE
NEVERSINK RIVER	SOURCENAME	EAST BRANCH NEVERSINK RIVER
YOUGHIOGHENY RIVER	SOURCENAME	BACKBONE MOUNTAIN MD ABOVE SILVER LAKE, WEST VIRGINIA
JOHN DAY RIVER	SOURCENAME	STRAWBERRY MOUNTAINS
OWYHEE RIVER	SOURCENAME	NEAR WILD HORSE
CLARK FORK RIVER	SOURCENAME	SILVER BOW CREEK
PEND OREILLE RIVER	SOURCENAME	LAKE PEND OREILLE
OKANOGAN RIVER	SOURCENAME	OKANAGAN LAKE
QUINN RIVER	SOURCENAME	W SIDE OF THE SANTA ROSA RANGE IN NE HUMBOLDT CO
GRANDE RONDE RIVER	SOURCENAME	BLUE MOUNTAINS
LONG TOM RIVER	SOURCENAME	CENTRAL OREGON COAST RANGE
COAST FORK WILLAMETTE RIVER	SOURCENAME	CONFLUENCE OF BIG RIVER AND GAROUTTE CREEK
KOBUK RIVER	SOURCENAME	WALKER LAKE
KANKAKEE RIVER	SOURCENAME	ST. JOSEPH COUNTY, INDIANA
NOOKSACK RIVER	SOURCENAME	CASCADE RANGE
NORTH SANTIAM RIVER	SOURCENAME	SANTIAM LAKE
MIDDLE SANTIAM RIVER	SOURCENAME	IRON MOUNTAIN
RIVER CHEW	SOURCENAME	CHEWTON MENDIP
SHASTA RIVER	SOURCENAME	MOUNT EDDY
TRINITY RIVER	SOURCENAME	SCOTT MOUNTAINS
ELWHA RIVER	SOURCENAME	OLYMPIC RANGE
BOGACHIEL RIVER	SOURCENAME	BOGACHIEL PEAK
NISQUALLY RIVER	SOURCENAME	NISQUALLY GLACIER
NEPONSET RIVER	SOURCENAME	NEPONSET RESERVOIR
OCMULGEE RIVER	SOURCENAME	CONFLUENCE OF SOUTH, YELLOW, AND ALCOVY RIVERS
HILLSBOROUGH RIVER	SOURCENAME	GREEN SWAMP
ALLAGASH RIVER	SOURCENAME	CHURCHILL LAKE
HET SCHEUR	SOURCENAME	NIEUWE MAAS
HET SCHEUR	SOURCENAME	OUDE MAAS
NEDERRIJN	SOURCENAME	PANNERDENS KANAAL
SKEENA RIVER	SOURCENAME	SPATSIZI PLATEAU
TAWA RIVER	SOURCENAME	SATPURA RANGE
RIVER ISE	SOURCENAME	BATTLE OF NASEBY
KROMME RIJN	SOURCENAME	NEDERRIJN
RIVER SUIR	SOURCENAME	DEVIL'S BIT
RIVER ANNAN	SOURCENAME	HART FELL, MOFFAT.  ANNANHEAD HILL, DEVIL'S BEEF TUB
SPAARNE	SOURCENAME	RINGVAART
VOLKHOV RIVER	SOURCENAME	LAKE ILMEN
RIVER LAGAN	SOURCENAME	SLIEVE CROOB
KENAI RIVER	SOURCENAME	KENAI LAKE
OUDE RIJN	SOURCENAME	LEIDSE RIJN
MANZANARES	SOURCENAME	SIERRA DE GUADARRAMA
NUSHAGAK RIVER	SOURCENAME	ALASKA RANGE
SAINT-MAURICE RIVER	SOURCENAME	GOUIN RESERVOIR
TIMIș RIVER	SOURCENAME	CONFLUENCE OF HEADWATERS BREBU, GRăDIșTEA AND SEMENIC IN LAKE TREI APE
CHEAT RIVER	SOURCENAME	SHAVERS FORK
BURNETT RIVER	SOURCENAME	MOUNT GAETA, GREAT DIVIDING RANGE
RIVER DOVE, CENTRAL ENGLAND	SOURCENAME	DOVE HEAD
RIVER FOYLE	SOURCENAME	RIVER MOURNE
KöRöS	SOURCENAME	CONFLUENCE OF HEADWATERS CRIșUL ALB AND CRIșUL NEGRU
RIO TINTO	SOURCENAME	SIERRA MORENA
RIVER AXE	SOURCENAME	MENDIP HILLS
MAGNETAWAN RIVER	SOURCENAME	MAGNETAWAN LAKE
CHOPTANK RIVER	SOURCENAME	CHOPTANK MILLS
MAMBERAMO RIVER	SOURCENAME	CONFLUENCE OF TARIKU AND TARITATU
NASS RIVER	SOURCENAME	COAST MOUNTAINS
ORAVA	SOURCENAME	ORAVA RESERVOIR, TAKING WATER FROM WHITE ORAVA IN SLOVAKIA AND FROM BLACK ORAVA IN POLAND
ARGEș	SOURCENAME	FăGăRAș MOUNTAINS
IALOMIțA	SOURCENAME	BUCEGI MOUNTAINS
RIVER KENT	SOURCENAME	HALL COVE ABOVE KENTMERE RESERVOIR
SABARMATI RIVER	SOURCENAME	DHEBAR LAKE, RAJASTHAN
TâRNAVA RIVER	SOURCENAME	JUNCTION OF THE TâRNAVA MARE AND THE TâRNAVA MICă
CHU RIVER	SOURCENAME	CONFLUENCE OF JOON ARYK AND KOCHKOR RIVER
RIVER LEACH	SOURCENAME	HAMPNETT
RUPERT RIVER	SOURCENAME	LAKE MISTASSINI
TEESTA RIVER	SOURCENAME	PAUHUNRI GLACIER
TEESTA RIVER	SOURCENAME	ZEMU GLACIER
TEESTA RIVER	SOURCENAME	LAKE CHOLAMU
TEESTA RIVER	SOURCENAME	LAKE GURUDONGMAR
COMAL RIVER	SOURCENAME	COMAL SPRINGS
MANDOVI RIVER	SOURCENAME	BHIMGAD WILDLIFE SANCTUARY
RIVER FEALE	SOURCENAME	MULLAGHAREIRK MOUNTAINS
PENNA RIVER	SOURCENAME	NANDI HILLS, KARNATAKA
PONNAIYAR RIVER	SOURCENAME	NANDI HILLS, INDIA
PONNAIYAR RIVER	SOURCENAME	CHIKKABALLAPURA
PONNAIYAR RIVER	SOURCENAME	KARNATAKA
ANDROSCOGGIN RIVER	SOURCENAME	UMBAGOG LAKE
RIVER AYR	SOURCENAME	GLENBUCK
TUNGABHADRA RIVER	SOURCENAME	KOODLI
ULHAS RIVER	SOURCENAME	WESTERN GHATS
BIG SANDY RIVER	SOURCENAME	BETWEEN HUALAPAI AND AQUARIUS RANGES
AGUSAN RIVER	SOURCENAME	MOUNT TAGUBUD
AGUSAN RIVER	SOURCENAME	PANTUKAN, COMPOSTELA VALLEY
ONYX RIVER	SOURCENAME	LAKE BROWNWORTH
WAINGANGA RIVER	SOURCENAME	MUNDARA
GREAT KEI RIVER	SOURCENAME	STORMBERG DISTRICT
PHALGU	SOURCENAME	CONFLUENCE OF LILAJAN AND MOHANA RIVERS
RAFT RIVER	SOURCENAME	ALBION MOUNTAINS
MAHANANDA RIVER	SOURCENAME	HIMALAYAS
SUCEAVA RIVER	SOURCENAME	OBCINA MESTECăNIș MOUNTAINS
SHARAVATI	SOURCENAME	AMBUTHEERTHA
RIVER VYRNWY	SOURCENAME	LAKE VYRNWY
LITTLE WOOD RIVER	SOURCENAME	PIONEER MOUNTAINS
BETWA RIVER	SOURCENAME	VINDHYA RANGE
BERG RIVER	SOURCENAME	SOUTH OF FRANSCHHOEK
CLE ELUM RIVER	SOURCENAME	CASCADE RANGE
DHALESHWARI RIVER	SOURCENAME	JAMUNA RIVER
ARIEș RIVER	SOURCENAME	CONFLUENCE OF HEADWATERS ARIEșUL MARE AND ARIEșUL MIC
CRIșUL NEGRU	SOURCENAME	CONFLUENCE OF HEADWATERS CRIșUL POIENII AND CRIșUL BăIțEI
IRRAWADDY RIVER	SOURCENAME	MALI RIVER
CHEHALIS RIVER	SOURCENAME	DOUGLAS RANGES
VAIGAI RIVER	SOURCENAME	VARUSANADU
VAIGAI RIVER	SOURCENAME	HILLS
KARUN	SOURCENAME	ZARD KUH
WALLKILL RIVER	SOURCENAME	LAKE MOHAWK, NEW JERSEY
DEAD RIVER	SOURCENAME	LIBERTY CORNER, NEW JERSEY
SAN MARCOS RIVER	SOURCENAME	SAN MARCOS SPRINGS
FLATROCK RIVER	SOURCENAME	DRIFTWOOD RIVER
THAMIRABARANI RIVER	SOURCENAME	POTHIGAI HILLS
MIDDLE ISLAND CREEK	SOURCENAME	CONFLUENCE OF MEATHOUSE FORK AND BUCKEYE CREEK
TYGART VALLEY RIVER	SOURCENAME	ALLEGHENY MOUNTAINS
SINDH RIVER	SOURCENAME	MALWA PLATEAU
BLACK FORK	SOURCENAME	DRY FORK
SHAVERS FORK	SOURCENAME	THORNY FLAT, CHEAT MOUNTAIN
TIMOK	SOURCENAME	ZAJEčAR
RIVER GRYFE	SOURCENAME	GRYFFE RESERVOIR
RIVER GRYFE	SOURCENAME	INVERCLYDE
COTTER RIVER	SOURCENAME	SCABBY RANGE, BRINDABELLA RANGES
RIVER COCKER, CUMBRIA	SOURCENAME	CRUMMOCK WATER
FIREHOLE RIVER	SOURCENAME	MADISON LAKE, WYOMING
MAGOG RIVER	SOURCENAME	LAKE MEMPHREMAGOG
BUZăU	SOURCENAME	CIUCAș MOUNTAINS
BâRLAD RIVER	SOURCENAME	CENTRAL MOLDAVIAN PLATEAU
WEBER RIVER	SOURCENAME	UINTA MOUNTAINS
QUEEN RIVER, AUSTRALIA	SOURCENAME	MOUNT LYELL
QUEEN RIVER, AUSTRALIA	SOURCENAME	WEST COAST RANGE
BOUND BROOK	SOURCENAME	EDISON, NEW JERSEY
ZUNI RIVER	SOURCENAME	CONFLUENCE OF RIO PESCADO AND RIO NUTRIA
RIVER ASH, SURREY	SOURCENAME	RIVER COLNE, HERTFORDSHIRE
CIBIN	SOURCENAME	CONFLUENCE OF HEADWATERS RâUL MARE AND RâUL MIC
CHAGRIN RIVER	SOURCENAME	BASS LAKE, OHIO
NECHAKO RIVER	SOURCENAME	NECHAKO PLATEAU
CHILKO RIVER	SOURCENAME	CHILKO LAKE
GUDGENBY RIVER	SOURCENAME	MOUNT GUDGENBY AND YANKEE HAT, BRINDABELLA RANGE
PITT RIVER	SOURCENAME	GARIBALDI RANGES
HARRISON RIVER	SOURCENAME	HARRISON LAKE
KNAPP CREEK	SOURCENAME	ALLEGHENY MOUNTAIN
SOBAT RIVER	SOURCENAME	PIBOR RIVER AND BARO RIVER CONFLUENCE
BLUESTONE LAKE	SOURCENAME	NEW RIVER
QUESNEL RIVER	SOURCENAME	QUESNEL LAKE
STUART RIVER	SOURCENAME	STUART LAKE
WEST ROAD RIVER	SOURCENAME	ILGACHUZ RANGE
PIPERS RIVER	SOURCENAME	MOUNT ARTHUR
ELSIESKRAAL RIVER	SOURCENAME	TYGERBERG NATURE RESERVE
RIVER NEB	SOURCENAME	BLABER RIVER
RâUL DOAMNEI	SOURCENAME	CONFLUENCE OF HEADWATERS VALEA REA AND ZâRNA
KOSHI RIVER	SOURCENAME	SUN KOSI, ARUN AND TAMUR FORM SAPTAKOSHI
RANGPO RIVER	SOURCENAME	RANGPO CHU
PANSIPIT RIVER	SOURCENAME	TAAL LAKE
AFON CLARACH	SOURCENAME	CAPEL DEWI, ABERYSTWYTH
SOMEșUL MIC RIVER	SOURCENAME	CONFLUENCE OF THE SOMEșUL RECE AND SOMEșUL CALD
RIVER DOVEY	SOURCENAME	CREIGLYN DYFI
CHEAT LAKE	SOURCENAME	CHEAT RIVER
MUNSTER BLACKWATER	SOURCENAME	MULLAGHAREIRK MOUNTAINS
CARBON RIVER	SOURCENAME	MOUNT RAINIER
BANICA RIVER	SOURCENAME	OKOY RIVER
PLIVA	SOURCENAME	PLJEVA
CHELIF RIVER	SOURCENAME	SAHARAN ATLAS
SAINT-FRANçOIS RIVER	SOURCENAME	LAC SAINT-FRANçOIS
LITTLE SUR RIVER	SOURCENAME	VENTANA DOUBLE CONE
BIG PINE CREEK	SOURCENAME	SIERRA NEVADA
CLEARWATER RIVER	SOURCENAME	CARIBOO MOUNTAINS
TASEKO RIVER	SOURCENAME	TAYLOR PASS
COLMA CREEK	SOURCENAME	SAN BRUNO MOUNTAIN
AMMONOOSUC RIVER	SOURCENAME	LAKES OF THE CLOUDS
YAMASKA RIVER	SOURCENAME	BROME LAKE
ANCLOTE RIVER	SOURCENAME	STARKEY WILDERNESS PARK
KING'S SEDGEMOOR DRAIN	SOURCENAME	RIVER CARY
ROCK CREEK	SOURCENAME	SUSQUEHANNA DRAINAGE DIVIDE
OSHIWARA RIVER	SOURCENAME	AAREY MILK COLONY
DAHISAR RIVER	SOURCENAME	SANJAY GANDHI NATIONAL PARK
AGUS RIVER	SOURCENAME	LAKE LANAO
ATRAI RIVER	SOURCENAME	JORAPANI RIVER
SOUTH THOMPSON RIVER	SOURCENAME	LITTLE SHUSWAP LAKE
PUTNA RIVER	SOURCENAME	LăCăUțI-ARIșOAIA RIDGE
TIșIțA RIVER	SOURCENAME	CONFLUENCE OF HEADWATERS TIșIțA MARE AND TIșIțA MICă
MORGAN CREEK	SOURCENAME	SIERRA CREST
LOSTINE RIVER	SOURCENAME	MINAM LAKE
ROSS RIVER	SOURCENAME	HERVEY RANGE
MATAWAN CREEK	SOURCENAME	BAKERS BROOK
RIVER ELLEN	SOURCENAME	SKIDDAW MASSIF
SANTA FE RIVER	SOURCENAME	LAKE SANTA FE
WAKULLA RIVER	SOURCENAME	WAKULLA SPRINGS
TELEAJEN	SOURCENAME	CONFLUENCE OF HEADWATERS CHEIțA AND TâMPA
MIDFORD BROOK	SOURCENAME	WELLOW BROOK, SOMERSET
MIDFORD BROOK	SOURCENAME	CAM BROOK, SOMERSET
BéCANCOUR RIVER	SOURCENAME	LAC BéCANCOUR
MACKENZIE RIVER	SOURCENAME	EXPEDITION RANGE
AFON CRAFNANT	SOURCENAME	LLYN CRAFNANT
RIVER GEIRIONYDD	SOURCENAME	LLYN GEIRIONYDD
HOLLAND BROOK	SOURCENAME	CUSHETUNK MOUNTAIN
SELWAY RIVER	SOURCENAME	SOUTHEAST OF STRIPE MOUNTAIN
SOPCHOPPY RIVER	SOURCENAME	EAST BRANCH SOPCHOPPY RIVER
PITHLACHASCOTEE RIVER	SOURCENAME	CREWS LAKE
NORMANBY RIVER	SOURCENAME	GREAT DIVIDING RANGE
NINEMILE CREEK	SOURCENAME	OTISCO LAKE
QUINEBAUG RIVER	SOURCENAME	HOLLAND POND
AMERICAN FORK RIVER	SOURCENAME	WASATCH MOUNTAINS
BLUE ROCK SPRINGS CREEK	SOURCENAME	SULFUR SPRINGS MOUNTAIN
MUNDESWARI RIVER	SOURCENAME	DAMODAR RIVER
KARA DARYA	SOURCENAME	CONFLUENCE OF TAR RIVER AND KARA-KULJA RIVER
GSCHNITZBACH	SOURCENAME	SOUTH-WEST OF BRENNER PASS
DAVAO RIVER	SOURCENAME	SALUG RIVER
DAVAO RIVER	SOURCENAME	APO–TALOMO
BARAKAR RIVER	SOURCENAME	PADMA, HAZARIBAGH
LEIDSE RIJN	SOURCENAME	KROMME RIJN
GOUWE	SOURCENAME	OUDE RIJN
RIPOLL	SOURCENAME	SERRA DE GRANERA
RAMGANGA	SOURCENAME	NAMIK GLACIER
VIGGARBACH	SOURCENAME	BLUE LAKE
SEEACHE	SOURCENAME	MONDSEE
TULOMA RIVER	SOURCENAME	NOTA RIVER
CASIMCEA RIVER	SOURCENAME	RăZBOIENI, TULCEA
RAGING RIVER	SOURCENAME	SOUTH SIDE OF RATTLESNAKE RIDGE
SILVER RIVER	SOURCENAME	SILVER SPRINGS, FLORIDA
AMERICAN RIVER	SOURCENAME	CASCADE RANGE
BIG WOOD RIVER	SOURCENAME	SAWTOOTH RANGE
KIPAWA RIVER	SOURCENAME	UPPER/LAC DUMOINE LOWER/LAKE KIPAWA
SELIZHAROVKA RIVER	SOURCENAME	LAKE SELIGER
YAAK RIVER	SOURCENAME	PURCELL MOUNTAINS
CROOKED RIVER	SOURCENAME	SOUTH FORK CROOKED RIVER
CHIWAWA RIVER	SOURCENAME	NORTH CASCADES
POISAR RIVER	SOURCENAME	SANJAY GANDHI NATIONAL PARK
COTTONWOOD RIVER	SOURCENAME	COTEAU DES PRAIRIES
BUTTE CREEK	SOURCENAME	CASCADE RANGE
GINNINDERRA CREEK	SOURCENAME	SPRINGRANGE, NEW SOUTH WALES
MOODNA CREEK	SOURCENAME	OTTER KILL
ALBA RIVER	SOURCENAME	CONFLUENCE OF HEADWATERS ANDRA AND ȚINTA
TALPE RIVER	SOURCENAME	VLăDEASA MOUNTAINS
AMARADIA RIVER	SOURCENAME	PARâNG MOUNTAINS
ARCUș RIVER	SOURCENAME	CONFLUENCE OF BRANCHES PâRâUL MARE AND PâRâUL UMBROS
LIMBășELU RIVER	SOURCENAME	BAIU MOUNTAINS
LIMBășELU RIVER	SOURCENAME	CONFLUENCE OF HEADWATERS LIMBăşELU MARE AND LIMBăşELU MIC
CEAUșOAIA RIVER	SOURCENAME	BAIU MOUNTAINS
CEAUșOAIA RIVER	SOURCENAME	MOUNT CEAUşOAIA
ARPAș RIVER	SOURCENAME	CONFLUENCE OF HEADWATERS ARPAșUL MARE AND PODRAGU
ELAN RIVER	SOURCENAME	FăLCIU HILLS
MOWICH RIVER	SOURCENAME	MOUNT RAINIER
GREENWATER RIVER	SOURCENAME	CASCADE RANGE
SOUFFEL	SOURCENAME	KUTTOLSHEIM
AVRIGEL RIVER	SOURCENAME	LAKE AVRIG
AVRIG RIVER	SOURCENAME	CONFLUENCE OF HEADWATERS AVRIGEL AND AURIșTEA
GILORT	SOURCENAME	PARâNGU MARE
STRâMBA RIVER	SOURCENAME	CONFLUENCE OF HEADWATERS IZVORUL NISTORULUI AND IZVORUL BăTRâNEI
ȘTEFăNIțA RIVER	SOURCENAME	MOUNT ŞTEFăNIţA
GHIMBAV RIVER	SOURCENAME	CONFLUENCE OF HEADWATERS CUMPăRATA MARE AND CUMPăRATA MICă
SECăRUIA RIVER	SOURCENAME	JUNCTION OF BRANCHES SECăRUIA MARE AND SECăRUIA MICă
VALEA CERBULUI RIVER	SOURCENAME	DEALUL TEBELEş
GERSA RIVER	SOURCENAME	CONFLUENCE OF HEADWATERS VALEA LUSCHII AND THE VALEA TăULUI
CRACăU RIVER	SOURCENAME	CONFLUENCE OF HEADWATERS: CRACăUL ALB AND CRACăUL NEGRU
FIRIZA RIVER	SOURCENAME	CONFLUENCE OF HEADWATERS RASTOșA AND VALEA ȘTURULUI
MATEIAșUL RIVER	SOURCENAME	CONFLUENCE OF HEADWATERS MATEIAșUL MARE AND MATEIAșUL MIC
TECșE RIVER	SOURCENAME	CONFLUENCE OF HEADWATERS NIREş AND ANAş
VALEA BOZII RIVER	SOURCENAME	PIATRA CRAIULUI MOUNTAINS
DăMUC RIVER	SOURCENAME	TARCăU MOUNTAINS
VALEA BRUSTURETULUI RIVER	SOURCENAME	PIATRA CRAIULUI MOUNTAINS
LUCăCILă RIVER	SOURCENAME	BUCEGI MOUNTAINS
VALEA CABANIERULUI RIVER	SOURCENAME	BUCEGI MOUNTAINS
VâLCELUL COCORA RIVER	SOURCENAME	BUCEGI MOUNTAINS
VALEA PIETROSULUI RIVER	SOURCENAME	BUCEGI MOUNTAINS
VALEA TRăSNETULUI RIVER	SOURCENAME	BUCEGI MOUNTAINS
COCORA RIVER	SOURCENAME	BUCEGI MOUNTAINS
LăPTICI RIVER	SOURCENAME	BUCEGI MOUNTAINS
ZăNOAGA RIVER	SOURCENAME	BUCEGI MOUNTAINS
MIRCEA RIVER	SOURCENAME	BUCEGI MOUNTAINS
VALEA ORLEI RIVER	SOURCENAME	BUCEGI MOUNTAINS
VALEA ȘUGăRILOR RIVER	SOURCENAME	BUCEGI MOUNTAINS
ORZEA RIVER	SOURCENAME	BUCEGI MOUNTAINS
OBOARELE RIVER	SOURCENAME	BUCEGI MOUNTAINS
VALEA LUI TăMâIE RIVER	SOURCENAME	BUCEGI MOUNTAINS
DICHIU RIVER	SOURCENAME	BUCEGI MOUNTAINS
DICHIU RIVER	SOURCENAME	BUCEGI MOUNTAINS
CăRPENIș RIVER	SOURCENAME	BUCEGI MOUNTAINS
COTEANU RIVER	SOURCENAME	BUCEGI MOUNTAINS
BRâNDUșA RIVER	SOURCENAME	BUCEGI MOUNTAINS
BLANA RIVER	SOURCENAME	BUCEGI MOUNTAINS
BOLBOCI RIVER	SOURCENAME	BUCEGI MOUNTAINS
VALEA SUCHENIțEI RIVER	SOURCENAME	BUCEGI MOUNTAINS
VALEA DOAMNELOR RIVER	SOURCENAME	BUCEGI MOUNTAINS
VALEA SPINăRII RIVER	SOURCENAME	BUCEGI MOUNTAINS
VALEA VăCăRIEI RIVER	SOURCENAME	BUCEGI MOUNTAINS
VALEA GâRBELOR RIVER	SOURCENAME	BUCEGI MOUNTAINS
LEșNIțA RIVER	SOURCENAME	BUCEGI MOUNTAINS
HOROABA RIVER	SOURCENAME	BUCEGI MOUNTAINS
TăTARU RIVER	SOURCENAME	BUCEGI MOUNTAINS
GâLMA RIVER	SOURCENAME	BUCEGI MOUNTAINS
GâLGOIU RIVER	SOURCENAME	BUCEGI MOUNTAINS
SCâNDURARI RIVER	SOURCENAME	BUCEGI MOUNTAINS
NUCET RIVER	SOURCENAME	BUCEGI MOUNTAINS
SCROPOASA RIVER	SOURCENAME	BUCEGI MOUNTAINS
DOFTANA RIVER	SOURCENAME	BAIU MOUNTAINS
DOFTANA RIVER	SOURCENAME	PREDELUș PASS
VARNA MARE RIVER	SOURCENAME	POSTăVARUL MASSIF
VAMA MARE RIVER	SOURCENAME	POSTăVARUL MASSIF
VARNA MICă RIVER	SOURCENAME	POSTăVARUL MASSIF
PLUNKETTS CREEK	SOURCENAME	LOYALSOCK STATE FOREST
DURBAV RIVER	SOURCENAME	POSTăVARUL MASSIF
GâRBăU RIVER	SOURCENAME	CONFLUENCE OF HEADWATERS GâRBăUL MARE AND GâRBăUL MIC
GHIMBășEL RIVER	SOURCENAME	CONFLUENCE OF HEADWATERS PâRâUL MARE AND PâRâUL MIC
CANALUL TIMIș	SOURCENAME	TIMIș RIVER
VALEA CETățII RIVER	SOURCENAME	CODRU-MOMA MOUNTAINS
TâRGULUI RIVER	SOURCENAME	CONFLUENCE OF HEADWATERS: CUCA AND BăTRâNA
TARCăU RIVER	SOURCENAME	MOUNT GRINDUșUL
VALEA DOICII RIVER	SOURCENAME	LEAOTA MOUNTAINS
CLAIA CU BRAZI RIVER	SOURCENAME	BUCEGI MOUNTAINS
PIETRICICA RIVER	SOURCENAME	BUCEGI MOUNTAINS
FUNDU VăII RIVER	SOURCENAME	BUCEGI MOUNTAINS
GâLMA RIVER	SOURCENAME	BUCEGI MOUNTAINS
GLăDăRIA RIVER	SOURCENAME	BUCEGI MOUNTAINS
PâRâUL URSULUI	SOURCENAME	BUCEGI MOUNTAINS
GLODU RIVER	SOURCENAME	BUCEGI MOUNTAINS
MUșCHIU RIVER	SOURCENAME	BUCEGI MOUNTAINS
RUșEțU RIVER	SOURCENAME	BUCEGI MOUNTAINS
VALEA LUI ȘTEFăNICă RIVER	SOURCENAME	BUCEGI MOUNTAINS
RăTEI RIVER	SOURCENAME	BUCEGI MOUNTAINS
IALOMICIOARA RIVER	SOURCENAME	BUCEGI MOUNTAINS
PUTNA RIVER	SOURCENAME	CONFLUENCE OF HEADWATERS PUTNA MICă AND PâRâUL ROșU
VALEA NEMțOAICELOR RIVER	SOURCENAME	IEZER-PăPUşA MOUNTAINS
RăCHITA RIVER	SOURCENAME	PIATRA CRAIULUI MOUNTAINS
BEREVOESCU RIVER	SOURCENAME	FăGăRAş MOUNTAINS
LUțELE MICI RIVER	SOURCENAME	FăGăRAş MOUNTAINS
LUțELE MARI RIVER	SOURCENAME	FăGăRAş MOUNTAINS
CăLțUNU RIVER	SOURCENAME	FăGăRAş MOUNTAINS
CăLțUNU RIVER	SOURCENAME	MOUNT CăLțUNU
VALEA LUI ARON RIVER	SOURCENAME	FăGăRAş MOUNTAINS
VALEA LUI ARON RIVER	SOURCENAME	MOUNT COMISU
VALEA LUI ARON RIVER	SOURCENAME	IEZER-PăPUşA MOUNTAINS
VALEA LUI ARON RIVER	SOURCENAME	MOUNT DRACSIN
VALEA LUI STANCIU RIVER	SOURCENAME	PIATRA CRAIULUI MOUNTAINS
VALEA TURCILOR RIVER	SOURCENAME	PIATRA CRAIULUI MOUNTAINS
VALEA DRAGOSLăVENILOR RIVER	SOURCENAME	PIATRA CRAIULUI MOUNTAINS
VALEA OțEțELEI RIVER	SOURCENAME	PIATRA CRAIULUI MOUNTAINS
VALEA PăIșULUI RIVER	SOURCENAME	PIATRA CRAIULUI MOUNTAINS
TăMAșUL RIVER	SOURCENAME	PIATRA CRAIULUI MOUNTAINS
PâRâUL LUI COMAN	SOURCENAME	CONFLUENCE OF HEADWATERS VALEA GăINII AND VALEA FIAşULUI
IZVORUL DORULUI RIVER	SOURCENAME	MOUNT COCORA
LOTRIOARA RIVER	SOURCENAME	CONFLUENCE OF HEADWATERS VALEA URSULUI AND STERPU
CRICOVUL SăRAT	SOURCENAME	POIANA HOțILOR HILL
VOUGA RIVER	SOURCENAME	CHAFARIZ DA LAPA
NăDRAG RIVER	SOURCENAME	CONFLUENCE OF HEADWATERS VALEA PADEșULUI AND VALEA CORNETULUI
BăLțATUL RIVER	SOURCENAME	IEZER-PăPUşA MOUNTAINS
COLțII LUI ANDREI MICI RIVER	SOURCENAME	IEZER-PăPUşA MOUNTAINS
COLțII LUI ANDREI MICI RIVER	SOURCENAME	MOUNT COLțII LUI ANDREI MICI
COLțII LUI ANDREI MARI RIVER	SOURCENAME	IEZER-PăPUşA MOUNTAINS
COLțII LUI ANDREI MARI RIVER	SOURCENAME	MOUNT COLțII LUI ANDREI MARI
COLțII LUI ANDREI RIVER	SOURCENAME	IEZER-PăPUşA MOUNTAINS
COLțII LUI ANDREI RIVER	SOURCENAME	CONFLUENCE OF HEADWATERS COLţII LUI ANDREI MARI AND COLţII LUI ANDREI MICI
VALEA ȘAULUI RIVER	SOURCENAME	PIATRA CRAIULUI MOUNTAINS
DEZNA RIVER	SOURCENAME	CODRU MOMA MOUNTAINS
BISTRIțA RIVER	SOURCENAME	CONFLUENCE OF HEADWATERS: NEGOIU AND GROAPELE
VALEA LUI BRAN RIVER	SOURCENAME	MăCIN MOUNTAINS
SEBEș RIVER	SOURCENAME	CONFLUENCE OF HEADWATERS VALEA LUI IONEL AND VALEA LUI FăTU
STREI	SOURCENAME	CONFLUENCE OF HEADWATERS PâRâUL CALD AND PâRâUL ROVINEI
SAN JUAN CREEK	SOURCENAME	HEAD OF SAN JUAN CANYON, AT THE CONFLUENCE OF MORRELL CANYON CREEK WITH BEAR CANYON CREEK, SANTA ANA MOUNTAINS
COMANA RIVER	SOURCENAME	CONFLUENCE OF HEADWATERS VALEA TIGăI AND DăBIș
RâOAIA RIVER	SOURCENAME	CONFLUENCE OF HEADWATERS RâOAIA MARE AND THE RâOAIA MICă
BREBU RIVER	SOURCENAME	SEMENIC MOUNTAINS
VALEA NIMăIEșTILOR RIVER	SOURCENAME	VLăDEASA MOUNTAINS
VALEA NIMăIEșTILOR RIVER	SOURCENAME	CONFLUENCE OF HEADWATERS VALEA MARE RIVER AND PLAIU RIVER.
BEIUșELE RIVER	SOURCENAME	VLăDEASA MOUNTAINS
BEIUșELE RIVER	SOURCENAME	MOUNT MERMEZ
SUHA RIVER	SOURCENAME	STâNIșOARA MOUNTAINS
CHECHIșEL RIVER	SOURCENAME	ŢIBLEş MOUNTAINS
LUGTON WATER	SOURCENAME	LOCH LIBO
VALEA STRâMBă RIVER	SOURCENAME	CODRU-MOMA MOUNTAINS
VALEA SEACă RIVER	SOURCENAME	CODRU-MOMA MOUNTAINS
SCăRIțA RIVER	SOURCENAME	CODRU-MOMA MOUNTAINS
BOROAIA RIVER	SOURCENAME	CODRU-MOMA MOUNTAINS
BâRLOGEL RIVER	SOURCENAME	CODRU-MOMA MOUNTAINS
CREțU RIVER	SOURCENAME	CODRU-MOMA MOUNTAINS
PâRâUL PINILOR	SOURCENAME	CODRU-MOMA MOUNTAINS
MEGHEș RIVER	SOURCENAME	CODRU-MOMA MOUNTAINS
VALEA RUGII RIVER	SOURCENAME	CODRU-MOMA MOUNTAINS
VLAD RIVER	SOURCENAME	CODRU-MOMA MOUNTAINS
VâLCEAUA RIVER	SOURCENAME	CODRU-MOMA MOUNTAINS
CHIOARA RIVER	SOURCENAME	CODRU-MOMA MOUNTAINS
LAZ RIVER	SOURCENAME	CODRU-MOMA MOUNTAINS
SăDUREL RIVER	SOURCENAME	CONFLUENCE OF HEADWATERS VALEA COMENZII AND IZVORUL NEGOVANULUI
BâRSA RIVER	SOURCENAME	PLAIUL FOII
LYRE RIVER	SOURCENAME	LAKE CRESCENT
RâNDIBOU RIVER	SOURCENAME	CONFLUENCE OF HEADWATERS PALTINU AND VALEA RăCHIţELE
SASUL RIVER	SOURCENAME	ŞUREANU MOUNTAINS
SASUL RIVER	SOURCENAME	CONFLUENCE OF HEADWATERS TITIANUL AND COMăRNICELUL
LUNCAVăț RIVER	SOURCENAME	CONFLUENCE OF HEADWATERS VALEA CURPENEI AND BALOTA
HINDON RIVER	SOURCENAME	SIWALIK HILLS
BANGALI RIVER	SOURCENAME	TEESTA RIVER
PIETROSU RIVER	SOURCENAME	RODNA MOUNTAINS
PORUMBACU RIVER	SOURCENAME	CONFLUENCE OF HEADWATERS ȘERBOTA AND RâUL SăRățII
CâRțIșOARA RIVER	SOURCENAME	CONFLUENCE OF HEADWATERS PâRâUL DOAMNEI AND BâLEA
VIșTEA RIVER	SOURCENAME	CONFLUENCE OF HEADWATERS VIșTEA MARE AND VIșTIșOARA
BREAZA RIVER	SOURCENAME	CONFLUENCE OF HEADWATERS BRESCIOARA AND POJORTA
BICAZ RIVER	SOURCENAME	HășMAș MOUNTAINS
SEBEș RIVER	SOURCENAME	CONFLUENCE OF HEADWATERS ȚIGANU AND BUZDUGANU
VALEA STUPULUI RIVER	SOURCENAME	CINDREL MOUNTAINS
SEBEș RIVER	SOURCENAME	CINDREL MOUNTAINS
TURCU RIVER	SOURCENAME	CONFLUENCE OF HEADWATERS MOIECIUL CALD AND MOIECIUL RECE
CISNăDIE	SOURCENAME	CINDREL MOUNTAINS, CURMăTURA MăGURII
BOUL RIVER	SOURCENAME	VADU SOREșTI, BUZăU
BâSCA CHIOJDULUI RIVER	SOURCENAME	MOUNT TăTăRUțU
NEAMț RIVER	SOURCENAME	CONFLUENCE OF HEADWATERS RâUL NEAMțULUI CEL MARE AND RâUL NEAMțULUI CEL MIC
RâUșOR	SOURCENAME	CONFLUENCE OF HEADWATERS ȘTEVIA AND VăLEREASCA
GALBENA RIVER	SOURCENAME	CONFLUENCE OF HEADWATERS LACURI AND POIENI.
IOVANUL RIVER	SOURCENAME	CONFLUENCE OF HEADWATERS IOVANUL MARE AND IOVANUL MIC
GREYBULL RIVER	SOURCENAME	ABSAROKA MOUNTAINS
PUTNA RIVER	SOURCENAME	CONFLUENCE OF HEADWATERS PUTNA ÎNTUNECOASă AND PUTNA NOROIOASă
ZăBALA RIVER	SOURCENAME	CONFLUENCE OF HEADWATERS ARIșOAIA AND ZăBăLUțA
GHELINțA RIVER	SOURCENAME	CONFLUENCE OF HEADWATERS GHELINțA MARE AND GHELINțA MICă
HELEșTEU RIVER	SOURCENAME	MOUNT ŢIUA GOLAşă
CHIUA RIVER	SOURCENAME	CONFLUENCE OF HEADWATERS CHIUA MARE AND CHIUA MICă
OITUZ RIVER	SOURCENAME	BREțCU MOUNTAINS
PâRâUL PINTII	SOURCENAME	STâNCILE DOISPREZECE APOSTOLI
DORNA RIVER	SOURCENAME	CăLIMANI MOUNTAINS
MOLAWIN RIVER	SOURCENAME	MOUNT MAKILING
PâRâUL MIC	SOURCENAME	POSTăVARUL MASSIF
PâRâUL MARE	SOURCENAME	BUCEGI MOUNTAINS
PâRâUL MARE	SOURCENAME	MOUNT FORBANU
VALEA CHEII RIVER	SOURCENAME	POSTăVARUL MASSIF
VALEA ȘOIMULUI RIVER	SOURCENAME	POSTăVARUL MASSIF
VALEA POIENII RIVER	SOURCENAME	POSTăVARUL MASSIF
VALEA POIENII RIVER	SOURCENAME	POIANA BRAşOV
RâUL TOCILELOR	SOURCENAME	CONFLUENCE OF HEADWATERS TOCILA MARE AND TOCILA MICă
MIZIEș RIVER	SOURCENAME	VLăDEASA MOUNTAINS
TOCILA MICă RIVER	SOURCENAME	POSTăVARUL MASSIF
TOCILA MARE RIVER	SOURCENAME	POSTăVARUL MASSIF
CRăCăNEL RIVER	SOURCENAME	POSTăVARUL MASSIF
TREI BRAZI RIVER	SOURCENAME	POSTăVARUL MASSIF
VALEA PLOșTILELOR RIVER	SOURCENAME	POSTăVARUL MASSIF
VALEA CU AFINE RIVER	SOURCENAME	POSTăVARUL MASSIF
VALEA MERELOR RIVER	SOURCENAME	POSTăVARUL MASSIF
VALEA GOLOMOS RIVER	SOURCENAME	POSTăVARUL MASSIF
LERINT RIVER	SOURCENAME	POSTăVARUL MASSIF
VALEA BARBULUI RIVER	SOURCENAME	POSTăVARUL MASSIF
VALEA BOARU RIVER	SOURCENAME	POSTăVARUL MASSIF
UDROAIA RIVER	SOURCENAME	POSTăVARUL MASSIF
VALEA NEAGRă RIVER	SOURCENAME	POSTăVARUL MASSIF
VANGA MARE RIVER	SOURCENAME	POSTăVARUL MASSIF
VANGA MICă RIVER	SOURCENAME	POSTăVARUL MASSIF
VALEA STICLăRIEI RIVER	SOURCENAME	POSTăVARUL MASSIF
VALEA LUNGă RIVER	SOURCENAME	POSTăVARUL MASSIF
VALEA CERBULUI RIVER	SOURCENAME	POSTăVARUL MASSIF
VALEA CU NOROI RIVER	SOURCENAME	POSTăVARUL MASSIF
VALEA ADâNCă RIVER	SOURCENAME	POSTăVARUL MASSIF
GROAPA DE AUR RIVER	SOURCENAME	POSTăVARUL MASSIF
PâRâUL CU BRAZI	SOURCENAME	POSTăVARUL MASSIF
PâRâUL DE AUR	SOURCENAME	POSTăVARUL MASSIF
SEBEș RIVER	SOURCENAME	CONFLUENCE OF HEADWATERS VALEA CRAIULUI AND CUNTU
SOHODOL RIVER	SOURCENAME	CONFLUENCE OF HEADWATERS PâRGAVU AND VIEZURATA
PEșTIOSUL RIVER	SOURCENAME	TARCăU MOUNTAINS
FRUMOSU RIVER	SOURCENAME	MOUNT SCORUşEţ
CULIșER CANAL	SOURCENAME	CRIşUL NEGRU RIVER
PLAPCEA RIVER	SOURCENAME	CONFLUENCE OF HEADWATERS PLAPCEA MARE AND PLAPCEA MICă
HOMOROD RIVER	SOURCENAME	CONFLUENCE OF HEADWATERS HOMORODUL MARE AND HOMORODUL MIC
POLOCIN RIVER	SOURCENAME	CENTRAL MOLDAVIAN PLATEAU
IZVORUL ALB RIVER	SOURCENAME	CONFLUENCE OF HEADWATERS CRACUL MARE AND CRACUL MIC
TăRHăUș RIVER	SOURCENAME	TARCăU MOUNTAINS
HOMORODUL VECHI RIVER	SOURCENAME	HOMOROD RIVER
LOOSE STREAM	SOURCENAME	LANGLEY, KENT
RăSTOLIțA RIVER	SOURCENAME	CONFLUENCE OF HEADWATERS SECU AND TIHUL
RIVER LEN	SOURCENAME	BLUEBELL WOODS NEAR PLATT'S HEATH IN KENT
VULCANA RIVER	SOURCENAME	DEALUL PIETRARILOR
RIVER DOUGLAS, ISLE OF MAN	SOURCENAME	CONFLUENCE OF RIVER GLASS & RIVER DHOO
RACIU RIVER	SOURCENAME	LEAOTA MOUNTAINS
LEAOTA RIVER	SOURCENAME	LEAOTA MOUNTAINS
POZEN RIVER	SOURCENAME	OBCINA MARE MOUNTAINS
RIVER HADDEO	SOURCENAME	WIMBLEBALL LAKE
SăRățEL RIVER	SOURCENAME	CONFLUENCE OF HEADWATERS FURU AND MONTEORU
JALANGI RIVER	SOURCENAME	PADMA RIVER
CHINEJA RIVER	SOURCENAME	BEREșTI
BANGSHI RIVER	SOURCENAME	BRAHMAPUTRA
LOUHAJANG RIVER	SOURCENAME	JAMUNA RIVER
PRANHITA RIVER	SOURCENAME	CONFLUENCE OF WARDHA AND WAINGANGA
ARCHBACH	SOURCENAME	PLANSEE
SKJERN RIVER	SOURCENAME	TINNET KRAT
BISTRA RIVER	SOURCENAME	CONFLUENCE OF HEADWATERS COFU, VALEA DIN MIJLOC AND STEGA
GăLăOAIA RIVER	SOURCENAME	CONFLUENCE OF HEADWATERS GăLăOAIA MARE, AND GăLăOAIA MICă
GUDEA RIVER	SOURCENAME	CONFLUENCE OF HEADWATERS GUDEA MARE, AND GUDEA MICă
CIBAN RIVER	SOURCENAME	CONFLUENCE OF HEADWATERS MARGINEA AND RUșINOSU
RIVER SHEPPEY	SOURCENAME	ST ALDHELM'S WELL
RUșINOSU RIVER	SOURCENAME	CINDREL MOUNTAINS
RUșINOSU RIVER	SOURCENAME	MOUNT FOLTEA
BOIA MARE	SOURCENAME	CONFLUENCE OF HEADWATERS GROHOTIșUL AND VALEA PIETRICELELOR
BOIA MICă RIVER	SOURCENAME	CONFLUENCE OF HEADWATERS SURU AND BUDISLAVU
BăRBULEțU RIVER	SOURCENAME	LEAOTA MOUNTAINS
BARTON RIVER, VERMONT	SOURCENAME	CRYSTAL LAKE
BâNGăLEASA RIVER	SOURCENAME	CONFLUENCE OF HEADWATERS BUCşA AND GROHOTIşUL
BăLăNEASA RIVER	SOURCENAME	IVăNEțU RIDGE
BOTA MARE RIVER	SOURCENAME	BUZăU MOUNTAINS
BâSCULIțA RIVER	SOURCENAME	CONFLUENCE OF HEADWATERS IZVORUL GROPII AND TăMășOIU
OSO CREEK	SOURCENAME	OSO CREEK CANYON, SAN JOAQUIN HILLS
LAPOș RIVER	SOURCENAME	HăşMAş MOUNTAINS
KOUKDJUAK RIVER	SOURCENAME	NETTILLING LAKE
ȘAPTE IZVOARE RIVER	SOURCENAME	MOUNT CRUCEA FETEI
BREBU RIVER	SOURCENAME	MOUNT PENTELEU
PăLTINIș RIVER	SOURCENAME	CONFLUENCE OF HEADWATERS PăLTINIșUL MARE AND PăLTINIșUL MIC
CăIAN RIVER	SOURCENAME	CONFLUENCE OF HEADWATERS: DUBA, RăCAş AND CARPEN
LUNCANI RIVER	SOURCENAME	CONFLUENCE OF HEADWATERS VALEA MORII AND PâRâUL VâNăTORULUI
CREMENEA RIVER	SOURCENAME	CONFLUENCE OF HEADWATERS CREMENEA MARE AND CREMENUţA
HOROIATA RIVER	SOURCENAME	TUTOVA PLATEAU
NIRAJ RIVER	SOURCENAME	CONFLUENCE OF HEADWATERS NIRAJUL MARE AND NIRAJUL MIC.
RIVER DYSYNNI	SOURCENAME	TAL-Y-LLYN LAKE
AFON TWYMYN	SOURCENAME	DYLIFE
SIRIU RIVER	SOURCENAME	CONFLUENCE OF HEADWATERS SIRIU MARE AND SIRIU MIC
VăRBILăU RIVER	SOURCENAME	CONFLUENCE OF HEADWATERS VăRSăTURILE AND CLăBUCET
SLăVEI RIVER	SOURCENAME	LAKE TăU SLăVEIULUI
TURCEL RIVER	SOURCENAME	LAKE TăU TURCEL
ZăNOAGA RIVER	SOURCENAME	LAKE TăU ZăNOAGA MARE
BâRLEA RIVER	SOURCENAME	RETEZAT MOUNTAINS
BâRLEA RIVER	SOURCENAME	LAKE TăU NEGRU
IEZER RIVER	SOURCENAME	VOINEșTI, VASLUI
ȘURGANI RIVER	SOURCENAME	DUMBRAVA FOREST
SIBIșEL RIVER	SOURCENAME	CONFLUENCE OF HEADWATERS STâNIșOARA AND PIETRELE
CLANțU RIVER	SOURCENAME	RETEZAT MOUNTAINS
HâRBOCA RIVER	SOURCENAME	MăRGăRITEşTI, BUZăU
IAZU MORILOR RIVER	SOURCENAME	PRAHOVA RIVER
VERMILION RIVER	SOURCENAME	VERMILION PASS
YEADING BROOK	SOURCENAME	HEADSTONE MANOR
IORDANA RIVER	SOURCENAME	CONFLUENCE OF HEADWATERS ASCâTAR AND CâMPUL ASCUNS
PâRâUL MUNTELUI	SOURCENAME	TRASCăU MOUNTAINS
PâRâUL MUNTELUI	SOURCENAME	MOUNT PLEşA
LAURA RIVER	SOURCENAME	GREAT DIVIDING RANGE
CAGAYAN RIVER	SOURCENAME	KITANGLAD MOUNTAIN RANGE
QUEICH	SOURCENAME	PALATINATE FOREST
MAJACEITE	SOURCENAME	BENAMAHOMA
MANADA CREEK	SOURCENAME	FORT INDIANTOWN GAP
PâRâUL LUI TITA	SOURCENAME	HăşMAş MOUNTAINS
PâRâUL LUI TITA	SOURCENAME	MOUNT SURDUC
LITTLE RIVER	SOURCENAME	SHUSWAP LAKE
BLACK RIVER	SOURCENAME	NEAR ALPINE
EAST VERDE RIVER	SOURCENAME	MOGOLLON RIM
CLYDE RIVER	SOURCENAME	SPECTACLE POND
CLYDE RIVER	SOURCENAME	ISLAND POND
MAPUSA RIVER	SOURCENAME	DUMACEM, AMTHANE
LAGUNA CANYON	SOURCENAME	SAN JOAQUIN HILLS
DORé RIVER	SOURCENAME	CARIBOO MOUNTAINS
NAHATLATCH RIVER	SOURCENAME	LILLOOET RANGES
SETON RIVER	SOURCENAME	ANDERSON LAKE
CAYOOSH CREEK	SOURCENAME	CAYOOSH RANGE
BICOL RIVER	SOURCENAME	LAKE BATO
ROGUE RIVER	SOURCENAME	SADDLEBACK MOUNTAIN, OREGON
GLADE CREEK	SOURCENAME	FLAT TOP MOUNTAIN
TRABUCO CREEK	SOURCENAME	SANTA ANA MOUNTAINS
WAIPAOA RIVER	SOURCENAME	RAUKUMARA RANGE
TRED AVON RIVER	SOURCENAME	SETH DEMONSTRATION FOREST
HOBART RIVULET	SOURCENAME	MOUNT WELLINGTON
SAN DIEGO CREEK	SOURCENAME	SANTA ANA MOUNTAINS
WATER POLITICS IN THE JORDAN RIVER BASIN	SOURCENAME	HASBANI
ZARQA RIVER	SOURCENAME	'AIN GHAZAL
RIVER BATHERM	SOURCENAME	SPERRY BARTON
PRATT RIVER	SOURCENAME	UPPER MELAKWA LAKE
TAYLOR RIVER	SOURCENAME	BEAR LAKE
LITTLE CHILLIWACK RIVER	SOURCENAME	RIDGE BETWEEN IT AND SILESIA CREEK
SWELTZER RIVER	SOURCENAME	CULTUS LAKE
DALSLAND CANAL	SOURCENAME	VäNERN
CARIBOO RIVER	SOURCENAME	CARIBOO MOUNTAINS
PARADISE RIVER	SOURCENAME	PARADISE GLACIER
WA RIVER	SOURCENAME	DOI PHI PAN NAM
BHARGAVI RIVER	SOURCENAME	YAMUNA
EMERALD RIVER	SOURCENAME	EMERALD LAKE
LEMPA RIVER	SOURCENAME	SIERRA MADRE
KOLVITSA RIVER	SOURCENAME	LAKE KOLVITSKOYE
COURSE OF THE ROGUE RIVER	SOURCENAME	BOUNDARY SPRINGS IN CRATER LAKE NATIONAL PARK
COMET RIVER	SOURCENAME	EXPEDITION RANGE
ÓRBIGO	SOURCENAME	UNION OF THE RIVERS LUNA AND OMAñA
ADAMS RIVER	SOURCENAME	MONASHEES
ROBSON RIVER	SOURCENAME	ROBSON LAKE
BELL CANYON	SOURCENAME	BELL CANYON, SANTA ANA MOUNTAINS
SEYMOUR RIVER	SOURCENAME	MONASHEE MOUNTAINS
SULLIVANS CREEK	SOURCENAME	RUNOFF FROM MOUNT MAJURA, MOUNT AINSLIE, O'CONNOR RIDGE AND BLACK MOUNTAIN
LAZARETTO CREEK	SOURCENAME	SAVANNAH RIVER
RIVER BRIT	SOURCENAME	BEAMINSTER
SAN MARTíN RIVER	SOURCENAME	SIERRA DE QUILA
SAN MARTíN RIVER	SOURCENAME	MESA DE RAMOS
TURAMA RIVER	SOURCENAME	MOUNT BOSAVI
LATAH CREEK	SOURCENAME	CHARLES BUTTE
CALAWAH RIVER	SOURCENAME	OLYMPIC MOUNTAINS
NORTH FORK CLEARWATER RIVER	SOURCENAME	BITTERROOT MOUNTAINS
NEW CUT, BRISTOL	SOURCENAME	RIVER AVON
KANAKA CREEK	SOURCENAME	COAST MOUNTAINS
NOORD	SOURCENAME	BENEDEN MERWEDE
KURSHAB RIVER	SOURCENAME	KEGART RIVER
NORTH FORK FLATHEAD RIVER	SOURCENAME	CLARK RANGE
MIDDLE FORK FLATHEAD RIVER	SOURCENAME	BOB MARSHALL WILDERNESS
KALI RIVER	SOURCENAME	DOON VALLEY
SVRLJIšKI TIMOK	SOURCENAME	ŠESTI GABAR
BELI TIMOK	SOURCENAME	KNJAžEVAC
KOLLAA RIVER	SOURCENAME	LAKE KOLLASJäRVI
SAN MATEO CREEK	SOURCENAME	CANYON ON THE WEST FACE OF SAN MATEO PEAK
RIVER AVILL	SOURCENAME	DUNKERY BEACON
TAMBRE	SOURCENAME	MONTES DE BOCELO
OCA	SOURCENAME	MONTES DE OCA
HALDI RIVER	SOURCENAME	KANSAI AND KELEGHAI
SLOCUMS RIVER	SOURCENAME	PASKAMANSET RIVER
OUDE MAAS	SOURCENAME	BENEDEN MERWEDE
NIEUWE MAAS	SOURCENAME	LEK RIVER
NIEUWE MAAS	SOURCENAME	NOORD RIVER
BAZTAN	SOURCENAME	IZPEGI PASS
BAZTAN	SOURCENAME	IZTAUZ
PLEASANT RUN	SOURCENAME	CUSHETUNK MOUNTAIN
RAILROAD CANYON	SOURCENAME	6
NORTHEAST BRANCH ANACOSTIA RIVER	SOURCENAME	PAINT BRANCH
RATUA KHOLA	SOURCENAME	CHURE PAHAD
CHAMBERS CREEK	SOURCENAME	LAKE STEILACOOM
DUCHESNE RIVER	SOURCENAME	UINTA MOUNTAINS
BAEZAEKO RIVER	SOURCENAME	FRASER PLATEAU
AT-BASHI RIVER	SOURCENAME	CONFLUENCE OF ULAN RIVER AND JANY-JER RIVER
KOMANI RIVER	SOURCENAME	STORMBERG DISTRICT
KLAAS SMITS RIVER	SOURCENAME	STORMBERG DISTRICT
WIT-KEI RIVER	SOURCENAME	STORMBERG DISTRICT
BLACK KEI RIVER	SOURCENAME	STORMBERG DISTRICT
SERGA RIVER	SOURCENAME	LAKE SERGOZERO
RUGGLES RIVER	SOURCENAME	LAKE HAZEN
WATER RESOURCES MANAGEMENT IN EL SALVADOR	SOURCENAME	SIERRA MADRE
LITTLE RIVER	SOURCENAME	CONFLUENCE OF ATTAPULGUS CREEK AND WILLACOOCHEE CREEK
CHAVANGA RIVER	SOURCENAME	LAKE NIZHNEE ONDOMOZERO
BOWERY CREEK	SOURCENAME	WINDHAM HIGH PEAK
BONYGUTT BROOK	SOURCENAME	PLAINFIELD, NEW JERSEY
BLUE BROOK	SOURCENAME	SUMMIT, NEW JERSEY
COCA RIVER	SOURCENAME	CONFLUENCE OF HEADWATERS COCA PLINă AND COCA SEACă
GIURGIU RIVER	SOURCENAME	MOUNT GIURGIU
ROCK CREEK	SOURCENAME	ROCK CREEK LAKE
WEST END BROOK	SOURCENAME	TADLEY
VALEA LUNGă RIVER	SOURCENAME	PIATRA MARE MASSIF
RISSEC	SOURCENAME	ELS ÀNGELS
NATCHAUG RIVER	SOURCENAME	CONFLUENCE OF STILL RIVER AND BIGELOW BROOK. NEARBY CHARLIE BROWN CAMPGROUND
PLUM RUN	SOURCENAME	FIELD OF PICKETT'S CHARGE
NIANTIC RIVER	SOURCENAME	BANNING COVE
BIG SANDY CREEK	SOURCENAME	CHESTNUT RIDGE, FAYETTE COUNTY, PENNSYLVANIA
PRUT	SOURCENAME	CARPATHIAN MOUNTAINS
CONGOST	SOURCENAME	WATERS OF THE WESTERN CLIFFS OF THE PLAIN OF VIC
SNAKE RIVER	SOURCENAME	WINNECUNNET POND
ROCK CREEK	SOURCENAME	ROCK CREEK ROADLESS AREA
KöKöMEREN RIVER	SOURCENAME	CONFLUENCE OF SUUSAMYR RIVER AND KARAKOL  RIVER
KOGALU RIVER	SOURCENAME	AYR LAKE
GADANANATHI RIVER	SOURCENAME	AGASTHYAMALA BIOSPHERE RESERVE,POTHIGAI HILLS
RAMANATHI RIVER	SOURCENAME	AGASTHYAMALA BIOSPHERE RESERVE,POTHIGAI HILLS
AARHUS	SOURCENAME	ASTRUP MOSE
WILDCAT CREEK	SOURCENAME	SOUTH OF VAUGHN
SAN ANDREAS CREEK	SOURCENAME	EAST SLOPE OF SWEENEY RIDGE
BOARDMAN CREEK	SOURCENAME	SOLDIER MOUNTAINS
DEADWOOD CREEK	SOURCENAME	SOLDIER MOUNTAINS
ARNOLD RIVER	SOURCENAME	NORTHEAST OF THE BULLWADDY CONSERVATION RESERVE
KEISKAMMA RIVER	SOURCENAME	NEAR KEISKAMMAHOEK
KEURBOOMS RIVER	SOURCENAME	SPITSKOP
MBHASHE RIVER	SOURCENAME	DRAKENSBERG
NARMADA CANAL	SOURCENAME	SARDAR SAROVAR DAM
JAYACO RIVER	SOURCENAME	CORDILLERA CENTRAL, DOMINICAN REPUBLIC
ORANGE CREEK	SOURCENAME	ORANGE LAKE
GIBRALTAR CREEK	SOURCENAME	BRINDABELLA RANGES
TIDBINBILLA RIVER	SOURCENAME	BRINDABELLA RANGES
EARL'S SLUICE	SOURCENAME	RUSKIN PARK
CIURBA MARE RIVER	SOURCENAME	CEAPA HILL
CIURBA MICă RIVER	SOURCENAME	VIZUINA HILL
PâRâUL MOCANULUI	SOURCENAME	CEAPA HILL
DăLMACIU RIVER	SOURCENAME	ARINIş HILL
MIRIOARA RIVER	SOURCENAME	OUşOR HILL
VALEA ÎNGUSTă RIVER	SOURCENAME	STRăOANE, VRANCEA
VOLăDANU RIVER	SOURCENAME	STRăOANE, VRANCEA
BIGELOW BROOK	SOURCENAME	MASHAPAUG LAKE
MORRELL CANYON CREEK	SOURCENAME	NORTHEASTERN SLOPE OF SAN MATEO PEAK, ELSINORE MOUNTAINS
LOS ALAMOS CANYON CREEK	SOURCENAME	SOUTHEASTERN SLOPE OF ELSINORE MOUNTAINS
TENAJA CANYON CREEK	SOURCENAME	AT THE HEAD OF TENAJA CANYON, AT THE CONFLUENCE OF ARROYOS FROM EL POTRERO DEL TENAJA, REDONDA MESA AND SQUAW MOUNTAIN HIGHLANDS.
DEVIL CANYON CREEK	SOURCENAME	A FLAT IN THE SANTA MARGARITA MOUNTAINS
CRISTIANITOS CREEK	SOURCENAME	AT THE HEAD OF CRISTIANITOS CANYON, SANTA ANA MOUNTAINS, IN ORANGE COUNTY COUNTY
DOGARI RIVER	SOURCENAME	RACOVIţENI, BUZăU
ȘCHIOPENI RIVER	SOURCENAME	MăRGăRITEşTI, BUZăU
ȘICOI RIVER	SOURCENAME	FLOREşTI, BUZăU
MORKILL RIVER	SOURCENAME	BIG SHALE HILL
RIVER ISBOURNE	SOURCENAME	CLEEVE HILL
SYCAMORE CREEK	SOURCENAME	PINE RIDGE, ABOUT 2 MILES SW OF SIERRA CEDARS, CALIFORNIA, NEAR SHAVER LAKE
PO	SOURCENAME	MONTE VISO
CHILAKO RIVER	SOURCENAME	TATUK LAKE
STELLAKO RIVER	SOURCENAME	FRANçOIS LAKE
DEVIL CANYON	SOURCENAME	ON SOUTH SLOPE OF PAIVIA PEAK, SAN BERNARDINO MOUNTAINS
MCKALE RIVER	SOURCENAME	PARK RANGES
BARRIèRE RIVER	SOURCENAME	SHUSWAP HIGHLAND
WARM SPRINGS CREEK	SOURCENAME	FORMERLY IN DIAMOND VALLEY, NOW IN DOMENIGONI VALLEY, WEST OF DIAMOND VALLEY LAKE
NAZKO RIVER	SOURCENAME	FRASER PLATEAU
RAFT RIVER	SOURCENAME	COLUMBIA MOUNTAINS
CANANDAIGUA OUTLET	SOURCENAME	CANANDAIGUA LAKE
CLYDE RIVER	SOURCENAME	CONFLUENCE OF THE CANANDAIGUA OUTLET, GANARGUA CREEK AND ERIE CANAL AT LOCK #27
GREAT DARLING ANABRANCH	SOURCENAME	DARLING RIVER
BOSTONNAIS RIVER	SOURCENAME	LAKE KISKISSINK
RIVER BRIDE, DORSET	SOURCENAME	LITTLEBREDY
KANHAN RIVER	SOURCENAME	SATPURA RANGE
MASSA	SOURCENAME	ALETSCH GLACIER
DOBROTFOR RIVER	SOURCENAME	STăNIșEșTI
KABACAN RIVER	SOURCENAME	MOUNT APO
SALUG RIVER	SOURCENAME	SAN FERNANDO, BUKIDNON
BLACK DUB	SOURCENAME	LANGRIGG
ESRUM Å	SOURCENAME	LAKE ESRUM
PRAVARA RIVER	SOURCENAME	WESTERN GHATS
ROSS CREEK	SOURCENAME	ROSS RIVER
KADVA RIVER	SOURCENAME	WESTERN GHATS
USSERøD Å	SOURCENAME	SJæLSø
LIKHU KHOLA	SOURCENAME	GLACIER ZURMOCHE, SUN KOSI, THAMAKOSHI AND TAMUR, SAPTAKOSHI
RIVER TALE	SOURCENAME	BROADHEMBURY
OGLE CREEK	SOURCENAME	CASCADE RANGE
ŠUICA	SOURCENAME	STRžANJ
COYOTE WASH	SOURCENAME	EASTERN SLOPE OF JACUMBA MOUNTAINS
RAHMAT KHALI CANAL	SOURCENAME	MEGHNA RIVER
WILLOUGHBY RIVER	SOURCENAME	LAKE WILLOUGHBY
