MISSOURI RIVER	SOURCECONFLUENCEREGION	MONTANA
RHINE	SOURCECONFLUENCEREGION	GRAUBüNDEN
DELAWARE RIVER	SOURCECONFLUENCEREGION	DELAWARE COUNTY, NEW YORK
OB RIVER	SOURCECONFLUENCEREGION	ALTAI KRAI
PLATTE RIVER	SOURCECONFLUENCEREGION	LINCOLN COUNTY, NEBRASKA
PLATTE RIVER	SOURCECONFLUENCEREGION	NEBRASKA
SOUTH SASKATCHEWAN RIVER	SOURCECONFLUENCEREGION	ALBERTA
SCHUYLKILL RIVER	SOURCECONFLUENCEREGION	SCHUYLKILL COUNTY, PENNSYLVANIA
SUN RIVER	SOURCECONFLUENCEREGION	LEWIS AND CLARK COUNTY, MONTANA
LITTLE TENNESSEE RIVER	SOURCECONFLUENCEREGION	GEORGIA
FRENCH BROAD RIVER	SOURCECONFLUENCEREGION	NORTH CAROLINA
BRANDYWINE CREEK	SOURCECONFLUENCEREGION	CHESTER COUNTY, PENNSYLVANIA
WHITE CLAY CREEK	SOURCECONFLUENCEREGION	CHESTER COUNTY, PENNSYLVANIA
NEVERSINK RIVER	SOURCECONFLUENCEREGION	SULLIVAN COUNTY, NEW YORK
SANTA ANA RIVER	SOURCECONFLUENCEREGION	SAN BERNARDINO COUNTY, CALIFORNIA
HOLSTON RIVER	SOURCECONFLUENCEREGION	TENNESSEE
WALKER RIVER	SOURCECONFLUENCEREGION	LYON COUNTY, NEVADA
LITTLE PIGEON RIVER	SOURCECONFLUENCEREGION	TENNESSEE
NOLICHUCKY RIVER	SOURCECONFLUENCEREGION	NORTH CAROLINA
PIGEON RIVER	SOURCECONFLUENCEREGION	NORTH CAROLINA
FARMINGTON RIVER	SOURCECONFLUENCEREGION	LITCHFIELD COUNTY, CONNECTICUT
BAYFIELD RIVER	SOURCECONFLUENCEREGION	PERTH COUNTY, ONTARIO
SHADE RIVER	SOURCECONFLUENCEREGION	MEIGS COUNTY, OHIO
RíO NEGRO	SOURCECONFLUENCEREGION	RíO NEGRO PROVINCE
SIL	SOURCECONFLUENCEREGION	GALICIA
MINHO	SOURCECONFLUENCEREGION	GALICIA
DUMARESQ RIVER	SOURCECONFLUENCEREGION	QUEENSLAND
LIDDEL WATER	SOURCECONFLUENCEREGION	CUMBRIA
SAUSAL CREEK	SOURCECONFLUENCEREGION	OAKLAND, CALIFORNIA
SALMON RIVER	SOURCECONFLUENCEREGION	NEW LONDON COUNTY
SALMON RIVER	SOURCECONFLUENCEREGION	CONNECTICUT
SAN GREGORIO CREEK	SOURCECONFLUENCEREGION	SAN MATEO COUNTY, CALIFORNIA
BYBROOK RIVER	SOURCECONFLUENCEREGION	WILTSHIRE
RIVER WEY	SOURCECONFLUENCEREGION	SURREY
WISCOY CREEK	SOURCECONFLUENCEREGION	WYOMING COUNTY, NEW YORK
WYNA	SOURCECONFLUENCEREGION	LUCERNE
SISTON BROOK	SOURCECONFLUENCEREGION	SOUTH GLOUCESTERSHIRE
KHARAA RIVER	SOURCECONFLUENCEREGION	TöV PROVINCE
SORRAIA RIVER	SOURCECONFLUENCEREGION	SANTARéM DISTRICT
COW CREEK	SOURCECONFLUENCEREGION	DOUGLAS COUNTY, OREGON
SOUTH FORK FEATHER RIVER	SOURCECONFLUENCEREGION	PLUMAS COUNTY, CALIFORNIA
ORESTIMBA CREEK	SOURCECONFLUENCEREGION	STANISLAUS COUNTY, CALIFORNIA
BITTERWATER CREEK	SOURCECONFLUENCEREGION	SAN LUIS OBISPO COUNTY
CHADAKOIN RIVER	SOURCECONFLUENCEREGION	NEW YORK
BIG HARTS CREEK	SOURCECONFLUENCEREGION	LOGAN COUNTY, WEST VIRGINIA
KIAH CREEK	SOURCECONFLUENCEREGION	LINCOLN COUNTY, WEST VIRGINIA
