Euphrates	sourceConfluenceMountain	Keban (District), Elazığ
Missouri River	sourceConfluenceMountain	Three Forks, Gallatin County, Montana
Ohio River	sourceConfluenceMountain	Pittsburgh
Rhine	sourceConfluenceMountain	Tamins
Monongahela River	sourceConfluenceMountain	Fairmont, West Virginia
Saskatchewan River	sourceConfluenceMountain	Prince Albert, Saskatchewan
Platte River	sourceConfluenceMountain	North Platte, Nebraska
River Dart	sourceConfluenceMountain	Dartmeet
South Saskatchewan River	sourceConfluenceMountain	Taber, Alberta (municipal district)
Big Sandy River (Ohio River)	sourceConfluenceMountain	Louisa, Kentucky
Little Colorado River	sourceConfluenceMountain	Greer, Arizona
Schuylkill River	sourceConfluenceMountain	Schuylkill Haven, Pennsylvania
Tuolumne River	sourceConfluenceMountain	Yosemite National Park
New River (Kanawha River)	sourceConfluenceMountain	Ashe County, North Carolina
Selenge River	sourceConfluenceMountain	Khövsgöl Province
Aroostook River	sourceConfluenceMountain	Penobscot County, Maine
Saint John River (Bay of Fundy)	sourceConfluenceMountain	Aroostook County, Maine
Sun River	sourceConfluenceMountain	Gibson Reservoir
Kanawha River	sourceConfluenceMountain	Gauley Bridge, West Virginia
Moose River (Ontario)	sourceConfluenceMountain	Unorganized North Cochrane District
Juniata River	sourceConfluenceMountain	Alexandria, Pennsylvania
White Clay Creek	sourceConfluenceMountain	London Britain Township, Chester County, Pennsylvania
Brandywine Creek (Christina River)	sourceConfluenceMountain	East Bradford Township, Chester County, Pennsylvania
Brandywine Creek (Christina River)	sourceConfluenceMountain	Pocopson Township, Chester County, Pennsylvania
Santa Ana River	sourceConfluenceMountain	Santa Ana Canyon
Carson River	sourceConfluenceMountain	Minden, Nevada
Clark Fork (river)	sourceConfluenceMountain	Deer Lodge County, Montana
Paw Paw River	sourceConfluenceMountain	Paw Paw, Michigan
Walker River	sourceConfluenceMountain	Yerington, Nevada
Pit River	sourceConfluenceMountain	Alturas, California
Feather River	sourceConfluenceMountain	Oroville Dam
Spanish River (Ontario)	sourceConfluenceMountain	Unorganized North Sudbury District
Nolichucky River	sourceConfluenceMountain	Yancey County, North Carolina
Cheat River	sourceConfluenceMountain	Parsons, West Virginia
Murg	sourceConfluenceMountain	Baiersbronn
Murg	sourceConfluenceMountain	Freudenstadt (district)
River Foyle	sourceConfluenceMountain	Lifford
San Gabriel River (California)	sourceConfluenceMountain	San Gabriel Mountains
Bayfield River	sourceConfluenceMountain	West Perth, Ontario
Bayfield River	sourceConfluenceMountain	West Perth, Ontario
Koksoak River	sourceConfluenceMountain	Kuujjuaq
Navarro River	sourceConfluenceMountain	Philo, California
Greenbrier River	sourceConfluenceMountain	Durbin, West Virginia
Coyote Creek (Santa Clara County)	sourceConfluenceMountain	Henry W. Coe State Park
Gauley River	sourceConfluenceMountain	Webster County, West Virginia
South Fork New River	sourceConfluenceMountain	Boone, North Carolina
Elk River (West Virginia)	sourceConfluenceMountain	Slaty Fork, West Virginia
Hughes River (West Virginia)	sourceConfluenceMountain	Cairo, West Virginia
Shade River	sourceConfluenceMountain	Chester Township, Meigs County, Ohio
Blue Earth River	sourceConfluenceMountain	Elmore Township, Faribault County, Minnesota
Black Fork (Cheat River)	sourceConfluenceMountain	Hendricks, West Virginia
Williams River (West Virginia)	sourceConfluenceMountain	Pocahontas County, West Virginia
Río Negro (Argentina)	sourceConfluenceMountain	Neuquén, Argentina
Sil (river)	sourceConfluenceMountain	Ourense
Cranberry River (West Virginia)	sourceConfluenceMountain	Pocahontas County, West Virginia
Twelvepole Creek	sourceConfluenceMountain	Wayne, West Virginia
River Neb	sourceConfluenceMountain	Glen Helen, Isle of Man
Minho River	sourceConfluenceMountain	Ourense
Garcia River	sourceConfluenceMountain	Boonville, California
Gualala River	sourceConfluenceMountain	Gualala, California
Seneca Creek (North Fork South Branch Potomac River)	sourceConfluenceMountain	Pendleton County, West Virginia
River Bela	sourceConfluenceMountain	Peasey Beck
River Bela	sourceConfluenceMountain	Stainton Beck
Liddel Water	sourceConfluenceMountain	Carwinley
Glady Fork	sourceConfluenceMountain	Glady, West Virginia
Middle Fork River	sourceConfluenceMountain	Adolph, West Virginia
Middle Fork River	sourceConfluenceMountain	Randolph County, West Virginia
Wheeling Creek (West Virginia)	sourceConfluenceMountain	Marshall County, West Virginia
Mill Creek (western West Virginia)	sourceConfluenceMountain	Ripley, West Virginia
Sandy Creek (West Virginia)	sourceConfluenceMountain	Jackson County, West Virginia
Yellow Bank River	sourceConfluenceMountain	Yellow Bank Township, Lac qui Parle County, Minnesota
Moodna Creek	sourceConfluenceMountain	Blooming Grove, New York
Amite River	sourceConfluenceMountain	St. Helena Parish, Louisiana
Amite River	sourceConfluenceMountain	East Feliciana Parish, Louisiana
North Fork Feather River	sourceConfluenceMountain	Feather River Meadows
San Gregorio Creek	sourceConfluenceMountain	La Honda, California
East Lyn River	sourceConfluenceMountain	Watersmeet House
Maacama Creek	sourceConfluenceMountain	Healdsburg, California
Lady Evelyn River	sourceConfluenceMountain	Unorganized West Timiskaming District
Bybrook River	sourceConfluenceMountain	Castle Combe
River Cladagh (Swanlinbar)	sourceConfluenceMountain	Irish grid reference system
Dreisam	sourceConfluenceMountain	Kirchzarten
Danube	sourceConfluenceMountain	Donaueschingen
American River	sourceConfluenceMountain	Folsom, California
Clearwater River (Idaho)	sourceConfluenceMountain	Idaho County, Idaho
Siston Brook	sourceConfluenceMountain	Siston
Whitelake River	sourceConfluenceMountain	Pilton, Somerset
Sorraia River	sourceConfluenceMountain	Couço
Cow Creek (South Umpqua River)	sourceConfluenceMountain	Umpqua National Forest
Corte Madera Creek (Marin County, California)	sourceConfluenceMountain	Ross, California
Holly River	sourceConfluenceMountain	Braxton County, West Virginia
San Anselmo Creek	sourceConfluenceMountain	Ross, California
