EUPHRATES	SOURCECONFLUENCELOCATION	KEBAN
INDUS RIVER	SOURCECONFLUENCELOCATION	SHIQUANHE
MISSOURI RIVER	SOURCECONFLUENCELOCATION	THREE FORKS, MONTANA
OHIO RIVER	SOURCECONFLUENCELOCATION	PITTSBURGH
RHINE	SOURCECONFLUENCELOCATION	TAMINS
LIMPOPO RIVER	SOURCECONFLUENCELOCATION	BOTSWANA/SOUTH AFRICA BORDER
GRAN VALIRA	SOURCECONFLUENCELOCATION	ESCALDES-ENGORDANY
MITTA MITTA RIVER	SOURCECONFLUENCELOCATION	NEAR ANGLERS REST
RIVER DERWENT	SOURCECONFLUENCELOCATION	CRADLE MOUNTAIN-LAKE ST CLAIR NATIONAL PARK
KANSAS RIVER	SOURCECONFLUENCELOCATION	JUNCTION CITY, KANSAS
REPUBLICAN RIVER	SOURCECONFLUENCELOCATION	HAIGLER, NEBRASKA
MONONGAHELA RIVER	SOURCECONFLUENCELOCATION	FAIRMONT, WEST VIRGINIA
SASKATCHEWAN RIVER	SOURCECONFLUENCELOCATION	EAST OF PRINCE ALBERT, SASKATCHEWAN
PLATTE RIVER	SOURCECONFLUENCELOCATION	NEAR NORTH PLATTE
RIVER DART	SOURCECONFLUENCELOCATION	DARTMEET
SOUTH SASKATCHEWAN RIVER	SOURCECONFLUENCELOCATION	MUNICIPAL DISTRICT OF TABER
BIG SANDY RIVER	SOURCECONFLUENCELOCATION	LOUISA, KENTUCKY
ABAKAN RIVER	SOURCECONFLUENCELOCATION	WESTERN SAYAN MOUNTAINS
LITTLE COLORADO RIVER	SOURCECONFLUENCELOCATION	GREER, ARIZONA
SCHUYLKILL RIVER	SOURCECONFLUENCELOCATION	SCHUYLKILL HAVEN, PENNSYLVANIA
NEW RIVER	SOURCECONFLUENCELOCATION	ASHE COUNTY, NORTH CAROLINA
SELENGA RIVER	SOURCECONFLUENCELOCATION	KHöVSGöL PROVINCE
AROOSTOOK RIVER	SOURCECONFLUENCELOCATION	MAINE TOWNSHIP 8, RANGE 8, WELS, PENOBSCOT COUNTY, MAINE
SAINT JOHN RIVER	SOURCECONFLUENCELOCATION	AROOSTOOK COUNTY, MAINE
SUN RIVER	SOURCECONFLUENCELOCATION	NEAR GIBSON RESERVOIR
LITTLE TENNESSEE RIVER	SOURCECONFLUENCELOCATION	RABUN COUNTY, GEORGIA
FRENCH BROAD RIVER	SOURCECONFLUENCELOCATION	ROSMAN, NORTH CAROLINA
GWYDIR RIVER	SOURCECONFLUENCELOCATION	NEAR MOREE
LANE COVE RIVER	SOURCECONFLUENCELOCATION	LANE COVE NATIONAL PARK AT CHELTENHAM
KING RIVER	SOURCECONFLUENCELOCATION	NEAR ELDON RANGE
KANAWHA RIVER	SOURCECONFLUENCELOCATION	GAULEY BRIDGE, WEST VIRGINIA
GOULBURN RIVER	SOURCECONFLUENCELOCATION	NEAR ULAN
MOOSE RIVER	SOURCECONFLUENCELOCATION	UNNAMED WILDERNESS OF UNORG. COCHRANE DISTRICT
LACHLAN RIVER	SOURCECONFLUENCELOCATION	EAST OF GUNNING
JUNIATA RIVER	SOURCECONFLUENCELOCATION	PETERSBURG, PENNSYLVANIA
BRANDYWINE CREEK	SOURCECONFLUENCELOCATION	EAST BRADFORD AND POCOPSON TOWNSHIPS
WHITE CLAY CREEK	SOURCECONFLUENCELOCATION	LONDON BRITAIN TOWNSHIP, PENNSYLVANIA
OSAGE RIVER	SOURCECONFLUENCELOCATION	VERNON COUNTY, MISSOURI
SANTA ANA RIVER	SOURCECONFLUENCELOCATION	SANTA ANA CANYON
CARSON RIVER	SOURCECONFLUENCELOCATION	NEAR MINDEN, NEVADA
SHENANDOAH RIVER	SOURCECONFLUENCELOCATION	FRONT ROYAL, VIRGINIA
CLARK FORK RIVER	SOURCECONFLUENCELOCATION	DEER LODGE COUNTY, MONTANA
COLO RIVER	SOURCECONFLUENCELOCATION	NORTHEAST OF NEWNES
PAW PAW RIVER	SOURCECONFLUENCELOCATION	NORTH OF PAW PAW, MICHIGAN
MORUYA RIVER	SOURCECONFLUENCELOCATION	NEAR KIORA
HOLSTON RIVER	SOURCECONFLUENCELOCATION	KINGSPORT, TENNESSEE
WALKER RIVER	SOURCECONFLUENCELOCATION	YERINGTON, NEVADA
FEATHER RIVER	SOURCECONFLUENCELOCATION	UPSTREAM OF OROVILLE DAM
LITTLE PIGEON RIVER	SOURCECONFLUENCELOCATION	GREENBRIER COVE IN THE GREAT SMOKY MOUNTAINS NATIONAL PARK
SPANISH RIVER	SOURCECONFLUENCELOCATION	UNORGANIZED SUDBURY
NOLICHUCKY RIVER	SOURCECONFLUENCELOCATION	YANCEY COUNTY, NORTH CAROLINA
PIGEON RIVER	SOURCECONFLUENCELOCATION	SOUTH OF CANTON
CHEAT RIVER	SOURCECONFLUENCELOCATION	PARSONS, WEST VIRGINIA
MURG	SOURCECONFLUENCELOCATION	OBERTAL, BAIERSBRONN, FREUDENSTADT DISTRICT
RIVER FOYLE	SOURCECONFLUENCELOCATION	STRABANE
RIVER FOYLE	SOURCECONFLUENCELOCATION	LIFFORD
SAN GABRIEL RIVER	SOURCECONFLUENCELOCATION	SAN GABRIEL MOUNTAINS
FARMINGTON RIVER	SOURCECONFLUENCELOCATION	NEW HARTFORD
BAYFIELD RIVER	SOURCECONFLUENCELOCATION	DUBLIN, ONTARIO
BAYFIELD RIVER	SOURCECONFLUENCELOCATION	WEST PERTH, ONTARIO
KOKSOAK RIVER	SOURCECONFLUENCELOCATION	ABOUT 80 KM SW FROM KUUJJUAQ
NAVARRO RIVER	SOURCECONFLUENCELOCATION	SOUTH OF PHILO, CALIFORNIA
GREENBRIER RIVER	SOURCECONFLUENCELOCATION	DURBIN, WEST VIRGINIA
ENDEAVOUR RIVER	SOURCECONFLUENCELOCATION	ENDEAVOUR RIVER NATIONAL PARK
COYOTE CREEK	SOURCECONFLUENCELOCATION	HENRY W. COE STATE PARK
GAULEY RIVER	SOURCECONFLUENCELOCATION	WEBSTER COUNTY, WEST VIRGINIA
SOUTH FORK NEW RIVER	SOURCECONFLUENCELOCATION	BOONE, NORTH CAROLINA
ELK RIVER	SOURCECONFLUENCELOCATION	SLATYFORK, WEST VIRGINIA
HUGHES RIVER	SOURCECONFLUENCELOCATION	CAIRO, WEST VIRGINIA
SHADE RIVER	SOURCECONFLUENCELOCATION	CHESTER TOWNSHIP, MEIGS COUNTY, OHIO
BLUE EARTH RIVER	SOURCECONFLUENCELOCATION	ELMORE TOWNSHIP, MINNESOTA
BLACK FORK	SOURCECONFLUENCELOCATION	HENDRICKS, WEST VIRGINIA
WILLIAMS RIVER	SOURCECONFLUENCELOCATION	POCAHONTAS COUNTY, WEST VIRGINIA
RíO NEGRO	SOURCECONFLUENCELOCATION	NEUQUéN, ARGENTINA
VERDIGRIS RIVER	SOURCECONFLUENCELOCATION	MADISON, KANSAS
SIL	SOURCECONFLUENCELOCATION	OURENSE
ABERCROMBIE RIVER	SOURCECONFLUENCELOCATION	WYANGALA DAM
QUEEN RIVER, AUSTRALIA	SOURCECONFLUENCELOCATION	QUEENSTOWN, TASMANIA
CRANBERRY RIVER	SOURCECONFLUENCELOCATION	POCAHONTAS COUNTY, WEST VIRGINIA
TWELVEPOLE CREEK	SOURCECONFLUENCELOCATION	WAYNE, WEST VIRGINIA
GUDGENBY RIVER	SOURCECONFLUENCELOCATION	NAMADGI NATIONAL PARK
LITTLE RIVER	SOURCECONFLUENCELOCATION	FLOYD COUNTY, VIRGINIA
RIVER NEB	SOURCECONFLUENCELOCATION	GLEN HELEN, ISLE OF MAN
MARAIS DES CYGNES RIVER	SOURCECONFLUENCELOCATION	LYON COUNTY, KANSAS
LITTLE OSAGE RIVER	SOURCECONFLUENCELOCATION	ALLEN COUNTY, KANSAS
MITCHELL RIVER	SOURCECONFLUENCELOCATION	HORSESHOE BEND, NORTH OF MITCHELL RIVER NATIONAL PARK
MINHO	SOURCECONFLUENCELOCATION	OURENSE
NIANGUA RIVER	SOURCECONFLUENCELOCATION	WEBSTER COUNTY, MISSOURI
DUMARESQ RIVER	SOURCECONFLUENCELOCATION	EAST OF GLENLYON DAM
GARCIA RIVER	SOURCECONFLUENCELOCATION	SOUTH OF BOONVILLE
GUALALA RIVER	SOURCECONFLUENCELOCATION	NORTHEAST OF GUALALA, CALIFORNIA
TAMIR RIVER	SOURCECONFLUENCELOCATION	BATTSENGEL
MORSES CREEK	SOURCECONFLUENCELOCATION	VICTORIAN ALPS
SENECA CREEK	SOURCECONFLUENCELOCATION	PENDLETON COUNTY, WEST VIRGINIA
MIDDLE HARBOUR CREEK	SOURCECONFLUENCELOCATION	NORTH OF DAVIDSON
RIVER BELA	SOURCECONFLUENCELOCATION	CONFLUENCE OF PEASEY BECK AND STAINTON BECK AT OVERTHWAITE
LIDDEL WATER	SOURCECONFLUENCELOCATION	CARWINLEY
HENTY RIVER	SOURCECONFLUENCELOCATION	BELOW MOUNT TYNDALL
BILLABONG CREEK	SOURCECONFLUENCELOCATION	NEAR ILLABO
WEKIVA RIVER	SOURCECONFLUENCELOCATION	APOPKA
PINE RIVER	SOURCECONFLUENCELOCATION	LAWNTON, QUEENSLAND
MOKOLO RIVER	SOURCECONFLUENCELOCATION	NEAR ALMA
GLADY FORK	SOURCECONFLUENCELOCATION	GLADY, WEST VIRGINIA
ROPER RIVER	SOURCECONFLUENCELOCATION	EAST OF MATARANKA
MIDDLE FORK RIVER	SOURCECONFLUENCELOCATION	ADOLPH, WEST VIRGINIA
MIDDLE FORK RIVER	SOURCECONFLUENCELOCATION	RANDOLPH COUNTY, WEST VIRGINIA
WHEELING CREEK	SOURCECONFLUENCELOCATION	NORTHEASTERN MARSHALL COUNTY NEAR MAJORSVILLE
MILL CREEK	SOURCECONFLUENCELOCATION	EAST OF RIPLEY
SANDY CREEK	SOURCECONFLUENCELOCATION	SOUTH OF SANDYVILLE, NORTHERN JACKSON COUNTY
SOLOMON RIVER	SOURCECONFLUENCELOCATION	CAWKER CITY, KANSAS
SALINE RIVER	SOURCECONFLUENCELOCATION	SHERIDAN COUNTY, KANSAS
NINNESCAH RIVER	SOURCECONFLUENCELOCATION	SEDGWICK COUNTY, KANSAS
YELLOW BANK RIVER	SOURCECONFLUENCELOCATION	YELLOW BANK TOWNSHIP, MINNESOTA
MOODNA CREEK	SOURCECONFLUENCELOCATION	BLOOMING GROVE, NEW YORK
SALMON RIVER	SOURCECONFLUENCELOCATION	COLCHESTER, CONNECTICUT
AMITE RIVER	SOURCECONFLUENCELOCATION	ST. HELENA PARISH AND EAST FELICIANA PARISH
SAN GREGORIO CREEK	SOURCECONFLUENCELOCATION	LA HONDA, CALIFORNIA
EAST LYN RIVER	SOURCECONFLUENCELOCATION	WATERSMEET HOUSE
MAACAMA CREEK	SOURCECONFLUENCELOCATION	NORTHEAST OF HEALDSBURG, CALIFORNIA
MOLE RIVER	SOURCECONFLUENCELOCATION	WEST OF SANDY FLAT
EIGHTEEN MILE CREEK	SOURCECONFLUENCELOCATION	HAMBURG, NEW YORK
LADY EVELYN RIVER	SOURCECONFLUENCELOCATION	TIMISKAMING, UNORGANIZED, WEST PART, ONTARIO
BYBROOK RIVER	SOURCECONFLUENCELOCATION	CASTLE COMBE
TINGALPA CREEK	SOURCECONFLUENCELOCATION	MOUNT COTTON, QUEENSLAND
MARANOA RIVER	SOURCECONFLUENCELOCATION	CARNARVON NATIONAL PARK
SUGGAN BUGGAN RIVER	SOURCECONFLUENCELOCATION	ALPINE NATIONAL PARK
POWELLS CREEK	SOURCECONFLUENCELOCATION	BRESSINGTON PARK, BICENTENNIAL PARK
HASLAMS CREEK	SOURCECONFLUENCELOCATION	HOMEBUSH BAY
RIVER WEY	SOURCECONFLUENCELOCATION	TILFORD
WISCOY CREEK	SOURCECONFLUENCELOCATION	EAGLE, NEW YORK
RIVER CLADAGH	SOURCECONFLUENCELOCATION	H143 259 IRISH GRID
NAVASOTA RIVER	SOURCECONFLUENCELOCATION	3.5
DREISAM	SOURCECONFLUENCELOCATION	KIRCHZARTEN
WARRAGAMBA RIVER	SOURCECONFLUENCELOCATION	LAKE BURRAGORANG
WOLGAN RIVER	SOURCECONFLUENCELOCATION	WOLGAN VALLEY
DANUBE	SOURCECONFLUENCELOCATION	DONAUESCHINGEN
NANXI RIVER	SOURCECONFLUENCELOCATION	YONGJIA COUNTY
AMERICAN RIVER	SOURCECONFLUENCELOCATION	NEAR FOLSOM
BEARDY RIVER	SOURCECONFLUENCELOCATION	NEAR BONSHAW
BLICKS RIVER	SOURCECONFLUENCELOCATION	EAST OF EBOR
BOW RIVER	SOURCECONFLUENCELOCATION	BOW, WEST OF MERRIWA
CAPERTEE RIVER	SOURCECONFLUENCELOCATION	NEAR BOGEE, SOUTHEAST OF KANDOS
BOYD RIVER	SOURCECONFLUENCELOCATION	WITHIN GUY FAWKES RIVER NATIONAL PARK
CAMDEN HAVEN RIVER	SOURCECONFLUENCELOCATION	WATSON TAYLORS LAKE, NEAR LAURIETON
KOWMUNG RIVER	SOURCECONFLUENCELOCATION	TUGLOW, NEAR SHOOTERS HILL
LITTLE PLAINS RIVER	SOURCECONFLUENCELOCATION	BENDOC UPPER, NEAR DELEGATE
OXLEY RIVER	SOURCECONFLUENCELOCATION	NEAR TYALGUM
PADDYS RIVER	SOURCECONFLUENCELOCATION	WEST OF BUNDANOON
MURRAH RIVER	SOURCECONFLUENCELOCATION	NEAR QUAAMA
MARYLAND RIVER	SOURCECONFLUENCELOCATION	NEAR MARYLAND
CLEARWATER RIVER	SOURCECONFLUENCELOCATION	IDAHO COUNTY
SISTON BROOK	SOURCECONFLUENCELOCATION	SISTON
KHARAA RIVER	SOURCECONFLUENCELOCATION	BATSüMBER
WHITELAKE RIVER	SOURCECONFLUENCELOCATION	WORTHY FARM, PILTON
SORRAIA RIVER	SOURCECONFLUENCELOCATION	COUçO
COW CREEK	SOURCECONFLUENCELOCATION	UMPQUA NATIONAL FOREST
CORTE MADERA CREEK	SOURCECONFLUENCELOCATION	ROSS, CALIFORNIA
YEERUNG RIVER	SOURCECONFLUENCELOCATION	CAPE CONRAN COASTAL PARK
SAN LORENZO CREEK	SOURCECONFLUENCELOCATION	AT PALOMARES CREEK AND EDEN CANYON CREEK
BEGA RIVER	SOURCECONFLUENCELOCATION	MORANS CROSSING, SNOWY MOUNTAINS HIGHWAY
HOLLY RIVER	SOURCECONFLUENCELOCATION	EASTERN BRAXTON COUNTY
SAN ANSELMO CREEK	SOURCECONFLUENCELOCATION	ROSS, CALIFORNIA
XIN RIVER	SOURCECONFLUENCELOCATION	XINZHOU DISTRICT, SHANGRAO
SPRING CREEK	SOURCECONFLUENCELOCATION	SOUTH OF SPENCER
STEER CREEK	SOURCECONFLUENCELOCATION	STUMPTOWN, WEST VIRGINIA
REEDY CREEK	SOURCECONFLUENCELOCATION	REEDY, WEST VIRGINIA
ORESTIMBA CREEK	SOURCECONFLUENCELOCATION	OF NORTH FORK ORESTIMBA CREEK AND SOUTH FORK ORESTIMBA CREEK.
BITTERWATER CREEK	SOURCECONFLUENCELOCATION	AT THE JUNCTION OF WALNUT CREEK AND YEGUAS CREEK.
MOGALAKWENA RIVER	SOURCECONFLUENCELOCATION	SOUTH OF CONFLUENCE WITH DORPS RIVER
PADDYS RIVER	SOURCECONFLUENCELOCATION	CASTLE HILL IN TIDBINBILLA NATURE RESERVE
CHADAKOIN RIVER	SOURCECONFLUENCELOCATION	FALCONER
BILLABONG CREEK	SOURCECONFLUENCELOCATION	NEAR HOLBROOK
SHANNON BROOK	SOURCECONFLUENCELOCATION	NEAR MUMMULGUM
TOOLOOM CREEK	SOURCECONFLUENCELOCATION	NEAR WOODENBONG
COMMISSIONERS WATERS	SOURCECONFLUENCELOCATION	EAST OF ARMIDALE
ARMSTRONG CREEK	SOURCECONFLUENCELOCATION	SOUTHWEST OF MCDUNN
TWOMILE CREEK	SOURCECONFLUENCELOCATION	SOUTHWEST OF MCDUNN
MEATHOUSE FORK	SOURCECONFLUENCELOCATION	WEST OF BIG ISAAC
ARNOLD CREEK	SOURCECONFLUENCELOCATION	SOUTHWEST OF WEST UNION, DODDRIDGE COUNTY
MCELROY CREEK	SOURCECONFLUENCELOCATION	CENTER POINT, WEST VIRGINIA
MCELROY CREEK	SOURCECONFLUENCELOCATION	DODDRIDGE COUNTY, WEST VIRGINIA
HUMFFRAY RIVER	SOURCECONFLUENCELOCATION	TEA TREE RANGE, GREAT DIVIDING RANGE
CROOKED RIVER	SOURCECONFLUENCELOCATION	SOUTH OF , GREAT DIVIDING RANGE
ABERFELDY RIVER	SOURCECONFLUENCELOCATION	BELOW MOUNT SELMA
BUFFALO RIVER	SOURCECONFLUENCELOCATION	MOUNT BUFFALO NATIONAL PARK
GIBBO RIVER	SOURCECONFLUENCELOCATION	VICTORIAN ALPS
FALACHO RIVER	SOURCECONFLUENCELOCATION	ARADA RIVER
ALJEZUR RIVER	SOURCECONFLUENCELOCATION	ALJEZUR
ALGOZ RIVER	SOURCECONFLUENCELOCATION	ALCANTARILHA RIVER
BULIU RIVER	SOURCECONFLUENCELOCATION	LINGYUN COUNTY
SAPPA CREEK	SOURCECONFLUENCELOCATION	OBERLIN, KANSAS
LITTLE SALMON RIVER	SOURCECONFLUENCELOCATION	MEXICO, NEW YORK
