Amu Darya	sourceConfluencePosition	Amu Darya  sourceConfluencePosition  1
Missouri River	sourceConfluencePosition	Missouri River  sourceConfluencePosition  1
Ohio River	sourceConfluencePosition	Ohio River  sourceConfluencePosition  1
Rhine	sourceConfluencePosition	Rhine  sourceConfluencePosition  1
Delaware River	sourceConfluencePosition	Delaware River  sourceConfluencePosition  1
Ob River	sourceConfluencePosition	Ob River  sourceConfluencePosition  1
Amur River	sourceConfluencePosition	Amur River  sourceConfluencePosition  1
Monongahela River	sourceConfluencePosition	Monongahela River  sourceConfluencePosition  1
Brazos River	sourceConfluencePosition	Brazos River  sourceConfluencePosition  1
Saskatchewan River	sourceConfluencePosition	Saskatchewan River  sourceConfluencePosition  1
Platte River	sourceConfluencePosition	Platte River  sourceConfluencePosition  1
South Saskatchewan River	sourceConfluencePosition	South Saskatchewan River  sourceConfluencePosition  1
Big Sandy River (Ohio River)	sourceConfluencePosition	Big Sandy River (Ohio River)  sourceConfluencePosition  1
Little Colorado River	sourceConfluencePosition	Little Colorado River  sourceConfluencePosition  1
Schuylkill River	sourceConfluencePosition	Schuylkill River  sourceConfluencePosition  1
Tuolumne River	sourceConfluencePosition	Tuolumne River  sourceConfluencePosition  1
Gila River	sourceConfluencePosition	Gila River  sourceConfluencePosition  1
New River (Kanawha River)	sourceConfluencePosition	New River (Kanawha River)  sourceConfluencePosition  1
Selenge River	sourceConfluencePosition	Selenge River  sourceConfluencePosition  1
Aroostook River	sourceConfluencePosition	Aroostook River  sourceConfluencePosition  1
Saint John River (Bay of Fundy)	sourceConfluencePosition	Saint John River (Bay of Fundy)  sourceConfluencePosition  1
Sun River	sourceConfluencePosition	Sun River  sourceConfluencePosition  1
Kanawha River	sourceConfluencePosition	Kanawha River  sourceConfluencePosition  1
Moose River (Ontario)	sourceConfluencePosition	Moose River (Ontario)  sourceConfluencePosition  1
Paraná River	sourceConfluencePosition	Paraná River  sourceConfluencePosition  1
Juniata River	sourceConfluencePosition	Juniata River  sourceConfluencePosition  1
Lackawaxen River	sourceConfluencePosition	Lackawaxen River  sourceConfluencePosition  1
White Clay Creek	sourceConfluencePosition	White Clay Creek  sourceConfluencePosition  1
Brandywine Creek (Christina River)	sourceConfluencePosition	Brandywine Creek (Christina River)  sourceConfluencePosition  1
Neversink River	sourceConfluencePosition	Neversink River  sourceConfluencePosition  1
Santa Ana River	sourceConfluencePosition	Santa Ana River  sourceConfluencePosition  1
Carson River	sourceConfluencePosition	Carson River  sourceConfluencePosition  1
Clark Fork (river)	sourceConfluencePosition	Clark Fork (river)  sourceConfluencePosition  1
Paw Paw River	sourceConfluencePosition	Paw Paw River  sourceConfluencePosition  1
Wapsipinicon River	sourceConfluencePosition	Wapsipinicon River  sourceConfluencePosition  1
Walker River	sourceConfluencePosition	Walker River  sourceConfluencePosition  1
Petitcodiac River	sourceConfluencePosition	Petitcodiac River  sourceConfluencePosition  1
Pit River	sourceConfluencePosition	Pit River  sourceConfluencePosition  1
Peace River (Canada)	sourceConfluencePosition	Peace River (Canada)  sourceConfluencePosition  1
Feather River	sourceConfluencePosition	Feather River  sourceConfluencePosition  1
Maquoketa River	sourceConfluencePosition	Maquoketa River  sourceConfluencePosition  1
Spanish River (Ontario)	sourceConfluencePosition	Spanish River (Ontario)  sourceConfluencePosition  1
Nolichucky River	sourceConfluencePosition	Nolichucky River  sourceConfluencePosition  1
Cheat River	sourceConfluencePosition	Cheat River  sourceConfluencePosition  1
Murg	sourceConfluencePosition	Murg  sourceConfluencePosition  1
River Foyle	sourceConfluencePosition	River Foyle  sourceConfluencePosition  1
San Gabriel River (California)	sourceConfluencePosition	San Gabriel River (California)  sourceConfluencePosition  1
Bayfield River	sourceConfluencePosition	Bayfield River  sourceConfluencePosition  1
Koksoak River	sourceConfluencePosition	Koksoak River  sourceConfluencePosition  1
Navarro River	sourceConfluencePosition	Navarro River  sourceConfluencePosition  1
Payette River	sourceConfluencePosition	Payette River  sourceConfluencePosition  1
Greenbrier River	sourceConfluencePosition	Greenbrier River  sourceConfluencePosition  1
Coyote Creek (Santa Clara County)	sourceConfluencePosition	Coyote Creek (Santa Clara County)  sourceConfluencePosition  1
Vils (Danube)	sourceConfluencePosition	Vils (Danube)  sourceConfluencePosition  1
Irrawaddy River	sourceConfluencePosition	Irrawaddy River  sourceConfluencePosition  1
Gauley River	sourceConfluencePosition	Gauley River  sourceConfluencePosition  1
South Fork New River	sourceConfluencePosition	South Fork New River  sourceConfluencePosition  1
Elk River (West Virginia)	sourceConfluencePosition	Elk River (West Virginia)  sourceConfluencePosition  1
Hughes River (West Virginia)	sourceConfluencePosition	Hughes River (West Virginia)  sourceConfluencePosition  1
Shade River	sourceConfluencePosition	Shade River  sourceConfluencePosition  1
Blue Earth River	sourceConfluencePosition	Blue Earth River  sourceConfluencePosition  1
Black Fork (Cheat River)	sourceConfluencePosition	Black Fork (Cheat River)  sourceConfluencePosition  1
Williams River (West Virginia)	sourceConfluencePosition	Williams River (West Virginia)  sourceConfluencePosition  1
Río Negro (Argentina)	sourceConfluencePosition	Río Negro (Argentina)  sourceConfluencePosition  1
Sil (river)	sourceConfluencePosition	Sil (river)  sourceConfluencePosition  1
Cranberry River (West Virginia)	sourceConfluencePosition	Cranberry River (West Virginia)  sourceConfluencePosition  1
Twelvepole Creek	sourceConfluencePosition	Twelvepole Creek  sourceConfluencePosition  1
Shell Rock River	sourceConfluencePosition	Shell Rock River  sourceConfluencePosition  1
River Neb	sourceConfluencePosition	River Neb  sourceConfluencePosition  1
Minho River	sourceConfluencePosition	Minho River  sourceConfluencePosition  1
Kelsey Creek	sourceConfluencePosition	Kelsey Creek  sourceConfluencePosition  1
Garcia River	sourceConfluencePosition	Garcia River  sourceConfluencePosition  1
Gualala River	sourceConfluencePosition	Gualala River  sourceConfluencePosition  1
Seneca Creek (North Fork South Branch Potomac River)	sourceConfluencePosition	Seneca Creek (North Fork South Branch Potomac River)  sourceConfluencePosition  1
Liddel Water	sourceConfluencePosition	Liddel Water  sourceConfluencePosition  1
Westfield River	sourceConfluencePosition	Westfield River  sourceConfluencePosition  1
Ostravice (river)	sourceConfluencePosition	Ostravice (river)  sourceConfluencePosition  1
Chockalog River	sourceConfluencePosition	Chockalog River  sourceConfluencePosition  1
Glady Fork	sourceConfluencePosition	Glady Fork  sourceConfluencePosition  1
Middle Fork River	sourceConfluencePosition	Middle Fork River  sourceConfluencePosition  1
Sausal Creek (Alameda County, California)	sourceConfluencePosition	Sausal Creek (Alameda County, California)  sourceConfluencePosition  1
Wheeling Creek (West Virginia)	sourceConfluencePosition	Wheeling Creek (West Virginia)  sourceConfluencePosition  1
Mill Creek (western West Virginia)	sourceConfluencePosition	Mill Creek (western West Virginia)  sourceConfluencePosition  1
Sandy Creek (West Virginia)	sourceConfluencePosition	Sandy Creek (West Virginia)  sourceConfluencePosition  1
Yellow Bank River	sourceConfluencePosition	Yellow Bank River  sourceConfluencePosition  1
Moodna Creek	sourceConfluencePosition	Moodna Creek  sourceConfluencePosition  1
Amite River	sourceConfluencePosition	Amite River  sourceConfluencePosition  1
San Pedro Creek	sourceConfluencePosition	San Pedro Creek  sourceConfluencePosition  1
San Gregorio Creek	sourceConfluencePosition	San Gregorio Creek  sourceConfluencePosition  1
East Lyn River	sourceConfluencePosition	East Lyn River  sourceConfluencePosition  1
Maacama Creek	sourceConfluencePosition	Maacama Creek  sourceConfluencePosition  1
Lady Evelyn River	sourceConfluencePosition	Lady Evelyn River  sourceConfluencePosition  1
Walker Creek (Marin County, California)	sourceConfluencePosition	Walker Creek (Marin County, California)  sourceConfluencePosition  1
Bybrook River	sourceConfluencePosition	Bybrook River  sourceConfluencePosition  1
Shizunai River	sourceConfluencePosition	Shizunai River  sourceConfluencePosition  1
River Cladagh (Swanlinbar)	sourceConfluencePosition	River Cladagh (Swanlinbar)  sourceConfluencePosition  1
Sandvikselva	sourceConfluencePosition	Sandvikselva  sourceConfluencePosition  1
Stryi River	sourceConfluencePosition	Stryi River  sourceConfluencePosition  1
Danube	sourceConfluencePosition	Danube  sourceConfluencePosition  1
American River	sourceConfluencePosition	American River  sourceConfluencePosition  1
Clearwater River (Idaho)	sourceConfluencePosition	Clearwater River (Idaho)  sourceConfluencePosition  1
Siston Brook	sourceConfluencePosition	Siston Brook  sourceConfluencePosition  1
Platte River (Wisconsin)	sourceConfluencePosition	Platte River (Wisconsin)  sourceConfluencePosition  1
Whitelake River	sourceConfluencePosition	Whitelake River  sourceConfluencePosition  1
Sorraia River	sourceConfluencePosition	Sorraia River  sourceConfluencePosition  1
Cow Creek (South Umpqua River)	sourceConfluencePosition	Cow Creek (South Umpqua River)  sourceConfluencePosition  1
Corte Madera Creek (Marin County, California)	sourceConfluencePosition	Corte Madera Creek (Marin County, California)  sourceConfluencePosition  1
Copper Creek (California)	sourceConfluencePosition	Copper Creek (California)  sourceConfluencePosition  1
Holly River	sourceConfluencePosition	Holly River  sourceConfluencePosition  1
Trail Creek (Lake Michigan)	sourceConfluencePosition	Trail Creek (Lake Michigan)  sourceConfluencePosition  1
