Euphrates	sourceConfluencePlace	Keban (District), Elazığ
Missouri River	sourceConfluencePlace	Three Forks, Gallatin County, Montana
Ohio River	sourceConfluencePlace	Pittsburgh
Rhine	sourceConfluencePlace	Tamins
Monongahela River	sourceConfluencePlace	Fairmont, West Virginia
Saskatchewan River	sourceConfluencePlace	Prince Albert, Saskatchewan
Platte River	sourceConfluencePlace	North Platte, Nebraska
River Dart	sourceConfluencePlace	Dartmeet
South Saskatchewan River	sourceConfluencePlace	Taber, Alberta (municipal district)
Big Sandy River (Ohio River)	sourceConfluencePlace	Louisa, Kentucky
Little Colorado River	sourceConfluencePlace	Greer, Arizona
Schuylkill River	sourceConfluencePlace	Schuylkill Haven, Pennsylvania
Tuolumne River	sourceConfluencePlace	Yosemite National Park
New River (Kanawha River)	sourceConfluencePlace	Ashe County, North Carolina
Selenge River	sourceConfluencePlace	Khövsgöl Province
Aroostook River	sourceConfluencePlace	Penobscot County, Maine
Saint John River (Bay of Fundy)	sourceConfluencePlace	Aroostook County, Maine
Sun River	sourceConfluencePlace	Gibson Reservoir
Kanawha River	sourceConfluencePlace	Gauley Bridge, West Virginia
Moose River (Ontario)	sourceConfluencePlace	Unorganized North Cochrane District
Juniata River	sourceConfluencePlace	Alexandria, Pennsylvania
White Clay Creek	sourceConfluencePlace	London Britain Township, Chester County, Pennsylvania
Brandywine Creek (Christina River)	sourceConfluencePlace	East Bradford Township, Chester County, Pennsylvania
Brandywine Creek (Christina River)	sourceConfluencePlace	Pocopson Township, Chester County, Pennsylvania
Santa Ana River	sourceConfluencePlace	Santa Ana Canyon
Carson River	sourceConfluencePlace	Minden, Nevada
Clark Fork (river)	sourceConfluencePlace	Deer Lodge County, Montana
Paw Paw River	sourceConfluencePlace	Paw Paw, Michigan
Walker River	sourceConfluencePlace	Yerington, Nevada
Pit River	sourceConfluencePlace	Alturas, California
Feather River	sourceConfluencePlace	Oroville Dam
Spanish River (Ontario)	sourceConfluencePlace	Unorganized North Sudbury District
Nolichucky River	sourceConfluencePlace	Yancey County, North Carolina
Cheat River	sourceConfluencePlace	Parsons, West Virginia
Murg	sourceConfluencePlace	Baiersbronn
Murg	sourceConfluencePlace	Freudenstadt (district)
River Foyle	sourceConfluencePlace	Lifford
San Gabriel River (California)	sourceConfluencePlace	San Gabriel Mountains
Bayfield River	sourceConfluencePlace	West Perth, Ontario
Bayfield River	sourceConfluencePlace	West Perth, Ontario
Koksoak River	sourceConfluencePlace	Kuujjuaq
Navarro River	sourceConfluencePlace	Philo, California
Greenbrier River	sourceConfluencePlace	Durbin, West Virginia
Coyote Creek (Santa Clara County)	sourceConfluencePlace	Henry W. Coe State Park
Gauley River	sourceConfluencePlace	Webster County, West Virginia
South Fork New River	sourceConfluencePlace	Boone, North Carolina
Elk River (West Virginia)	sourceConfluencePlace	Slaty Fork, West Virginia
Hughes River (West Virginia)	sourceConfluencePlace	Cairo, West Virginia
Shade River	sourceConfluencePlace	Chester Township, Meigs County, Ohio
Blue Earth River	sourceConfluencePlace	Elmore Township, Faribault County, Minnesota
Black Fork (Cheat River)	sourceConfluencePlace	Hendricks, West Virginia
Williams River (West Virginia)	sourceConfluencePlace	Pocahontas County, West Virginia
Río Negro (Argentina)	sourceConfluencePlace	Neuquén, Argentina
Sil (river)	sourceConfluencePlace	Ourense
Cranberry River (West Virginia)	sourceConfluencePlace	Pocahontas County, West Virginia
Twelvepole Creek	sourceConfluencePlace	Wayne, West Virginia
River Neb	sourceConfluencePlace	Glen Helen, Isle of Man
Minho River	sourceConfluencePlace	Ourense
Garcia River	sourceConfluencePlace	Boonville, California
Gualala River	sourceConfluencePlace	Gualala, California
Seneca Creek (North Fork South Branch Potomac River)	sourceConfluencePlace	Pendleton County, West Virginia
River Bela	sourceConfluencePlace	Peasey Beck
River Bela	sourceConfluencePlace	Stainton Beck
Liddel Water	sourceConfluencePlace	Carwinley
Glady Fork	sourceConfluencePlace	Glady, West Virginia
Middle Fork River	sourceConfluencePlace	Adolph, West Virginia
Middle Fork River	sourceConfluencePlace	Randolph County, West Virginia
Wheeling Creek (West Virginia)	sourceConfluencePlace	Marshall County, West Virginia
Mill Creek (western West Virginia)	sourceConfluencePlace	Ripley, West Virginia
Sandy Creek (West Virginia)	sourceConfluencePlace	Jackson County, West Virginia
Yellow Bank River	sourceConfluencePlace	Yellow Bank Township, Lac qui Parle County, Minnesota
Moodna Creek	sourceConfluencePlace	Blooming Grove, New York
Amite River	sourceConfluencePlace	St. Helena Parish, Louisiana
Amite River	sourceConfluencePlace	East Feliciana Parish, Louisiana
North Fork Feather River	sourceConfluencePlace	Feather River Meadows
San Gregorio Creek	sourceConfluencePlace	La Honda, California
East Lyn River	sourceConfluencePlace	Watersmeet House
Maacama Creek	sourceConfluencePlace	Healdsburg, California
Lady Evelyn River	sourceConfluencePlace	Unorganized West Timiskaming District
Bybrook River	sourceConfluencePlace	Castle Combe
River Cladagh (Swanlinbar)	sourceConfluencePlace	Irish grid reference system
Dreisam	sourceConfluencePlace	Kirchzarten
Danube	sourceConfluencePlace	Donaueschingen
American River	sourceConfluencePlace	Folsom, California
Clearwater River (Idaho)	sourceConfluencePlace	Idaho County, Idaho
Siston Brook	sourceConfluencePlace	Siston
Whitelake River	sourceConfluencePlace	Pilton, Somerset
Sorraia River	sourceConfluencePlace	Couço
Cow Creek (South Umpqua River)	sourceConfluencePlace	Umpqua National Forest
Corte Madera Creek (Marin County, California)	sourceConfluencePlace	Ross, California
Holly River	sourceConfluencePlace	Braxton County, West Virginia
San Anselmo Creek	sourceConfluencePlace	Ross, California
