PAMELA ANDERSON	SUCCEEDED	DEBORAH DRIGGS
NICOLE, ERICA AND JACLYN DAHM	SUCCEEDED	JAIME BERGMAN
JAYNE MANSFIELD	SUCCEEDED	MARILYN WALTZ
KELLY MONACO	SUCCEEDED	LINN THOMAS
STELLA STEVENS	SUCCEEDED	SUSIE SCOTT
MELISSA HOLLIDAY	SUCCEEDED	LISA MARIE SCOTT
LISA MARIE SCOTT	SUCCEEDED	STACY SANCHES
LENA SöDERBERG	SUCCEEDED	MERCY ROONEY
NICOLE MARIE LENZ	SUCCEEDED	BRANDE RODERICK
KAREN MCDOUGAL	SUCCEEDED	HEATHER KOZAR
NIKKI ZIERING	SUCCEEDED	LAYLA ROBERTS
TERI WEIGEL	SUCCEEDED	CHRISTINE RICHTERS
RENEE TENISON	SUCCEEDED	PETRA VERKAIK
ALICIA RICKTER	SUCCEEDED	HOLLY WITT
REBECCA FERRATTI	SUCCEEDED	LYNNE AUSTIN
LINDSEY VUOLO	SUCCEEDED	SHANNA MOAKLER
VICTORIA ZDROK	SUCCEEDED	DONNA PERRY
SHANNA MOAKLER	SUCCEEDED	NICOLE NARAIN
ANGEL BORIS	SUCCEEDED	JESSICA LEE
DAPHNéE DUPLAIX	SUCCEEDED	KALIN OLSON
CARRIE STEVENS	SUCCEEDED	DAPHNéE DUPLAIX
LILLIAN MüLLER	SUCCEEDED	MESINA MILLER
ELISA BRIDGES	SUCCEEDED	MELISSA HOLLIDAY
HEATHER KOZAR	SUCCEEDED	LIST OF PLAYBOY PLAYMATES OF 1998
COLLEEN SHANNON	SUCCEEDED	ALIYA WOLF
LISA DERGAN PODSEDNIK	SUCCEEDED	ANGELA LITTLE
SHAE MARKS	SUCCEEDED	LIST OF PLAYBOY PLAYMATES OF 1994
LIV LINDELAND	SUCCEEDED	WILLY REY
LINN THOMAS	SUCCEEDED	CARRIE STEVENS
LAUREN ANDERSON	SUCCEEDED	CHRISTINA SANTIAGO
STACY ARTHUR	SUCCEEDED	CRISTY THOM
LYNNE AUSTIN	SUCCEEDED	AVA FABIAN
TINA BOCKRATH	SUCCEEDED	BONNIE MARINO
BRANDI BRANDT	SUCCEEDED	PAMELA STEIN
FAWNA MACLAREN	SUCCEEDED	SIMONE EDEN
JODI ANN PATERSON	SUCCEEDED	CARA WAKELIN
KARI KENNELL	SUCCEEDED	SUSIE OWENS
CHRISTA SPECK	SUCCEEDED	JEAN CANNON
STACY SANCHES	SUCCEEDED	DANELLE FOLTA
VICTORIA VETRI	SUCCEEDED	REAGAN WILSON
JANET PILGRIM	SUCCEEDED	PAT LAWLER
JANET PILGRIM	SUCCEEDED	LYNN TURNER
JANET PILGRIM	SUCCEEDED	BETTY BLUE
JENNIFER LEROY	SUCCEEDED	KIMBERLY DONLEY
MARINA BAKER	SUCCEEDED	ANNA CLARK
SUSIE OWENS	SUCCEEDED	ELOISE BROADY
CORINNA HARNEY	SUCCEEDED	SAMANTHA DORMAN
TIFFANY FALLON	SUCCEEDED	DESTINY DAVIS
JENNIFER LYN JACKSON	SUCCEEDED	MONIQUE NOEL
DIANA LEE	SUCCEEDED	EMILY ARTH
MONIQUE NOEL	SUCCEEDED	TAWNNI CABLE
JENNIFER WALCOTT	SUCCEEDED	DALENE KURTIS
CYNTHIA WOOD	SUCCEEDED	BONNIE LARGE
MARTHA SMITH	SUCCEEDED	PHYLLIS COLEMAN
DENISE MICHELE	SUCCEEDED	PATRICIA MCCLAIN
PILAR LASTRA	SUCCEEDED	SCARLETT KEEGAN
VICTORIA FULLER	SUCCEEDED	KONA CARMACK
DEANNA BROOKS	SUCCEEDED	MARIA LUISA GIL
TERI HARRISON	SUCCEEDED	SERRIA TAWAN
HELLE MICHAELSEN	SUCCEEDED	LAURA RICHMOND
SHARRY KONOPSKI	SUCCEEDED	GWEN HAJEK
JENNIFER LAVOIE	SUCCEEDED	CARRIE WESTCOTT
YVETTE VICKERS	SUCCEEDED	LIST OF PLAYBOY PLAYMATES OF 1959
PIA REYES	SUCCEEDED	KATA KäRKKäINEN
ANGELA LITTLE	SUCCEEDED	VANESSA GLEASON
KATARIINA SOURI	SUCCEEDED	FAWNA MACLAREN
ALEXANDRIA KARLSEN	SUCCEEDED	NATALIA SOKOLOVA
JENNIFER ROVERO	SUCCEEDED	REBECCA SCOTT
KERISSA FARE	SUCCEEDED	NICHOLE VAN CROFT
IRINA VORONINA	SUCCEEDED	LAUREN MICHELLE HILL
NICOLE NARAIN	SUCCEEDED	ANKA ROMENSKY
STEPHANIE HEINRICH	SUCCEEDED	LINDSEY VUOLO
JANICE PENNINGTON	SUCCEEDED	LIEKO ENGLISH
KRISTINE HANSON	SUCCEEDED	ESTER CORDET
SERRIA TAWAN	SUCCEEDED	LANI TODD
MARY COLLINSON	SUCCEEDED	AVIS MILLER
MADELEINE COLLINSON	SUCCEEDED	AVIS MILLER
SHALLAN MEIERS	SUCCEEDED	TERI HARRISON
DEBRA JO FONDREN	SUCCEEDED	KRISTINE WINDER
MARIANNE GRAVATTE	SUCCEEDED	MARLENE JANSSEN
HIROMI OSHIMA	SUCCEEDED	STEPHANIE GLASSON
TAMARA WITMER	SUCCEEDED	VANESSA HOELSHER
CYNTHIA BRIMHALL	SUCCEEDED	PAMELA SAUNDERS
CHINA LEE	SUCCEEDED	ASTRID SCHULZ
CLAUDIA JENNINGS	SUCCEEDED	GLORIA ROOT
LEE ANN MICHELLE	SUCCEEDED	DENISE MCCONNELL
DEVIN DEVASQUEZ	SUCCEEDED	HOPE MARIE CARLTON
AVA FABIAN	SUCCEEDED	REBEKKA ARMSTRONG
JENNIFER JACKSON	SUCCEEDED	SUE HAMILTON
HEIDI MARK	SUCCEEDED	RACHEL JEáN MARTEEN
SUSAN KIGER	SUCCEEDED	STAR STOWE
CANDY LOVING	SUCCEEDED	LEE ANN MICHELLE
KARA MONACO	SUCCEEDED	QIANA CHASE
ALLISON PARKS	SUCCEEDED	PAT RUSSO
DIANNE CHANDLER	SUCCEEDED	LINDA MOON
KATHY SHOWER	SUCCEEDED	DEVIN DEVASQUEZ
VICKI IOVINE	SUCCEEDED	URSULA BUCHFELLNER
PENNY BAKER	SUCCEEDED	JUSTINE GREINER
COLLEEN FARRINGTON	SUCCEEDED	MARLENE CALLAHAN
CYNTHIA MYERS	SUCCEEDED	LESLIE BIANCHINI
KARIN TAYLOR	SUCCEEDED	ANGEL BORIS
KAREN PRICE	SUCCEEDED	VICKI LASSETER
JO COLLINS	SUCCEEDED	SALLY DUBERSON
JOANNE ARNOLD	SUCCEEDED	MARGIE HARRISON
KATIE LOHMANN	SUCCEEDED	CRISTA NICOLE
TINA MARIE JORDAN	SUCCEEDED	HEATHER CAROLIN
EVE MEYER	SUCCEEDED	JANET PILGRIM
MARA CORDAY	SUCCEEDED	JOAN STALEY
CONNIE KRESKI	SUCCEEDED	NANCY HARWOOD
SHAY KNUTH	SUCCEEDED	JEAN BELL
SUE HAMILTON	SUCCEEDED	MARIA MCBANE
GLORIA ROOT	SUCCEEDED	JILL TAYLOR
JESSICA ST. GEORGE	SUCCEEDED	JENNIFER JACKSON
JEAN BELL	SUCCEEDED	CLAUDIA JENNINGS
REAGAN WILSON	SUCCEEDED	KAYA CHRISTIAN
JOEY GIBSON	SUCCEEDED	HEATHER RYAN
ANNE RANDALL	SUCCEEDED	JOEY GIBSON
LISA BAKER	SUCCEEDED	SUSAN BERNARD
SUSAN DENBERG	SUCCEEDED	DIANNE CHANDLER
KELLY BURKE	SUCCEEDED	TISH HOWARD
KARLA CONWAY	SUCCEEDED	DOLLY READ
MELINDA WINDSOR	SUCCEEDED	PRISCILLA WRIGHT
WILLY REY	SUCCEEDED	CYNTHIA HALL
MARIA MCBANE	SUCCEEDED	HEDY SCOTT
PATTI REYNOLDS	SUCCEEDED	ALLISON PARKS
HEDY SCOTT	SUCCEEDED	GAY COLLIER
ASHLYN MARTIN	SUCCEEDED	TERRI KIMBALL
DONNA MICHELLE	SUCCEEDED	SHARON ROGERS
CHRISTINE WILLIAMS	SUCCEEDED	TERRE TUCKER
CONNIE MASON	SUCCEEDED	CARRIE ENWRIGHT
SHARON CINTRON	SUCCEEDED	CONNIE MASON
DOLLY MARTIN	SUCCEEDED	KELLY BURKE
PAT SHEEHAN	SUCCEEDED	JOAN STALEY
MARILYN COLE	SUCCEEDED	P. J. LANSING
JUNE COCHRAN	SUCCEEDED	JUDI MONTEREY
DELORES WELLS	SUCCEEDED	TEDDI SMITH
AVIS KIMBLE	SUCCEEDED	JUNE COCHRAN
MERLE PERTILE	SUCCEEDED	KARI KNUDSEN
MARYA CARTER	SUCCEEDED	MERISSA MATHES
AZIZI JOHARI	SUCCEEDED	LYNN SCHILLER
LINNé AHLSTRAND	SUCCEEDED	LIST OF PLAYBOY PLAYMATES OF 1958
JOYCE NIZZARI	SUCCEEDED	VIRGINIA GORDON
MARIANNE GABA	SUCCEEDED	LIST OF PLAYBOY PLAYMATES OF 1959
INGEBORG SøRENSEN	SUCCEEDED	VICTORIA CUNNINGHAM
NEVA GILBERT	SUCCEEDED	ARLINE HUNTER
CAROL EDEN	SUCCEEDED	CONNIE COOPER
URSULA BUCHFELLNER	SUCCEEDED	SYLVIE GARANT
VICKI PETERS	SUCCEEDED	DEANNA BAKER
JUNE BLAIR	SUCCEEDED	SALLY TODD
JOAN STALEY	SUCCEEDED	JOYCE NIZZARI
SHARON CLARK	SUCCEEDED	DEBBIE ELLISON
MARILYN HANOLD	SUCCEEDED	YVETTE VICKERS
SHARON JOHANSEN	SUCCEEDED	LENA SöDERBERG
CHRIS CRANSTON	SUCCEEDED	JANICE PENNINGTON
SARA JEAN UNDERWOOD	SUCCEEDED	NICOLE VOSS
ARLINE HUNTER	SUCCEEDED	JACKIE RAINBOW
JEAN MOORHEAD	SUCCEEDED	LIST OF PLAYBOY PLAYMATES OF 1955
MARIAN STAFFORD	SUCCEEDED	RUSTY FISHER
BETTY BLUE	SUCCEEDED	LISA WINTERS
SALLY TODD	SUCCEEDED	SANDRA EDWARDS
SAUNDRA EDWARDS	SUCCEEDED	GLORIA WINDSOR
ELIZABETH ANN ROBERTS	SUCCEEDED	CHERYL KUBERT
ANULKA DZIUBINSKA	SUCCEEDED	RUTHY ROSS
FELICIA ATKINS	SUCCEEDED	LARI LAINE
CORINNE COLE	SUCCEEDED	JUDY LEE TOMERLIN
TERI HOPE	SUCCEEDED	MARA CORDAY
TERI HOPE	SUCCEEDED	PAT SHEEHAN
VIRGINIA GORDON	SUCCEEDED	LIST OF PLAYBOY PLAYMATES OF 1959
ELLEN MICHAELS	SUCCEEDED	VICKI PETERS
MONICA TIDWELL	SUCCEEDED	CHRISTINE MADDOX
JULIE MCCULLOUGH	SUCCEEDED	KIM MORRIS
SANDY JOHNSON	SUCCEEDED	CAROL VITALE
JEANE MANSON	SUCCEEDED	KRISTINE HANSON
DAINA HOUSE	SUCCEEDED	LAURA LYONS
LAURA LYONS	SUCCEEDED	ANN PENNINGTON
PATRICIA MCCLAIN	SUCCEEDED	DEBRA PETERSON
STAR STOWE	SUCCEEDED	NICKI THOMAS
ASHLEY COX	SUCCEEDED	DEBRA JENSEN
DEBRA JENSEN	SUCCEEDED	JANIS SCHMITT
PAMELA BRYANT	SUCCEEDED	KATHRYN MORRISON
ROSANNE KATON	SUCCEEDED	MARCY HANSON
TERI PETERSON	SUCCEEDED	VICTORIA COOKE
KAREN WITTER	SUCCEEDED	LINDA RHYS VAUGHN
LYNDA WIESMEIER	SUCCEEDED	CATHY ST. GEORGE
PRISCILLA TAYLOR	SUCCEEDED	GILLIAN BONNER
EUGENA WASHINGTON	SUCCEEDED	LIST OF PLAYBOY PLAYMATES OF 2016
JAYDE NICOLE	SUCCEEDED	HEATHER RENE SMITH
HEATHER RENE SMITH	SUCCEEDED	TYRAN RICHARD
ANN PENNINGTON	SUCCEEDED	DENISE MICHELE
TAMARA SKY	SUCCEEDED	PATRICE HOLLIS
JENNY MCCARTHY	SUCCEEDED	JULIANNA YOUNG
LAURA CROFT	SUCCEEDED	LIST OF PLAYBOY PLAYMATES OF 2008
IDA LJUNGQVIST	SUCCEEDED	REGINA DEUTINGER
JULIETTE FRETTé	SUCCEEDED	LAURA CROFT
JANINE HABECK	SUCCEEDED	JORDAN MONROE
KRISTINA AND KARISSA SHANNON	SUCCEEDED	KIMBERLY PHILLIPS
DASHA ASTAFIEVA	SUCCEEDED	JESSICA BURCIAGA
HOPE DWORACZYK	SUCCEEDED	CRYSTAL MCCAHILL
CRYSTAL HEFNER	SUCCEEDED	JAIME FAITH EDMONDSON
DIANE WEBBER	SUCCEEDED	EVE MEYER
DIANE WEBBER	SUCCEEDED	MARIAN STAFFORD
KRISTA KELLY	SUCCEEDED	NICOLE WHITEHEAD
LIST OF PLAYBOY PLAYMATES OF 1955	SUCCEEDED	JANET PILGRIM
LIST OF PLAYBOY PLAYMATES OF 1957	SUCCEEDED	DAWN RICHARD
LIST OF PLAYBOY PLAYMATES OF 1963	SUCCEEDED	SHARON ROGERS
LIST OF PLAYBOY PLAYMATES OF 1965	SUCCEEDED	PAT RUSSO
LIST OF PLAYBOY PLAYMATES OF 1989	SUCCEEDED	LISA MATTHEWS
STEPHANIE ADAMS	SUCCEEDED	BARBARA MOORE
ANNA SOPHIA BERGLUND	SUCCEEDED	KYLIE JOHNSON
PAMELA ANNE GORDON	SUCCEEDED	ROBERTA LANE
