MACQUARIE UNIVERSITY	VICECHANCELLOR	S BRUCE DOWTON
MOUNT SAINT VINCENT UNIVERSITY	VICECHANCELLOR	RAMONA LUMPKIN
SIMON FRASER UNIVERSITY	VICECHANCELLOR	ANDREW PETTER
UNIVERSITY OF OXFORD	VICECHANCELLOR	LOUISE RICHARDSON
UNIVERSITY OF SYDNEY	VICECHANCELLOR	MICHAEL SPENCE
UNIVERSITY OF CANTERBURY	VICECHANCELLOR	ROD CARR
VICTORIA UNIVERSITY OF WELLINGTON	VICECHANCELLOR	GRANT GUILFORD
MANCHESTER METROPOLITAN UNIVERSITY	VICECHANCELLOR	MALCOLM PRESS
UNIVERSITY OF LONDON	VICECHANCELLOR	SIR ADRIAN SMITH
UNIVERSITY OF BRISTOL	VICECHANCELLOR	HUGH R. BRADY
UNIVERSITY OF WARWICK	VICECHANCELLOR	STUART CROFT
UNIVERSITY OF FORT HARE	VICECHANCELLOR	MVUYO TOM
JEWISH THEOLOGICAL SEMINARY OF AMERICA	VICECHANCELLOR	MARC GARY
MASSEY UNIVERSITY	VICECHANCELLOR	STEVE MAHAREY
AUSTRALIAN CATHOLIC UNIVERSITY	VICECHANCELLOR	GREG CRAVEN
UNIVERSITY OF OTAGO	VICECHANCELLOR	HARLENE HAYNE
UNIVERSITY OF SOUTHAMPTON	VICECHANCELLOR	SIR
UNIVERSITY OF SOUTHAMPTON	VICECHANCELLOR	CHRISTOPHER SNOWDEN
UNIVERSITY OF NEW SOUTH WALES	VICECHANCELLOR	IAN JACOBS
MONASH UNIVERSITY	VICECHANCELLOR	MARGARET GARDNER,
UNIVERSITY OF BATH	VICECHANCELLOR	GLYNIS BREAKWELL
UNIVERSITY OF YORK	VICECHANCELLOR	KOEN LAMBERTS
UNIVERSITY OF LIVERPOOL	VICECHANCELLOR	PROFESSOR JANET BEER
OPEN UNIVERSITY	VICECHANCELLOR	PETER HORROCKS
LA TROBE UNIVERSITY	VICECHANCELLOR	JOHN DEWAR
UNIVERSITY OF QUEENSLAND	VICECHANCELLOR	PETER HøJ
UNIVERSITY OF LEEDS	VICECHANCELLOR	ALAN LANGLANDS
UNIVERSITY OF EAST ANGLIA	VICECHANCELLOR	DAVID RICHARDSON
DE MONTFORT UNIVERSITY	VICECHANCELLOR	DOMINIC SHELLARD
QUEENSLAND UNIVERSITY OF TECHNOLOGY	VICECHANCELLOR	PROFESSOR PETER COALDRAKE
NEWCASTLE UNIVERSITY	VICECHANCELLOR	CHRIS BRINK
UNIVERSITY OF KENT	VICECHANCELLOR	DAME
UNIVERSITY OF KENT	VICECHANCELLOR	JULIA GOODFELLOW
UNIVERSITY OF ADELAIDE	VICECHANCELLOR	WARREN BEBBINGTON
UNIVERSITY OF BIRMINGHAM	VICECHANCELLOR	SIR DAVID EASTWOOD
ASTON UNIVERSITY	VICECHANCELLOR	ALEC CAMERON
HALMSTAD UNIVERSITY, SWEDEN	VICECHANCELLOR	MIKAEL ALEXANDERSSON
MIDDLESEX UNIVERSITY	VICECHANCELLOR	PROFESSOR TIM BLACKMAN
UNIVERSITY OF SALFORD	VICECHANCELLOR	HELEN MARSHALL
UNIVERSITY OF HONG KONG	VICECHANCELLOR	PETER MATHIESON
CHINESE UNIVERSITY OF HONG KONG	VICECHANCELLOR	JOSEPH SUNG
UNIVERSITY OF THE WEST OF ENGLAND	VICECHANCELLOR	STEVEN WEST
AUCKLAND UNIVERSITY OF TECHNOLOGY	VICECHANCELLOR	DEREK MCCORMACK
LINCOLN UNIVERSITY	VICECHANCELLOR	PROFESSOR ROBIN POLLARD
UNIVERSITY OF AUCKLAND	VICECHANCELLOR	STUART MCCUTCHEON
AUSTRALIAN NATIONAL UNIVERSITY	VICECHANCELLOR	BRIAN SCHMIDT
CHARLES DARWIN UNIVERSITY	VICECHANCELLOR	SIMON MADDOCKS
WESTERN SYDNEY UNIVERSITY	VICECHANCELLOR	BARNEY GLOVER
UNIVERSITY OF SHEFFIELD	VICECHANCELLOR	SIR KEITH BURNETT
SHEFFIELD HALLAM UNIVERSITY	VICECHANCELLOR	CHRIS HUSBANDS
LANCASTER UNIVERSITY	VICECHANCELLOR	MARK SMITH
UNIVERSITY OF WALES	VICECHANCELLOR	MEDWIN HUGHES
UNIVERSITY OF THE WITWATERSRAND	VICECHANCELLOR	PROFESSOR ADAM HABIB
QUEEN'S UNIVERSITY BELFAST	VICECHANCELLOR	PATRICK JOHNSTON
UNIVERSITY OF ESSEX	VICECHANCELLOR	PROFESSOR ANTHONY FORSTER
UNIVERSITY OF SOUTH AUSTRALIA	VICECHANCELLOR	DAVID LLOYD
CARDIFF UNIVERSITY	VICECHANCELLOR	COLIN RIORDAN
LOUGHBOROUGH UNIVERSITY	VICECHANCELLOR	ROBERT ALLISON
UNIVERSITY OF ZIMBABWE	VICECHANCELLOR	PROF LEVI NYAGURA
DARUL ULOOM DEOBAND	VICECHANCELLOR	MUFTI ABUL QASIM NOMANI
UNIVERSITY OF MELBOURNE	VICECHANCELLOR	GLYN DAVIS
UNIVERSITY OF BRADFORD	VICECHANCELLOR	BRIAN CANTOR
LONDON SOUTH BANK UNIVERSITY	VICECHANCELLOR	DAVID ANDREW PHOENIX
LIVERPOOL JOHN MOORES UNIVERSITY	VICECHANCELLOR	NIGEL WEATHERILL
UNIVERSITY OF ROEHAMPTON	VICECHANCELLOR	PAUL O'PREY
UNIVERSITY OF CANBERRA	VICECHANCELLOR	STEPHEN PARKER,
UNIVERSITY OF NOTTINGHAM MALAYSIA CAMPUS	VICECHANCELLOR	DAVID GREENAWAY
OXFORD BROOKES UNIVERSITY	VICECHANCELLOR	ALISTAIR FITT
ULSTER UNIVERSITY	VICECHANCELLOR	PADDY NIXON
UNIVERSITY OF WOLLONGONG	VICECHANCELLOR	PAUL WELLINGS
UNIVERSITY OF WOLLONGONG	VICECHANCELLOR	COMMANDER OF THE MOST EXCELLENT ORDER OF THE BRITISH EMPIRE
UNIVERSITY OF READING	VICECHANCELLOR	DAVID ROBERT BELL
OPEN UNIVERSITY OF SRI LANKA	VICECHANCELLOR	PROF. S.A. ARIADURAI
UNIVERSITY OF HERTFORDSHIRE	VICECHANCELLOR	QUINTIN MCKELLAR
RMIT UNIVERSITY	VICECHANCELLOR	MARTIN G. BEAN
UNIVERSITY OF CALCUTTA	VICECHANCELLOR	ASHUTOSH GHOSH
BANGLADESH UNIVERSITY OF ENGINEERING AND TECHNOLOGY	VICECHANCELLOR	SAIFUL ISLAM
UNIVERSITY OF HULL	VICECHANCELLOR	CALIE PISTORIUS
UNIVERSITY OF NOTRE DAME AUSTRALIA	VICECHANCELLOR	CELIA HAMMOND
UNIVERSITY OF TASMANIA	VICECHANCELLOR	PETER RATHJEN
DEAKIN UNIVERSITY	VICECHANCELLOR	JANE DEN HOLLANDER
SRI SATHYA SAI UNIVERSITY	VICECHANCELLOR	KALIDHINDI B. R. VARMA
UNIVERSITY OF CAPE TOWN	VICECHANCELLOR	DR MAX PRICE
UNIVERSITY OF KWAZULU-NATAL	VICECHANCELLOR	DR. ALBERT VAN JAARSVELD
PRESIDENCY UNIVERSITY, KOLKATA	VICECHANCELLOR	DR. ANURADHA LOHIA
UNIVERSITY OF BUCKINGHAM	VICECHANCELLOR	ANTHONY SELDON
UNIVERSITY OF ENGINEERING AND TECHNOLOGY, LAHORE	VICECHANCELLOR	FAZAL AHMAD KHALID
BOURNEMOUTH UNIVERSITY	VICECHANCELLOR	JOHN VINNEY
UNIVERSITY OF DERBY	VICECHANCELLOR	KATHRYN MITCHELL
CRANFIELD UNIVERSITY	VICECHANCELLOR	PETER GREGSON
UNIVERSITY OF GLOUCESTERSHIRE	VICECHANCELLOR	STEPHEN MARSTON
UNIVERSITY OF HUDDERSFIELD	VICECHANCELLOR	BOB CRYAN
LEEDS BECKETT UNIVERSITY	VICECHANCELLOR	PETER SLEE
UNIVERSITY OF LINCOLN	VICECHANCELLOR	MARY STUART
UNIVERSITY OF WEST LONDON	VICECHANCELLOR	PETER JOHN
BIRKBECK, UNIVERSITY OF LONDON	VICECHANCELLOR	SIR ADRIAN SMITH
EDITH COWAN UNIVERSITY	VICECHANCELLOR	STEVE CHAPMAN
QUAID-I-AZAM UNIVERSITY	VICECHANCELLOR	DR. JAVED ASHRAF
NORTH EASTERN HILL UNIVERSITY	VICECHANCELLOR	SRI KRISHNA SRIVASTAVA
UNIVERSITY OF BOLTON	VICECHANCELLOR	PROFESSOR GEORGE HOLMES DL
UNIVERSITY OF CHESTER	VICECHANCELLOR	TIM WHEELER
BATH SPA UNIVERSITY	VICECHANCELLOR	PROF. CHRISTINA SLADE
FEDERAL UNIVERSITY OF TECHNOLOGY AKURE	VICECHANCELLOR	PROF. BIYI DARAMOLA
UNIVERSITY OF MACEDONIA	VICECHANCELLOR	CHRISTOS KONSTANTATOS
UNIVERSITY OF MACEDONIA	VICECHANCELLOR	HARRY PAPAPANAGOS
SUNNI CULTURAL CENTER, KARANTHUR	VICECHANCELLOR	HUSSAIN SAQAFI CHULLIKKOD
DOW UNIVERSITY OF HEALTH SCIENCES	VICECHANCELLOR	PROF. MASOOD HAMEED
ISLAMIA COLLEGE UNIVERSITY	VICECHANCELLOR	PROFESSOR DR. HABIB AHMAD
BUCKINGHAMSHIRE NEW UNIVERSITY	VICECHANCELLOR	REBECCA BUNTING
UNIVERSITY OF THE SOUTH PACIFIC	VICECHANCELLOR	RAJESH CHANDRA
JAMIA MILLIA ISLAMIA	VICECHANCELLOR	PROF. TALAT AHMAD
UNIVERSITY OF LONDON INSTITUTE IN PARIS	VICECHANCELLOR	ADRIAN SMITH
UNIVERSITY OF BOTSWANA	VICECHANCELLOR	THABO FAKO
UNIVERSITY OF JOHANNESBURG	VICECHANCELLOR	IHRON RENSBURG
UNIVERSITY OF THE WEST INDIES	VICECHANCELLOR	SIR HILARY BECKLES
RHODES UNIVERSITY	VICECHANCELLOR	SIZWE MABIZELA
WEST BENGAL NATIONAL UNIVERSITY OF JURIDICAL SCIENCES	VICECHANCELLOR	PROF.  P ISHWAR BHAT.
BANGLADESH AGRICULTURAL UNIVERSITY	VICECHANCELLOR	ALI AKBAR
PONTIFICAL CATHOLIC UNIVERSITY OF VALPARAíSO	VICECHANCELLOR	PBR. DIETRICH LORENZ DAIBER
UNIVERSITY OF WALES, NEWPORT	VICECHANCELLOR	STEPHEN HAGEN
CARDIFF METROPOLITAN UNIVERSITY	VICECHANCELLOR	CARA AITCHISON
UNIVERSITY OF CHITTAGONG	VICECHANCELLOR	IFTEKHAR UDDIN CHOWDHURY
INTERNATIONAL MEDICAL UNIVERSITY	VICECHANCELLOR	ABDUL AZIZ BABA
MBM ENGINEERING COLLEGE	VICECHANCELLOR	VICE CHANCELLOR OF JNVU
LIVERPOOL HOPE UNIVERSITY	VICECHANCELLOR	GERALD J. PILLAY
TOKYO UNIVERSITY OF THE ARTS	VICECHANCELLOR	KENJI WATANABE
JAWAHARLAL NEHRU UNIVERSITY, DELHI	VICECHANCELLOR	MAMIDALA JAGADESH KUMAR
UNIVERSITY OF ZAMBIA	VICECHANCELLOR	PROFESSOR LUKE EVUTA MUMBA
MAGEE COLLEGE	VICECHANCELLOR	PROFESSOR PADDY NIXON
COMILLAS PONTIFICAL UNIVERSITY	VICECHANCELLOR	REV. JOAQUíN BARRERO DíAZ, SJ
UNIVERSITY OF COLOMBO	VICECHANCELLOR	LAKSHMAN DISSANAYAKE
UNIVERSITY OF THE PUNJAB	VICECHANCELLOR	MUJAHID KAMRAN
BOND UNIVERSITY	VICECHANCELLOR	TIM BRAILSFORD
UNIVERSITY OF RAJSHAHI	VICECHANCELLOR	MUHAMMAD MIZANUDDIN
UNIVERSITY OF GHANA	VICECHANCELLOR	EBENEZER ODURO OWUSU
NORTH SOUTH UNIVERSITY	VICECHANCELLOR	ATIQUL ISLAM
ST MARY'S UNIVERSITY, TWICKENHAM	VICECHANCELLOR	FRANCIS CAMPBELL
KONSTFACK	VICECHANCELLOR	MARIA LANTZ
UNIVERSITY OF TECHNOLOGY, MALAYSIA	VICECHANCELLOR	PROFESSOR DATUK IR. DR. WAHID OMAR
ISLAMIA UNIVERSITY	VICECHANCELLOR	QAISER MUSHTAQ
ADEKUNLE AJASIN UNIVERSITY	VICECHANCELLOR	PROFESSOR IGBEKELE AMOS AJIBEFUN
ISLAMIC UNIVERSITY IN UGANDA	VICECHANCELLOR	AHMAD SSENGENDO
UNIVERSITY OF LIMPOPO	VICECHANCELLOR	PROF. MAHLO MOKGALONG
UNIVERSITY OF KHARTOUM	VICECHANCELLOR	PROF. AHMED MOHAMED SULEIMAN\NPRECEDED BY PROF. ELSIDDIG AHMED ELMUSTAFA
SHAHJALAL UNIVERSITY OF SCIENCE AND TECHNOLOGY	VICECHANCELLOR	MD AMINUL HAQUE BHUYAN
JAHANGIRNAGAR UNIVERSITY	VICECHANCELLOR	FARZANA ISLAM
IT UNIVERSITY OF COPENHAGEN	VICECHANCELLOR	MADS TOFTE
UNIVERSITY OF LAGOS	VICECHANCELLOR	PROFESSOR RAHMON ADE BELLO
UNIVERSITY OF PIURA	VICECHANCELLOR	MONS. EMILIO ARIZMENDI ECHECOPAR
MBARARA UNIVERSITY OF SCIENCE AND TECHNOLOGY	VICECHANCELLOR	CELESTINO OBUA
NDEJJE UNIVERSITY	VICECHANCELLOR	PROF. ERIABU LUGUJJO
MAKERERE UNIVERSITY	VICECHANCELLOR	JOHN DDUMBA SSENTAMU
NKUMBA UNIVERSITY	VICECHANCELLOR	PROF. HANNINGTON SENGENDO
PAPUA NEW GUINEA UNIVERSITY OF TECHNOLOGY	VICECHANCELLOR	ALBERT SCHRAM
UNIVERSITY OF IBADAN	VICECHANCELLOR	ABEL IDOWU OLAYINKA GET
UNIVERSITY FOR THE CREATIVE ARTS	VICECHANCELLOR	PROFESSOR SIMON OFIELD-KERR PHD FRSA
LAGOS STATE UNIVERSITY	VICECHANCELLOR	OLANREWAJU FAGBOHUN
UNIVERSITY OF CAPE COAST	VICECHANCELLOR	PROF. JOSEPH GHARTEY AMPIAH
UNIVERSITY OF ZULULAND	VICECHANCELLOR	NTOMB'FIKILE MAZIBUKO
KWAME NKRUMAH UNIVERSITY OF SCIENCE AND TECHNOLOGY	VICECHANCELLOR	PROFESSOR KWASI OBIRI-DANSO
GURU GOBIND SINGH INDRAPRASTHA UNIVERSITY	VICECHANCELLOR	ANIL KUMAR TYAGI
SIDDHARTHA UNIVERSITY	VICECHANCELLOR	DR. BHIKKHU SUNANDA MAHASTHAVIRA
UNIVERSITY OF KELANIYA	VICECHANCELLOR	PROF. SUNANDA MADDUMA BANDARA
UNIVERSITY OF ENGINEERING AND TECHNOLOGY, PESHAWAR	VICECHANCELLOR	DR. IFTIKHAR HUSSAIN
KING EDWARD MEDICAL UNIVERSITY	VICECHANCELLOR	FAISAL MASUD
UNIVERSITY OF NORTHAMPTON	VICECHANCELLOR	NICK PETFORD
RIVERS STATE UNIVERSITY OF SCIENCE AND TECHNOLOGY	VICECHANCELLOR	BLESSING DIDIA
UNIVERSITY OF NAMIBIA	VICECHANCELLOR	PROF. LAZARUS HANGULA
UNIVERSITY OF WINCHESTER	VICECHANCELLOR	JOY CARTER
NATIONAL UNIVERSITY OF KAOHSIUNG	VICECHANCELLOR	PAO-TIAO, CHUANG AND HSING-LUNG, LIEN
TWINTECH INTERNATIONAL UNIVERSITY COLLEGE OF TECHNOLOGY	VICECHANCELLOR	PROFESSOR DATO' DR. MOHD RAZALI AGUS
UNIVERSITY OF ASIA PACIFIC	VICECHANCELLOR	JAMILUR REZA CHOUDHURY
BETHLEHEM UNIVERSITY	VICECHANCELLOR	BROTHER PETER BRAY
NALSAR UNIVERSITY OF LAW	VICECHANCELLOR	FAIZAN MUSTAFA
OBAFEMI AWOLOWO UNIVERSITY	VICECHANCELLOR	PROFESSOR ANTHONY ELUJOBA
COLLEGE OF DIGITAL SCIENCES	VICECHANCELLOR	HANIF AKHTAR
AL JAMEA TUS SAIFIYAH	VICECHANCELLOR	DR. SYEDNA ALIQADR MUFADDAL SAIFUDDIN
BAYERO UNIVERSITY KANO	VICECHANCELLOR	MUHAMMAD YAHUZA BELLO
UNIVERSITY OF CHICHESTER	VICECHANCELLOR	CLIVE BEHAGG
FALMOUTH UNIVERSITY	VICECHANCELLOR	ANNE CARLISLE
FACULTY OF MEDICINE, UNIVERSITY OF COLOMBO	VICECHANCELLOR	PROFESSOR
FACULTY OF MEDICINE, UNIVERSITY OF COLOMBO	VICECHANCELLOR	KSHANIKA HIRIMBUREGAMA
DELHI TECHNOLOGICAL UNIVERSITY	VICECHANCELLOR	VICE-CHANCELLOR.PHP
REGENT'S UNIVERSITY LONDON	VICECHANCELLOR	ALDWYN COOPER
EASTERN UNIVERSITY, SRI LANKA	VICECHANCELLOR	VC-S-MESSAGE
AGRICULTURAL UNIVERSITY OF ATHENS	VICECHANCELLOR	EPAMEINONDAS PAPLOMATAS
AGRICULTURAL UNIVERSITY OF ATHENS	VICECHANCELLOR	GEORGIOS PAPADAKIS
JAMIA HAMDARD	VICECHANCELLOR	SEYED E. HASNAIN
ZIAUDDIN UNIVERSITY	VICECHANCELLOR	DR. PIRZADA QASIM
UNIVERSITY OF PERADENIYA	VICECHANCELLOR	PROF. UPUL B.DISSANAYAKE
UNIVERSITY OF BEDFORDSHIRE	VICECHANCELLOR	BILL RAMMELL
UNIVERSITY OF MALAWI	VICECHANCELLOR	PROFESSOR JOHN SAKA
ULSTER UNIVERSITY AT COLERAINE	VICECHANCELLOR	PROFESSOR PADDY NIXON
PUNJAB AGRICULTURAL UNIVERSITY	VICECHANCELLOR	BALDEV SINGH DHILLON
CENTRAL UNIVERSITY OF TECHNOLOGY	VICECHANCELLOR	PROF. HENK DE JAGER
AHSANULLAH UNIVERSITY OF SCIENCE AND TECHNOLOGY	VICECHANCELLOR	A. M. M. SAFIULLAH
UNIVERSITY OF MOSUL	VICECHANCELLOR	DR. NAZAR MAJEED QUBBA\N                   DR. ADNAN ALSAFFAWI
EDGE HILL UNIVERSITY	VICECHANCELLOR	JOHN CATER
UNIVERSITY OF ABUJA	VICECHANCELLOR	PROFESSOR PROFESSOR MICHAEL UMALE ADIKWU
BAHAUDDIN ZAKARIYA UNIVERSITY	VICECHANCELLOR	MUHAMMAD NAEEEM
MICHAEL OKPARA UNIVERSITY OF AGRICULTURE	VICECHANCELLOR	FRANCIS OTUNTA
UNIVERSITY OF ST MARK & ST JOHN	VICECHANCELLOR	CARA AITCHISON
DARUL HUDA ISLAMIC UNIVERSITY	VICECHANCELLOR	BAHAUDDEEN MUHAMMED NADWI
FEDERAL CENTER FOR TECHNOLOGICAL EDUCATION OF RIO DE JANEIRO	VICECHANCELLOR	MAURICIO MOTTA
ANIL NEERUKONDA INSTITUTE OF TECHNOLOGY AND SCIENCES	VICECHANCELLOR	G S N RAJU, ANDHRA UNIVERSITY
MIDLANDS STATE UNIVERSITY	VICECHANCELLOR	NGWABI BHEBE
JAYPEE UNIVERSITY OF INFORMATION TECHNOLOGY	VICECHANCELLOR	PROF. S. K. KAK
MIZORAM UNIVERSITY	VICECHANCELLOR	PROF R. LALTHANTLUANGA
GIRNE AMERICAN UNIVERSITY	VICECHANCELLOR	ASSOC. PROF. DR. ASIM VEHBI
UGANDA CHRISTIAN UNIVERSITY	VICECHANCELLOR	JOHN SENYONYI
AMERICAN INTERNATIONAL UNIVERSITY-BANGLADESH	VICECHANCELLOR	CARMEN LAMAGNA
ASIAN UNIVERSITY OF BANGLADESH	VICECHANCELLOR	ABUL HASAN M SADEQ
STAMFORD UNIVERSITY BANGLADESH	VICECHANCELLOR	M. FEROZE AHMED
BERHAMPUR UNIVERSITY	VICECHANCELLOR	INDEX.PHP?OPTION=COM CONTENT&VIEW=ARTICLE&ID=57&ITEMID=26
UNIVERSITY OF LIBERAL ARTS BANGLADESH	VICECHANCELLOR	IMRAN RAHMAN
MAHARAJA GANGA SINGH UNIVERSITY	VICECHANCELLOR	CHANDRA KALA PADIA
DEVI AHILYA VISHWAVIDYALAYA	VICECHANCELLOR	VC.PHP
SOUTHEAST UNIVERSITY	VICECHANCELLOR	PROF. DR. ANWAR HOSSAIN
UNIVERSITY OF DEVELOPMENT ALTERNATIVE	VICECHANCELLOR	EMAJUDDIN AHAMED
JAGANNATH UNIVERSITY	VICECHANCELLOR	PROFESSOR DR. MIJANUR RAHMAN
DR. BALASAHEB SAWANT KONKAN KRISHI VIDYAPEETH	VICECHANCELLOR	DR. TAPAS BHATTACHARYYA
JUNAGADH AGRICULTURAL UNIVERSITY	VICECHANCELLOR	DR.A.R.PATHAK
UGANDA MARTYRS UNIVERSITY	VICECHANCELLOR	JOHN MAVIIRII
UNIVERSITY OF MINES AND TECHNOLOGY	VICECHANCELLOR	JERRY KUMA
UNIVERSITY OF JUBA	VICECHANCELLOR	PROF. JOHN AKECH
UNIVERSITY OF NOVA GORICA	VICECHANCELLOR	GVIDO BRATINA
UNIVERSITY OF NOVA GORICA	VICECHANCELLOR	MLADEN FRANKO
DR. RAM MANOHAR LOHIYA NATIONAL LAW UNIVERSITY	VICECHANCELLOR	GURDIP SINGH
KYAMBOGO UNIVERSITY	VICECHANCELLOR	ELLY KATUNGUKA
BINDURA UNIVERSITY OF SCIENCE EDUCATION	VICECHANCELLOR	EDDIE MWENJE
UNIVERSITY OF AGRICULTURE, MAKURDI	VICECHANCELLOR	EMMANUEL KUCHA
YOGI VEMANA UNIVERSITY	VICECHANCELLOR	PROF. SHYAM SUNDAR
PONTIFICAL JOHN PAUL II INSTITUTE FOR STUDIES ON MARRIAGE AND FAMILY	VICECHANCELLOR	DIOCESAN ORDINARY OF EACH SESSION
DEEN DAYAL UPADHYAY GORAKHPUR UNIVERSITY	VICECHANCELLOR	WEBPAGES.PHP?TAG=VICE-CHANCELLOR
BANGLADESH NATIONAL UNIVERSITY	VICECHANCELLOR	HARUN-OR-RASHID
ISLAMIC UNIVERSITY, BANGLADESH	VICECHANCELLOR	RASHID ASKARI
NAMIBIA UNIVERSITY OF SCIENCE AND TECHNOLOGY	VICECHANCELLOR	PROF. TJAMA TJIVIKUA
WORLD UNIVERSITY OF BANGLADESH	VICECHANCELLOR	ABDUL MANNAN CHOUDHURY
KING GEORGE'S MEDICAL UNIVERSITY	VICECHANCELLOR	RAVI KANT
UTTAR PRADESH UNIVERSITY OF MEDICAL SCIENCES	VICECHANCELLOR	T. PRABHAKAR
PREMIER UNIVERSITY, CHITTAGONG	VICECHANCELLOR	ANUPAM SEN
UNIVERSITY OF NOTTINGHAM NINGBO CHINA	VICECHANCELLOR	PROFESSOR DAVID GREENAWAY
SHER-E-BANGLA AGRICULTURAL UNIVERSITY	VICECHANCELLOR	PROFESSOR DR. KAMAL UDDIN AHAMED
RAJIV GANDHI UNIVERSITY	VICECHANCELLOR	PROF. TAMO MIBANG
JAI PRAKASH UNIVERSITY	VICECHANCELLOR	PROF. LOKESH CHANDRA PRASAD
KRANTIGURU SHYAMJI KRISHNA VERMA KACHCHH UNIVERSITY	VICECHANCELLOR	CHANDRASINH B JADEJA
MAHARSHI DAYANAND UNIVERSITY	VICECHANCELLOR	PROF. BIJENDER KUMAR PUNIA
BABA GHULAM SHAH BADSHAH UNIVERSITY	VICECHANCELLOR	PROF JAVED MASSARAT
BHARATH UNIVERSITY	VICECHANCELLOR	
TILAK MAHARASHTRA UNIVERSITY	VICECHANCELLOR	DEEPAK J. TILAK
HEMWATI NANDAN BAHUGUNA GARHWAL UNIVERSITY	VICECHANCELLOR	JAWAHAR LAL KAUL
JOHN PAUL II INSTITUTE	VICECHANCELLOR	DONALD WUERL
MAHATMA GANDHI ANTARRASHTRIYA HINDI VISHWAVIDYALAYA	VICECHANCELLOR	GIRISHWAR MISRA
OXFORD AVIATION ACADEMY	VICECHANCELLOR	CAPT.DAVE PRATT\N*
OXFORD AVIATION ACADEMY	VICECHANCELLOR	MULTI CREW COORDINATION
OXFORD AVIATION ACADEMY	VICECHANCELLOR	:
OXFORD AVIATION ACADEMY	VICECHANCELLOR	PILOT IN COMMAND
OXFORD AVIATION ACADEMY	VICECHANCELLOR	.LAURIE RAMAGE
OXFORD AVIATION ACADEMY	VICECHANCELLOR	*CFI: CAPT.PAUL TAYLOR
PAN AFRICA CHRISTIAN UNIVERSITY	VICECHANCELLOR	PROFESSOR MARGARET MUTHWII
GULU UNIVERSITY	VICECHANCELLOR	PEN-MOGI NYEKO
BUSITEMA UNIVERSITY	VICECHANCELLOR	MARY OKWAKOL
BANGLADESH ISLAMI UNIVERSITY	VICECHANCELLOR	ANWARULLAH CHOWDHURY
UNIVERSITI MALAYSIA SABAH	VICECHANCELLOR	PROF. DATUK DR. MOHD. HARUN BIN ABDULLAH
HONG KONG COLLEGE OF ENGINEERING	VICECHANCELLOR	MR. C M KWAN
UNIVERSITI UTARA MALAYSIA	VICECHANCELLOR	PROFESSOR DATO' DR MOHAMED MUSTAFA ISHAK
UNIVERSITY OF ILORIN	VICECHANCELLOR	ABDUL GANIYU AMBALI
BEACONHOUSE NATIONAL UNIVERSITY	VICECHANCELLOR	SHAHID HAFEEZ KARDAR
SOUTH EASTERN UNIVERSITY OF SRI LANKA	VICECHANCELLOR	PROF. M. M. M. NAJIM
RMIT UNIVERSITY VIETNAM	VICECHANCELLOR	MARTIN G. BEAN
AMRITA SCHOOL OF ENGINEERING	VICECHANCELLOR	P. VENKAT RANGAN
SIKKIM UNIVERSITY	VICECHANCELLOR	TANKA BAHADUR SUBBA
NATIONAL LAW UNIVERSITY, DELHI	VICECHANCELLOR	RANBIR SINGH
NEELAIN UNIVERSITY	VICECHANCELLOR	PROFESSOR MOHAMMED ALAMIN AHMED
CHINHOYI UNIVERSITY OF TECHNOLOGY	VICECHANCELLOR	PROFESSOR DAVID J SIMBI
KHYBER MEDICAL UNIVERSITY	VICECHANCELLOR	MUHAMMAD HAFIZULLAH
FEDERAL RURAL UNIVERSITY OF RIO DE JANEIRO	VICECHANCELLOR	ANA MARIA DANTAS SOARES
UNIVERSITY OF MAURITIUS	VICECHANCELLOR	PROFESSOR  ROMEELA MOHEE, CSK
GONO UNIVERSITY	VICECHANCELLOR	DR. MESBAHUDDIN AHMAD
G. B. PANT UNIVERSITY OF AGRICULTURE AND TECHNOLOGY	VICECHANCELLOR	SUVAM GAIROLA
RANA INSTITUTE OF HIGHER STUDIES	VICECHANCELLOR	DR.M.NAIM AZIMI
UNIVERSITY OF PRETORIA	VICECHANCELLOR	CHERYL DE LA REY
SOHAR UNIVERSITY	VICECHANCELLOR	PROFESSOR BARRY WINN
BANGOR UNIVERSITY	VICECHANCELLOR	JOHN G HUGHES
INTERNATIONAL UNIVERSITY OF MANAGEMENT	VICECHANCELLOR	VIRGINIA NAMWANDI
UNIVERSITY OF JAFFNA	VICECHANCELLOR	VASANTHY ARASARATNAM
UNIVERSITY OF WALES TRINITY SAINT DAVID	VICECHANCELLOR	MEDWIN HUGHES
BUSOGA UNIVERSITY	VICECHANCELLOR	DAVID LAMECK KIBIKYO
KABALE UNIVERSITY	VICECHANCELLOR	JOY KWESIGA
MUTEESA I ROYAL UNIVERSITY	VICECHANCELLOR	ARTHUR SSERWANGA
AFRICAN BIBLE UNIVERSITY	VICECHANCELLOR	DR. O. PALMER ROBERTSON
UNIVERSITY OF NOTTINGHAM	VICECHANCELLOR	DAVID GREENAWAY
BIRLA INSTITUTE OF MANAGEMENT TECHNOLOGY, BHUBANESWAR	VICECHANCELLOR	H. CHATURVEDI
CENTRAL UNIVERSITY OF KARNATAKA	VICECHANCELLOR	PROF. H.M. MAHESHWARAIAH
NATIONAL UNIVERSITY OF SCIENCE AND TECHNOLOGY, ZIMBABWE	VICECHANCELLOR	PROFESSOR SAMSON SIBANDA
IONIS EDUCATION GROUP	VICECHANCELLOR	FABRICE BARDECHE
IONIS EDUCATION GROUP	VICECHANCELLOR	MARC DRILLECH
UNIVERSITY OF CAMBRIDGE	VICECHANCELLOR	SIR LESZEK BORYSIEWICZ
UNIVERSITY OF PORT HARCOURT	VICECHANCELLOR	PROF. NDOKWA LALE
UNIVERSITY OF SEYCHELLES	VICECHANCELLOR	MARINA CONFAIT
UNIVERSITY OF THE ARTS LONDON	VICECHANCELLOR	NIGEL CARRINGTON
NORTH-WEST UNIVERSITY	VICECHANCELLOR	PROF DAN KGWADI
KINGSWAY CAMPUS AUCKLAND PARK	VICECHANCELLOR	IHRON RENSBURG
BHATKHANDE MUSIC INSTITUTE	VICECHANCELLOR	PRO.SHRUTI SADOLIKAR KATKAR
BUNTING ROAD CAMPUS AUCKLAND PARK	VICECHANCELLOR	IHRON RENSBURG
INSTITUTE FOR MARINE AND ANTARCTIC STUDIES	VICECHANCELLOR	PROFESSOR PETER RATHJEN
GURU TEGH BAHADUR INSTITUTE OF TECHNOLOGY	VICECHANCELLOR	ANIL KUMAR TYAGI
MEWAR UNIVERSITY	VICECHANCELLOR	MR. CHHOTU RAM CHAUDHARY
MADRASA KASHIFUL HUDA	VICECHANCELLOR	MAULANA ABDUL MAJEED SAHIB BAQAVI
UTTARAKHAND TECHNICAL UNIVERSITY	VICECHANCELLOR	PROF. P.K GARG
UNIVERSITY SCHOOL OF INFORMATION, COMMUNICATION AND TECHNOLOGY	VICECHANCELLOR	ANIL KUMAR TYAGI
NASARAWA STATE UNIVERSITY	VICECHANCELLOR	PROF. MUHAMMAD AKARO MAINOMA
KADUNA STATE UNIVERSITY	VICECHANCELLOR	PROF. WILLIAM BARNABAS QUIRIX
FOUNTAIN UNIVERSITY	VICECHANCELLOR	PROFESSOR BASHIRU ADEMOLA RAJI
DURHAM UNIVERSITY	VICECHANCELLOR	STUART CORBRIDGE
TASMANIAN INSTITUTE OF AGRICULTURE	VICECHANCELLOR	PETER RATHJEN
NOIDA INTERNATIONAL UNIVERSITY	VICECHANCELLOR	VIKRAM SINGH
UNIVERSITY SCHOOL OF CHEMICAL TECHNOLOGY	VICECHANCELLOR	ANIL KUMAR TYAGI
UNIVERSITY OF MILITARY SCIENCE AND TECHNOLOGY	VICECHANCELLOR	BRIGADIER TIMOTHY SABIITI MUTEBILE
NATIONAL UNIVERSITY OF STUDY AND RESEARCH IN LAW	VICECHANCELLOR	PROF. B.C. NIRMAL
CANTERBURY CHRIST CHURCH UNIVERSITY	VICECHANCELLOR	RAMA THIRUNAMACHANDRAN
JAMIA QURANIA ARABIA LALBAGH	VICECHANCELLOR	MUFTI FAZLUL HOQUE AMINI
AL-JAMIATUL ISLAMIAH AZIZUL ULOOM BABUNAGAR	VICECHANCELLOR	HAZRAT MAULANA MUHIBBULLAH
VICTORIA UNIVERSITY UGANDA	VICECHANCELLOR	STEPHEN ISABALIJA
UPPER NILE UNIVERSITY	VICECHANCELLOR	PROF. BOL DENG CHOL PHD
UNIVERSITY OF ENERGY AND NATURAL RESOURCES	VICECHANCELLOR	PROF MRS. ESI AWUAH
FEDERAL UNIVERSITY OF SãO JOãO DEL-REI	VICECHANCELLOR	SéRGIO AUGUSTO ARAúJO DA GAMA CERQUEIRA
UNIVERSITY OF DHAKA	VICECHANCELLOR	AAMS AREFIN SIDDIQUE
JAGADGURU RAMBHADRACHARYA HANDICAPPED UNIVERSITY	VICECHANCELLOR	PROF. YOGESH CHANDRA DUBEY
INTERNATIONAL UNIVERSITY OF AFRICA	VICECHANCELLOR	KAMAL OBEID
JOHN GARANG MEMORIAL UNIVERSITY	VICECHANCELLOR	PROF. JULIA AKER DUANY PHD
INSTITUTE OF CHEMICAL TECHNOLOGY	VICECHANCELLOR	G. D. YADAV
INSTITUTE OF CHEMICAL TECHNOLOGY	VICECHANCELLOR	FELLOW OF THE ROYAL SOCIETY OF CHEMISTRY
UNIVERSITY OF EXETER	VICECHANCELLOR	STEVE SMITH
JIANGSU SECOND NORMAL UNIVERSITY	VICECHANCELLOR	PROFESSOR 周成平 HENGPING ZHOU
MUNI UNIVERSITY	VICECHANCELLOR	CHRISTINE DRANZOA
THE EAST AFRICAN UNIVERSITY	VICECHANCELLOR	PROF.
AMRITA VISHWA VIDYAPEETHAM	VICECHANCELLOR	P. VENKAT RANGAN
UNIVERSITY OF INDIANAPOLIS – ATHENS CAMPUS	VICECHANCELLOR	SUSIE MICHAELIDIS
UNIVERSITY OF INDIANAPOLIS – ATHENS CAMPUS	VICECHANCELLOR	VASILIS KIRITSIS
UNIVERSITY OF INDIANAPOLIS – ATHENS CAMPUS	VICECHANCELLOR	DIMITRIOS LEVENDAKIS
JINDAL GLOBAL BUSINESS SCHOOL	VICECHANCELLOR	PROF. C. RAJ KUMAR
MADRASAH RIYAZUL ULOOM	VICECHANCELLOR	MAULANA ABDUL RAHEEM MAZAAHIRI
NEW YORK UNIVERSITY ABU DHABI	VICECHANCELLOR	ALFRED BLOOM
CENTRAL UNIVERSITY OF JAMMU	VICECHANCELLOR	PROF ASHOK AIMA
COVENANT UNIVERSITY	VICECHANCELLOR	AA ATAYERO
O. P. JINDAL GLOBAL UNIVERSITY	VICECHANCELLOR	C. RAJ KUMAR
NATIONAL LAW UNIVERSITY AND JUDICIAL ACADEMY, ASSAM	VICECHANCELLOR	DR. J. S. PATIL
LAHORE LEADS UNIVERSITY	VICECHANCELLOR	MAHMOOD AHMAD BODLA
ABDUL WALI KHAN UNIVERSITY MARDAN	VICECHANCELLOR	PROF. DR IHSAN ALI
SOROTI UNIVERSITY	VICECHANCELLOR	ROBERT IKOJA
UTAS FACULTY OF LAW	VICECHANCELLOR	PETER RATHJEN
HAMDARD UNIVERSITY BANGLADESH	VICECHANCELLOR	DR.TANVIR AHMED KHAN
THUNCHATH EZHUTHACHAN MALAYALAM UNIVERSITY	VICECHANCELLOR	K. JAYAKUMAR
EUROPEAN UNIVERSITY OF BANGLADESH	VICECHANCELLOR	PROF. DR. MOKBUL AHMED KHAN
RAJABAZAR SCIENCE COLLEGE	VICECHANCELLOR	SUGATA MARJIT
UNIVERSITY SCHOOL OF LAW AND LEGAL STUDIES	VICECHANCELLOR	ANIL KUMAR TYAGI
ASSAM DON BOSCO UNIVERSITY	VICECHANCELLOR	FR  STEPHEN MAVELY, SDB
NORTHWEST UNIVERSITY KANO	VICECHANCELLOR	PROFESSOR MUSTAPHA AHMAD ISAH
SOL PLAATJE UNIVERSITY	VICECHANCELLOR	YUNUS BALLIM
PRAJYOTHI NIKETAN COLLEGE	VICECHANCELLOR	M.ABDUL SALAM
FACULTY OF ENGINEERING, JAMIA MILLIA ISLAMIA	VICECHANCELLOR	TALAT AHMAD
LANDMARK UNIVERSITY	VICECHANCELLOR	PROFESSOR AIZE OBAYAN
GREGORY UNIVERSITY	VICECHANCELLOR	JULIET ELU
BAUCHI STATE UNIVERSITY	VICECHANCELLOR	PROFESSOR
BAUCHI STATE UNIVERSITY	VICECHANCELLOR	EZZELDIN MUKTAR ABDURAHMAN
LAIKIPIA UNIVERSITY	VICECHANCELLOR	PROF. FRANCIS LELO, PHD
PONTIFICIA UNIVERSIDAD CATóLICA DEL ECUADOR	VICECHANCELLOR	GILBERTO FREIRE YáNEZ, S.J.
UNIVERSITY OF MPUMALANGA	VICECHANCELLOR	PROF THOKO MAYEKISO
COLEG CYMRAEG CENEDLAETHOL	VICECHANCELLOR	ANDREW GREEN
RAJSHAHI UNIVERSITY OF ENGINEERING & TECHNOLOGY	VICECHANCELLOR	MOHD. RAFIQUL ALAM BEG
SALEM UNIVERSITY, LOKOJA	VICECHANCELLOR	JOSEPH FUWAPE
CHANDIGARH UNIVERSITY	VICECHANCELLOR	DR. R.S BAWA
INDIRA GANDHI UNIVERSITY, MEERPUR	VICECHANCELLOR	PROF. DR. S.P. BANSAL
KINGSTON UNIVERSITY	VICECHANCELLOR	JULIUS WEINBERG
JAGAN NATH UNIVERSITY, NCR	VICECHANCELLOR	H. L. VERMA
GURU RAVIDAS AYURVED UNIVERSITY	VICECHANCELLOR	PROF. OM PRAKASH UPADHYAYA
UET KSK CAMPUS	VICECHANCELLOR	FAZAL AHMAD KHALID
NFC INSTITUTE OF ENGINEERING AND FERTILIZER RESEARCH	VICECHANCELLOR	FAZAL AHMAD KHALID
AMU MALAPPURAM CAMPUS	VICECHANCELLOR	LT. GENERAL ZAMEERUD-DIN SHAH
UNIVERSITY OF KENT – SCHOOL OF SPORT & EXERCISE SCIENCES	VICECHANCELLOR	DAME
UNIVERSITY OF KENT – SCHOOL OF SPORT & EXERCISE SCIENCES	VICECHANCELLOR	JULIA GOODFELLOW
ALIGARH MUSLIM UNIVERSITY	VICECHANCELLOR	LT. GENERAL ZAMEER UDDIN SHAH
CIHAN UNIVERSITY	VICECHANCELLOR	SERWAN BABAN
UNIVERSITY OF VOCATIONAL TECHNOLOGY	VICECHANCELLOR	DR. T.A. PIYASIRI
MAHARAJA AGRASEN UNIVERSITY	VICECHANCELLOR	PROF.S.P. BANSAL
ST. AUGUSTINE INTERNATIONAL UNIVERSITY	VICECHANCELLOR	CHARITY B. MULENGA PHD
LIAQUAT UNIVERSITY OF MEDICAL AND HEALTH SCIENCES	VICECHANCELLOR	NOSHAD A. SHAIKH
UGANDA TECHNOLOGY AND MANAGEMENT UNIVERSITY	VICECHANCELLOR	PROF. VENANSIUS BARYAMUREEBA
AMRITA SCHOOL OF ENGINEERING, BENGALURU	VICECHANCELLOR	P. VENKAT RANGAN
APEX PROFESSIONAL UNIVERSITY	VICECHANCELLOR	PROF. DR. AJIT KUMAR ANANDRAO DANGE
RAMAKRISHNA MISSION VIVEKANANDA UNIVERSITY - COIMBATORE CAMPUS	VICECHANCELLOR	SWAMI ATMAPRIYANANDA, SWAMI ABHIRAMANANDA
MUHAMMAD NAWAZ SHARIF UNIVERSITY OF ENGINEERING & TECHNOLOGY	VICECHANCELLOR	DR PLAN C
UNIVERSITY OF ENGINEERING AND TECHNOLOGY, RASUL	VICECHANCELLOR	FAZAL AHMAD KHALID
KHAWAJA FAREED UNIVERSITY OF ENGINEERING AND INFORMATION TECHNOLOGY	VICECHANCELLOR	ATHAR MAHBOOB
FEDERAL UNIVERSITY DUTSE	VICECHANCELLOR	PROFESSOR FATIMA BOTOUL
FEDERAL UNIVERSITY, LOKOJA	VICECHANCELLOR	PROFESSOR ABDULMUMINI HASSAN RAFINDADI
PAKISTAN INSTITUTE OF ENGINEERING AND TECHNOLOGY	VICECHANCELLOR	ZUBAIR AHMAD KHAN
UNIVERSITY OF SWABI	VICECHANCELLOR	PROF. DR NOOR JEHAN
FATA UNIVERSITY	VICECHANCELLOR	DR. MOHAMMAD TAHIR SHAH
INFORMATION TECHNOLOGY UNIVERSITY	VICECHANCELLOR	UMAR SAIF
INDIRA GANDHI TECHNOLOGICAL AND MEDICAL SCIENCES UNIVERSITY	VICECHANCELLOR	DR.S.N.PANDEY
ATAL BIHARI VAJPAYEE HINDI VISHWAVIDYALAYA	VICECHANCELLOR	MOHAN LAL CHEEPA
CHAUDHARY RANBIR SINGH UNIVERSITY	VICECHANCELLOR	MAJOR GENERAL  RANJIT SINGH
CHHATTISGARH KAMDHENU VISHWAVIDYALAYA	VICECHANCELLOR	DR. UMESH K. MISHRA
DARUL ULOOM MAU	VICECHANCELLOR	HAFIZ ZAKI NAQSHBANDI
PACIFIC UNIVERSITY	VICECHANCELLOR	PROF. BHAGAWATI PRAKASH SHARMA
TASMANIAN SCHOOL OF BUSINESS AND ECONOMICS	VICECHANCELLOR	PETER RATHJEN
JAMIA-TUL-MADINA	VICECHANCELLOR	MUFTI MUHAMMAD QASAM QADRI
FACULTY OF SOCIAL SCIENCES, BANARAS HINDU UNIVERSITY	VICECHANCELLOR	GIRISH CHANDRA TRIPATHI
FEDERAL UNIVERSITY, OTUOKE	VICECHANCELLOR	PROF. SETH ACCRA JAJA
INSTITUTE OF SCIENCE, BANARAS HINDU UNIVERSITY	VICECHANCELLOR	GIRISH CHANDRA TRIPATHI
ADELEKE UNIVERSITY	VICECHANCELLOR	PROFESSOR OLUWOLE OLAYIWOLA AMUSAN
MUSLIM YOUTH UNIVERSITY	VICECHANCELLOR	DR. MARIA SULTAN
ONDO STATE UNIVERSITY OF MEDICAL SCIENCES	VICECHANCELLOR	PROFESSOR FRIDAY OKONOFUA
FLAME UNIVERSITY	VICECHANCELLOR	DR. DEVI SINGH
RIPHAH INTERNATIONAL UNIVERSITY FAISALABAD	VICECHANCELLOR	ANIS AHMAD
FACULTY OF VISUAL ARTS, BANARAS HINDU UNIVERSITY	VICECHANCELLOR	GIRISH CHANDRA TRIPATHI
CHAUDHARY BANSI LAL UNIVERSITY	VICECHANCELLOR	PROF. S.K. GAKHAR
UNIVERSITY COLLEGE OF SCIENCE, TECHNOLOGY & AGRICULTURE	VICECHANCELLOR	SUGATA MARJIT
UTTARAKHAND SANSKRIT UNIVERSITY	VICECHANCELLOR	PROF. PIYUSH KANT DIXIT
GUANGDONG TECHNION-ISRAEL INSTITUTE OF TECHNOLOGY	VICECHANCELLOR	AARON CIECHANOVER
FARIDPUR ENGINEERING COLLEGE	VICECHANCELLOR	AAMS AREFIN SIDDIQUE
BANGLADESH ARMY INTERNATIONAL UNIVERSITY OF SCIENCE & TECHNOLOGY	VICECHANCELLOR	BRIG. GEN.
BRAC UNIVERSITY	VICECHANCELLOR	SYED SAAD ANDALEEB
UNIVERSITY OF KISUBI	VICECHANCELLOR	JOHN SSEBUWUFU
MARKAZ LAW COLLEGE	VICECHANCELLOR	HUSSAIN SAQAFI CHULLIKKOD
MARKAZ ARTS AND SCIENCE COLLEGE	VICECHANCELLOR	HUSSAIN SAQAFI CHULLIKKOD
RAJSHAHI SCIENCE & TECHNOLOGY UNIVERSITY	VICECHANCELLOR	PROF. DR. MOHAMMED SHAHJAHAN
